WKT;WKT_2;ID;CO_FRAC_RA;COMUNA;FRACCION;RADIO;TOTAL_POB;T_VARON;T_MUJER;I_MASCULINIDAD;T_VIVIENDA;V_PARTICUL;V_PARTICUL_POR;V_COLECTIV;V_COLECTIV_POR;T_HOGAR;H_CON_NBI;H_CON_NBI_POR;H_SIN_NBI;H_SIN_NBI_POR
MULTIPOLYGON (((-58.372489764082054 -34.591546570810728,-58.372611919516402 -34.59151271605257,-58.372623878948012 -34.591682549694383,-58.373690762625685 -34.591164829575689,-58.373750269203882 -34.591153518884397,-58.373974541729943 -34.591130973987106,-58.374153045168192 -34.591112180170079,-58.374001304695014 -34.590945612852963,-58.373551693744893 -34.590495846031075,-58.373790906972935 -34.590357690084311,-58.373497681143306 -34.58998309511086,-58.372689323596518 -34.588991405959604,-58.377251348888542 -34.586418666982766,-58.377214745405055 -34.586239760920847,-58.377141384871457 -34.58603223638012,-58.37705375669249 -34.585859005335308,-58.37705321764016 -34.585811871026067,-58.376927562809364 -34.585686321586984,-58.376632769274693 -34.585638679410209,-58.375536787014418 -34.584311824619405,-58.375648181119558 -34.58422221290656,-58.375779490532565 -34.584191622656306,-58.37643628980414 -34.583793198745461,-58.377290103311786 -34.583291056293547,-58.376710511988811 -34.582589123603846,-58.376624569389953 -34.582472927844861,-58.376502452244758 -34.582296765741411,-58.376380331741061 -34.582124349805063,-58.375927946975359 -34.581573323438718,-58.375832963030412 -34.58144213548961,-58.375126962143703 -34.580535192916891,-58.373971739765643 -34.579102296303084,-58.373972662806899 -34.579100266318122,-58.3738505825076 -34.57894498558219,-58.374303728020109 -34.57869977404517,-58.368009146042262 -34.578210314661916,-58.367976707757961 -34.578208247154095,-58.36794980412057 -34.578206043083306,-58.367928512282667 -34.578210745058392,-58.367909428560566 -34.578220448951797,-58.367877732676227 -34.57823943920458,-58.365429003621173 -34.579640316691886,-58.365333404361294 -34.579695031454669,-58.365315256456633 -34.57970487653688,-58.365292924080464 -34.579725211666585,-58.365242545634061 -34.580138146179145,-58.365250783198057 -34.580156815494988,-58.365275294210342 -34.580166765047828,-58.365302113505876 -34.58016875836433,-58.370562952187214 -34.58058257824058,-58.370590026724187 -34.580584993140455,-58.370608747712424 -34.580595571081339,-58.370616640491541 -34.58061916955441,-58.370596956612808 -34.580786767215976,-58.370590121030858 -34.580808241812555,-58.37057205507589 -34.580821327306339,-58.369830535058234 -34.581244867228968,-58.369027319092893 -34.581704201810858,-58.369008745753753 -34.581713765411138,-58.368987701177169 -34.581725017320785,-58.368951083561662 -34.581727947067272,-58.368929457480867 -34.581726240244244,-58.368898210375434 -34.581723751344001,-58.368871305738999 -34.581721406624986,-58.365205958336304 -34.581428169825557,-58.36266917580047 -34.58122744700993,-58.362639204703591 -34.581226295636107,-58.36261228529473 -34.581236555674629,-58.36054462089119 -34.582410665163621,-58.36052536134612 -34.582423396039147,-58.360509157117733 -34.582444369241514,-58.360505553394766 -34.582466761500704,-58.360465333312959 -34.58283822178101,-58.360471264020084 -34.582862593934991,-58.360489803239808 -34.58288190601963,-58.360510142183898 -34.58289178260604,-58.360537983012328 -34.58289462292926,-58.365203474626739 -34.583263383423045,-58.366092286096666 -34.583333811336701,-58.366114931904228 -34.583337632231093,-58.366139263550032 -34.583356314212836,-58.366141876275542 -34.583379627084675,-58.366144245672508 -34.58353970587298,-58.36614277635136 -34.583558508289684,-58.36613160156169 -34.583575753668853,-58.366113191504056 -34.583590739708775,-58.366072109965465 -34.583624018399789,-58.365537547629224 -34.584046709726671,-58.365202591076461 -34.584311594170387,-58.364986790390105 -34.584478400161608,-58.364959180672301 -34.584495773122015,-58.36493414167888 -34.58449934476134,-58.364909195177859 -34.584496648610958,-58.36052442746751 -34.584160507894047,-58.359949541001399 -34.584111502171133,-58.359906778862495 -34.584124354006995,-58.359894898598832 -34.584160190517103,-58.359709119095299 -34.585867637788496,-58.35970857567677 -34.585893976413956,-58.359717324705876 -34.585911660561607,-58.359731954040846 -34.585925546700636,-58.359750761909545 -34.58593457701302,-58.35977902949513 -34.585937417868827,-58.359801933348372 -34.585939479517002,-58.35983709874229 -34.585942044473377,-58.36361443254247 -34.586235392575603,-58.363635632154548 -34.586238578926348,-58.363653412568056 -34.586252748854335,-58.363655427355425 -34.586277117662874,-58.363521695096573 -34.587457619621787,-58.363497045442827 -34.5874910516253,-58.363441613053112 -34.587487837413612,-58.359651547188648 -34.587184684098688,-58.359614933119261 -34.587182540417267,-58.359592275869872 -34.58718738062602,-58.35956875479863 -34.587202150073971,-58.359556211504099 -34.587222774099075,-58.359551925813875 -34.587245377011868,-58.359455945544042 -34.588079906526197,-58.359478421758425 -34.588083939782464,-58.359501238598988 -34.588087973322615,-58.359524225927814 -34.588091866151956,-58.359547043120862 -34.588095617982546,-58.359569774724903 -34.588099721863195,-58.359591995221237 -34.588103966158243,-58.359613704261911 -34.588108632569615,-58.359634646292157 -34.588113791306483,-58.359636921417753 -34.588133301044863,-58.35963774958708 -34.588152246158536,-58.359641047456826 -34.588171052507086,-58.359644941768465 -34.588189577657815,-58.359651731824286 -34.588207753126937,-58.359659714590521 -34.588225507050446,-58.35966948650848 -34.588242558230668,-58.359680025096665 -34.588259398781219,-58.359693887039718 -34.588274411077336,-58.359708686314157 -34.588288931185446,-58.359725616844777 -34.588301551606307,-58.35974348505443 -34.588313398137139,-58.359763314815361 -34.588322851858635,-58.359784168539633 -34.588330616232454,-58.359805278257404 -34.588337958266571,-58.359834735114063 -34.588343828401008,-58.360832427846219 -34.588552279126063,-58.360813633901877 -34.58867078926334,-58.360797224426051 -34.588719439463233,-58.360740245487229 -34.588936020171808,-58.360772598040505 -34.588941822073885,-58.360847270495398 -34.588671028616503,-58.360876266071436 -34.588566541626406,-58.361405388902647 -34.588669732503618,-58.363467318268889 -34.589034967677641,-58.364530496011376 -34.589248864823261,-58.36519086542036 -34.589375031615511,-58.365639921828993 -34.589457327000474,-58.366821978984532 -34.589693148644422,-58.367990838611519 -34.589923486100261,-58.36797503341289 -34.590111615981904,-58.3679315748821 -34.590440645025531,-58.367774340983857 -34.590528552355131,-58.367728688062492 -34.590557860012417,-58.367530883858713 -34.59066250297645,-58.367461603248202 -34.590647996858763,-58.367428396049071 -34.590643886271231,-58.367395017329713 -34.590640831920346,-58.367361467330262 -34.590638622530193,-58.367327916205973 -34.590637399084322,-58.367294278877516 -34.590637091090827,-58.367260640260824 -34.590637909892003,-58.367227085835431 -34.590639573853473,-58.367193700517106 -34.590642294317703,-58.367160399387849 -34.590645859942505,-58.367127182204726 -34.590650482003404,-58.367094304523064 -34.590656090275608,-58.36706159618587 -34.590662543775373,-58.367029227348027 -34.590669983486855,-58.366997198089187 -34.590678338985029,-58.366965508408491 -34.590687610270159,-58.366934243463632 -34.590697797409462,-58.366903403172877 -34.590708970828203,-58.366873072936578 -34.590720919318038,-58.366843337831945 -34.590733713371577,-58.366814112537789 -34.590747493772653,-58.366785397377107 -34.590761978820488,-58.366757362585915 -34.590777239075237,-58.366730007920907 -34.590793485812419,-58.366703418864269 -34.590810437398716,-58.366677510338036 -34.590828023342119,-58.366652282017853 -34.590846525344844,-58.366627989785201 -34.590865591481375,-58.366604377920389 -34.590885432827122,-58.366581701980991 -34.590905979158158,-58.366559962048214 -34.590927160050548,-58.366538987966713 -34.590948834519374,-58.366519034970096 -34.590971214042312,-58.366499932903103 -34.590994157635059,-58.366481596038696 -34.591018158207596,-58.366363870150707 -34.591196945600252,-58.366268193955001 -34.591159896751797,-58.366228521773202 -34.591223177743075,-58.366318400526353 -34.591265996918445,-58.365896288992779 -34.591906744291606,-58.365801891471193 -34.591868076313865,-58.365760086328088 -34.59193417246297,-58.365849709471085 -34.591977555178296,-58.365191532211092 -34.592976788417936,-58.365047883362706 -34.593179850483601,-58.364379959335714 -34.594195339567982,-58.364368263729801 -34.594219415585663,-58.364362537526624 -34.594236665161418,-58.364358939631408 -34.594254550279231,-58.364357385547102 -34.594272507469491,-58.364357960437374 -34.594290536800578,-58.364360749797889 -34.594308356640461,-58.364365583305307 -34.594325966851436,-58.364372461375773 -34.594343015307601,-58.364381384010443 -34.594359502008516,-58.364392181217355 -34.594375145115762,-58.364404768000668 -34.594389803709021,-58.364418974036077 -34.594403477652811,-58.364434799655541 -34.594415885243848,-58.364452074616999 -34.59442695591963,-58.364470458353281 -34.594436618980133,-58.364490036274887 -34.594444663217899,-58.364510297323243 -34.594451158646379,-58.364595588000668 -34.594487073702794,-58.364614738064098 -34.594496878208105,-58.364634486918241 -34.594504429583104,-58.364655260208821 -34.594509869020335,-58.364676717284375 -34.594513196245302,-58.364698432330414 -34.594514410915806,-58.364720235103007 -34.594513442469776,-58.364741614625032 -34.594510290496977,-58.364762485566999 -34.594505095779553,-58.364782337117539 -34.5944977170575,-58.364801083699703 -34.594488506389027,-58.364818299500051 -34.594477463432824,-58.364833728865307 -34.594464728835291,-58.36484728630257 -34.594450584229435,-58.364858630996991 -34.594435170193215,-58.364867592294196 -34.594418768291483,-58.364873829545417 -34.594401378251604,-58.365191283827485 -34.593918233295206,-58.365677737305525 -34.593178873943586,-58.3658929794519 -34.592851074350705,-58.365907219204118 -34.592835662509273,-58.36592724221137 -34.592826875228859,-58.365956198692849 -34.592825348831745,-58.365985141543675 -34.592835583439161,-58.366098519220095 -34.592884548387481,-58.366119887515111 -34.592890692300202,-58.36614451017941 -34.592881063521027,-58.366168961212921 -34.592872561405606,-58.366192847062131 -34.592837297230865,-58.366379934619573 -34.59292061729964,-58.366359370021982 -34.592955954557823,-58.366366927074381 -34.592975257050718,-58.366368265262828 -34.592996385691414,-58.366386303792659 -34.593009921582983,-58.366777765980132 -34.593178475908367,-58.366911496187619 -34.59322914630232,-58.366977554479931 -34.593178351084639,-58.367166013584985 -34.593255191895096,-58.367150597875145 -34.593330886999929,-58.369121906914565 -34.594173292352934,-58.369054323959553 -34.594217185877106,-58.367899385220838 -34.597486631419443,-58.367884941461249 -34.597512715280516,-58.367863141909091 -34.597519783681705,-58.367834003992705 -34.597518886633019,-58.366501795126545 -34.597418892277375,-58.366482127725213 -34.597426224094576,-58.366462706478508 -34.597444606666272,-58.366456756241 -34.597471383843242,-58.366448714945342 -34.597496446628703,-58.366442127904833 -34.59755549495906,-58.366426952144039 -34.597688869495002,-58.366360402535868 -34.598257990811895,-58.366092322083134 -34.598237637252609,-58.366175398733823 -34.597467391887534,-58.366174382367156 -34.597424249714706,-58.366148930791304 -34.59739363460573,-58.366103357819618 -34.597385852889872,-58.363836844183076 -34.5972078348575,-58.363820097818291 -34.59720046551417,-58.363810596288189 -34.597187648310083,-58.364399939224896 -34.595524914111344,-58.364405942651416 -34.595489283770483,-58.364404686434902 -34.59547125389436,-58.364400619408102 -34.595453573880249,-58.364393826487373 -34.595436455071848,-58.36437862007152 -34.595414148439943,-58.36436793333624 -34.595398887409566,-58.364350989593149 -34.595383522176874,-58.36431331938698 -34.595362136620935,-58.364147481339515 -34.595317868140228,-58.364082473036852 -34.595304582434643,-58.3640670709134 -34.595303839817426,-58.364047175334555 -34.595305022654316,-58.363997230757192 -34.595311328427613,-58.363970416542749 -34.595318806743649,-58.363944186406897 -34.595330143703862,-58.363922239000487 -34.595342601914574,-58.363901356760948 -34.595357693197961,-58.363884057724661 -34.595375482694578,-58.36386060473081 -34.595407392819581,-58.363848427945065 -34.59543537276766,-58.363817979544748 -34.595427929221024,-58.363809436340837 -34.595452883260982,-58.363820083472959 -34.595455488044934,-58.363792423390237 -34.59553277339834,-58.363799768497863 -34.595534573223503,-58.363791795983744 -34.595556273513942,-58.363784647080656 -34.595554482861466,-58.363582587462332 -34.596132279182868,-58.363600036224476 -34.596135466434148,-58.363532549642919 -34.596326670789942,-58.363522610730165 -34.596324273888392,-58.363495134767682 -34.596402091163696,-58.36350507368892 -34.596404488067414,-58.36341459507679 -34.596660829959418,-58.36313793377137 -34.596637666200458,-58.36276610352585 -34.596567148296835,-58.362483013030968 -34.596498674077743,-58.362239067520157 -34.596385370557513,-58.36201622711522 -34.596285605609594,-58.361679340888699 -34.596124828060795,-58.361094151283396 -34.595857888587076,-58.361115406028141 -34.595826109003291,-58.360925930030817 -34.595739343848287,-58.360906996995453 -34.595766778126652,-58.360428826791725 -34.595537777965411,-58.36037974242349 -34.595512309360416,-58.360348837641872 -34.595477244347151,-58.3603289843497 -34.595470538985396,-58.360318247013637 -34.595429371208702,-58.360318943260545 -34.595382766053532,-58.360352436600401 -34.595257209620371,-58.360360812322249 -34.59521503358031,-58.360360721096512 -34.595194463983418,-58.360362406039243 -34.595177697138958,-58.360359201135914 -34.595159395153864,-58.360337058449645 -34.595109039992295,-58.360323481197341 -34.595086979301065,-58.360309426797379 -34.595071778190928,-58.360294597831853 -34.595057072222907,-58.360283914095035 -34.595048896180892,-58.360271117626183 -34.595040725125891,-58.360238225916561 -34.595024347586268,-58.360205661748807 -34.595018100281251,-58.360184703226196 -34.595014945653368,-58.360160537135314 -34.595013996863237,-58.360109572259695 -34.595007928782408,-58.360081179717724 -34.595002164608573,-58.360045741546116 -34.59499497004056,-58.360015250574079 -34.594995954003608,-58.359886931410877 -34.594991086338695,-58.359504605362218 -34.594946610931707,-58.35943383148178 -34.594941071976137,-58.359338993521362 -34.59493091784968,-58.359307791870719 -34.594927577129525,-58.359260960895043 -34.594928249582203,-58.359234034531404 -34.594937802979665,-58.359199566940141 -34.594937239001858,-58.359145272951579 -34.594934614812409,-58.359084164507372 -34.594933129645703,-58.358943424032098 -34.594923815340678,-58.358885983929021 -34.594917798934169,-58.358837980139768 -34.594914873468404,-58.358805969160841 -34.594919714012576,-58.358743870535193 -34.594934300565406,-58.358680643459827 -34.594962155369039,-58.35867369695822 -34.594973020852514,-58.358673064934095 -34.59499032802416,-58.358667017700974 -34.595013803774748,-58.358531523177916 -34.594950462650004,-58.358499945800936 -34.594936372958941,-58.358475975574471 -34.594934750294705,-58.355931628879539 -34.594774037621754,-58.354261270344224 -34.594688124861229,-58.351140094745695 -34.595166949667821,-58.351138308258705 -34.595356603212736,-58.354279530871885 -34.594857302539488,-58.357323174419989 -34.595093242042012,-58.357688512992546 -34.595143149208816,-58.358515789601732 -34.595181677815603,-58.359252361857017 -34.595240320045903,-58.363281413407599 -34.597085898945409,-58.363450930119512 -34.597125686343283,-58.363439820690566 -34.597157579936656,-58.363533560683656 -34.597180333075912,-58.363499349393003 -34.597302422617325,-58.363233665172878 -34.598061390262586,-58.363730729601876 -34.598104401680793,-58.363861677708201 -34.59813619916595,-58.364088622384607 -34.598156172263408,-58.365068718313069 -34.598227667288214,-58.365960931457323 -34.598292816956857,-58.3666064564148 -34.598325018359333,-58.367359403104786 -34.598259761394623,-58.367777702989038 -34.598292976083215,-58.367980701469946 -34.598401870366146,-58.368116331843062 -34.598437188181158,-58.369512342616247 -34.598321285979978,-58.370478477094679 -34.595927632361018,-58.372189171576558 -34.591762835613089,-58.372289866312663 -34.591614178227424,-58.372350541104318 -34.591534565939853,-58.372489764082054 -34.591546570810728)));;1;1_1_1;COMUNA 1;1;1;336;212;124;170,97%;82;80;97,56%;2;2,50%;65;19;29,23%;46;70,77%
MULTIPOLYGON (((-58.386522330570898 -34.603993093474372,-58.38634220079723 -34.603982487531539,-58.385132649433665 -34.603911581128436,-58.385042562216405 -34.605074102378872,-58.385038627131635 -34.605183963113554,-58.38647593187769 -34.605275929211338,-58.386495104114609 -34.605173754289858,-58.386522330570898 -34.603993093474372)));;2;1_12_1;COMUNA 1;12;1;341;184;157;117,20%;365;361;98,90%;4;1,11%;116;25;21,55%;91;78,45%
MULTIPOLYGON (((-58.37938327879349 -34.604838177477156,-58.378006464296227 -34.604744338782503,-58.378071018883702 -34.603491519965146,-58.376658703910358 -34.603405036074776,-58.376653954057929 -34.60355102409688,-58.376579393773895 -34.604657350756305,-58.376569879030882 -34.604798476046234,-58.376528871720375 -34.605825668270683,-58.37651426933661 -34.60619179824868,-58.376502281935885 -34.606417572761551,-58.376724708135299 -34.60630117609977,-58.377508053798636 -34.60588994978815,-58.377957246838314 -34.605654197523712,-58.379379035670311 -34.60490789548102,-58.37938327879349 -34.604838177477156)));;3;1_12_10;COMUNA 1;12;10;296;162;134;120,90%;629;627;99,68%;2;0,32%;101;1;0,99%;100;99,01%
MULTIPOLYGON (((-58.367921141467477 -34.605174261616412,-58.367724625064341 -34.606913327850215,-58.368012847947959 -34.606922425432757,-58.368155131885302 -34.606964438710435,-58.368380547233173 -34.606915700628299,-58.368828936542997 -34.606825446813339,-58.369082147261544 -34.606767174167018,-58.36922021389622 -34.60673700082976,-58.369250818098642 -34.606589564796515,-58.369365877809663 -34.60652387579885,-58.369438812030673 -34.606501958929279,-58.3696631849498 -34.606529786931773,-58.369844443586622 -34.606552622271025,-58.369846165110374 -34.606552765320956,-58.369846280498024 -34.606552774909098,-58.370192455483576 -34.606771691619187,-58.37019425809995 -34.606790462465426,-58.370303681293386 -34.607190811249652,-58.370582267025931 -34.607363918609721,-58.370624043142783 -34.607389873942779,-58.370757686885668 -34.607509224200079,-58.370823899834889 -34.607585174206434,-58.370927288321411 -34.607699469549971,-58.370917765517895 -34.607838904111929,-58.372177935104276 -34.607929355892466,-58.37318473640871 -34.607992917913229,-58.373517924034154 -34.608013937318539,-58.373515280771393 -34.607936890312665,-58.373570897045759 -34.607940522634429,-58.375001698201153 -34.607203081665311,-58.37557967513608 -34.606900526844349,-58.376502281935885 -34.606417572761551,-58.37651426933661 -34.60619179824868,-58.376528871720375 -34.605825668270683,-58.376569879030882 -34.604798476046234,-58.376579393773895 -34.604657350756305,-58.376653954057929 -34.60355102409688,-58.376658703910358 -34.603405036074776,-58.375216328330616 -34.603316612809458,-58.373849753508658 -34.603232875776051,-58.372575160556714 -34.603154755001292,-58.372460613102795 -34.603147205272002,-58.371274260267313 -34.603069136136284,-58.371094050620243 -34.603057310396608,-58.370614996532318 -34.603025751450453,-58.370472513266215 -34.603018178768842,-58.370263429936813 -34.603007104651574,-58.370074445900947 -34.602997101812974,-58.369931111022126 -34.602989527852699,-58.369182869304694 -34.602924165520427,-58.369010841053985 -34.602908469590133,-58.3681856739856 -34.602833225734528,-58.368047530225532 -34.604056008376695,-58.367921141467477 -34.605174261616412)));;4;1_12_11;COMUNA 1;12;11;528;294;234;125,64%;375;370;98,67%;5;1,35%;136;7;5,15%;129;94,85%
MULTIPOLYGON (((-58.385132649433665 -34.603911581128436,-58.383711459095991 -34.603828201507511,-58.383710635415902 -34.603978488280141,-58.383620055590889 -34.605100584096874,-58.383735459359222 -34.605107208377326,-58.384901080080141 -34.605175142768779,-58.385038627131635 -34.605183963113554,-58.385042562216405 -34.605074102378872,-58.385132649433665 -34.603911581128436)));;5;1_12_2;COMUNA 1;12;2;229;101;128;78,91%;445;445;100,00%;0;0,00%;129;16;12,40%;113;87,60%
MULTIPOLYGON (((-58.382133606503793 -34.605014326781173,-58.382125873703281 -34.605172074015492,-58.382078091972808 -34.606140810754042,-58.382209851233299 -34.606146743032035,-58.383450174049834 -34.606224459209031,-58.383581417285349 -34.606235882831683,-58.383614540261931 -34.605168329518811,-58.383620055590889 -34.605100584096874,-58.383710635415902 -34.603978488280141,-58.383711459095991 -34.603828201507511,-58.382205530228347 -34.603739819699364,-58.382150026327054 -34.604680804088588,-58.382133606503793 -34.605014326781173)));;6;1_12_3;COMUNA 1;12;3;723;374;349;107,16%;744;739;99,33%;5;0,68%;314;104;33,12%;210;66,88%
MULTIPOLYGON (((-58.385038627131635 -34.605183963113554,-58.384901080080141 -34.605175142768779,-58.383735459359222 -34.605107208377326,-58.383620055590889 -34.605100584096874,-58.383614540261931 -34.605168329518811,-58.383581417285349 -34.606235882831683,-58.383708657618634 -34.606247022021158,-58.384879891854084 -34.606340594998528,-58.384992401238485 -34.606347497944554,-58.385010466172496 -34.606247576175022,-58.385035739822378 -34.605266217853639,-58.385038627131635 -34.605183963113554)));;7;1_12_4;COMUNA 1;12;4;393;168;225;74,67%;341;339;99,41%;2;0,59%;209;110;52,63%;99;47,37%
MULTIPOLYGON (((-58.384992401238485 -34.606347497944554,-58.384977504395685 -34.606429533742769,-58.384917545936467 -34.607429321140401,-58.38491575014703 -34.60752826729783,-58.38538010272682 -34.607557014200879,-58.386309408571691 -34.607610700124752,-58.386308226069197 -34.607506822323423,-58.386366742864141 -34.606575064024696,-58.386376664345654 -34.606436966535234,-58.386450768208881 -34.605410073402638,-58.38647593187769 -34.605275929211338,-58.385038627131635 -34.605183963113554,-58.385035739822378 -34.605266217853639,-58.385010466172496 -34.606247576175022,-58.384992401238485 -34.606347497944554)));;8;1_12_5;COMUNA 1;12;5;600;264;336;78,57%;505;504;99,80%;1;0,20%;275;32;11,64%;243;88,36%
MULTIPOLYGON (((-58.384992401238485 -34.606347497944554,-58.384879891854084 -34.606340594998528,-58.383708657618634 -34.606247022021158,-58.383581417285349 -34.606235882831683,-58.383450174049834 -34.606224459209031,-58.382209851233299 -34.606146743032035,-58.382078091972808 -34.606140810754042,-58.382070619996462 -34.60629285369172,-58.382022336556908 -34.60733863498622,-58.38216567833615 -34.607347955376419,-58.38350881116191 -34.607441514000882,-58.383647808987583 -34.607451181955994,-58.38491575014703 -34.60752826729783,-58.384917545936467 -34.607429321140401,-58.384977504395685 -34.606429533742769,-58.384992401238485 -34.606347497944554)));;9;1_12_6;COMUNA 1;12;6;472;220;252;87,30%;504;502;99,60%;2;0,40%;202;49;24,26%;153;75,74%
MULTIPOLYGON (((-58.38538010272682 -34.607557014200879,-58.38491575014703 -34.60752826729783,-58.383647808987583 -34.607451181955994,-58.38350881116191 -34.607441514000882,-58.383464292047378 -34.60857779439521,-58.383607804137014 -34.608589578080434,-58.384707615290893 -34.608674866639696,-58.384865947090852 -34.608688207669999,-58.385063542564041 -34.608704813040667,-58.386143437443778 -34.608776836061729,-58.386275794889301 -34.608785510904191,-58.386309408571691 -34.607610700124752,-58.38538010272682 -34.607557014200879)));;10;1_12_7;COMUNA 1;12;7;786;381;405;94,07%;546;542;99,27%;4;0,74%;347;89;25,65%;258;74,35%
MULTIPOLYGON (((-58.38350881116191 -34.607441514000882,-58.38216567833615 -34.607347955376419,-58.382022336556908 -34.60733863498622,-58.381970573441549 -34.608458148872828,-58.382168252144801 -34.608475604088731,-58.383304086657958 -34.608564591177036,-58.383464292047378 -34.60857779439521,-58.38350881116191 -34.607441514000882)));;11;1_12_8;COMUNA 1;12;8;329;162;167;97,01%;275;269;97,82%;6;2,23%;129;15;11,63%;114;88,37%
MULTIPOLYGON (((-58.376502281935899 -34.606417572761551,-58.37557967513608 -34.606900526844349,-58.375001698201153 -34.607203081665318,-58.373570897045745 -34.607940522634429,-58.374110281220432 -34.607975987174903,-58.374916845204474 -34.608029600258099,-58.374981574809595 -34.608033872319417,-58.376203091213952 -34.608115099468577,-58.376399325997816 -34.608126647297624,-58.377809082019809 -34.608211301351915,-58.37921713550152 -34.608297839431231,-58.37935545374787 -34.608306596284223,-58.380491478732857 -34.608369763668648,-58.38071293188851 -34.60837639179168,-58.380887108596696 -34.608386438651237,-58.381343117758206 -34.608414631921121,-58.38179248378129 -34.60844246695612,-58.381970573441549 -34.608458148872828,-58.382022336556908 -34.60733863498622,-58.382070619996462 -34.60629285369172,-58.382078091972808 -34.606140810754042,-58.382125873703281 -34.605172074015492,-58.382133606503793 -34.605014326781173,-58.382150026327054 -34.604680804088588,-58.382205530228347 -34.603739819699364,-58.38200120590119 -34.603736233901458,-58.381836820345903 -34.603827677786704,-58.38144786246427 -34.603810972929132,-58.38135887617527 -34.603805896615853,-58.381269888264789 -34.603802492577785,-58.381173224662199 -34.603673216359397,-58.380975118304811 -34.603669421722294,-58.380955935561197 -34.604036535260882,-58.380555987350483 -34.604274444558364,-58.380331596092795 -34.604407889813309,-58.379497914593415 -34.604845509492506,-58.37938327879349 -34.604838177477156,-58.379379035670333 -34.604907895481013,-58.377957246838314 -34.605654197523712,-58.377508053798628 -34.605889949788171,-58.376724708135313 -34.60630117609977,-58.376502281935899 -34.606417572761551)));;12;1_12_9;COMUNA 1;12;9;1356;650;706;92,07%;895;885;98,88%;10;1,13%;342;57;16,67%;285;83,33%
MULTIPOLYGON (((-58.363178630754426 -34.598218464054099,-58.363006432498921 -34.598710525320811,-58.362953882568355 -34.598860679664675,-58.362920118973406 -34.598957154286424,-58.360933544972291 -34.604575313576746,-58.361536078525234 -34.604637143196435,-58.363077158480159 -34.600404673447329,-58.363742151905669 -34.60044980278019,-58.363801017317634 -34.600453797464979,-58.363379292511006 -34.604792184321084,-58.363590165578763 -34.604805314017653,-58.364531685485979 -34.604864105481425,-58.364648450487316 -34.604885886562514,-58.364735225648083 -34.604926636848909,-58.364798842471366 -34.60497215444488,-58.364842192225403 -34.605024834680897,-58.364876881827193 -34.605091081256667,-58.365340946976787 -34.605129552433844,-58.36553606060626 -34.605145694472711,-58.365567742081659 -34.605148325427912,-58.36638020439306 -34.605154955642114,-58.366638923282352 -34.605187864967967,-58.366712344012534 -34.605213950850448,-58.366743766330956 -34.605263139756033,-58.366800869219539 -34.605309306778565,-58.366824144246124 -34.605322489170263,-58.366869605482719 -34.605329754912212,-58.366904603644628 -34.605310984322713,-58.366922141736346 -34.605267617923793,-58.366950137913122 -34.605254625846747,-58.366954246902353 -34.605252594145036,-58.367028835134619 -34.605254687578835,-58.367105791814723 -34.605247517868605,-58.367216078813208 -34.605150721850492,-58.367287800484561 -34.605133425889086,-58.367349001081934 -34.605140703759389,-58.367921141467477 -34.605174261616412,-58.368047530225532 -34.604056008376695,-58.3681856739856 -34.602833225734528,-58.368185678807876 -34.602833183049391,-58.368185702732582 -34.602832971276086,-58.368313374938417 -34.601703168589822,-58.368389511862567 -34.601029540132984,-58.368631465797804 -34.600435901670906,-58.369072405725632 -34.599354087128596,-58.369129874784022 -34.599219196507597,-58.369512342616261 -34.598321285979864,-58.368942099547901 -34.598368597464798,-58.368116331843062 -34.598437188181158,-58.367980701469946 -34.598401870366118,-58.367777702989017 -34.598292976083258,-58.367359403104786 -34.598259761395141,-58.3666064564148 -34.598325018359333,-58.366221100126026 -34.598305769901494,-58.365960931457323 -34.598292816956842,-58.365068718313069 -34.598227667288214,-58.364088622384578 -34.598156172263401,-58.363861677708201 -34.59813619916595,-58.363730729601876 -34.598104401680793,-58.363233665172878 -34.598061390262586,-58.363178630754426 -34.598218464054099),(-58.36480828006178 -34.599025587595335,-58.364696003996009 -34.600062508603308,-58.363889167870418 -34.60000183424183,-58.364001635356118 -34.598975358461566,-58.36480828006178 -34.599025587595335)));;13;1_13_1;COMUNA 1;13;1;586;364;222;163,96%;404;402;99,50%;2;0,50%;163;1;0,61%;162;99,39%
MULTIPOLYGON (((-58.361396052022585 -34.60505971871077,-58.361278960603542 -34.605391887228905,-58.361493140199777 -34.605488758781767,-58.361577153078684 -34.60553305542286,-58.361657317953977 -34.605589954917946,-58.361733719942791 -34.605659527769802,-58.361798519313034 -34.605744866207885,-58.361844328737533 -34.605827090209111,-58.361874714148961 -34.60591556928388,-58.361893779105216 -34.605997700735969,-58.361947142569711 -34.606102044426045,-58.362015783002789 -34.606181047653465,-58.362103583930782 -34.606263306196091,-58.36217607269468 -34.606329706407138,-58.362271574000218 -34.606383448996262,-58.362367094319353 -34.606421486723505,-58.362489274505954 -34.606459475849917,-58.362638296182098 -34.60648804990312,-58.362787247970012 -34.606503947195009,-58.362940129142793 -34.606510410551536,-58.363139016222178 -34.606523443101359,-58.362970821999888 -34.608099369363259,-58.364134582558492 -34.608168206014952,-58.363866623920444 -34.610599941510173,-58.363735545653967 -34.611633920456171,-58.363728293706039 -34.611697335046692,-58.363624585379654 -34.611824259768255,-58.363675023471004 -34.611901886994431,-58.363675175212251 -34.611902120532967,-58.363697415035375 -34.611967352187961,-58.364652196387667 -34.612045238677084,-58.364704747764151 -34.612049506402428,-58.365007788991889 -34.612076088407925,-58.365592617898493 -34.612094020716299,-58.365956456503049 -34.612139593082944,-58.365981578478099 -34.612145035730748,-58.366073124571351 -34.612164968137058,-58.36619520181052 -34.612227038814154,-58.366325454026168 -34.612365034038881,-58.366432694720601 -34.612219197984977,-58.366609109932831 -34.612140108867678,-58.366839609819976 -34.612139163393934,-58.367127324726731 -34.612161220888126,-58.367259152179045 -34.610998465378898,-58.367550142375777 -34.60844493809833,-58.367724625064341 -34.606913327850215,-58.367921141467477 -34.605174261616412,-58.367349001081934 -34.605140703759389,-58.367287800484561 -34.605133425889086,-58.367216078813208 -34.605150721850492,-58.367105791814723 -34.605247517868605,-58.367028835134619 -34.605254687578835,-58.366954246902353 -34.605252594145036,-58.366950137913122 -34.605254625846747,-58.366922141736346 -34.605267617923793,-58.366904603644628 -34.605310984322713,-58.366869605482719 -34.605329754912212,-58.366824144246124 -34.605322489170263,-58.366800869219539 -34.605309306778565,-58.366743766330956 -34.605263139756033,-58.366712344012534 -34.605213950850448,-58.366638923282352 -34.605187864967967,-58.36638020439306 -34.605154955642114,-58.365567742081659 -34.605148325427912,-58.36553606060626 -34.605145694472711,-58.365340946976787 -34.605129552433844,-58.364876881827193 -34.605091081256667,-58.364842192225403 -34.605024834680897,-58.364798842471366 -34.60497215444488,-58.364735225648083 -34.604926636848909,-58.364648450487316 -34.604885886562514,-58.364531685485979 -34.604864105481425,-58.363590165578763 -34.604805314017653,-58.363379292511006 -34.604792184321084,-58.362279818720253 -34.604699731700947,-58.361536078525234 -34.604637143196435,-58.361396052022585 -34.60505971871077)));;14;1_13_4;COMUNA 1;13;4;725;449;276;162,68%;641;640;99,84%;1;0,16%;136;1;0,74%;135;99,26%
MULTIPOLYGON (((-58.364540753219124 -34.612033562994846,-58.364503634533676 -34.612397546264653,-58.363997352488497 -34.612360736407851,-58.363679349920368 -34.612353932012404,-58.363391783975786 -34.614903053398791,-58.363038473987274 -34.61487713057835,-58.362888071260485 -34.616203181134672,-58.362101670043394 -34.616147717200924,-58.361943784584312 -34.61750055218689,-58.362879529534283 -34.617574560218493,-58.363144416442552 -34.617823869873817,-58.3638980784838 -34.617880893008163,-58.364102081878897 -34.617896340282364,-58.364933509199183 -34.61796306807134,-58.365742664940477 -34.618063506066115,-58.366451437996659 -34.61812012561726,-58.36659223413151 -34.616878996026792,-58.366734488830801 -34.615625120236245,-58.366855036447198 -34.614577149764003,-58.366989623280638 -34.613391861166541,-58.367127324726731 -34.612161220888126,-58.366839609819976 -34.612139163393934,-58.366609109932831 -34.612140108867678,-58.366432694720601 -34.612219197984977,-58.366325454026168 -34.612365034038881,-58.36619520181052 -34.612227038814154,-58.366073124571351 -34.612164968137058,-58.365981578478099 -34.612145035730748,-58.365956456503049 -34.612139593082944,-58.365592617898493 -34.612094020716299,-58.365007788991889 -34.612076088407925,-58.364704747764151 -34.612049506402428,-58.364652196387667 -34.612045238677084,-58.364540753219124 -34.612033562994846)));;15;1_13_13;COMUNA 1;13;13;358;226;132;171,21%;266;262;98,50%;4;1,53%;104;2;1,92%;102;98,08%
MULTIPOLYGON (((-58.36219701087785 -34.613481179518097,-58.361343815960424 -34.613420964519371,-58.361200203203204 -34.61474737105538,-58.362056137192802 -34.614807800592473,-58.362238669587704 -34.614820697967851,-58.363038473987274 -34.61487713057835,-58.363391783975786 -34.614903053398791,-58.363679349920368 -34.612353932012404,-58.363997352488497 -34.612360736407851,-58.364503634533676 -34.612397546264653,-58.364540753219124 -34.612033562994846,-58.363697415035375 -34.611967352187961,-58.363675175212251 -34.611902120532967,-58.363675023471004 -34.611901886994431,-58.363624585379654 -34.611824259768255,-58.363537758489407 -34.611776300185561,-58.363421984746495 -34.611716344713756,-58.362588056951829 -34.611656717506705,-58.362549556308693 -34.611653980288942,-58.362540956357094 -34.611653368870442,-58.362418137140239 -34.611644605697009,-58.362344204264254 -34.611712505089777,-58.362292816458805 -34.611803311138061,-58.362285024232605 -34.611907956364242,-58.36232715338997 -34.612007924190252,-58.362336981095801 -34.612122936394513,-58.36219701087785 -34.613481179518097)));;16;1_13_9;COMUNA 1;13;9;426;211;215;98,14%;252;251;99,60%;1;0,40%;157;2;1,27%;155;98,73%
MULTIPOLYGON (((-58.360906804628698 -34.617418461088441,-58.361056500467136 -34.6160739179046,-58.361200203203204 -34.61474737105538,-58.361343815960424 -34.613420964519371,-58.36219701087785 -34.613481179518097,-58.362336981095801 -34.612122936394513,-58.36232715338997 -34.612007924190252,-58.362285024232605 -34.611907956364242,-58.362292816458805 -34.611803311138061,-58.362344204264254 -34.611712505089777,-58.362418137140239 -34.611644605697009,-58.361802423368694 -34.611600504937371,-58.359527549896576 -34.611437821977084,-58.35913106458262 -34.611484529986285,-58.359234923509234 -34.611190100491491,-58.358809777727224 -34.611133047029654,-58.358817545204396 -34.611188478170106,-58.358806265435106 -34.611285796004481,-58.358776674095971 -34.61138140803817,-58.358731246258358 -34.611471372563692,-58.358679027292503 -34.611542598214704,-58.358624517781237 -34.611606286407131,-58.358570086332065 -34.61167560864579,-58.358517798284097 -34.611733735105339,-58.358474709710812 -34.611791798976107,-58.358431956955648 -34.611853736496194,-58.356844868368398 -34.61635647300006,-58.356721164621227 -34.616902625241565,-58.357670111305957 -34.617119250453463,-58.357815040601821 -34.61713283924675,-58.358077164754057 -34.617162282511138,-58.359839538839964 -34.617328012289647,-58.36024225137146 -34.617365887697986,-58.360899056933853 -34.617417847799835,-58.360906804628698 -34.617418461088441)));;17;1_13_10;COMUNA 1;13;10;614;312;302;103,31%;641;641;100,00%;0;0,00%;235;5;2,13%;230;97,87%
MULTIPOLYGON (((-58.360906804628698 -34.617418461088441,-58.361737973659778 -34.617484251490588,-58.361932945956958 -34.61749969491747,-58.361943784584312 -34.61750055218689,-58.362101670043394 -34.616147717200924,-58.362073774049364 -34.616145749635507,-58.361891409149777 -34.616132852152006,-58.361056500467136 -34.6160739179046,-58.360906804628698 -34.617418461088441)));;18;1_13_11;COMUNA 1;13;11;292;146;146;100,00%;382;382;100,00%;0;0,00%;142;1;0,70%;141;99,30%
MULTIPOLYGON (((-58.373379474430919 -34.611389803728414,-58.374646526529474 -34.611469107881881,-58.374786809497664 -34.61147709665569,-58.376205219411403 -34.611565860128763,-58.376215243603838 -34.611263391536966,-58.376263870541827 -34.610451847356025,-58.376332865957579 -34.609299812119581,-58.376357481678205 -34.608889039921564,-58.376367725259691 -34.608702913616305,-58.376399325997816 -34.608126647297624,-58.376203091213952 -34.608115099468577,-58.374981574809595 -34.608033872319417,-58.374916845204474 -34.608029600258099,-58.374110281220432 -34.607975987174903,-58.373570897045745 -34.607940522634429,-58.373515280771407 -34.607936890312658,-58.373517924034154 -34.608013937318553,-58.373510597897443 -34.608174149092562,-58.37350735072387 -34.608343237407553,-58.373504017606336 -34.608513029906028,-58.373501405732974 -34.608645568046306,-58.373495817147969 -34.608933180084001,-58.373498781548754 -34.609028537838768,-58.373500758773609 -34.609091217623877,-58.373513775136139 -34.609504270338299,-58.373448587454384 -34.610245446753332,-58.372181482849932 -34.610154228280351,-58.372053212459875 -34.610146315861826,-58.372047226212914 -34.610246526312103,-58.371988070800732 -34.611302647264864,-58.373379474430919 -34.611389803728414)));;19;1_14_1;COMUNA 1;14;1;622;325;297;109,43%;538;530;98,51%;8;1,51%;247;74;29,96%;173;70,04%
MULTIPOLYGON (((-58.373183674374943 -34.614854854553194,-58.373001818534846 -34.614844861475994,-58.371923934527068 -34.614820260547653,-58.371787391825585 -34.614814524870326,-58.371560559005481 -34.614804918670117,-58.370911906380996 -34.614787952908671,-58.370655420789269 -34.614786632865922,-58.370564754411134 -34.615894279660608,-58.370689958387338 -34.615909867658289,-58.371717036903277 -34.615979584054429,-58.371714090603703 -34.616025428544567,-58.372990837801829 -34.616025176847693,-58.373127553999645 -34.616029925355754,-58.373177771521398 -34.614957670769741,-58.373183674374943 -34.614854854553194)));;20;1_14_10;COMUNA 1;14;10;431;207;224;92,41%;341;341;100,00%;0;0,00%;220;3;1,36%;217;98,64%
MULTIPOLYGON (((-58.374576262379904 -34.614926434302546,-58.373396535191389 -34.614866560259905,-58.373183674374943 -34.614854854553194,-58.373177771521398 -34.614957670769741,-58.373127553999645 -34.616029925355754,-58.373267507075326 -34.616034816933556,-58.374337464516188 -34.616078767138731,-58.374533379193608 -34.616088275411194,-58.374542004203832 -34.615987503439591,-58.374568458320518 -34.615056574125731,-58.374576262379904 -34.614926434302546)));;21;1_14_11;COMUNA 1;14;11;522;254;268;94,78%;412;412;100,00%;0;0,00%;253;31;12,25%;222;87,75%
MULTIPOLYGON (((-58.376036485874749 -34.615000581522864,-58.374576262379904 -34.614926434302546,-58.374568458320518 -34.615056574125731,-58.374542004203832 -34.615987503439591,-58.374533379193608 -34.616088275411194,-58.374705784075921 -34.616096710038725,-58.375251439676219 -34.616132455752712,-58.375858041122804 -34.616213244013018,-58.375976099996016 -34.616220229647155,-58.376032657650953 -34.615077694214733,-58.376036485874749 -34.615000581522864)));;22;1_14_12;COMUNA 1;14;12;511;241;270;89,26%;309;307;99,35%;2;0,65%;217;43;19,82%;174;80,18%
MULTIPOLYGON (((-58.369365877809663 -34.60652387579885,-58.369250818098642 -34.606589564796515,-58.36922021389622 -34.60673700082976,-58.369082147261544 -34.606767174167018,-58.368828936542997 -34.606825446813339,-58.368380547233173 -34.606915700628299,-58.368155131885302 -34.606964438710435,-58.368012847947959 -34.606922425432757,-58.367724625064341 -34.606913327850215,-58.367550142375777 -34.60844493809833,-58.367259152179045 -34.610998465378898,-58.367127324726731 -34.612161220888126,-58.367376627681629 -34.612179444744491,-58.367365050851951 -34.612247184606247,-58.367954364304865 -34.612293067847169,-58.368387300066281 -34.612326855195477,-58.368392321942792 -34.612254884666513,-58.368875679916904 -34.612292934751501,-58.369173624227614 -34.612309079581628,-58.369358966477137 -34.612319081031806,-58.369581019476911 -34.612331082127369,-58.369778115987408 -34.61234179616239,-58.370526976308561 -34.612386732014976,-58.370810609971656 -34.612403707135826,-58.371217748422083 -34.612427675924813,-58.371922320069778 -34.612469048742668,-58.371933863751075 -34.612271867159862,-58.371988070800732 -34.611302647264864,-58.372047226212914 -34.610246526312103,-58.372053212459875 -34.610146315861826,-58.372181482849946 -34.610154228280344,-58.373448587454384 -34.610245446753318,-58.373513775136139 -34.609504270338299,-58.373500758773609 -34.609091217623877,-58.373498781548754 -34.609028537838768,-58.373495817147941 -34.60893318008398,-58.373501405732952 -34.608645568046299,-58.373504017606322 -34.608513029906028,-58.37350735072387 -34.608343237407539,-58.373510597897429 -34.608174149092562,-58.373517924034154 -34.608013937318539,-58.37318473640871 -34.607992917913229,-58.372177935104276 -34.607929355892466,-58.370917765517895 -34.607838904111929,-58.370927288321411 -34.607699469549971,-58.370823899834889 -34.607585174206434,-58.370757686885668 -34.607509224200079,-58.370624043142783 -34.607389873942779,-58.370582267025931 -34.607363918609721,-58.370303681293386 -34.607190811249652,-58.37019425809995 -34.606790462465426,-58.370192455483576 -34.606771691619187,-58.369846280498024 -34.606552774909098,-58.369846165110374 -34.606552765320956,-58.3698462813962 -34.606551968069382,-58.369844443586622 -34.606552622271025,-58.3696631849498 -34.606529786931773,-58.369438812030673 -34.606501958929279,-58.369365877809663 -34.60652387579885)));;23;1_14_2;COMUNA 1;14;2;1096;627;469;133,69%;382;378;98,95%;4;1,06%;226;74;32,74%;152;67,26%
MULTIPOLYGON (((-58.373379474430919 -34.611389803728414,-58.371988070800732 -34.611302647264864,-58.371933863751103 -34.612271867159869,-58.371922320069778 -34.612469048742689,-58.372178187386645 -34.612484098544584,-58.37331612974068 -34.612554728791849,-58.373326110695089 -34.61238198342906,-58.373379474430919 -34.611389803728414)));;24;1_14_3;COMUNA 1;14;3;383;185;198;93,43%;345;345;100,00%;0;0,00%;196;48;24,49%;148;75,51%
MULTIPOLYGON (((-58.374786809497664 -34.61147709665569,-58.374646526529474 -34.611469107881881,-58.373379474430919 -34.611389803728414,-58.373326110695089 -34.61238198342906,-58.37331612974068 -34.612554728791849,-58.373599593518321 -34.612572331130316,-58.374714019709337 -34.612651100470373,-58.374724162867295 -34.612483355289982,-58.374786809497664 -34.61147709665569)));;25;1_14_4;COMUNA 1;14;4;70;28;42;66,67%;148;148;100,00%;0;0,00%;39;0;0,00%;39;100,00%
MULTIPOLYGON (((-58.374714019709337 -34.612651100470373,-58.374643025289629 -34.613816936004362,-58.374637563164185 -34.613907498670791,-58.374576262379904 -34.614926434302546,-58.376036485874749 -34.615000581522864,-58.376086599731309 -34.613991496720381,-58.376091372246961 -34.613907271753696,-58.376156968025811 -34.612753051683562,-58.376205219411403 -34.611565860128763,-58.374786809497664 -34.61147709665569,-58.374724162867295 -34.612483355289982,-58.374714019709337 -34.612651100470373)));;26;1_14_5;COMUNA 1;14;5;484;253;231;109,52%;290;289;99,66%;1;0,35%;226;123;54,42%;103;45,58%
MULTIPOLYGON (((-58.373248778245831 -34.613720988736475,-58.373183674374943 -34.614854854553194,-58.373396535191389 -34.614866560259905,-58.374576262379904 -34.614926434302546,-58.374637563164185 -34.613907498670791,-58.374643025289629 -34.613816936004362,-58.374714019709337 -34.612651100470373,-58.373599593518321 -34.612572331130316,-58.37331612974068 -34.612554728791849,-58.373255722216776 -34.613600355721651,-58.373248778245831 -34.613720988736475)));;27;1_14_6;COMUNA 1;14;6;698;344;354;97,18%;424;423;99,76%;1;0,24%;293;81;27,65%;212;72,35%
MULTIPOLYGON (((-58.367376627681629 -34.612179444744498,-58.367127324726731 -34.612161220888133,-58.366989623280638 -34.613391861166555,-58.367820328362448 -34.613457019375538,-58.36883330832876 -34.613536397315755,-58.369054508954619 -34.613551708691233,-58.369276816950006 -34.613567090938716,-58.369515819448857 -34.613583612334331,-58.369656018400498 -34.613593297144426,-58.370476937691294 -34.613575962073497,-58.370675665046967 -34.613578224886112,-58.370737591611487 -34.613578975831842,-58.370920304913717 -34.613581085323595,-58.371122773654093 -34.613589406776491,-58.371719362459586 -34.613613938502418,-58.371854879240992 -34.613621293267528,-58.371998402703696 -34.613629076385266,-58.373036607738314 -34.613703790125861,-58.373248778245831 -34.613720988736475,-58.373255722216776 -34.613600355721651,-58.37331612974068 -34.612554728791849,-58.372178187386645 -34.612484098544584,-58.371922320069778 -34.612469048742689,-58.371217748422069 -34.612427675924806,-58.370810609971656 -34.61240370713584,-58.370526976308575 -34.612386732014983,-58.369778115987408 -34.612341796162397,-58.369581019476918 -34.612331082127383,-58.369358966477151 -34.612319081031828,-58.369173624227614 -34.612309079581628,-58.368875679916904 -34.612292934751501,-58.368392321942792 -34.612254884666513,-58.368387300066303 -34.612326855195491,-58.367954364304879 -34.612293067847176,-58.367365050851951 -34.612247184606247,-58.367376627681629 -34.612179444744498)));;28;1_14_7;COMUNA 1;14;7;476;232;244;95,08%;365;363;99,45%;2;0,55%;215;1;0,47%;214;99,53%
MULTIPOLYGON (((-58.366734488830815 -34.615625120236245,-58.367568117919802 -34.615685282281468,-58.368579683806317 -34.615758252542115,-58.368814159496559 -34.615777657807627,-58.369141350414225 -34.615792911133994,-58.369491783546408 -34.615818806560476,-58.370247138318156 -34.61586108046523,-58.370346797321154 -34.615867212500987,-58.370564754411134 -34.615894279660608,-58.370655420789269 -34.614786632865922,-58.370737591611487 -34.613578975831842,-58.370675665046967 -34.613578224886112,-58.370476937691294 -34.613575962073497,-58.369656018400498 -34.613593297144426,-58.369515819448857 -34.613583612334331,-58.369276816950006 -34.613567090938716,-58.369054508954619 -34.613551708691233,-58.36883330832876 -34.613536397315755,-58.367820328362448 -34.613457019375538,-58.366989623280638 -34.613391861166555,-58.366855036447198 -34.61457714976401,-58.366734488830815 -34.615625120236245)));;29;1_14_8;COMUNA 1;14;8;411;229;182;125,82%;374;374;100,00%;0;0,00%;196;111;56,63%;85;43,37%
MULTIPOLYGON (((-58.373248778245831 -34.613720988736475,-58.373036607738314 -34.613703790125861,-58.371998402703696 -34.613629076385266,-58.371854879240992 -34.613621293267528,-58.371719362459586 -34.613613938502418,-58.371122773654093 -34.613589406776491,-58.370920304913717 -34.613581085323595,-58.370737591611487 -34.613578975831842,-58.370655420789269 -34.614786632865922,-58.370911906380996 -34.614787952908671,-58.371560559005481 -34.614804918670117,-58.371787391825585 -34.614814524870326,-58.371923934527068 -34.614820260547653,-58.373001818534846 -34.614844861475994,-58.373183674374943 -34.614854854553194,-58.373248778245831 -34.613720988736475)));;30;1_14_9;COMUNA 1;14;9;521;246;275;89,45%;354;354;100,00%;0;0,00%;246;15;6,10%;231;93,90%
MULTIPOLYGON (((-58.381970573441549 -34.608458148872828,-58.38179248378129 -34.60844246695612,-58.381343117758206 -34.608414631921121,-58.380887108596696 -34.608386438651237,-58.38071293188851 -34.60837639179168,-58.380491478732857 -34.608369763668648,-58.37935545374787 -34.608306596284223,-58.37921713550152 -34.608297839431231,-58.377809082019809 -34.608211301351915,-58.377781139193409 -34.608801726027686,-58.377752674853809 -34.609402009790401,-58.37905078825289 -34.609483965986172,-58.379160574421427 -34.609492140093835,-58.379155766468116 -34.609615099023898,-58.379127779123891 -34.610513985739757,-58.379120503267259 -34.610634548504287,-58.379283185250564 -34.610644660203391,-58.380370769884962 -34.610713077463792,-58.380593410805595 -34.610730833770944,-58.381225135592622 -34.610781399933877,-58.381861119773916 -34.610832317773685,-58.381903171429393 -34.609892945340199,-58.381913174584263 -34.609678577966854,-58.38192935544344 -34.609329843580042,-58.381940491203487 -34.609089208369944,-58.381970573441549 -34.608458148872828)));;31;1_15_1;COMUNA 1;15;1;697;345;352;98,01%;434;420;96,77%;14;3,33%;170;36;21,18%;134;78,82%
MULTIPOLYGON (((-58.381564814973459 -34.616488097919614,-58.381179966892212 -34.616469530857785,-58.380743754924964 -34.616448392785969,-58.380317594451881 -34.616427823342775,-58.380119548743167 -34.616418252491123,-58.37898706661921 -34.616365788678586,-58.378843281088571 -34.616359140402039,-58.378772999223145 -34.617548218414662,-58.378948555985801 -34.617560100040542,-58.379863478866248 -34.617622417029736,-58.38004312446261 -34.617634722406919,-58.380274486221403 -34.617638893172085,-58.380683798953797 -34.617646281964717,-58.381132978225565 -34.617654400296097,-58.381511198620935 -34.617661272544872,-58.381555124904743 -34.616729085888501,-58.381564814973459 -34.616488097919614)));;32;1_15_10;COMUNA 1;15;10;625;282;343;82,22%;384;383;99,74%;1;0,26%;291;47;16,15%;244;83,85%
MULTIPOLYGON (((-58.378843281088571 -34.616359140402039,-58.37742535952021 -34.616293436926853,-58.377357984742069 -34.617452303826035,-58.378772999223145 -34.617548218414662,-58.378843281088571 -34.616359140402039)));;33;1_15_11;COMUNA 1;15;11;554;276;278;99,28%;271;270;99,63%;1;0,37%;281;109;38,79%;172;61,21%
MULTIPOLYGON (((-58.376263870541827 -34.610451847356025,-58.376215243603838 -34.611263391536966,-58.376205219411403 -34.611565860128763,-58.376705875109081 -34.611597553200944,-58.377475087302372 -34.611645700305282,-58.377646034025126 -34.611655326984561,-58.378894533595435 -34.611726052654582,-58.379053638911472 -34.611737359428879,-58.379120503267259 -34.610634548504287,-58.379127779123891 -34.610513985739757,-58.379155766468116 -34.609615099023898,-58.379160574421427 -34.609492140093835,-58.37905078825289 -34.609483965986172,-58.377752674853809 -34.609402009790401,-58.377781139193409 -34.608801726027686,-58.377809082019809 -34.608211301351915,-58.376399325997816 -34.608126647297624,-58.376367725259691 -34.608702913616305,-58.376357481678205 -34.608889039921564,-58.376332865957579 -34.609299812119581,-58.376263870541827 -34.610451847356025)));;34;1_15_2;COMUNA 1;15;2;662;322;340;94,71%;500;498;99,60%;2;0,40%;249;34;13,65%;215;86,35%
MULTIPOLYGON (((-58.381225135592622 -34.610781399933877,-58.380593410805595 -34.610730833770944,-58.380370769884962 -34.610713077463792,-58.379283185250564 -34.610644660203391,-58.379120503267259 -34.610634548504287,-58.379053638911472 -34.611737359428879,-58.379046622828547 -34.611853485563216,-58.379023090699938 -34.612724697929018,-58.379017758493326 -34.612945265561642,-58.379285636347063 -34.612963125698379,-58.380241058022143 -34.613022861820852,-58.380482019729726 -34.613039996885028,-58.380893503211738 -34.613069218194077,-58.381218107769129 -34.613092253141524,-58.381391695919348 -34.613104552489119,-58.381754544627839 -34.613130358068759,-58.381775397085917 -34.612884588441439,-58.381797255500068 -34.612479799669551,-58.381821022092723 -34.612039517895752,-58.381820288720569 -34.611917400334207,-58.381819036678216 -34.611715279541286,-58.381850935058353 -34.611057952994969,-58.381861119773916 -34.610832317773685,-58.381225135592622 -34.610781399933877)));;35;1_15_3;COMUNA 1;15;3;418;176;242;72,73%;435;435;100,00%;0;0,00%;200;1;0,50%;199;99,50%
MULTIPOLYGON (((-58.376205219411403 -34.611565860128763,-58.376156968025811 -34.612753051683562,-58.376091372246961 -34.613907271753696,-58.377535207923692 -34.613997375885489,-58.377581439515481 -34.612851099563741,-58.377772147273497 -34.61286419067963,-58.378742214855805 -34.612926977011234,-58.379017758493326 -34.612945265561642,-58.379023090699938 -34.612724697929018,-58.379046622828547 -34.611853485563216,-58.379053638911472 -34.611737359428879,-58.378894533595435 -34.611726052654582,-58.377646034025126 -34.611655326984561,-58.377475087302372 -34.611645700305282,-58.376705875109081 -34.611597553200944,-58.376205219411403 -34.611565860128763)));;36;1_15_4;COMUNA 1;15;4;759;366;393;93,13%;685;684;99,85%;1;0,15%;335;2;0,60%;333;99,40%
MULTIPOLYGON (((-58.379017758493326 -34.612945265561642,-58.378742214855805 -34.612926977011234,-58.377772147273497 -34.61286419067963,-58.377581439515481 -34.612851099563741,-58.377535207923692 -34.613997375885489,-58.377829835635502 -34.614015750863828,-58.378833553570971 -34.614088701078821,-58.378982014784278 -34.614100775303505,-58.379122043739699 -34.614112068895636,-58.380204906289677 -34.614177385692649,-58.380424493527677 -34.614191407712511,-58.380827553038166 -34.614217102309063,-58.381276864208246 -34.61424571387839,-58.381678391096592 -34.614271263791089,-58.381728866746286 -34.613432887074929,-58.381754544627839 -34.613130358068759,-58.381391695919348 -34.613104552489119,-58.381218107769129 -34.613092253141524,-58.380893503211738 -34.613069218194077,-58.380482019729726 -34.613039996885028,-58.380241058022143 -34.613022861820852,-58.379285636347063 -34.612963125698379,-58.379017758493326 -34.612945265561642)));;37;1_15_5;COMUNA 1;15;5;464;232;232;100,00%;221;220;99,55%;1;0,45%;187;41;21,93%;146;78,07%
MULTIPOLYGON (((-58.381678391096592 -34.614271263791089,-58.381276864208246 -34.61424571387839,-58.380827553038166 -34.614217102309063,-58.380424493527677 -34.614191407712511,-58.380204906289677 -34.614177385692649,-58.379122043739699 -34.614112068895636,-58.378982014784278 -34.614100775303505,-58.378833553570971 -34.614088701078821,-58.377829835635502 -34.614015750863828,-58.377535207923692 -34.613997375885489,-58.377483929357169 -34.615079702517676,-58.377785712861602 -34.61510146300202,-58.378751716597307 -34.61516530280187,-58.378911598433767 -34.615173300317764,-58.379028720136276 -34.615179225978906,-58.380135377311014 -34.615229840877092,-58.380365192975411 -34.615240207823476,-58.380785215681463 -34.615259223628122,-58.381227044739745 -34.615279168076988,-58.381612910708434 -34.615296538440859,-58.381619719872624 -34.615127029907647,-58.381665578462048 -34.614482812115007,-58.381678391096592 -34.614271263791089)));;38;1_15_6;COMUNA 1;15;6;804;415;389;106,68%;480;475;98,96%;5;1,05%;305;111;36,39%;194;63,61%
MULTIPOLYGON (((-58.377535207923692 -34.613997375885489,-58.376091372246961 -34.613907271753696,-58.376086599731309 -34.613991496720381,-58.376036485874749 -34.615000581522864,-58.377216642828358 -34.61506043033981,-58.377483929357169 -34.615079702517676,-58.377535207923692 -34.613997375885489)));;39;1_15_7;COMUNA 1;15;7;577;287;290;98,97%;365;364;99,73%;1;0,27%;270;58;21,48%;212;78,52%
MULTIPOLYGON (((-58.377483929357169 -34.615079702517676,-58.377216642828358 -34.61506043033981,-58.376036485874749 -34.615000581522864,-58.376032657650953 -34.615077694214733,-58.375976099996016 -34.616220229647155,-58.376154551299557 -34.616230708851084,-58.377263004818083 -34.616285928706453,-58.37742535952021 -34.616293436926853,-58.37743142990891 -34.616188367039648,-58.377483929357169 -34.615079702517676)));;40;1_15_8;COMUNA 1;15;8;818;394;424;92,92%;421;418;99,29%;3;0,72%;310;114;36,77%;196;63,23%
MULTIPOLYGON (((-58.378911598433767 -34.615173300317764,-58.378751716597307 -34.61516530280187,-58.377785712861602 -34.61510146300202,-58.377483929357169 -34.615079702517676,-58.37743142990891 -34.616188367039648,-58.37742535952021 -34.616293436926853,-58.378843281088571 -34.616359140402039,-58.37898706661921 -34.616365788678586,-58.380119548743167 -34.616418252491123,-58.380317594451881 -34.616427823342775,-58.380743754924964 -34.616448392785969,-58.381179966892212 -34.616469530857785,-58.381564814973459 -34.616488097919614,-58.381612910708434 -34.615296538440859,-58.381227044739745 -34.615279168076988,-58.380785215681463 -34.615259223628122,-58.380365192975411 -34.615240207823476,-58.380135377311014 -34.615229840877092,-58.379028720136276 -34.615179225978906,-58.378911598433767 -34.615173300317764)));;41;1_15_9;COMUNA 1;15;9;872;389;483;80,54%;527;526;99,81%;1;0,19%;352;80;22,73%;272;77,27%
MULTIPOLYGON (((-58.383464292047378 -34.60857779439521,-58.383304086657958 -34.608564591177036,-58.382168252144801 -34.608475604088731,-58.381970573441549 -34.608458148872828,-58.381940491203487 -34.609089208369944,-58.38192935544344 -34.609329843580042,-58.381913174584263 -34.609678577966854,-58.381903171429393 -34.609892945340199,-58.381861119773916 -34.610832317773685,-58.382099092380315 -34.6108513491425,-58.383363681812504 -34.610922955236184,-58.383370454553884 -34.610787602624384,-58.383414018827999 -34.609762382439463,-58.383438155364502 -34.609191884369302,-58.383464292047378 -34.60857779439521)));;42;1_16_1;COMUNA 1;16;1;538;274;264;103,79%;348;339;97,41%;9;2,65%;189;61;32,28%;128;67,72%
MULTIPOLYGON (((-58.391794675321755 -34.611499645963214,-58.391536601200315 -34.611474706074809,-58.390364087197305 -34.611389928975882,-58.390368623480434 -34.61156127589264,-58.390355693992689 -34.612424397972184,-58.390357022815635 -34.612561868499483,-58.391506046781579 -34.612642547301348,-58.391756802642597 -34.612663116642295,-58.391766434342351 -34.612455509132218,-58.391785587824344 -34.611668520029696,-58.391794675321755 -34.611499645963214)));;43;1_16_10;COMUNA 1;16;10;591;252;339;74,34%;438;438;100,00%;0;0,00%;291;0;0,00%;291;100,00%
MULTIPOLYGON (((-58.390364087197305 -34.611389928975882,-58.388939459469235 -34.61128695962605,-58.388922275992272 -34.611453715833974,-58.388930794786241 -34.61222318538892,-58.388941396534314 -34.612467637224782,-58.390123129896622 -34.612545390968336,-58.390357022815635 -34.612561868499483,-58.390355693992689 -34.612424397972184,-58.390368623480434 -34.61156127589264,-58.390364087197305 -34.611389928975882)));;44;1_16_11;COMUNA 1;16;11;464;207;257;80,54%;300;299;99,67%;1;0,33%;217;22;10,14%;195;89,86%
MULTIPOLYGON (((-58.388939459469235 -34.61128695962605,-58.387478551118726 -34.611181345550058,-58.387470312687498 -34.611343599863822,-58.387484967222221 -34.612378505406511,-58.387632753332014 -34.612381554280994,-58.388941396534314 -34.612467637224782,-58.388930794786241 -34.61222318538892,-58.388922275992272 -34.611453715833974,-58.388939459469235 -34.61128695962605)));;45;1_16_12;COMUNA 1;16;12;364;162;202;80,20%;204;203;99,51%;1;0,49%;139;0;0,00%;139;100,00%
MULTIPOLYGON (((-58.384820305698959 -34.609859559322686,-58.383532325153773 -34.60976893837271,-58.383414018827999 -34.609762382439463,-58.383370454553884 -34.610787602624384,-58.383363681812504 -34.610922955236184,-58.384816169398242 -34.611005232078853,-58.38482081227977 -34.610867765274435,-58.384817863243882 -34.610012309800553,-58.384820305698959 -34.609859559322686)));;46;1_16_2;COMUNA 1;16;2;326;164;162;101,23%;292;291;99,66%;1;0,34%;164;14;8,54%;150;91,46%
MULTIPOLYGON (((-58.386275794889301 -34.608785510904191,-58.386143437443778 -34.608776836061729,-58.385063542564041 -34.608704813040667,-58.384865947090852 -34.608688207669999,-58.384707615290893 -34.608674866639696,-58.383607804137014 -34.608589578080434,-58.383464292047378 -34.60857779439521,-58.383438155364502 -34.609191884369302,-58.383414018827999 -34.609762382439463,-58.383532325153773 -34.60976893837271,-58.384820305698959 -34.609859559322686,-58.384822207023682 -34.609738992766317,-58.384840941281389 -34.609288072791024,-58.386254462156352 -34.609385026487658,-58.386249740807656 -34.609517845275796,-58.386223953734493 -34.609958478970725,-58.386979440142177 -34.610009374557514,-58.387560082898275 -34.610030368093994,-58.387410623020813 -34.60990456715291,-58.387301870684766 -34.609787735177726,-58.387283279922208 -34.609623562775091,-58.387287520148021 -34.60945581279892,-58.38730064914099 -34.609254545960589,-58.387319584726676 -34.609131384147624,-58.387377596206122 -34.609030923344655,-58.387503465810838 -34.608961632252907,-58.387656481035471 -34.608920950325086,-58.387317772409659 -34.608874753927132,-58.387229460149726 -34.60885638880265,-58.386275794889301 -34.608785510904191)));;47;1_16_3;COMUNA 1;16;3;945;466;479;97,29%;683;673;98,54%;10;1,49%;413;110;26,63%;303;73,37%
MULTIPOLYGON (((-58.386254462156352 -34.609385026487658,-58.384840941281389 -34.609288072791024,-58.384822207023682 -34.609738992766317,-58.384820305698959 -34.609859559322686,-58.384950023735833 -34.609868726893815,-58.386062465438535 -34.609947602599419,-58.386223953734493 -34.609958478970725,-58.386249740807656 -34.609517845275796,-58.386254462156352 -34.609385026487658)));;48;1_16_4;COMUNA 1;16;4;573;287;286;100,35%;610;608;99,67%;2;0,33%;348;27;7,76%;321;92,24%
MULTIPOLYGON (((-58.386223953734493 -34.609958478970725,-58.386062465438535 -34.609947602599419,-58.384950023735833 -34.609868726893815,-58.384820305698959 -34.609859559322686,-58.384817863243882 -34.610012309800553,-58.38482081227977 -34.610867765274435,-58.384816169398242 -34.611005232078853,-58.384968206757385 -34.611013850475445,-58.385846011272385 -34.611073986209554,-58.386154432392267 -34.611089321496408,-58.386156873533629 -34.610935373789772,-58.386215386999069 -34.6101046761029,-58.386223953734493 -34.609958478970725)));;49;1_16_5;COMUNA 1;16;5;477;202;275;73,45%;291;291;100,00%;0;0,00%;208;49;23,56%;159;76,44%
MULTIPOLYGON (((-58.386979440142177 -34.610009374557514,-58.386223953734493 -34.609958478970725,-58.386215386999069 -34.6101046761029,-58.386156873533629 -34.610935373789772,-58.386154432392267 -34.611089321496408,-58.386319247428432 -34.611097453249918,-58.387478551118726 -34.611181345550058,-58.387488351073685 -34.61098768260522,-58.387560082898275 -34.610030368093994,-58.386979440142177 -34.610009374557514)));;50;1_16_6;COMUNA 1;16;6;559;263;296;88,85%;240;240;100,00%;0;0,00%;228;47;20,61%;181;79,39%
MULTIPOLYGON (((-58.388679876258998 -34.609029114639327,-58.388507577667141 -34.609011755834665,-58.388173286281415 -34.608978029742509,-58.387801178704812 -34.608941744221418,-58.387656481035471 -34.608920950325086,-58.387503465810838 -34.608961632252907,-58.387377596206122 -34.609030923344655,-58.387319584726676 -34.609131384147624,-58.38730064914099 -34.609254545960589,-58.387287520148021 -34.60945581279892,-58.387283279922208 -34.609623562775091,-58.387301870684766 -34.609787735177726,-58.387410623020813 -34.60990456715291,-58.387560082898275 -34.610030368093994,-58.387488351073685 -34.61098768260522,-58.387478551118726 -34.611181345550058,-58.388939459469235 -34.61128695962605,-58.38895818968404 -34.611104851677112,-58.389024244207192 -34.610287819673601,-58.389049726247343 -34.610079517620939,-58.389122996657299 -34.609481089312439,-58.38915062316854 -34.60925518222701,-58.389172243463065 -34.609078780360015,-58.388679876258998 -34.609029114639327)));;51;1_16_7;COMUNA 1;16;7;1074;489;585;83,59%;687;685;99,71%;2;0,29%;475;98;20,63%;377;79,37%
MULTIPOLYGON (((-58.390417267789275 -34.61017787425105,-58.390007414057074 -34.610148122627137,-58.389049726247343 -34.610079517620939,-58.389024244207192 -34.610287819673601,-58.38895818968404 -34.611104851677112,-58.388939459469235 -34.61128695962605,-58.390364087197305 -34.611389928975882,-58.390359881449321 -34.611230343239505,-58.390417267789275 -34.61017787425105)));;52;1_16_8;COMUNA 1;16;8;546;252;294;85,71%;299;297;99,33%;2;0,67%;220;10;4,55%;210;95,45%
MULTIPOLYGON (((-58.390417267789275 -34.61017787425105,-58.390359881449321 -34.611230343239505,-58.390364087197305 -34.611389928975882,-58.391536601200315 -34.611474706074809,-58.391794675321755 -34.611499645963214,-58.391806531758014 -34.611279926588331,-58.391875132652387 -34.610340495708634,-58.391951660757499 -34.609292121598571,-58.391409877647725 -34.609254058373033,-58.390552786538819 -34.60919376363708,-58.389758127997162 -34.609137866578322,-58.389555508410346 -34.609117462842704,-58.389172243463065 -34.609078780360015,-58.38915062316854 -34.60925518222701,-58.389122996657299 -34.609481089312439,-58.389049726247343 -34.610079517620939,-58.390007414057074 -34.610148122627137,-58.390417267789275 -34.61017787425105)));;53;1_16_9;COMUNA 1;16;9;382;176;206;85,44%;203;203;100,00%;0;0,00%;160;2;1,25%;158;98,75%
MULTIPOLYGON (((-58.384816169398242 -34.611005232078853,-58.383363681812504 -34.610922955236184,-58.383308109704501 -34.612033593007347,-58.384627029633769 -34.612141208560843,-58.384768673192255 -34.612153905208366,-58.386015359668946 -34.61226582594626,-58.38615563862853 -34.61228084415319,-58.386293106931923 -34.612295578738348,-58.387340673538212 -34.612375458510321,-58.387484967222221 -34.612378505406511,-58.387470312687498 -34.611343599863822,-58.387478551118726 -34.611181345550058,-58.386319247428432 -34.611097453249918,-58.386154432392267 -34.611089321496408,-58.385846011272385 -34.611073986209554,-58.384968206757385 -34.611013850475445,-58.384816169398242 -34.611005232078853)));;54;1_17_1;COMUNA 1;17;1;888;457;431;106,03%;544;543;99,82%;1;0,18%;389;74;19,02%;315;80,98%
MULTIPOLYGON (((-58.384559249186999 -34.614479840512921,-58.384382585158136 -34.614473881952193,-58.383271609946284 -34.614403442906202,-58.383112075331972 -34.614389746901864,-58.383094538820032 -34.61455650196519,-58.383067600678871 -34.615380527760607,-58.384381850739324 -34.615437225595706,-58.384480063823226 -34.615441584532753,-58.385762968112481 -34.615498247388395,-58.385902838022837 -34.615500800392823,-58.385905122312757 -34.615332838122164,-58.385954310359089 -34.61455227792554,-58.38577918618936 -34.614538927726038,-58.384702267012386 -34.614484650510633,-58.384559249186999 -34.614479840512921)));;55;1_17_10;COMUNA 1;17;10;574;264;310;85,16%;363;363;100,00%;0;0,00%;279;37;13,26%;242;86,74%
MULTIPOLYGON (((-58.383112075331972 -34.614389746901864,-58.38188094330188 -34.614284215499509,-58.381678391096592 -34.614271263791089,-58.381665578462048 -34.614482812115007,-58.381619719872624 -34.615127029907647,-58.381612910708434 -34.615296538440859,-58.381805077065394 -34.615305257869331,-58.382920664438075 -34.61537416393314,-58.383067600678871 -34.615380527760607,-58.383094538820032 -34.61455650196519,-58.383112075331972 -34.614389746901864)));;56;1_17_11;COMUNA 1;17;11;474;213;261;81,61%;276;274;99,28%;2;0,73%;218;31;14,22%;187;85,78%
MULTIPOLYGON (((-58.383363681812504 -34.610922955236184,-58.382099092380315 -34.6108513491425,-58.381861119773916 -34.610832317773685,-58.381850935058353 -34.611057952994969,-58.381819036678216 -34.611715279541286,-58.381820288720569 -34.611917400334207,-58.38201295451227 -34.611930133994605,-58.383189206942681 -34.612023867339801,-58.383308109704501 -34.612033593007347,-58.383363681812504 -34.610922955236184)));;57;1_17_2;COMUNA 1;17;2;657;328;329;99,70%;467;467;100,00%;0;0,00%;303;89;29,37%;214;70,63%
MULTIPOLYGON (((-58.381754544627839 -34.613130358068759,-58.381728866746286 -34.613432887074929,-58.381678391096592 -34.614271263791089,-58.38188094330188 -34.614284215499509,-58.383112075331972 -34.614389746901864,-58.38313261984591 -34.614195035049413,-58.383216248447937 -34.613233858013082,-58.38323485097024 -34.613020552624775,-58.383301683178431 -34.612162959682145,-58.383308109704501 -34.612033593007347,-58.383189206942681 -34.612023867339801,-58.38201295451227 -34.611930133994605,-58.381820288720569 -34.611917400334207,-58.381821022092723 -34.612039517895752,-58.381797255500068 -34.612479799669551,-58.381775397085917 -34.612884588441439,-58.381754544627839 -34.613130358068759)));;58;1_17_3;COMUNA 1;17;3;720;329;391;84,14%;423;422;99,76%;1;0,24%;324;46;14,20%;278;85,80%
MULTIPOLYGON (((-58.384768673192255 -34.612153905208366,-58.384627029633769 -34.612141208560843,-58.383308109704501 -34.612033593007347,-58.383301683178431 -34.612162959682145,-58.38323485097024 -34.613020552624775,-58.383216248447937 -34.613233858013082,-58.384655724991326 -34.61333570645224,-58.384673813292856 -34.61312183711604,-58.384752860543351 -34.61230305540753,-58.384768673192255 -34.612153905208366)));;59;1_17_4;COMUNA 1;17;4;586;252;334;75,45%;378;377;99,74%;1;0,27%;287;27;9,41%;260;90,59%
MULTIPOLYGON (((-58.386075019555484 -34.613434708231509,-58.384849245399103 -34.613349422130781,-58.384655724991326 -34.61333570645224,-58.383216248447937 -34.613233858013082,-58.38313261984591 -34.614195035049413,-58.383112075331972 -34.614389746901864,-58.383271609946284 -34.614403442906202,-58.384382585158136 -34.614473881952193,-58.384559249186999 -34.614479840512921,-58.384702267012386 -34.614484650510633,-58.38577918618936 -34.614538927726038,-58.385954310359089 -34.61455227792554,-58.386043516382642 -34.613697303476933,-58.386075019555484 -34.613434708231509)));;60;1_17_5;COMUNA 1;17;5;577;261;316;82,59%;318;318;100,00%;0;0,00%;256;33;12,89%;223;87,11%
MULTIPOLYGON (((-58.38615563862853 -34.61228084415319,-58.386015359668946 -34.61226582594626,-58.384768673192255 -34.612153905208366,-58.384752860543351 -34.61230305540753,-58.384673813292856 -34.61312183711604,-58.384655724991326 -34.61333570645224,-58.384849245399103 -34.613349422130781,-58.386075019555484 -34.613434708231509,-58.386105492262921 -34.613180915452176,-58.386154558848396 -34.612436412456546,-58.38615563862853 -34.61228084415319)));;61;1_17_6;COMUNA 1;17;6;759;355;404;87,87%;457;455;99,56%;2;0,44%;367;127;34,60%;240;65,40%
MULTIPOLYGON (((-58.387484967222221 -34.612378505406511,-58.387340673538212 -34.612375458510321,-58.386293106931923 -34.612295578738348,-58.38615563862853 -34.61228084415319,-58.386154558848396 -34.612436412456546,-58.386105492262921 -34.613180915452176,-58.386075019555484 -34.613434708231509,-58.386359594443554 -34.613454464799055,-58.387514332821461 -34.613536452416,-58.387520602325885 -34.613290672823183,-58.387487130291923 -34.612530202341262,-58.387484967222221 -34.612378505406511)));;62;1_17_7;COMUNA 1;17;7;615;294;321;91,59%;477;477;100,00%;0;0,00%;323;81;25,08%;242;74,92%
MULTIPOLYGON (((-58.387514332821461 -34.613536452416,-58.386359594443554 -34.613454464799055,-58.386075019555484 -34.613434708231509,-58.386043516382642 -34.613697303476933,-58.385954310359089 -34.61455227792554,-58.386124835087095 -34.614565202436538,-58.387389539150099 -34.614670430042779,-58.387495419187033 -34.614673453209143,-58.38750745074622 -34.613800260435035,-58.387514332821461 -34.613536452416)));;63;1_17_8;COMUNA 1;17;8;597;248;349;71,06%;316;313;99,05%;3;0,96%;267;80;29,96%;187;70,04%
MULTIPOLYGON (((-58.387495419187033 -34.614673453209143,-58.387389539150099 -34.614670430042779,-58.386124835087095 -34.614565202436538,-58.385954310359089 -34.61455227792554,-58.385905122312757 -34.615332838122164,-58.385902838022837 -34.615500800392823,-58.386048926247334 -34.615503497994105,-58.387329987181978 -34.615528451948329,-58.38748365707707 -34.61553094124023,-58.387495419187033 -34.614673453209143)));;64;1_17_9;COMUNA 1;17;9;439;204;235;86,81%;309;309;100,00%;0;0,00%;239;46;19,25%;193;80,75%
MULTIPOLYGON (((-58.391756802642597 -34.612663116642295,-58.391506046781579 -34.612642547301348,-58.390357022815635 -34.612561868499483,-58.390358580916683 -34.612729621939195,-58.39036240063281 -34.613530709307319,-58.390366060580511 -34.613730436942525,-58.391432057463142 -34.613799869597081,-58.391710241598254 -34.613825032680275,-58.391749254192959 -34.61282494906181,-58.391756802642597 -34.612663116642295)));;65;1_18_1;COMUNA 1;18;1;842;406;436;93,12%;496;495;99,80%;1;0,20%;442;139;31,45%;303;68,55%
MULTIPOLYGON (((-58.390357022815635 -34.612561868499483,-58.390123129896622 -34.612545390968336,-58.388941396534314 -34.612467637224782,-58.388948325732606 -34.612626872496946,-58.388942634813901 -34.613379008747543,-58.388950753314113 -34.61363831872216,-58.390366060580511 -34.613730436942525,-58.39036240063281 -34.613530709307319,-58.390358580916683 -34.612729621939195,-58.390357022815635 -34.612561868499483)));;66;1_18_2;COMUNA 1;18;2;735;318;417;76,26%;490;487;99,39%;3;0,62%;357;48;13,45%;309;86,55%
MULTIPOLYGON (((-58.388941396534314 -34.612467637224782,-58.387632753332014 -34.612381554280994,-58.387484967222221 -34.612378505406511,-58.387487130291923 -34.612530202341262,-58.387520602325885 -34.613290672823183,-58.387514332821461 -34.613536452416,-58.38750745074622 -34.613800260435035,-58.387495419187033 -34.614673453209143,-58.38748365707707 -34.61553094124023,-58.387665692833885 -34.615533940763534,-58.388798612674371 -34.615566605271354,-58.388973747277156 -34.615571148013018,-58.388973802257354 -34.615412621290318,-58.388970730969099 -34.614839852582421,-58.388969324760929 -34.614696114217118,-58.388967925033242 -34.614545051647461,-58.388956966289385 -34.613836991561328,-58.388950753314113 -34.61363831872216,-58.388942634813901 -34.613379008747543,-58.388948325732606 -34.612626872496946,-58.388941396534314 -34.612467637224782)));;67;1_18_3;COMUNA 1;18;3;642;314;328;95,73%;354;352;99,44%;2;0,57%;292;78;26,71%;214;73,29%
MULTIPOLYGON (((-58.390366060580511 -34.613730436942525,-58.388950753314113 -34.61363831872216,-58.388956966289385 -34.613836991561328,-58.388967925033242 -34.614545051647461,-58.388969324760929 -34.614696114217118,-58.388970730969099 -34.614839852582421,-58.388973802257354 -34.615412621290318,-58.388973747277156 -34.615571148013018,-58.389161233410192 -34.615575909224432,-58.390245671798539 -34.615623320318271,-58.390382728117189 -34.615629176492277,-58.390379663087515 -34.615038026901566,-58.39037779831969 -34.614830905744128,-58.390376475174797 -34.614686815317221,-58.390370129719855 -34.613949461278672,-58.390366060580511 -34.613730436942525)));;68;1_18_4;COMUNA 1;18;4;730;316;414;76,33%;436;434;99,54%;2;0,46%;341;70;20,53%;271;79,47%
MULTIPOLYGON (((-58.391710241598254 -34.613825032680275,-58.391432057463142 -34.613799869597081,-58.390366060580511 -34.613730436942525,-58.390370129719855 -34.613949461278672,-58.390376475174797 -34.614686815317221,-58.39037779831969 -34.614830905744128,-58.390379663087515 -34.615038026901566,-58.390382728117189 -34.615629176492277,-58.390599088004784 -34.615638459808665,-58.391432829942126 -34.615686768305117,-58.391658642010597 -34.615700210340883,-58.391660336064028 -34.615511542655561,-58.391668625324591 -34.615180549798211,-58.391676771869633 -34.614917024031811,-58.39168369071065 -34.614694696191258,-58.391700488374958 -34.614074965525866,-58.391710241598254 -34.613825032680275)));;69;1_18_5;COMUNA 1;18;5;698;296;402;73,63%;362;359;99,17%;3;0,84%;274;27;9,85%;247;90,15%
MULTIPOLYGON (((-58.391658642010597 -34.615700210340883,-58.391432829942126 -34.615686768305117,-58.390599088004784 -34.615638459808665,-58.390382728117189 -34.615629176492277,-58.390383302460656 -34.615752702343158,-58.390355059837937 -34.61659187024236,-58.390351137536285 -34.616792579231486,-58.390511278275675 -34.616801618075172,-58.39146257528018 -34.616864503425909,-58.391675186137675 -34.616878712396371,-58.391657419592356 -34.615835214419711,-58.391658642010597 -34.615700210340883)));;70;1_18_6;COMUNA 1;18;6;1180;511;669;76,38%;616;616;100,00%;0;0,00%;507;68;13,41%;439;86,59%
MULTIPOLYGON (((-58.390382728117189 -34.615629176492277,-58.390245671798539 -34.615623320318271,-58.389161233410192 -34.615575909224432,-58.388973747277156 -34.615571148013018,-58.38897360206817 -34.61573537910477,-58.389043311034953 -34.616571366298679,-58.389050918566561 -34.616734756943998,-58.389287470026837 -34.616744125199773,-58.39014474345251 -34.616780906951867,-58.390351137536285 -34.616792579231486,-58.390355059837937 -34.61659187024236,-58.390383302460656 -34.615752702343158,-58.390382728117189 -34.615629176492277)));;71;1_18_7;COMUNA 1;18;7;734;331;403;82,13%;416;416;100,00%;0;0,00%;317;67;21,14%;250;78,86%
MULTIPOLYGON (((-58.390351137536285 -34.616792579231486,-58.39014474345251 -34.616780906951867,-58.389287470026837 -34.616744125199773,-58.389050918566561 -34.616734756943998,-58.389057103849787 -34.616868849917672,-58.388964361164724 -34.617997284314519,-58.390123774329965 -34.618068686289838,-58.390325912019712 -34.618080637779478,-58.390351137536285 -34.616792579231486)));;72;1_18_8;COMUNA 1;18;8;674;324;350;92,57%;368;367;99,73%;1;0,27%;301;25;8,31%;276;91,69%
MULTIPOLYGON (((-58.391675186137675 -34.616878712396371,-58.39146257528018 -34.616864503425909,-58.390511278275675 -34.616801618075172,-58.390351137536285 -34.616792579231486,-58.390325912019712 -34.618080637779478,-58.39141096563916 -34.618144800033754,-58.391697010620504 -34.618159192705939,-58.391675186137675 -34.616878712396371)));;73;1_18_9;COMUNA 1;18;9;650;307;343;89,50%;528;528;100,00%;0;0,00%;303;39;12,87%;264;87,13%
MULTIPOLYGON (((-58.388973747277156 -34.615571148013018,-58.388798612674371 -34.615566605271354,-58.387665692833885 -34.615533940763534,-58.38748365707707 -34.61553094124023,-58.387478900243913 -34.616554706950112,-58.387488049541453 -34.616705351713087,-58.38770722883082 -34.616708162794438,-58.388802015792358 -34.616724817348292,-58.389050918566561 -34.616734756943998,-58.389043311034953 -34.616571366298679,-58.38897360206817 -34.61573537910477,-58.388973747277156 -34.615571148013018)));;74;1_19_1;COMUNA 1;19;1;892;412;480;85,83%;493;493;100,00%;0;0,00%;424;89;20,99%;335;79,01%
MULTIPOLYGON (((-58.38748365707707 -34.61553094124023,-58.387329987181978 -34.615528451948329,-58.386048926247334 -34.615503497994105,-58.385902838022837 -34.615500800392823,-58.385900005839922 -34.615708693306992,-58.385888287627068 -34.616685481040527,-58.386181916320531 -34.616690947440738,-58.387306436587444 -34.61670298601004,-58.387488049541453 -34.616705351713087,-58.387478900243913 -34.616554706950112,-58.38748365707707 -34.61553094124023)));;75;1_19_2;COMUNA 1;19;2;1066;485;581;83,48%;641;640;99,84%;1;0,16%;498;12;2,41%;486;97,59%
MULTIPOLYGON (((-58.385902838022837 -34.615500800392823,-58.385762968112481 -34.615498247388395,-58.384480063823226 -34.615441584532753,-58.38439741650911 -34.616640869723298,-58.384547076998068 -34.616651529443956,-58.385704290555047 -34.616682055075984,-58.385888287627068 -34.616685481040527,-58.385900005839922 -34.615708693306992,-58.385902838022837 -34.615500800392823)));;76;1_19_3;COMUNA 1;19;3;374;172;202;85,15%;179;178;99,44%;1;0,56%;145;2;1,38%;143;98,62%
MULTIPOLYGON (((-58.384480063823226 -34.615441584532753,-58.384381850739324 -34.615437225595706,-58.383067600678871 -34.615380527760607,-58.383060053570787 -34.615612221190773,-58.383062322713911 -34.616536410284965,-58.383235747671691 -34.616548988600755,-58.384186682392517 -34.616625804177552,-58.38439741650911 -34.616640869723298,-58.384480063823226 -34.615441584532753)));;77;1_19_4;COMUNA 1;19;4;720;356;364;97,80%;400;399;99,75%;1;0,25%;303;17;5,61%;286;94,39%
MULTIPOLYGON (((-58.383067600678871 -34.615380527760607,-58.382920664438075 -34.61537416393314,-58.381805077065394 -34.615305257869331,-58.381612910708434 -34.615296538440859,-58.381564814973459 -34.616488097919614,-58.381555124904743 -34.616729085888501,-58.381511198620935 -34.617661272544872,-58.381782427008297 -34.617666171225729,-58.382846692426973 -34.617720606783678,-58.383014070374827 -34.61773444910569,-58.383062759933445 -34.616702965741389,-58.383062322713911 -34.616536410284965,-58.383060053570787 -34.615612221190773,-58.383067600678871 -34.615380527760607)));;78;1_19_5;COMUNA 1;19;5;643;293;350;83,71%;365;363;99,45%;2;0,55%;271;19;7,01%;252;92,99%
MULTIPOLYGON (((-58.38439741650911 -34.616640869723298,-58.384186682392517 -34.616625804177552,-58.383235747671691 -34.616548988600755,-58.383062322713911 -34.616536410284965,-58.383062759933445 -34.616702965741389,-58.383014070374827 -34.61773444910569,-58.383303084928521 -34.617758370774204,-58.384317876925493 -34.6177939578128,-58.38439741650911 -34.616640869723298)));;79;1_19_6;COMUNA 1;19;6;431;214;217;98,62%;229;228;99,56%;1;0,44%;216;108;50,00%;108;50,00%
MULTIPOLYGON (((-58.385888287627068 -34.616685481040527,-58.385704290555047 -34.616682055075984,-58.384547076998068 -34.616651529443956,-58.38439741650911 -34.616640869723298,-58.384317876925493 -34.6177939578128,-58.385572547187323 -34.617837857604329,-58.385874267371179 -34.617849034287758,-58.385888287627068 -34.616685481040527)));;80;1_19_7;COMUNA 1;19;7;746;370;376;98,40%;402;400;99,50%;2;0,50%;325;106;32,62%;219;67,38%
MULTIPOLYGON (((-58.387488049541453 -34.616705351713087,-58.387306436587444 -34.61670298601004,-58.386181916320531 -34.616690947440738,-58.385888287627068 -34.616685481040527,-58.385874267371179 -34.617849034287758,-58.387203302391228 -34.617898175567461,-58.387460385103815 -34.61790953197076,-58.38749728202437 -34.616858250123592,-58.387488049541453 -34.616705351713087)));;81;1_19_8;COMUNA 1;19;8;450;240;210;114,29%;187;184;98,40%;3;1,63%;160;103;64,38%;57;35,63%
MULTIPOLYGON (((-58.389050918566561 -34.616734756943998,-58.388802015792358 -34.616724817348292,-58.38770722883082 -34.616708162794438,-58.387488049541453 -34.616705351713087,-58.38749728202437 -34.616858250123592,-58.387460385103815 -34.61790953197076,-58.387737230398152 -34.617921745077751,-58.388964361164724 -34.617997284314519,-58.389057103849787 -34.616868849917672,-58.389050918566561 -34.616734756943998)));;82;1_19_9;COMUNA 1;19;9;507;221;286;77,27%;292;291;99,66%;1;0,34%;223;7;3,14%;216;96,86%
MULTIPOLYGON (((-58.391697010620504 -34.618159192705939,-58.39141096563916 -34.618144800033754,-58.390325912019712 -34.618080637779478,-58.390311978437815 -34.618332328481486,-58.39027358894171 -34.618984441196787,-58.39166595979377 -34.619109348745042,-58.391697010620504 -34.618159192705939)));;83;1_20_1;COMUNA 1;20;1;627;285;342;83,33%;344;343;99,71%;1;0,29%;259;68;26,25%;191;73,75%
MULTIPOLYGON (((-58.39003034045848 -34.621471073071085,-58.388741487160082 -34.621387408288719,-58.38867301796693 -34.622320145383505,-58.388650825619806 -34.622559999312536,-58.3898874815497 -34.62263574630876,-58.391488484531997 -34.622733807443026,-58.391553720746721 -34.621559931842043,-58.390247478014231 -34.621485146373168,-58.39003034045848 -34.621471073071085)));;84;1_20_10;COMUNA 1;20;10;860;398;462;86,15%;383;382;99,74%;1;0,26%;316;78;24,68%;238;75,32%
MULTIPOLYGON (((-58.390325912019712 -34.618080637779478,-58.390123774329965 -34.618068686289838,-58.388964361164724 -34.617997284314519,-58.387737230398152 -34.617921745077751,-58.387460385103815 -34.61790953197076,-58.387418958021584 -34.618787917464182,-58.387662836607184 -34.618802434416956,-58.388682310607031 -34.618858200008113,-58.388913667062525 -34.618872706862085,-58.389148430912982 -34.618887426606719,-58.390017449775698 -34.61896140073425,-58.39027358894171 -34.618984441196787,-58.390311978437815 -34.618332328481486,-58.390325912019712 -34.618080637779478)));;85;1_20_2;COMUNA 1;20;2;738;331;407;81,33%;371;370;99,73%;1;0,27%;298;31;10,40%;267;89,60%
MULTIPOLYGON (((-58.388913667062525 -34.618872706862085,-58.388682310607031 -34.618858200008113,-58.387662836607184 -34.618802434416956,-58.387418958021584 -34.618787917464182,-58.387408136801838 -34.618979255499724,-58.387319594724836 -34.619956981368624,-58.387427692051894 -34.619964794864721,-58.388838082590219 -34.620052702254085,-58.388905349125622 -34.619030805946601,-58.388913667062525 -34.618872706862085)));;86;1_20_3;COMUNA 1;20;3;567;254;313;81,15%;311;311;100,00%;0;0,00%;238;21;8,82%;217;91,18%
MULTIPOLYGON (((-58.39027358894171 -34.618984441196787,-58.390017449775698 -34.61896140073425,-58.389148430912982 -34.618887426606719,-58.388913667062525 -34.618872706862085,-58.388905349125622 -34.619030805946601,-58.388838082590219 -34.620052702254085,-58.390196343475878 -34.620137252391942,-58.390215053376352 -34.619977680497058,-58.39027358894171 -34.618984441196787)));;87;1_20_4;COMUNA 1;20;4;769;313;456;68,64%;447;447;100,00%;0;0,00%;343;44;12,83%;299;87,17%
MULTIPOLYGON (((-58.39166595979377 -34.619109348745042,-58.39027358894171 -34.618984441196787,-58.390215053376352 -34.619977680497058,-58.390196343475878 -34.620137252391942,-58.390408196614146 -34.620150477168096,-58.391309788868824 -34.62020467196222,-58.3916226707086 -34.620224573659456,-58.39166595979377 -34.619109348745042)));;88;1_20_5;COMUNA 1;20;5;700;304;396;76,77%;469;469;100,00%;0;0,00%;352;6;1,70%;346;98,30%
MULTIPOLYGON (((-58.3916226707086 -34.620224573659456,-58.391309788868824 -34.62020467196222,-58.390408196614146 -34.620150477168096,-58.390196343475878 -34.620137252391942,-58.390178405410914 -34.620290838615162,-58.39003034045848 -34.621471073071085,-58.390247478014231 -34.621485146373168,-58.391553720746721 -34.621559931842043,-58.391610475716341 -34.620539507068095,-58.3916226707086 -34.620224573659456)));;89;1_20_6;COMUNA 1;20;6;785;349;436;80,05%;388;387;99,74%;1;0,26%;336;58;17,26%;278;82,74%
MULTIPOLYGON (((-58.390196343475878 -34.620137252391942,-58.388838082590219 -34.620052702254085,-58.388825907738074 -34.620236926635094,-58.388741487160082 -34.621387408288719,-58.39003034045848 -34.621471073071085,-58.390178405410914 -34.620290838615162,-58.390196343475878 -34.620137252391942)));;90;1_20_7;COMUNA 1;20;7;481;211;270;78,15%;320;320;100,00%;0;0,00%;207;5;2,42%;202;97,58%
MULTIPOLYGON (((-58.388838082590219 -34.620052702254085,-58.387427692051894 -34.619964794864721,-58.387319594724836 -34.619956981368624,-58.387212893488837 -34.621135759071301,-58.387209033729036 -34.621258789103678,-58.387466032208408 -34.621280568339081,-58.38852452049818 -34.621373332410009,-58.388741487160082 -34.621387408288719,-58.388825907738074 -34.620236926635094,-58.388838082590219 -34.620052702254085)));;91;1_20_8;COMUNA 1;20;8;563;249;314;79,30%;332;331;99,70%;1;0,30%;218;65;29,82%;153;70,18%
MULTIPOLYGON (((-58.388741487160082 -34.621387408288719,-58.38852452049818 -34.621373332410009,-58.387466032208408 -34.621280568339081,-58.387209033729036 -34.621258789103678,-58.387203330628637 -34.621441820064121,-58.387179570464021 -34.622467544903081,-58.38754587256232 -34.622489814138149,-58.388299515876703 -34.622538517214707,-58.388650825619806 -34.622559999312536,-58.38867301796693 -34.622320145383505,-58.388741487160082 -34.621387408288719)));;92;1_20_9;COMUNA 1;20;9;572;275;297;92,59%;316;316;100,00%;0;0,00%;247;21;8,50%;226;91,50%
MULTIPOLYGON (((-58.387460385103815 -34.61790953197076,-58.387203302391228 -34.617898175567461,-58.385874267371179 -34.617849034287758,-58.38586429719637 -34.618684620658499,-58.386115500405552 -34.61870013126758,-58.387142539601804 -34.618771548824277,-58.387418958021584 -34.618787917464182,-58.387460385103815 -34.61790953197076)));;93;1_21_1;COMUNA 1;21;1;627;275;352;78,13%;325;324;99,69%;1;0,31%;266;78;29,32%;188;70,68%
MULTIPOLYGON (((-58.382976946688686 -34.619765129575562,-58.382790468570853 -34.619765782240755,-58.38168473401884 -34.619754066622917,-58.381442371661436 -34.619755384350988,-58.381446103076101 -34.619860108784096,-58.38145755033328 -34.620176958389571,-58.381455428264317 -34.620955857176099,-58.381454598192306 -34.621283121442445,-58.381426990821709 -34.62216292207119,-58.382961116105385 -34.622243866853111,-58.382968059309214 -34.621130311910662,-58.382968948195817 -34.621002561599667,-58.382976946688686 -34.619765129575562)));;94;1_21_10;COMUNA 1;21;10;816;391;425;92,00%;546;544;99,63%;2;0,37%;376;65;17,29%;311;82,71%
MULTIPOLYGON (((-58.385874267371179 -34.617849034287758,-58.385572547187323 -34.617837857604329,-58.384317876925493 -34.6177939578128,-58.383303084928521 -34.617758370774204,-58.383014070374827 -34.61773444910569,-58.382846692426973 -34.617720606783678,-58.381782427008297 -34.617666171225729,-58.381511198620935 -34.617661272544872,-58.381500847063322 -34.617881414221465,-58.381471022234706 -34.618415849697421,-58.381467412853738 -34.61853564021397,-58.381665041990246 -34.618540912676515,-58.382791784261237 -34.618570811875045,-58.382977737607 -34.618581638137314,-58.383147250815156 -34.618591467446457,-58.384023126008998 -34.618612669996281,-58.384292992535222 -34.618619815818541,-58.384460722136581 -34.618624219431517,-58.385657559364276 -34.618671813771705,-58.38586429719637 -34.618684620658499,-58.385874267371179 -34.617849034287758)));;95;1_21_2;COMUNA 1;21;2;640;317;323;98,14%;319;319;100,00%;0;0,00%;266;59;22,18%;207;77,82%
MULTIPOLYGON (((-58.382977737607 -34.618581638137314,-58.382791784261237 -34.618570811875045,-58.381665041990246 -34.618540912676515,-58.381467412853738 -34.61853564021397,-58.381453330796731 -34.618999590694258,-58.381435904140126 -34.619573613161002,-58.381442371661436 -34.619755384350988,-58.38168473401884 -34.619754066622917,-58.382790468570853 -34.619765782240755,-58.382976946688686 -34.619765129575562,-58.382977652708085 -34.619650407738476,-58.382971543381352 -34.618734245055201,-58.382977737607 -34.618581638137314)));;96;1_21_3;COMUNA 1;21;3;400;192;208;92,31%;182;182;100,00%;0;0,00%;170;54;31,76%;116;68,24%
MULTIPOLYGON (((-58.384292992535222 -34.618619815818541,-58.384023126008998 -34.618612669996281,-58.383147250815156 -34.618591467446457,-58.382977737607 -34.618581638137314,-58.382971543381352 -34.618734245055201,-58.382977652708085 -34.619650407738476,-58.382976946688686 -34.619765129575562,-58.382968948195817 -34.621002561599667,-58.38414155036893 -34.621038746131127,-58.384347017442423 -34.621050005420621,-58.384353570475334 -34.619969197533742,-58.384344694768465 -34.619805031198979,-58.384291861886496 -34.618825667354848,-58.384292992535222 -34.618619815818541)));;97;1_21_4;COMUNA 1;21;4;1160;552;608;90,79%;549;548;99,82%;1;0,18%;500;195;39,00%;305;61,00%
MULTIPOLYGON (((-58.38586429719637 -34.618684620658499,-58.385657559364276 -34.618671813771705,-58.384460722136581 -34.618624219431517,-58.384292992535222 -34.618619815818541,-58.384291861886496 -34.618825667354848,-58.384344694768465 -34.619805031198979,-58.384580402772102 -34.619814126341261,-58.385639254010385 -34.619859237973422,-58.385833047170522 -34.619870909935237,-58.385862088236074 -34.618863076207674,-58.38586429719637 -34.618684620658499)));;98;1_21_5;COMUNA 1;21;5;724;354;370;95,68%;374;372;99,47%;2;0,54%;275;56;20,36%;219;79,64%
MULTIPOLYGON (((-58.387418958021584 -34.618787917464182,-58.387142539601804 -34.618771548824277,-58.386115500405552 -34.61870013126758,-58.38586429719637 -34.618684620658499,-58.385862088236074 -34.618863076207674,-58.385833047170522 -34.619870909935237,-58.386023262727079 -34.619882297640629,-58.387180064872823 -34.619946894722531,-58.387319594724836 -34.619956981368624,-58.387408136801838 -34.618979255499724,-58.387418958021584 -34.618787917464182)));;99;1_21_6;COMUNA 1;21;6;602;274;328;83,54%;319;317;99,37%;2;0,63%;264;70;26,52%;194;73,48%
MULTIPOLYGON (((-58.385840551573047 -34.621156100052907,-58.385842527638594 -34.621322797196576,-58.385829786183528 -34.622391276670413,-58.38685943965838 -34.622448049855478,-58.387179570464021 -34.622467544903081,-58.387203330628637 -34.621441820064121,-58.387209033729036 -34.621258789103678,-58.387212893488837 -34.621135759071301,-58.387319594724836 -34.619956981368624,-58.387180064872823 -34.619946894722531,-58.386023262727079 -34.619882297640629,-58.385833047170522 -34.619870909935237,-58.385827852801775 -34.620053377791741,-58.385840551573047 -34.621156100052907)));;100;1_21_7;COMUNA 1;21;7;785;375;410;91,46%;390;389;99,74%;1;0,26%;332;111;33,43%;221;66,57%
MULTIPOLYGON (((-58.384347017442423 -34.621050005420621,-58.384345904621249 -34.621236982995782,-58.384391235783056 -34.622314514002419,-58.384771426138585 -34.622332997535437,-58.385829786183528 -34.622391276670413,-58.385842527638594 -34.621322797196576,-58.385840551573047 -34.621156100052907,-58.385827852801775 -34.620053377791741,-58.385833047170522 -34.619870909935237,-58.385639254010385 -34.619859237973422,-58.384580402772102 -34.619814126341261,-58.384344694768465 -34.619805031198979,-58.384353570475334 -34.619969197533742,-58.384347017442423 -34.621050005420621)));;101;1_21_8;COMUNA 1;21;8;553;243;310;78,39%;332;329;99,10%;3;0,91%;240;38;15,83%;202;84,17%
MULTIPOLYGON (((-58.384347017442423 -34.621050005420621,-58.38414155036893 -34.621038746131127,-58.382968948195817 -34.621002561599667,-58.382968059309214 -34.621130311910662,-58.382961116105385 -34.622243866853111,-58.383250154462345 -34.622259196811754,-58.384391235783056 -34.622314514002419,-58.384345904621249 -34.621236982995782,-58.384347017442423 -34.621050005420621)));;102;1_21_9;COMUNA 1;21;9;709;319;390;81,79%;430;429;99,77%;1;0,23%;328;31;9,45%;297;90,55%
MULTIPOLYGON (((-58.383843385900349 -34.587679172576628,-58.382835661570354 -34.588227098856699,-58.383546173079893 -34.589607968836084,-58.383674916619043 -34.589533683119853,-58.384948968686885 -34.588792007133939,-58.383843385900349 -34.587679172576628)));;103;1_4_1;COMUNA 1;4;1;1472;656;816;80,39%;1244;1244;100,00%;0;0,00%;663;31;4,68%;632;95,32%
MULTIPOLYGON (((-58.382835661570354 -34.588227098856699,-58.381968399585595 -34.588699223142576,-58.380905417348671 -34.589277834157294,-58.381436588901451 -34.590368232236152,-58.381549907548482 -34.590221048291589,-58.38159124849863 -34.590180722064154,-58.381642119049253 -34.590148712340628,-58.381700218431867 -34.590126566939361,-58.381762650261237 -34.590115340309112,-58.382234008886492 -34.590106848845309,-58.382363962522284 -34.59010446957501,-58.38269140128962 -34.590098557681308,-58.383546173079893 -34.589607968836084,-58.382835661570354 -34.588227098856699)));;104;1_4_2;COMUNA 1;4;2;1299;584;715;81,68%;938;938;100,00%;0;0,00%;616;2;0,32%;614;99,68%
MULTIPOLYGON (((-58.384275988945113 -34.590861024839761,-58.384210551032488 -34.59089915329217,-58.383546173079893 -34.589607968836084,-58.38269140128962 -34.590098557681308,-58.382363962522284 -34.59010446957501,-58.382234008886492 -34.590106848845309,-58.381762650261237 -34.590115340309112,-58.381700218431867 -34.590126566939361,-58.381642119049253 -34.590148712340628,-58.38159124849863 -34.590180722064154,-58.381549907548482 -34.590221048291589,-58.381436588901451 -34.590368232236152,-58.381546224479948 -34.590593243665595,-58.381546067470289 -34.591367781172174,-58.381557081736354 -34.591601037119169,-58.38184467418241 -34.591592565691265,-58.38206251887879 -34.59158608985215,-58.382164968880566 -34.591583058791549,-58.382732318521846 -34.591566388959755,-58.382893104478313 -34.591561634867652,-58.38308241968334 -34.591556054076179,-58.383148335079461 -34.59155412515377,-58.384331916342305 -34.591519326177149,-58.384275988945113 -34.590861024839761)));;105;1_4_3;COMUNA 1;4;3;1189;522;667;78,26%;542;541;99,82%;1;0,18%;469;22;4,69%;447;95,31%
MULTIPOLYGON (((-58.384948968686885 -34.588792007133939,-58.383674916619043 -34.589533683119853,-58.383546173079893 -34.589607968836084,-58.384210551032488 -34.59089915329217,-58.384275988945113 -34.590861024839761,-58.384330435290387 -34.590829297997878,-58.384913104391323 -34.590450993836171,-58.38584188737763 -34.589848037258896,-58.385935958378099 -34.58978640387754,-58.384948968686885 -34.588792007133939)));;106;1_4_4;COMUNA 1;4;4;1545;658;887;74,18%;660;659;99,85%;1;0,15%;604;4;0,66%;600;99,34%
MULTIPOLYGON (((-58.385935958378099 -34.58978640387754,-58.38584188737763 -34.589848037258896,-58.384913104391323 -34.590450993836171,-58.385917004743881 -34.591412864759661,-58.386008563370758 -34.591492291659137,-58.386080745984984 -34.591435151646593,-58.386917441373527 -34.590775155048043,-58.385935958378099 -34.58978640387754)));;107;1_4_5;COMUNA 1;4;5;1069;500;569;87,87%;483;483;100,00%;0;0,00%;384;1;0,26%;383;99,74%
MULTIPOLYGON (((-58.384913104391323 -34.590450993836171,-58.384330435290387 -34.590829297997878,-58.384275988945113 -34.590861024839761,-58.384331916342305 -34.591519326177149,-58.384435690373195 -34.592737750519412,-58.386008563370758 -34.591492291659137,-58.385917004743881 -34.591412864759661,-58.384913104391323 -34.590450993836171)));;108;1_4_6;COMUNA 1;4;6;1271;480;791;60,68%;517;516;99,81%;1;0,19%;486;15;3,09%;471;96,91%
MULTIPOLYGON (((-58.387057440201168 -34.592375023272389,-58.386077147376511 -34.59155177370306,-58.386008563370758 -34.591492291659137,-58.384435690373195 -34.592737750519412,-58.384443102173286 -34.592825575616324,-58.386251674482473 -34.592815101830695,-58.386504081859606 -34.592825612209701,-58.386892277048979 -34.592509503535027,-58.387057440201168 -34.592375023272389)));;109;1_4_7;COMUNA 1;4;7;1393;635;758;83,77%;672;670;99,70%;2;0,30%;549;25;4,55%;524;95,45%
MULTIPOLYGON (((-58.386892277048979 -34.592509503535027,-58.386504081859606 -34.592825612209701,-58.386704798497462 -34.592834047554113,-58.387028922264243 -34.59283269961211,-58.387566545330003 -34.592830426063571,-58.387909752032606 -34.591681014227184,-58.387949976813594 -34.591648220677847,-58.387878238086628 -34.591591413914081,-58.386917441373527 -34.590775155048043,-58.386080745984984 -34.591435151646593,-58.386008563370758 -34.591492291659137,-58.386077147376511 -34.59155177370306,-58.387057440201168 -34.592375023272389,-58.386892277048979 -34.592509503535027)));;110;1_4_8;COMUNA 1;4;8;1128;469;659;71,17%;500;499;99,80%;1;0,20%;451;3;0,67%;448;99,33%
MULTIPOLYGON (((-58.380156786291906 -34.61976226799792,-58.380344201416747 -34.619761690416219,-58.380614931811778 -34.619760112261652,-58.381037979908314 -34.619757720040141,-58.381120187240512 -34.619757211643325,-58.381442371661436 -34.619755384350988,-58.381435904140126 -34.619573613161002,-58.381453330796731 -34.618999590694258,-58.381467412853738 -34.61853564021397,-58.381471022234706 -34.618415849697421,-58.381500847063322 -34.617881414221465,-58.381511198620935 -34.617661272544872,-58.381132978225565 -34.617654400296097,-58.380683798953797 -34.617646281964717,-58.380274486221403 -34.617638893172085,-58.38004312446261 -34.617634722406919,-58.379863478866248 -34.617622417029736,-58.378948555985801 -34.617560100040542,-58.378772999223145 -34.617548218414662,-58.378761212418567 -34.617748358169067,-58.378732229118199 -34.618360261049752,-58.378727805571003 -34.618523291869941,-58.378694727313245 -34.619732395710663,-58.37893742770045 -34.619733759822793,-58.379923624866898 -34.619762955109131,-58.380156786291906 -34.61976226799792)));;111;1_22_1;COMUNA 1;22;1;567;265;302;87,75%;367;367;100,00%;0;0,00%;261;1;0,38%;260;99,62%
MULTIPOLYGON (((-58.378587131526402 -34.623619145439484,-58.377251095853069 -34.623500607231385,-58.377082854731178 -34.623487390225854,-58.377065274145941 -34.623600480331966,-58.376750546291518 -34.625114183617335,-58.378006265534928 -34.625655502742738,-58.378055569541651 -34.625594830691171,-58.378587131526402 -34.623619145439484)));;112;1_22_10;COMUNA 1;22;10;1231;601;630;95,40%;737;737;100,00%;0;0,00%;582;85;14,60%;497;85,40%
MULTIPOLYGON (((-58.378772999223145 -34.617548218414662,-58.377357984742069 -34.617452303826035,-58.377348445082298 -34.617617584639454,-58.377306441618352 -34.618455824013232,-58.377303530254792 -34.618553642291964,-58.378727805571003 -34.618523291869941,-58.378732229118199 -34.618360261049752,-58.378761212418567 -34.617748358169067,-58.378772999223145 -34.617548218414662)));;113;1_22_2;COMUNA 1;22;2;810;352;458;76,86%;564;563;99,82%;1;0,18%;422;42;9,95%;380;90,05%
MULTIPOLYGON (((-58.378727805571003 -34.618523291869941,-58.377303530254792 -34.618553642291964,-58.377268000485564 -34.619724080693928,-58.378694727313245 -34.619732395710663,-58.378727805571003 -34.618523291869941)));;114;1_22_3;COMUNA 1;22;3;817;370;447;82,77%;461;461;100,00%;0;0,00%;371;76;20,49%;295;79,51%
MULTIPOLYGON (((-58.378694727313245 -34.619732395710663,-58.377268000485564 -34.619724080693928,-58.377265266911735 -34.619814574878035,-58.377224550174574 -34.620808383575998,-58.377228305793516 -34.620884374746758,-58.378550201792351 -34.620875152580432,-58.378663925387514 -34.620879597323906,-58.37867187738857 -34.620765936903112,-58.378691896687265 -34.619836200182121,-58.378694727313245 -34.619732395710663)));;115;1_22_4;COMUNA 1;22;4;446;203;243;83,54%;269;267;99,26%;2;0,75%;207;30;14,49%;177;85,51%
MULTIPOLYGON (((-58.381120187240512 -34.619757211643325,-58.381037979908314 -34.619757720040141,-58.380614931811778 -34.619760112261652,-58.380344201416747 -34.619761690416219,-58.380156786291906 -34.61976226799792,-58.379923624866898 -34.619762955109131,-58.37893742770045 -34.619733759822793,-58.378694727313245 -34.619732395710663,-58.378691896687265 -34.619836200182121,-58.37867187738857 -34.620765936903112,-58.378663925387514 -34.620879597323906,-58.378928769330166 -34.620889991103752,-58.380086957999254 -34.620939374178043,-58.380004669097509 -34.622137387854245,-58.380246267151875 -34.622140650093634,-58.380395263996689 -34.622142652187073,-58.38077043954857 -34.622147764064273,-58.38099465894603 -34.62215080187336,-58.381040492434579 -34.622149987464134,-58.381147068008787 -34.622148157287008,-58.381426990821709 -34.62216292207119,-58.381454598192306 -34.621283121442445,-58.381455428264317 -34.620955857176099,-58.38145755033328 -34.620176958389571,-58.381446103076101 -34.619860108784096,-58.381442371661436 -34.619755384350988,-58.381120187240512 -34.619757211643325)));;116;1_22_5;COMUNA 1;22;5;447;178;269;66,17%;252;251;99,60%;1;0,40%;186;0;0,00%;186;100,00%
MULTIPOLYGON (((-58.380086957999254 -34.620939374178043,-58.378928769330166 -34.620889991103752,-58.378663925387514 -34.620879597323906,-58.378654935682484 -34.621008539244755,-58.378625826405347 -34.621912353132203,-58.378616690887462 -34.622101226563359,-58.380004669097509 -34.622137387854245,-58.380086957999254 -34.620939374178043)));;117;1_22_6;COMUNA 1;22;6;578;247;331;74,62%;355;353;99,44%;2;0,57%;259;39;15,06%;220;84,94%
MULTIPOLYGON (((-58.378663925387514 -34.620879597323906,-58.378550201792351 -34.620875152580432,-58.377228305793516 -34.620884374746758,-58.37723456606372 -34.621010158121713,-58.377211426609897 -34.621892637080656,-58.377198555099149 -34.622066295995708,-58.378386085403797 -34.622095222121743,-58.378616690887462 -34.622101226563359,-58.378625826405347 -34.621912353132203,-58.378654935682484 -34.621008539244755,-58.378663925387514 -34.620879597323906)));;118;1_22_7;COMUNA 1;22;7;562;283;279;101,43%;334;332;99,40%;2;0,60%;268;40;14,93%;228;85,07%
MULTIPOLYGON (((-58.380004669097509 -34.622137387854245,-58.378616690887462 -34.622101226563359,-58.378386085403797 -34.622095222121743,-58.377198555099149 -34.622066295995708,-58.377103179420629 -34.623356766231176,-58.377082854731178 -34.623487390225854,-58.377251095853069 -34.623500607231385,-58.378587131526402 -34.623619145439484,-58.379776993626081 -34.623724681972824,-58.379804903167731 -34.623501453893091,-58.379885965162508 -34.622942475769122,-58.379942150347155 -34.622555035842829,-58.380004669097509 -34.622137387854245)));;119;1_22_8;COMUNA 1;22;8;533;254;279;91,04%;360;358;99,44%;2;0,56%;276;52;18,84%;224;81,16%
MULTIPOLYGON (((-58.380246267151875 -34.622140650093634,-58.380004669097509 -34.622137387854245,-58.379942150347155 -34.622555035842829,-58.379885965162508 -34.622942475769122,-58.379804903167731 -34.623501453893091,-58.379776993626081 -34.623724681972824,-58.378587131526402 -34.623619145439484,-58.378055569541651 -34.625594830691171,-58.378006265534928 -34.625655502742738,-58.379009084608654 -34.626084589625322,-58.380054854106639 -34.626340170384964,-58.380181764196415 -34.626371172837899,-58.380347108283019 -34.626046273634017,-58.38088955375742 -34.624647436394483,-58.381422368413894 -34.624632087817105,-58.381441936206201 -34.62396031744877,-58.381446081879993 -34.623815033570473,-58.381451813306207 -34.623616086942548,-58.381444385773541 -34.622933100911951,-58.381437893937793 -34.622339062143254,-58.381426990821709 -34.62216292207119,-58.381147068008787 -34.622148157287008,-58.381040492434579 -34.622149987464134,-58.38099465894603 -34.62215080187336,-58.38077043954857 -34.622147764064273,-58.380395263996689 -34.622142652187073,-58.380246267151875 -34.622140650093634)));;120;1_22_9;COMUNA 1;22;9;880;413;467;88,44%;441;441;100,00%;0;0,00%;377;68;18,04%;309;81,96%
MULTIPOLYGON (((-58.37591137236528 -34.617353674200167,-58.375900529771116 -34.617540363175195,-58.375861630775276 -34.618410225082066,-58.3758498241491 -34.618540784614893,-58.37718895095756 -34.618556097330625,-58.377303530254792 -34.618553642291964,-58.377306441618352 -34.618455824013232,-58.377348445082298 -34.617617584639454,-58.377357984742069 -34.617452303826035,-58.37742535952021 -34.616293436926853,-58.377263004818083 -34.616285928706453,-58.376154551299557 -34.616230708851084,-58.375976099996016 -34.616220229647155,-58.375970964658116 -34.616325440974734,-58.37591137236528 -34.617353674200167)));;121;1_23_1;COMUNA 1;23;1;607;275;332;82,83%;362;361;99,72%;1;0,28%;272;3;1,10%;269;98,90%
MULTIPOLYGON (((-58.377303530254792 -34.618553642291964,-58.37718895095756 -34.618556097330625,-58.3758498241491 -34.618540784614893,-58.375840344761016 -34.618645218129025,-58.375799903541257 -34.619604166360332,-58.375800832282451 -34.619693888446193,-58.377162367532975 -34.619723443271738,-58.377268000485564 -34.619724080693928,-58.377303530254792 -34.618553642291964)));;122;1_23_10;COMUNA 1;23;10;362;177;185;95,68%;191;190;99,48%;1;0,53%;150;51;34,00%;99;66,00%
MULTIPOLYGON (((-58.37591137236528 -34.617353674200167,-58.374438698605893 -34.617253107093894,-58.374428723003803 -34.617422401589707,-58.374365376230067 -34.618437813793754,-58.374361288123168 -34.618517391074882,-58.374488464255386 -34.618525229850206,-58.3758498241491 -34.618540784614893,-58.375861630775276 -34.618410225082066,-58.375900529771116 -34.617540363175195,-58.37591137236528 -34.617353674200167)));;123;1_23_2;COMUNA 1;23;2;525;258;267;96,63%;313;312;99,68%;1;0,32%;219;1;0,46%;218;99,54%
MULTIPOLYGON (((-58.375976099996016 -34.616220229647155,-58.375858041122804 -34.616213244013018,-58.375251439676219 -34.616132455752712,-58.374705784075921 -34.616096710038725,-58.374533379193608 -34.616088275411194,-58.37444893441959 -34.617079376005236,-58.374438698605893 -34.617253107093894,-58.37591137236528 -34.617353674200167,-58.375970964658116 -34.616325440974734,-58.375976099996016 -34.616220229647155)));;124;1_23_3;COMUNA 1;23;3;790;388;402;96,52%;508;505;99,41%;3;0,59%;373;28;7,51%;345;92,49%
MULTIPOLYGON (((-58.374533379193608 -34.616088275411194,-58.374337464516188 -34.616078767138731,-58.373267507075326 -34.616034816933556,-58.373127553999645 -34.616029925355754,-58.37312345636122 -34.616117390221071,-58.373082726935792 -34.617158101146984,-58.374438698605893 -34.617253107093894,-58.37444893441959 -34.617079376005236,-58.374533379193608 -34.616088275411194)));;125;1_23_4;COMUNA 1;23;4;370;174;196;88,78%;169;168;99,41%;1;0,60%;131;33;25,19%;98;74,81%
MULTIPOLYGON (((-58.373127553999645 -34.616029925355754,-58.372990837801829 -34.616025176847693,-58.371714090603703 -34.616025428544567,-58.371709323147329 -34.616100850183599,-58.371687247278317 -34.616659092808455,-58.371683743163686 -34.616747684858083,-58.371671586261222 -34.617037263423995,-58.371666462654758 -34.617204730265556,-58.37186656473618 -34.617204175169732,-58.373082726935792 -34.617158101146984,-58.37312345636122 -34.616117390221071,-58.373127553999645 -34.616029925355754)));;126;1_23_5;COMUNA 1;23;5;501;246;255;96,47%;250;250;100,00%;0;0,00%;228;46;20,18%;182;79,82%
MULTIPOLYGON (((-58.373082726935792 -34.617158101146984,-58.37186656473618 -34.617204175169732,-58.371666462654758 -34.617204730265556,-58.371660542902781 -34.617399169284354,-58.371635590885326 -34.617860293563027,-58.371606290525413 -34.618402614570137,-58.371599814164995 -34.618482542098626,-58.37289284323866 -34.618506881937975,-58.373019178932367 -34.618503946602559,-58.373030696553897 -34.618408599630243,-58.373082726935792 -34.617158101146984)));;127;1_23_6;COMUNA 1;23;6;484;210;274;76,64%;274;273;99,64%;1;0,37%;214;1;0,47%;213;99,53%
MULTIPOLYGON (((-58.374438698605893 -34.617253107093894,-58.373082726935792 -34.617158101146984,-58.373030696553897 -34.618408599630243,-58.373019178932367 -34.618503946602559,-58.373141510673804 -34.618501149046935,-58.374276532419266 -34.618512188646577,-58.374361288123168 -34.618517391074882,-58.374365376230067 -34.618437813793754,-58.374428723003803 -34.617422401589707,-58.374438698605893 -34.617253107093894)));;128;1_23_7;COMUNA 1;23;7;568;282;286;98,60%;314;314;100,00%;0;0,00%;265;96;36,23%;169;63,77%
MULTIPOLYGON (((-58.373019178932367 -34.618503946602559,-58.37289284323866 -34.618506881937975,-58.371599814164995 -34.618482542098626,-58.371524081366708 -34.619418644845219,-58.371516487234118 -34.619507867617571,-58.371625858827038 -34.619517034141964,-58.372775217584532 -34.619596128951464,-58.372937918157248 -34.619604488499419,-58.374301973429809 -34.619665275368213,-58.374361288123168 -34.618517391074882,-58.374276532419266 -34.618512188646577,-58.373141510673804 -34.618501149046935,-58.373019178932367 -34.618503946602559)));;129;1_23_8;COMUNA 1;23;8;681;326;355;91,83%;364;363;99,73%;1;0,28%;315;63;20,00%;252;80,00%
MULTIPOLYGON (((-58.3758498241491 -34.618540784614893,-58.374488464255386 -34.618525229850206,-58.374361288123168 -34.618517391074882,-58.374301973429809 -34.619665275368213,-58.374428479345035 -34.619664099323053,-58.375800832282451 -34.619693888446193,-58.375799903541257 -34.619604166360332,-58.375840344761016 -34.618645218129025,-58.3758498241491 -34.618540784614893)));;130;1_23_9;COMUNA 1;23;9;898;423;475;89,05%;509;508;99,80%;1;0,20%;405;18;4,44%;387;95,56%
MULTIPOLYGON (((-58.370564754411134 -34.615894279660608,-58.370346797321154 -34.615867212500987,-58.370247138318156 -34.61586108046523,-58.369491783546408 -34.615818806560476,-58.369457702744093 -34.616574730154504,-58.370096820164619 -34.616598950192959,-58.370270505524225 -34.616605490584909,-58.371687247278317 -34.616659092808455,-58.371709323147329 -34.616100850183599,-58.371714090603703 -34.616025428544567,-58.371717036903277 -34.615979584054429,-58.370689958387338 -34.615909867658289,-58.370564754411134 -34.615894279660608)));;131;1_24_1;COMUNA 1;24;1;248;125;123;101,63%;216;214;99,07%;2;0,93%;113;22;19,47%;91;80,53%
MULTIPOLYGON (((-58.369141350414225 -34.615792911133994,-58.368814159496559 -34.615777657807627,-58.368579683806317 -34.615758252542115,-58.367568117919802 -34.615685282281468,-58.366734488830815 -34.615625120236245,-58.36659223413151 -34.616878996026799,-58.367224767449102 -34.616926184476327,-58.367428868647423 -34.616929090613866,-58.367636547649951 -34.616931999197995,-58.368680855505502 -34.617011398176814,-58.368984920103856 -34.617033891062832,-58.368985308984541 -34.617034346108774,-58.36928778230989 -34.61708895037485,-58.369424751114558 -34.617116902909061,-58.369424925028966 -34.617117018198321,-58.369797529311988 -34.617165784804222,-58.369874279667805 -34.617167603852899,-58.371471130973099 -34.617205288600616,-58.371666462654758 -34.617204730265556,-58.371671586261222 -34.617037263423995,-58.371683743163686 -34.616747684858083,-58.371687247278317 -34.616659092808455,-58.370270505524225 -34.616605490584909,-58.370096820164619 -34.616598950192959,-58.369457702744093 -34.616574730154504,-58.369491783546408 -34.615818806560476,-58.369141350414225 -34.615792911133994)));;132;1_24_2;COMUNA 1;24;2;287;140;147;95,24%;237;236;99,58%;1;0,42%;145;1;0,69%;144;99,31%
MULTIPOLYGON (((-58.36715695470739 -34.619309453946812,-58.368490114683006 -34.619412818282697,-58.368651191275227 -34.619425266942031,-58.368684634758878 -34.619154508676374,-58.368808474321234 -34.619175379422572,-58.368960165121514 -34.619200919496201,-58.369297911914458 -34.61838502340477,-58.36946656828372 -34.618397476791145,-58.370152377923631 -34.61842553516842,-58.371499125075317 -34.618480635815764,-58.371599814164995 -34.618482542098626,-58.371606290525413 -34.618402614570137,-58.371635590885326 -34.617860293563027,-58.371660542902781 -34.617399169284354,-58.371666462654758 -34.617204730265556,-58.371471130973099 -34.617205288600616,-58.369874279667805 -34.617167603852899,-58.369797529311988 -34.617165784804222,-58.369424925028966 -34.617117018198321,-58.369424751114558 -34.617116902909061,-58.36928778230989 -34.61708895037485,-58.368985308984541 -34.617034346108774,-58.368984920103856 -34.617033891062832,-58.368680855505502 -34.617011398176814,-58.367636547649951 -34.616931999197995,-58.367428868647423 -34.616929090613866,-58.367224767449102 -34.616926184476327,-58.36659223413151 -34.616878996026799,-58.366451437996659 -34.61812012561726,-58.366323891054606 -34.619244923194536,-58.36715695470739 -34.619309453946812)));;133;1_24_3;COMUNA 1;24;3;534;296;238;124,37%;254;252;99,21%;2;0,79%;200;9;4,50%;191;95,50%
MULTIPOLYGON (((-58.371599814164995 -34.618482542098626,-58.371499125075317 -34.618480635815764,-58.370152377923631 -34.61842553516842,-58.370106927836993 -34.619386872143004,-58.370259482313372 -34.619402481334298,-58.371516487234118 -34.619507867617571,-58.371524081366708 -34.619418644845219,-58.371599814164995 -34.618482542098626)));;134;1_24_4;COMUNA 1;24;4;328;169;159;106,29%;260;259;99,62%;1;0,39%;168;19;11,31%;149;88,69%
MULTIPOLYGON (((-58.370152377923631 -34.61842553516842,-58.36946656828372 -34.618397476791145,-58.369297911914458 -34.61838502340477,-58.368960165121514 -34.619200919496201,-58.370106927836993 -34.619386872143004,-58.370152377923631 -34.61842553516842)));;135;1_24_5;COMUNA 1;24;5;345;153;192;79,69%;232;232;100,00%;0;0,00%;168;11;6,55%;157;93,45%
MULTIPOLYGON (((-58.368808474321234 -34.619175379422572,-58.368684634758878 -34.619154508676374,-58.368651191275227 -34.619425266942031,-58.368614737609889 -34.619721164580525,-58.368463055634798 -34.620365365553248,-58.368432806656088 -34.620597462866996,-58.368402471840035 -34.62082998264767,-58.368311114745289 -34.621687617533354,-58.368766601027922 -34.62171135020408,-58.36974870789021 -34.621759287216818,-58.369973369468937 -34.620674139173907,-58.369999663846485 -34.620547112521734,-58.370097756566288 -34.619514123117092,-58.370106927836993 -34.619386872143004,-58.368960165121514 -34.619200919496201,-58.368808474321234 -34.619175379422572)));;136;1_24_6;COMUNA 1;24;6;720;331;389;85,09%;540;539;99,81%;1;0,19%;365;2;0,55%;363;99,45%
MULTIPOLYGON (((-58.363455008161345 -34.625121344980698,-58.363727109594358 -34.625127974727064,-58.366487910717062 -34.625195326570669,-58.367971222901353 -34.625195431129939,-58.36797484194058 -34.625009512174422,-58.36805931083574 -34.624072222082319,-58.368081829203753 -34.623822864892453,-58.368161639065406 -34.623010293493408,-58.368187252225212 -34.622810940344735,-58.369756514610984 -34.622933065714719,-58.369746539140046 -34.622711078706104,-58.369748707890196 -34.621759287216797,-58.368766601027907 -34.621711350204073,-58.368311114745289 -34.62168761753334,-58.368402471840035 -34.62082998264767,-58.36843280665606 -34.620597462866996,-58.368463055634784 -34.620365365553248,-58.368614737609875 -34.619721164580525,-58.36865119127522 -34.619425266942031,-58.368490114683006 -34.619412818282676,-58.367156954707362 -34.619309453946812,-58.366323891054606 -34.619244923194529,-58.36619031667081 -34.620422182258025,-58.366067066362 -34.621508812211438,-58.365936238644849 -34.622662057825124,-58.365856432186909 -34.623599984170369,-58.365839848927862 -34.623794766349114,-58.365785868549402 -34.623987335640955,-58.365478775868326 -34.623964062324106,-58.36506831061785 -34.624188037865217,-58.364697994859874 -34.624390142128803,-58.364152918278322 -34.624687529957832,-58.363737704916474 -34.62488635545953,-58.363521019255813 -34.624990056215317,-58.363455008161345 -34.625121344980698)));;137;1_24_7;COMUNA 1;24;7;566;281;285;98,60%;509;509;100,00%;0;0,00%;261;13;4,98%;248;95,02%
MULTIPOLYGON (((-58.36805931083574 -34.624072222082326,-58.367974841940594 -34.625009512174429,-58.367971222901353 -34.625195431129946,-58.369723040516725 -34.625295233007158,-58.369746093588006 -34.624333034949821,-58.369752249570105 -34.624160428155577,-58.369758052505823 -34.6239988073755,-58.369761004798967 -34.62303187532261,-58.369756514610998 -34.622933065714726,-58.368187252225226 -34.622810940344742,-58.368161639065406 -34.623010293493422,-58.368081829203753 -34.623822864892475,-58.36805931083574 -34.624072222082326)));;138;1_24_8;COMUNA 1;24;8;428;202;226;89,38%;247;246;99,60%;1;0,41%;184;24;13,04%;160;86,96%
MULTIPOLYGON (((-58.374301973429809 -34.619665275368213,-58.372937918157248 -34.619604488499419,-58.372850211676756 -34.620597345620972,-58.37285016199214 -34.620722490749174,-58.372974701230092 -34.620729624910538,-58.374018920301999 -34.620760459946844,-58.374223886481239 -34.620760115802383,-58.374229561751434 -34.620630115429954,-58.374295450415438 -34.619791542626608,-58.374301973429809 -34.619665275368213)));;139;1_25_1;COMUNA 1;25;1;424;198;226;87,61%;236;236;100,00%;0;0,00%;175;13;7,43%;162;92,57%
MULTIPOLYGON (((-58.374028896207058 -34.624436438028638,-58.372976945221417 -34.624343623439657,-58.372669504450911 -34.624324030064024,-58.372660543501176 -34.624496282810824,-58.372622677707035 -34.625479316256992,-58.372617595030825 -34.62561016198547,-58.372554625578317 -34.626565429278607,-58.372547282168405 -34.626738316972819,-58.372785303778635 -34.626752014238313,-58.373865893691324 -34.626780835097897,-58.373892394576103 -34.626696133244288,-58.373965852032377 -34.625557979409251,-58.373967749143176 -34.625456498492689,-58.374028896207058 -34.624436438028638)));;140;1_25_10;COMUNA 1;25;10;542;254;288;88,19%;246;246;100,00%;0;0,00%;227;12;5,29%;215;94,71%
MULTIPOLYGON (((-58.369723040516725 -34.625295233007158,-58.367971222901353 -34.625195431129946,-58.367965794790607 -34.625473887003309,-58.367976864869448 -34.626902816796914,-58.367977609819718 -34.626996975453352,-58.3679784282022 -34.627101486623936,-58.367945155304767 -34.627142377641498,-58.368023336653827 -34.627167509608974,-58.368091298214246 -34.627189394055243,-58.368305448133 -34.627368861726751,-58.368634590613595 -34.627644618140785,-58.369444475918961 -34.628323149896886,-58.369630093562272 -34.628499917251823,-58.370248054350348 -34.629092378660282,-58.370459206459707 -34.62929479873624,-58.370658180047961 -34.62949375843327,-58.370688892227655 -34.629225322022762,-58.370693021383801 -34.629189408455886,-58.370711862099711 -34.629024205928083,-58.370710598819315 -34.628933709019329,-58.37070918426825 -34.628825887477063,-58.370793632074012 -34.628115223303105,-58.370947387365987 -34.626822478997092,-58.370963682331364 -34.626647133265458,-58.372547282168405 -34.626738316972819,-58.372554625578317 -34.626565429278607,-58.372617595030825 -34.62561016198547,-58.372622677707035 -34.625479316256992,-58.372394040045698 -34.625457385907318,-58.371298189796128 -34.625376637424502,-58.371093475896338 -34.625369652642242,-58.369723040516725 -34.625295233007158)));;141;1_25_11;COMUNA 1;25;11;557;271;286;94,76%;308;308;100,00%;0;0,00%;252;27;10,71%;225;89,29%
MULTIPOLYGON (((-58.371451337229459 -34.620268901597768,-58.371425535603443 -34.620570442007924,-58.371417926529709 -34.620673115914251,-58.371344868345581 -34.621652461132868,-58.371332655217188 -34.621836120262209,-58.371532246567611 -34.621845354410134,-58.372797789213628 -34.621890097977229,-58.372809225423396 -34.621712917223448,-58.372850047458776 -34.620828761936707,-58.37285016199214 -34.620722490749174,-58.372850211676756 -34.620597345620972,-58.372937918157248 -34.619604488499419,-58.372775217584532 -34.619596128951464,-58.371625858827038 -34.619517034141964,-58.371516487234118 -34.619507867617571,-58.371451337229459 -34.620268901597768)));;142;1_25_2;COMUNA 1;25;2;388;190;198;95,96%;297;296;99,66%;1;0,34%;179;2;1,12%;177;98,88%
MULTIPOLYGON (((-58.36974870789021 -34.621759287216818,-58.36974653914006 -34.622711078706118,-58.369756514610998 -34.622933065714726,-58.371268793245996 -34.623050691429839,-58.371320616197941 -34.622016328692652,-58.371332655217188 -34.621836120262209,-58.371344868345581 -34.621652461132868,-58.371417926529709 -34.620673115914251,-58.371425535603443 -34.620570442007924,-58.371451337229459 -34.620268901597768,-58.371516487234118 -34.619507867617571,-58.370259482313372 -34.619402481334298,-58.370106927836993 -34.619386872143004,-58.370097756566288 -34.619514123117092,-58.369999663846485 -34.620547112521734,-58.369973369468937 -34.620674139173907,-58.36974870789021 -34.621759287216818)));;143;1_25_3;COMUNA 1;25;3;513;225;288;78,13%;337;334;99,11%;3;0,90%;221;2;0,90%;219;99,10%
MULTIPOLYGON (((-58.372797789213628 -34.621890097977229,-58.371532246567611 -34.621845354410134,-58.371332655217188 -34.621836120262209,-58.371320616197941 -34.622016328692652,-58.371268793245996 -34.623050691429839,-58.372731697378796 -34.623138190544388,-58.372735871861352 -34.623059176842844,-58.372786438524876 -34.622066926663017,-58.372797789213628 -34.621890097977229)));;144;1_25_4;COMUNA 1;25;4;912;449;463;96,98%;510;510;100,00%;0;0,00%;430;3;0,70%;427;99,30%
MULTIPOLYGON (((-58.372797789213628 -34.621890097977229,-58.372786438524876 -34.622066926663017,-58.372735871861352 -34.623059176842844,-58.372731697378796 -34.623138190544388,-58.374108525848477 -34.623258498079807,-58.374106679899739 -34.623151732533785,-58.374165887157972 -34.622109979319163,-58.374163252602152 -34.621943563247285,-58.374159978493488 -34.621737638307231,-58.374212973196578 -34.621009412260904,-58.374223886481239 -34.620760115802383,-58.374018920301999 -34.620760459946844,-58.372974701230092 -34.620729624910538,-58.37285016199214 -34.620722490749174,-58.372850047458776 -34.620828761936707,-58.372809225423396 -34.621712917223448,-58.372797789213628 -34.621890097977229)));;145;1_25_5;COMUNA 1;25;5;477;216;261;82,76%;319;318;99,69%;1;0,31%;226;4;1,77%;222;98,23%
MULTIPOLYGON (((-58.372731697378796 -34.623138190544388,-58.371268793245996 -34.623050691429839,-58.371263566026904 -34.623156184067113,-58.371201921783104 -34.624055957187409,-58.371188347517176 -34.624237220760932,-58.371434028350883 -34.624251630657682,-58.37232662598165 -34.624302156066506,-58.372669504450911 -34.624324030064024,-58.372976945221417 -34.624343623439657,-58.374028896207058 -34.624436438028638,-58.374039998228881 -34.624250946847546,-58.374109967695567 -34.623344699249166,-58.374108525848477 -34.623258498079807,-58.372731697378796 -34.623138190544388)));;146;1_25_6;COMUNA 1;25;6;752;365;387;94,32%;404;404;100,00%;0;0,00%;351;77;21,94%;274;78,06%
MULTIPOLYGON (((-58.371268793245996 -34.623050691429839,-58.369756514610998 -34.622933065714726,-58.369761004798967 -34.62303187532261,-58.369758052505823 -34.6239988073755,-58.369752249570105 -34.624160428155577,-58.370036437096481 -34.62417487020187,-58.370949907779647 -34.62422316794067,-58.371188347517176 -34.624237220760932,-58.371201921783104 -34.624055957187409,-58.371263566026904 -34.623156184067113,-58.371268793245996 -34.623050691429839)));;147;1_25_7;COMUNA 1;25;7;418;187;231;80,95%;271;270;99,63%;1;0,37%;193;6;3,11%;187;96,89%
MULTIPOLYGON (((-58.371188347517176 -34.624237220760932,-58.370949907779647 -34.62422316794067,-58.370036437096481 -34.62417487020187,-58.369752249570105 -34.624160428155577,-58.369746093588006 -34.624333034949821,-58.369723040516725 -34.625295233007158,-58.371093475896338 -34.625369652642242,-58.371111660621501 -34.625257197714291,-58.371188347517176 -34.624237220760932)));;148;1_25_8;COMUNA 1;25;8;612;285;327;87,16%;420;419;99,76%;1;0,24%;321;13;4,05%;308;95,95%
MULTIPOLYGON (((-58.372669504450911 -34.624324030064024,-58.37232662598165 -34.624302156066506,-58.371434028350883 -34.624251630657682,-58.371188347517176 -34.624237220760932,-58.371111660621501 -34.625257197714291,-58.371093475896338 -34.625369652642242,-58.371298189796128 -34.625376637424502,-58.372394040045698 -34.625457385907318,-58.372622677707035 -34.625479316256992,-58.372660543501176 -34.624496282810824,-58.372669504450911 -34.624324030064024)));;149;1_25_9;COMUNA 1;25;9;658;332;326;101,84%;189;187;98,94%;2;1,07%;212;80;37,74%;132;62,26%
MULTIPOLYGON (((-58.377268000485564 -34.619724080693928,-58.377162367532975 -34.619723443271738,-58.375800832282451 -34.619693888446193,-58.375801917161851 -34.61979727308772,-58.375738155867545 -34.62073430233756,-58.375735414426799 -34.620830712162608,-58.375860120790875 -34.620841364745836,-58.377228305793516 -34.620884374746758,-58.377224550174574 -34.620808383575998,-58.377265266911735 -34.619814574878035,-58.377268000485564 -34.619724080693928)));;150;1_26_1;COMUNA 1;26;1;639;312;327;95,41%;295;286;96,95%;9;3,15%;249;102;40,96%;147;59,04%
MULTIPOLYGON (((-58.375800832282451 -34.619693888446193,-58.374428479345035 -34.619664099323053,-58.374301973429809 -34.619665275368213,-58.374295450415438 -34.619791542626608,-58.374229561751434 -34.620630115429954,-58.374223886481239 -34.620760115802383,-58.374331480896188 -34.62075998251624,-58.375621866956237 -34.620820982942426,-58.375735414426799 -34.620830712162608,-58.375738155867545 -34.62073430233756,-58.375801917161851 -34.61979727308772,-58.375800832282451 -34.619693888446193)));;151;1_26_2;COMUNA 1;26;2;677;289;388;74,48%;405;405;100,00%;0;0,00%;320;41;12,81%;279;87,19%
MULTIPOLYGON (((-58.375735414426799 -34.620830712162608,-58.375621866956237 -34.620820982942426,-58.374331480896188 -34.62075998251624,-58.374223886481239 -34.620760115802383,-58.374212973196578 -34.621009412260904,-58.374159978493488 -34.621737638307231,-58.374163252602152 -34.621943563247285,-58.375414736299682 -34.621993480908486,-58.375644314942924 -34.622003363606474,-58.37565651051019 -34.621827450775307,-58.375732495253786 -34.620934164355866,-58.375735414426799 -34.620830712162608)));;152;1_26_3;COMUNA 1;26;3;440;189;251;75,30%;308;308;100,00%;0;0,00%;217;3;1,38%;214;98,62%
MULTIPOLYGON (((-58.377228305793516 -34.620884374746758,-58.375860120790875 -34.620841364745836,-58.375735414426799 -34.620830712162608,-58.375732495253786 -34.620934164355866,-58.37565651051019 -34.621827450775307,-58.375644314942924 -34.622003363606474,-58.376978512817296 -34.622060930121272,-58.377198555099149 -34.622066295995708,-58.377211426609897 -34.621892637080656,-58.37723456606372 -34.621010158121713,-58.377228305793516 -34.620884374746758)));;153;1_26_4;COMUNA 1;26;4;553;249;304;81,91%;291;291;100,00%;0;0,00%;244;0;0,00%;244;100,00%
MULTIPOLYGON (((-58.377198555099149 -34.622066295995708,-58.376978512817296 -34.622060930121272,-58.375644314942924 -34.622003363606474,-58.375556089738595 -34.623276301920221,-58.375550861377178 -34.62338806256021,-58.375545720476126 -34.623497640087415,-58.375472020938027 -34.624563891258383,-58.376750546291518 -34.625114183617335,-58.377065274145941 -34.623600480331966,-58.377082854731178 -34.623487390225854,-58.377103179420629 -34.623356766231176,-58.377198555099149 -34.622066295995708)));;154;1_26_5;COMUNA 1;26;5;683;316;367;86,10%;391;391;100,00%;0;0,00%;310;44;14,19%;266;85,81%
MULTIPOLYGON (((-58.375644314942924 -34.622003363606474,-58.375414736299682 -34.621993480908486,-58.374163252602152 -34.621943563247285,-58.374165887157972 -34.622109979319163,-58.374106679899739 -34.623151732533785,-58.374108525848477 -34.623258498079807,-58.374226506365197 -34.623268302347469,-58.375335511394425 -34.623373048856507,-58.375550861377178 -34.62338806256021,-58.375556089738595 -34.623276301920221,-58.375644314942924 -34.622003363606474)));;155;1_26_6;COMUNA 1;26;6;465;194;271;71,59%;288;288;100,00%;0;0,00%;214;3;1,40%;211;98,60%
MULTIPOLYGON (((-58.375550861377178 -34.62338806256021,-58.375335511394425 -34.623373048856507,-58.374226506365197 -34.623268302347469,-58.374108525848477 -34.623258498079807,-58.374109967695567 -34.623344699249166,-58.374039998228881 -34.624250946847546,-58.374028896207058 -34.624436438028638,-58.375472020938027 -34.624563891258383,-58.375545720476126 -34.623497640087415,-58.375550861377178 -34.62338806256021)));;156;1_26_7;COMUNA 1;26;7;313;128;185;69,19%;202;202;100,00%;0;0,00%;142;4;2,82%;138;97,18%
MULTIPOLYGON (((-58.376750546291518 -34.625114183617335,-58.375472020938027 -34.624563891258383,-58.374028896207058 -34.624436438028638,-58.373967749143176 -34.625456498492689,-58.373965852032377 -34.625557979409251,-58.375057103253262 -34.625642081019379,-58.376224553222677 -34.626269555066237,-58.376750546291518 -34.625114183617335)));;157;1_26_8;COMUNA 1;26;8;449;209;240;87,08%;281;281;100,00%;0;0,00%;213;2;0,94%;211;99,06%
MULTIPOLYGON (((-58.375057103253262 -34.625642081019379,-58.373965852032377 -34.625557979409251,-58.373892394576103 -34.626696133244288,-58.373865893691324 -34.626780835097897,-58.374560559030471 -34.626799367799578,-58.375572924785551 -34.627301590783361,-58.375692114184005 -34.627138360535021,-58.376176235758351 -34.626363045074086,-58.376224553222677 -34.626269555066237,-58.375057103253262 -34.625642081019379)));;158;1_26_9;COMUNA 1;26;9;739;325;414;78,50%;398;398;100,00%;0;0,00%;316;26;8,23%;290;91,77%
MULTIPOLYGON (((-58.384349849502229 -34.627009999030435,-58.384088139187959 -34.626997999263033,-58.383148888465904 -34.6269630934001,-58.382840738639985 -34.626959582074001,-58.38283151154323 -34.627253388707729,-58.382824744724481 -34.627469095730753,-58.384341170960639 -34.627541560578941,-58.38434623782701 -34.627226834974266,-58.384349849502229 -34.627009999030435)));;159;1_27_1;COMUNA 1;27;1;596;257;339;75,81%;310;307;99,03%;3;0,98%;234;2;0,85%;232;99,15%
MULTIPOLYGON (((-58.378006265534928 -34.625655502742738,-58.376750546291518 -34.625114183617335,-58.376224553222677 -34.626269555066237,-58.377262339113472 -34.626827347338462,-58.378006265534928 -34.625655502742738)));;160;1_27_10;COMUNA 1;27;10;513;242;271;89,30%;366;366;100,00%;0;0,00%;248;23;9,27%;225;90,73%
MULTIPOLYGON (((-58.384341170960639 -34.627541560578941,-58.382824744724481 -34.627469095730753,-58.382821228816141 -34.627581843682506,-58.382809458975551 -34.627861774916077,-58.38415130154695 -34.628138993654218,-58.384328307028014 -34.628175024203209,-58.384613151636316 -34.628232955293846,-58.38544776775251 -34.628389407438469,-58.385682623647064 -34.628425050097214,-58.38589677972508 -34.62845751015189,-58.387024529727142 -34.628652869412456,-58.387041449930535 -34.628502734056852,-58.387173178396431 -34.62735981970922,-58.387181746548613 -34.627118197185034,-58.386951555908603 -34.627108476667843,-58.385729035568694 -34.627063554946574,-58.384669661058645 -34.627024570714219,-58.384349849502229 -34.627009999030435,-58.38434623782701 -34.627226834974266,-58.384341170960639 -34.627541560578941)));;161;1_27_2;COMUNA 1;27;2;780;429;351;122,22%;199;188;94,47%;11;5,85%;275;80;29,09%;195;70,91%
MULTIPOLYGON (((-58.385682623647064 -34.628425050097214,-58.38544776775251 -34.628389407438469,-58.384613151636316 -34.628232955293846,-58.384328307028014 -34.628175024203209,-58.384322612464196 -34.628341716248762,-58.384258337813634 -34.629104094685836,-58.384210432323933 -34.629672603865231,-58.384195539009774 -34.62983605040008,-58.384368994522596 -34.629845739697323,-58.385414133582508 -34.629931057091696,-58.385591161466863 -34.629947578126625,-58.385827227133916 -34.629969629266419,-58.386868291186957 -34.630042325581776,-58.387024529727142 -34.628652869412456,-58.38589677972508 -34.62845751015189,-58.385682623647064 -34.628425050097214)));;162;1_27_3;COMUNA 1;27;3;888;413;475;86,95%;337;333;98,81%;4;1,20%;293;106;36,18%;187;63,82%
MULTIPOLYGON (((-58.385591161466863 -34.629947578126625,-58.385414133582508 -34.629931057091696,-58.384368994522596 -34.629845739697323,-58.384195539009774 -34.62983605040008,-58.384176083781504 -34.630048650547842,-58.384105329646076 -34.630993424891876,-58.384093336405662 -34.631152929455467,-58.383990006691008 -34.63239677685474,-58.385416906410221 -34.632820872158078,-58.385521661258444 -34.631119755967809,-58.38553316579808 -34.630932996532771,-58.385586163794962 -34.630100326501648,-58.385591161466863 -34.629947578126625)));;163;1_27_4;COMUNA 1;27;4;802;360;442;81,45%;360;359;99,72%;1;0,28%;325;148;45,54%;177;54,46%
MULTIPOLYGON (((-58.384105329646076 -34.630993424891876,-58.383908278874117 -34.630975832396381,-58.382847719271787 -34.630877815537069,-58.382662596260204 -34.630861003510788,-58.38263234827955 -34.631483891465912,-58.382625394272075 -34.631627483162994,-58.382620555968629 -34.63173165189778,-58.3833915497326 -34.632220538367747,-58.383990006691008 -34.63239677685474,-58.384093336405662 -34.631152929455467,-58.384105329646076 -34.630993424891876)));;164;1_27_5;COMUNA 1;27;5;641;298;343;86,88%;364;364;100,00%;0;0,00%;288;51;17,71%;237;82,29%
MULTIPOLYGON (((-58.382716606194727 -34.629713958798739,-58.382700580294447 -34.630077903995442,-58.382693887397423 -34.630216002761749,-58.382662596260204 -34.630861003510788,-58.382847719271787 -34.630877815537069,-58.383908278874117 -34.630975832396381,-58.384105329646076 -34.630993424891876,-58.384176083781504 -34.630048650547842,-58.384195539009774 -34.62983605040008,-58.384210432323933 -34.629672603865231,-58.384258337813634 -34.629104094685836,-58.384322612464196 -34.628341716248762,-58.384328307028014 -34.628175024203209,-58.38415130154695 -34.628138993654218,-58.382809458975551 -34.627861774916077,-58.382758916209511 -34.628860859625533,-58.38274987473055 -34.629049451519435,-58.382716606194727 -34.629713958798739)));;165;1_27_6;COMUNA 1;27;6;929;437;492;88,82%;384;383;99,74%;1;0,26%;359;224;62,40%;135;37,60%
MULTIPOLYGON (((-58.382164116263667 -34.627838603294798,-58.381792170386674 -34.627815046511202,-58.381432054687203 -34.627804172956054,-58.381395867394588 -34.628830380239584,-58.381390249161988 -34.629000100446568,-58.381353404362379 -34.630175114811792,-58.381336323503426 -34.630740755882393,-58.3813263761351 -34.630900099655953,-58.381545250806475 -34.6310417799532,-58.382218009548609 -34.631489531420456,-58.382621294005105 -34.631757952539374,-58.382620555968629 -34.63173165189778,-58.382625394272075 -34.631627483162994,-58.38263234827955 -34.631483891465912,-58.382662596260204 -34.630861003510788,-58.382693887397423 -34.630216002761749,-58.382700580294447 -34.630077903995442,-58.382716606194727 -34.629713958798739,-58.38274987473055 -34.629049451519435,-58.382758916209511 -34.628860859625533,-58.382809458975551 -34.627861774916077,-58.382430426091744 -34.627854201886571,-58.382164116263667 -34.627838603294798)));;166;1_27_7;COMUNA 1;27;7;866;440;426;103,29%;252;249;98,81%;3;1,20%;265;123;46,42%;142;53,58%
MULTIPOLYGON (((-58.377262339113472 -34.626827347338462,-58.376224553222677 -34.626269555066237,-58.376176235758351 -34.626363045074086,-58.375692114184005 -34.627138360535021,-58.375572924785551 -34.627301590783361,-58.376589835416624 -34.627873640941829,-58.377703724730537 -34.628493244154939,-58.377926501399621 -34.628620292444865,-58.379082390227921 -34.629318134052262,-58.378981208065689 -34.629559683281265,-58.378762059762209 -34.630105117377397,-58.378735575078565 -34.630177566330183,-58.378660221890051 -34.630383436722404,-58.378622778457583 -34.630485931126259,-58.379042573186865 -34.631275391240862,-58.379470863213008 -34.632034258039404,-58.379525691563458 -34.632160778450043,-58.379510049223057 -34.632211403240269,-58.379577618533446 -34.632292015320331,-58.379635741163874 -34.632362057203714,-58.380092152435019 -34.632632164715034,-58.380113352033064 -34.632733872528689,-58.380143303553474 -34.633031719410312,-58.380292232922834 -34.633035482215632,-58.381068396908155 -34.633062272618069,-58.381250380819708 -34.633070070587017,-58.381280643015607 -34.63235661681513,-58.381324172984634 -34.63111733714134,-58.3813263761351 -34.630900099655953,-58.381336323503426 -34.630740755882393,-58.381353404362379 -34.630175114811792,-58.381390249161988 -34.629000100446568,-58.381395867394588 -34.628830380239584,-58.381432054687203 -34.627804172956054,-58.381792170386674 -34.627815046511202,-58.382164116263667 -34.627838603294798,-58.382430426091744 -34.627854201886571,-58.382809458975551 -34.627861774916077,-58.382821228816141 -34.627581843682506,-58.382824744724481 -34.627469095730753,-58.38283151154323 -34.627253388707729,-58.382840738639985 -34.626959582074001,-58.382230244482962 -34.626940025284391,-58.382138002231493 -34.626914400158427,-58.380181764196415 -34.626371172837899,-58.380036052189887 -34.626657351409619,-58.37993714414592 -34.626910813980913,-58.379766060982824 -34.627349092758038,-58.379729503798337 -34.627442733004543,-58.379652862376759 -34.627663885430913,-58.378541791917421 -34.627348958472794,-58.37849342939132 -34.627489000205522,-58.377262339113472 -34.626827347338462)));;167;1_27_8;COMUNA 1;27;8;694;332;362;91,71%;363;357;98,35%;6;1,68%;255;50;19,61%;205;80,39%
MULTIPOLYGON (((-58.379009084608654 -34.626084589625322,-58.378006265534928 -34.625655502742738,-58.377262339113472 -34.626827347338462,-58.37849342939132 -34.627489000205522,-58.378541791917421 -34.627348958472794,-58.379652862376759 -34.627663885430913,-58.379729503798337 -34.627442733004543,-58.379766060982824 -34.627349092758038,-58.37993714414592 -34.626910813980913,-58.380036052189887 -34.626657351409619,-58.380181764196415 -34.626371172837899,-58.380054854106639 -34.626340170384964,-58.379009084608654 -34.626084589625322)));;168;1_27_9;COMUNA 1;27;9;723;353;370;95,41%;344;344;100,00%;0;0,00%;324;115;35,49%;209;64,51%
MULTIPOLYGON (((-58.3898874815497 -34.62263574630876,-58.388650825619806 -34.622559999312536,-58.388299515876703 -34.622538517214707,-58.38754587256232 -34.622489814138149,-58.387179570464021 -34.622467544903081,-58.387173896190539 -34.622712620226189,-58.387176298683052 -34.623351939389792,-58.387177815418042 -34.623746531277902,-58.388465391266578 -34.623868875086679,-58.389516240019795 -34.62396866838025,-58.38975553477421 -34.623981981173316,-58.390023964104742 -34.623996930631982,-58.391149454448282 -34.62398682097492,-58.391431355881416 -34.623988464924679,-58.391457394844188 -34.623425503145448,-58.391488484531997 -34.622733807443026,-58.3898874815497 -34.62263574630876)));;169;1_28_1;COMUNA 1;28;1;512;226;286;79,02%;277;275;99,28%;2;0,73%;220;39;17,73%;181;82,27%
MULTIPOLYGON (((-58.384362761359647 -34.626053214554425,-58.384353730711886 -34.626778303597391,-58.384349849502229 -34.627009999030435,-58.384669661058645 -34.627024570714219,-58.385729035568694 -34.627063554946574,-58.386951555908603 -34.627108476667843,-58.387181746548613 -34.627118197185034,-58.387190663790328 -34.626867349204382,-58.387203338074698 -34.626324944418656,-58.387206712436083 -34.626173744223934,-58.387012222740793 -34.626162214863825,-58.385990005526487 -34.626121645377523,-58.385751298554098 -34.626111635540049,-58.385782276339093 -34.624762736175498,-58.385539484322258 -34.624752371223444,-58.384379442608704 -34.624711208009728,-58.38437777320928 -34.624855859735696,-58.384362761359647 -34.626053214554425)));;170;1_28_10;COMUNA 1;28;10;909;435;474;91,77%;413;412;99,76%;1;0,24%;353;97;27,48%;256;72,52%
MULTIPOLYGON (((-58.387187037664688 -34.624851363338799,-58.386975259575706 -34.624836724519021,-58.385925310644829 -34.624768882827709,-58.385782276339093 -34.624762736175498,-58.385751298554098 -34.626111635540049,-58.385990005526487 -34.626121645377523,-58.387012222740793 -34.626162214863825,-58.387206712436083 -34.626173744223934,-58.387211151217777 -34.625976064241158,-58.387187037664688 -34.624851363338799)));;171;1_28_11;COMUNA 1;28;11;610;310;300;103,33%;251;250;99,60%;1;0,40%;249;153;61,45%;96;38,55%
MULTIPOLYGON (((-58.388389041603169 -34.624939217150647,-58.388179567523366 -34.624919863355139,-58.387187037664688 -34.624851363338799,-58.387211151217777 -34.625976064241158,-58.387206712436083 -34.626173744223934,-58.387338505830051 -34.626177346965036,-58.388307660559889 -34.626203717394077,-58.388389041603169 -34.624939217150647)));;172;1_28_12;COMUNA 1;28;12;573;276;297;92,93%;264;263;99,62%;1;0,38%;235;75;31,91%;160;68,09%
MULTIPOLYGON (((-58.391328999884912 -34.625228588131691,-58.389652949535012 -34.625066393313119,-58.389566097729549 -34.625985034358258,-58.389533868103172 -34.626208754981498,-58.388307660559889 -34.626203717394077,-58.387338505830051 -34.626177346965036,-58.387206712436083 -34.626173744223934,-58.387203338074698 -34.626324944418656,-58.387190663790328 -34.626867349204382,-58.387181746548613 -34.627118197185034,-58.387289430163165 -34.627122700574347,-58.387502582397232 -34.627131635277379,-58.388295471817678 -34.627164657805636,-58.388684121648019 -34.627180810282951,-58.388811315369068 -34.627185253740961,-58.389263777635115 -34.627200950034968,-58.389437741919409 -34.627207815435327,-58.389670404310543 -34.62721696934161,-58.390248191931661 -34.627230835480965,-58.391169824038741 -34.62725299986802,-58.391186275766749 -34.627044058828787,-58.391218662183149 -34.626632725935472,-58.391242262871657 -34.626332800070848,-58.391328999884912 -34.625228588131691)));;173;1_28_13;COMUNA 1;28;13;652;330;322;102,48%;277;276;99,64%;1;0,36%;261;113;43,30%;148;56,70%
MULTIPOLYGON (((-58.391431355881416 -34.623988464924679,-58.391149454448282 -34.62398682097492,-58.390023964104742 -34.623996930631982,-58.38975553477421 -34.623981981173316,-58.389652949535012 -34.625066393313119,-58.391328999884912 -34.625228588131691,-58.391403158297372 -34.624285852957755,-58.391431355881416 -34.623988464924679)));;174;1_28_2;COMUNA 1;28;2;753;365;388;94,07%;371;371;100,00%;0;0,00%;345;168;48,70%;177;51,30%
MULTIPOLYGON (((-58.38975553477421 -34.623981981173316,-58.389516240019795 -34.62396866838025,-58.388465391266578 -34.623868875086679,-58.387177815418042 -34.623746531277902,-58.387179009370293 -34.624027245819683,-58.387179734408583 -34.624261338752333,-58.387183768242615 -34.624698680071631,-58.387187037664688 -34.624851363338799,-58.388179567523366 -34.624919863355139,-58.388389041603169 -34.624939217150647,-58.388307660559889 -34.626203717394077,-58.389533868103172 -34.626208754981498,-58.389566097729549 -34.625985034358258,-58.389652949535012 -34.625066393313119,-58.38975553477421 -34.623981981173316)));;175;1_28_3;COMUNA 1;28;3;677;308;369;83,47%;264;260;98,48%;4;1,54%;241;74;30,71%;167;69,29%
MULTIPOLYGON (((-58.387179570464021 -34.622467544903081,-58.38685943965838 -34.622448049855478,-58.385829786183528 -34.622391276670413,-58.385827290029951 -34.622603817606141,-58.385813738243627 -34.62325728215955,-58.385806960155797 -34.623586303218531,-58.385799740001517 -34.623932718940033,-58.385785204563767 -34.624636114001852,-58.385782276339093 -34.624762736175498,-58.385925310644829 -34.624768882827709,-58.386975259575706 -34.624836724519021,-58.387187037664688 -34.624851363338799,-58.387183768242615 -34.624698680071631,-58.387179734408583 -34.624261338752333,-58.387179009370293 -34.624027245819683,-58.387177815418042 -34.623746531277902,-58.387176298683052 -34.623351939389792,-58.387173896190539 -34.622712620226189,-58.387179570464021 -34.622467544903081)));;176;1_28_4;COMUNA 1;28;4;661;281;380;73,95%;323;320;99,07%;3;0,94%;280;62;22,14%;218;77,86%
MULTIPOLYGON (((-58.385829786183528 -34.622391276670413,-58.384771426138585 -34.622332997535437,-58.384391235783056 -34.622314514002419,-58.383250154462345 -34.622259196811754,-58.382961116105385 -34.622243866853111,-58.382950742548637 -34.623915184860373,-58.383095987772116 -34.623923871572956,-58.384387773897274 -34.624004569602626,-58.384393705137065 -34.62349476728501,-58.385806960155797 -34.623586303218531,-58.385813738243627 -34.62325728215955,-58.385827290029951 -34.622603817606141,-58.385829786183528 -34.622391276670413)));;177;1_28_5;COMUNA 1;28;5;805;373;432;86,34%;460;460;100,00%;0;0,00%;354;26;7,34%;328;92,66%
MULTIPOLYGON (((-58.385806960155797 -34.623586303218531,-58.384393705137065 -34.62349476728501,-58.384387773897274 -34.624004569602626,-58.384379442608704 -34.624711208009728,-58.385539484322258 -34.624752371223444,-58.385782276339093 -34.624762736175498,-58.385785204563767 -34.624636114001852,-58.385799740001517 -34.623932718940033,-58.385806960155797 -34.623586303218531)));;178;1_28_6;COMUNA 1;28;6;632;304;328;92,68%;320;320;100,00%;0;0,00%;281;122;43,42%;159;56,58%
MULTIPOLYGON (((-58.382950742548637 -34.623915184860373,-58.382961116105385 -34.622243866853111,-58.381426990821709 -34.62216292207119,-58.381437893937793 -34.622339062143254,-58.381444385773541 -34.622933100911951,-58.381451813306207 -34.623616086942548,-58.381446081879993 -34.623815033570473,-58.381441936206201 -34.62396031744877,-58.381422368413894 -34.624632087817105,-58.382107669721336 -34.624655315163992,-58.382487422357528 -34.624667512307482,-58.382926750946005 -34.624682167092629,-58.384144486792906 -34.624702887635209,-58.384379442608704 -34.624711208009728,-58.384387773897274 -34.624004569602626,-58.383095987772116 -34.623923871572956,-58.382950742548637 -34.623915184860373)));;179;1_28_7;COMUNA 1;28;7;727;348;379;91,82%;347;347;100,00%;0;0,00%;314;77;24,52%;237;75,48%
MULTIPOLYGON (((-58.381422368413894 -34.624632087817105,-58.38088955375742 -34.624647436394483,-58.380347108283019 -34.626046273634017,-58.380181764196415 -34.626371172837899,-58.382138002231493 -34.626914400158427,-58.382230244482962 -34.626940025284391,-58.382840738639985 -34.626959582074001,-58.382847417546479 -34.626746621545635,-58.382876511607137 -34.625990699639935,-58.382926750946005 -34.624682167092629,-58.382487422357528 -34.624667512307482,-58.382107669721336 -34.624655315163992,-58.381422368413894 -34.624632087817105)));;180;1_28_8;COMUNA 1;28;8;306;161;145;111,03%;96;93;96,88%;3;3,23%;110;20;18,18%;90;81,82%
MULTIPOLYGON (((-58.382876511607137 -34.625990699639935,-58.382847417546479 -34.626746621545635,-58.382840738639985 -34.626959582074001,-58.383148888465904 -34.6269630934001,-58.384088139187959 -34.626997999263033,-58.384349849502229 -34.627009999030435,-58.384353730711886 -34.626778303597391,-58.384362761359647 -34.626053214554425,-58.38437777320928 -34.624855859735696,-58.384379442608704 -34.624711208009728,-58.384144486792906 -34.624702887635209,-58.382926750946005 -34.624682167092629,-58.382876511607137 -34.625990699639935)));;181;1_28_9;COMUNA 1;28;9;741;376;365;103,01%;304;300;98,68%;4;1,33%;262;67;25,57%;195;74,43%
MULTIPOLYGON (((-58.391169824038741 -34.62725299986802,-58.390248191931661 -34.627230835480965,-58.389670404310543 -34.62721696934161,-58.389437741919409 -34.627207815435327,-58.389425896091588 -34.62740570228808,-58.389369197047493 -34.628133016523414,-58.389312928075576 -34.628854556063374,-58.389293164199124 -34.62904574772169,-58.390048244670062 -34.629176485830776,-58.390925313139334 -34.62932834814594,-58.39106149307451 -34.62819944689172,-58.391169824038741 -34.62725299986802)));;182;1_29_1;COMUNA 1;29;1;1123;524;599;87,48%;454;453;99,78%;1;0,22%;420;141;33,57%;279;66,43%
MULTIPOLYGON (((-58.388811315369068 -34.627185253740961,-58.388684121648019 -34.627180810282951,-58.388295471817678 -34.627164657805636,-58.387502582397232 -34.627131635277379,-58.387289430163165 -34.627122700574347,-58.387181746548613 -34.627118197185034,-58.387173178396431 -34.62735981970922,-58.387041449930535 -34.628502734056852,-58.387024529727142 -34.628652869412456,-58.388094785553648 -34.628838182758294,-58.389293164199124 -34.62904574772169,-58.389312928075576 -34.628854556063374,-58.389369197047493 -34.628133016523414,-58.389425896091588 -34.62740570228808,-58.389437741919409 -34.627207815435327,-58.389263777635115 -34.627200950034968,-58.388811315369068 -34.627185253740961)));;183;1_29_2;COMUNA 1;29;2;624;312;312;100,00%;250;250;100,00%;0;0,00%;266;142;53,38%;124;46,62%
MULTIPOLYGON (((-58.388094785553648 -34.628838182758294,-58.387024529727142 -34.628652869412456,-58.386868291186957 -34.630042325581776,-58.387941389865553 -34.630117286246019,-58.388094785553648 -34.628838182758294)));;184;1_29_3;COMUNA 1;29;3;817;391;426;91,78%;300;299;99,67%;1;0,33%;276;124;44,93%;152;55,07%
MULTIPOLYGON (((-58.387941389865553 -34.630117286246019,-58.387927311460324 -34.630235168841608,-58.387826786053985 -34.631172814180324,-58.387804756473599 -34.631320974546568,-58.387981192272925 -34.631336505799773,-58.38902967061793 -34.631428555039854,-58.389162472239803 -34.630202538384033,-58.389184290786666 -34.630000784291703,-58.389280703921798 -34.629166730164052,-58.389293164199124 -34.62904574772169,-58.388094785553648 -34.628838182758294,-58.387941389865553 -34.630117286246019)));;185;1_29_4;COMUNA 1;29;4;723;341;382;89,27%;295;294;99,66%;1;0,34%;272;71;26,10%;201;73,90%
MULTIPOLYGON (((-58.390048244670062 -34.629176485830776,-58.389293164199124 -34.62904574772169,-58.389280703921798 -34.629166730164052,-58.389184290786666 -34.630000784291703,-58.389162472239803 -34.630202538384033,-58.38902967061793 -34.631428555039854,-58.389232772594653 -34.631446354181243,-58.39066244801338 -34.631529885715587,-58.39078302758373 -34.630518374218489,-58.390890044804145 -34.629620661045649,-58.390925313139334 -34.62932834814594,-58.390048244670062 -34.629176485830776)));;186;1_29_5;COMUNA 1;29;5;804;385;419;91,89%;335;334;99,70%;1;0,30%;306;114;37,25%;192;62,75%
MULTIPOLYGON (((-58.39066244801338 -34.631529885715587,-58.389232772594653 -34.631446354181243,-58.38902967061793 -34.631428555039854,-58.387981192272925 -34.631336505799773,-58.387804756473599 -34.631320974546568,-58.387785898156849 -34.631448079822604,-58.387718010862756 -34.632470325157257,-58.3879189054189 -34.632481927742035,-58.388731599825796 -34.632529396673817,-58.388903098856645 -34.632542458728857,-58.390526847155726 -34.63266618085094,-58.390557314060814 -34.632411683504074,-58.39066244801338 -34.631529885715587)));;187;1_29_6;COMUNA 1;29;6;990;493;497;99,20%;349;349;100,00%;0;0,00%;323;15;4,64%;308;95,36%
MULTIPOLYGON (((-58.390526847155726 -34.63266618085094,-58.388903098856645 -34.632542458728857,-58.388731599825796 -34.632529396673817,-58.3879189054189 -34.632481927742035,-58.387718010862756 -34.632470325157257,-58.387652452916228 -34.633458626947942,-58.388556821763942 -34.633712005183661,-58.388763651750587 -34.633759526645477,-58.389515414431784 -34.633932098313664,-58.390352621841565 -34.634124364583819,-58.390526847155726 -34.63266618085094)));;188;1_29_7;COMUNA 1;29;7;916;405;511;79,26%;388;386;99,48%;2;0,52%;328;58;17,68%;270;82,32%
MULTIPOLYGON (((-58.387941389865553 -34.630117286246019,-58.386868291186957 -34.630042325581776,-58.386735153153523 -34.631226788876702,-58.386603042465374 -34.632401674656357,-58.386519891402756 -34.63314129479091,-58.387267771803288 -34.633355780671501,-58.387652452916228 -34.633458626947942,-58.387718010862756 -34.632470325157257,-58.387785898156849 -34.631448079822604,-58.387804756473599 -34.631320974546568,-58.387826786053985 -34.631172814180324,-58.387927311460324 -34.630235168841608,-58.387941389865553 -34.630117286246019)));;189;1_29_8;COMUNA 1;29;8;648;300;348;86,21%;279;279;100,00%;0;0,00%;260;103;39,62%;157;60,38%
MULTIPOLYGON (((-58.386868291186957 -34.630042325581776,-58.385827227133916 -34.629969629266419,-58.385591161466863 -34.629947578126625,-58.385586163794962 -34.630100326501648,-58.38553316579808 -34.630932996532771,-58.385521661258444 -34.631119755967809,-58.385416906410221 -34.632820872158078,-58.386519891402756 -34.63314129479091,-58.386603042465374 -34.632401674656357,-58.386735153153523 -34.631226788876702,-58.386868291186957 -34.630042325581776)));;190;1_29_9;COMUNA 1;29;9;923;434;489;88,75%;433;432;99,77%;1;0,23%;376;64;17,02%;312;82,98%
MULTIPOLYGON (((-58.38184467418241 -34.591592565691265,-58.381557081736354 -34.591601037119169,-58.381615239095929 -34.592835067889219,-58.381966443128789 -34.59283473733786,-58.382210088759798 -34.592834546156517,-58.382836448017166 -34.592833971724154,-58.383015286146183 -34.592833806930692,-58.384443102173286 -34.592825575616324,-58.384435690373195 -34.592737750519412,-58.384331916342305 -34.591519326177149,-58.383148335079461 -34.59155412515377,-58.38308241968334 -34.591556054076179,-58.382893104478313 -34.591561634867652,-58.382732318521846 -34.591566388959755,-58.382164968880566 -34.591583058791549,-58.38206251887879 -34.59158608985215,-58.38184467418241 -34.591592565691265)));;191;1_5_1;COMUNA 1;5;1;631;261;370;70,54%;362;362;100,00%;0;0,00%;257;1;0,39%;256;99,61%
MULTIPOLYGON (((-58.382836448017166 -34.592833971724154,-58.382210088759798 -34.592834546156517,-58.381966443128789 -34.59283473733786,-58.381615239095929 -34.592835067889219,-58.381623499321158 -34.593010784481706,-58.381592471802186 -34.594179612310889,-58.381704959864521 -34.594191307194514,-58.382022413074822 -34.59422433566214,-58.382417186284222 -34.594265372252629,-58.382489884880819 -34.594385283879326,-58.382584601285131 -34.594635074122614,-58.382671076438932 -34.594421038030326,-58.382771000755532 -34.594302225654054,-58.382952378731495 -34.59432107744346,-58.384413577313069 -34.59443195744975,-58.384416411718476 -34.594315546284754,-58.384466684465934 -34.593105883405094,-58.384443102173286 -34.592825575616324,-58.383015286146183 -34.592833806930692,-58.382836448017166 -34.592833971724154)));;192;1_5_2;COMUNA 1;5;2;533;232;301;77,08%;430;430;100,00%;0;0,00%;240;2;0,83%;238;99,17%
MULTIPOLYGON (((-58.386504081859606 -34.592825612209701,-58.386251674482473 -34.592815101830695,-58.384443102173286 -34.592825575616324,-58.384466684465934 -34.593105883405094,-58.384416411718476 -34.594315546284754,-58.384413577313069 -34.59443195744975,-58.385820000772931 -34.594563913046855,-58.385827934150811 -34.594457082900192,-58.386079577834664 -34.593171345887448,-58.386504081859606 -34.592825612209701)));;193;1_5_3;COMUNA 1;5;3;928;362;566;63,96%;643;640;99,53%;3;0,47%;405;3;0,74%;402;99,26%
MULTIPOLYGON (((-58.387566545330003 -34.592830426063571,-58.387028922264243 -34.59283269961211,-58.386704798497462 -34.592834047554113,-58.386504081859606 -34.592825612209701,-58.386079577834664 -34.593171345887448,-58.385827934150811 -34.594457082900192,-58.385820000772931 -34.594563913046855,-58.385912650615566 -34.59457171816193,-58.387139705597079 -34.594631993470685,-58.387290176875347 -34.594644551822242,-58.387309257049317 -34.594546179500362,-58.387566545330003 -34.592830426063571)));;194;1_5_4;COMUNA 1;5;4;1200;497;703;70,70%;698;697;99,86%;1;0,14%;490;4;0,82%;486;99,18%
MULTIPOLYGON (((-58.387290176875347 -34.594644551822242,-58.387139705597079 -34.594631993470685,-58.385912650615566 -34.59457171816193,-58.385820000772931 -34.594563913046855,-58.385754115441706 -34.595454328643932,-58.385748031660931 -34.595679333526988,-58.385990139124523 -34.595693852714476,-58.387156256726662 -34.59572824346391,-58.387178390444632 -34.595549869969702,-58.387270411788656 -34.594746867531548,-58.387290176875347 -34.594644551822242)));;195;1_5_5;COMUNA 1;5;5;637;275;362;75,97%;389;387;99,49%;2;0,52%;242;0;0,00%;242;100,00%
MULTIPOLYGON (((-58.385820000772931 -34.594563913046855,-58.384413577313069 -34.59443195744975,-58.384410391809809 -34.594559495580668,-58.384315206689308 -34.595437637593577,-58.384299987243686 -34.595592492972067,-58.385748031660931 -34.595679333526988,-58.385754115441706 -34.595454328643932,-58.385820000772931 -34.594563913046855)));;196;1_5_6;COMUNA 1;5;6;888;435;453;96,03%;641;638;99,53%;3;0,47%;365;3;0,82%;362;99,18%
MULTIPOLYGON (((-58.384413577313069 -34.59443195744975,-58.382952378731495 -34.59432107744346,-58.382771000755532 -34.594302225654054,-58.382671076438932 -34.594421038030326,-58.382584601285131 -34.594635074122614,-58.382489884880819 -34.594385283879326,-58.382417186284222 -34.594265372252629,-58.382022413074822 -34.59422433566214,-58.381704959864521 -34.594191307194514,-58.381592471802186 -34.594179612310889,-58.381492777840045 -34.595197825014438,-58.381484527489278 -34.595362051241757,-58.381972304155177 -34.595403362405484,-58.382023057451342 -34.595407691911518,-58.38241128652453 -34.595440554859969,-58.382717424831064 -34.595466461119742,-58.384299987243686 -34.595592492972067,-58.384315206689308 -34.595437637593577,-58.384410391809809 -34.594559495580668,-58.384413577313069 -34.59443195744975)));;197;1_5_7;COMUNA 1;5;7;597;253;344;73,55%;563;563;100,00%;0;0,00%;270;1;0,37%;269;99,63%
MULTIPOLYGON (((-58.380905417348671 -34.589277834157294,-58.379539349400396 -34.590021377079928,-58.379449709789505 -34.590074839210004,-58.380143173710167 -34.591344656210623,-58.380137872537269 -34.591452262496425,-58.380073830314707 -34.592744805124269,-58.380077889337734 -34.592859812375501,-58.381424137798376 -34.59283522246411,-58.381615239095929 -34.592835067889219,-58.381557081736354 -34.591601037119169,-58.381546067470289 -34.591367781172174,-58.381546224479948 -34.590593243665595,-58.381436588901451 -34.590368232236152,-58.380905417348671 -34.589277834157294)));;198;1_6_1;COMUNA 1;6;1;948;444;504;88,10%;513;509;99,22%;4;0,79%;326;1;0,31%;325;99,69%
MULTIPOLYGON (((-58.380033813901932 -34.594111098986971,-58.379972412387069 -34.594110634825419,-58.379958537960896 -34.594704803456516,-58.379950264667137 -34.595060938429995,-58.379953931156962 -34.595228200922008,-58.381225992464749 -34.595340117495908,-58.381484527489278 -34.595362051241757,-58.381492777840045 -34.595197825014438,-58.381592471802186 -34.594179612310889,-58.381390061499744 -34.594158561304525,-58.380163770418079 -34.594112172906414,-58.380033813901932 -34.594111098986971)));;199;1_6_10;COMUNA 1;6;10;415;184;231;79,65%;354;352;99,44%;2;0,57%;193;1;0,52%;192;99,48%
MULTIPOLYGON (((-58.380137872537269 -34.591452262496425,-58.3800297290096 -34.591443104420208,-58.37958936993445 -34.591442312337527,-58.379461149882417 -34.591497438389041,-58.379395537902425 -34.591536620514439,-58.379334252328128 -34.591592496357421,-58.379301853674178 -34.591630503885966,-58.378770820660947 -34.592285165556966,-58.378713907630406 -34.592310902060689,-58.378659134353519 -34.592325935366141,-58.378571569059851 -34.592346157517078,-58.378580902433121 -34.592887100633519,-58.380077889337734 -34.592859812375501,-58.380073830314707 -34.592744805124269,-58.380137872537269 -34.591452262496425)));;200;1_6_2;COMUNA 1;6;2;641;291;350;83,14%;425;423;99,53%;2;0,47%;210;0;0,00%;210;100,00%
MULTIPOLYGON (((-58.379449709789505 -34.590074839210004,-58.379452358835586 -34.590071092806518,-58.378749204665766 -34.590492615319022,-58.37785538058516 -34.591078992171241,-58.378571569059851 -34.592346157517078,-58.378659134353519 -34.592325935366141,-58.378713907630406 -34.592310902060689,-58.378770820660947 -34.592285165556966,-58.379301853674178 -34.591630503885966,-58.379334252328128 -34.591592496357421,-58.379395537902425 -34.591536620514439,-58.379461149882417 -34.591497438389041,-58.37958936993445 -34.591442312337527,-58.3800297290096 -34.591443104420208,-58.380137872537269 -34.591452262496425,-58.380143173710167 -34.591344656210623,-58.379449709789505 -34.590074839210004)));;201;1_6_3;COMUNA 1;6;3;1160;543;617;88,01%;685;684;99,85%;1;0,15%;426;0;0,00%;426;100,00%
MULTIPOLYGON (((-58.37785538058516 -34.591078992171241,-58.377129421524536 -34.591555264630628,-58.376670017405374 -34.591854601299637,-58.377086767308953 -34.592873032882693,-58.37785559982666 -34.592873781115443,-58.378580902433121 -34.592887100633519,-58.378571569059851 -34.592346157517078,-58.37785538058516 -34.591078992171241)));;202;1_6_4;COMUNA 1;6;4;789;350;439;79,73%;704;704;100,00%;0;0,00%;397;2;0,50%;395;99,50%
MULTIPOLYGON (((-58.376670017405374 -34.591854601299637,-58.375439895610661 -34.592656224159775,-58.375287013771633 -34.592754991854179,-58.375148022178806 -34.592844825309733,-58.375041072633977 -34.592913906166082,-58.375508190529175 -34.592904592547377,-58.375693675098823 -34.592900851542687,-58.377086767308953 -34.592873032882693,-58.376670017405374 -34.591854601299637)));;203;1_6_5;COMUNA 1;6;5;332;146;186;78,49%;331;330;99,70%;1;0,30%;169;1;0,59%;168;99,41%
MULTIPOLYGON (((-58.377086767308953 -34.592873032882693,-58.375693675098823 -34.592900851542687,-58.37594914855827 -34.593237736717498,-58.375734260620803 -34.593344278074156,-58.376668092452782 -34.594465406159415,-58.376864722513297 -34.594558294707198,-58.377031492492314 -34.594537425167069,-58.377249001985028 -34.59453349300437,-58.377471290563754 -34.594603158199725,-58.377634235384022 -34.594742291377038,-58.377658845116628 -34.594828156931676,-58.377688402675844 -34.594905856596206,-58.377685296916958 -34.595028605671509,-58.378501172884022 -34.595100371284481,-58.378504035172874 -34.594964522921352,-58.378516458613625 -34.59463712441849,-58.378536844240855 -34.594099018963938,-58.378577086609752 -34.593039780031674,-58.378580902433121 -34.592887100633519,-58.37785559982666 -34.592873781115443,-58.377086767308953 -34.592873032882693)));;204;1_6_6;COMUNA 1;6;6;569;245;324;75,62%;396;396;100,00%;0;0,00%;252;2;0,79%;250;99,21%
MULTIPOLYGON (((-58.379972412387069 -34.594110634825419,-58.378536844240855 -34.594099018963938,-58.378516458613625 -34.59463712441849,-58.378504035172874 -34.594964522921352,-58.378501172884022 -34.595100371284481,-58.379953931156962 -34.595228200922008,-58.379950264667137 -34.595060938429995,-58.379958537960896 -34.594704803456516,-58.379972412387069 -34.594110634825419)));;205;1_6_7;COMUNA 1;6;7;498;220;278;79,14%;387;387;100,00%;0;0,00%;227;1;0,44%;226;99,56%
MULTIPOLYGON (((-58.380077889337734 -34.592859812375501,-58.378580902433121 -34.592887100633519,-58.378577086609752 -34.593039780031674,-58.378536844240855 -34.594099018963938,-58.379972412387069 -34.594110634825419,-58.380033813901932 -34.594111098986971,-58.380081782860174 -34.592969960167316,-58.380077889337734 -34.592859812375501)));;206;1_6_8;COMUNA 1;6;8;730;354;376;94,15%;511;505;98,83%;6;1,19%;296;3;1,01%;293;98,99%
MULTIPOLYGON (((-58.381615239095929 -34.592835067889219,-58.381424137798376 -34.59283522246411,-58.380077889337734 -34.592859812375501,-58.380081782860174 -34.592969960167316,-58.380033813901932 -34.594111098986971,-58.380163770418079 -34.594112172906414,-58.381390061499744 -34.594158561304525,-58.381592471802186 -34.594179612310889,-58.381623499321158 -34.593010784481706,-58.381615239095929 -34.592835067889219)));;207;1_6_9;COMUNA 1;6;9;1046;462;584;79,11%;602;602;100,00%;0;0,00%;419;2;0,48%;417;99,52%
MULTIPOLYGON (((-58.379953931156962 -34.595228200922008,-58.378501172884022 -34.595100371284481,-58.378496703385039 -34.595309812935518,-58.378435974128969 -34.596245159283349,-58.378437809097903 -34.596367770912778,-58.379900706382259 -34.596513284912547,-58.37995792064779 -34.595413281219791,-58.379953931156962 -34.595228200922008)));;208;1_7_1;COMUNA 1;7;1;669;326;343;95,04%;620;618;99,68%;2;0,32%;264;2;0,76%;262;99,24%
MULTIPOLYGON (((-58.378361984869436 -34.597659176637222,-58.377571682393572 -34.59762320396765,-58.376900359370872 -34.597585126713298,-58.376886591910818 -34.597722164538844,-58.376838608539799 -34.598666533097692,-58.376838973729157 -34.598808228901483,-58.37827904625447 -34.598909026237131,-58.378361984869436 -34.597659176637222)));;209;1_7_10;COMUNA 1;7;10;384;179;205;87,32%;853;852;99,88%;1;0,12%;232;1;0,43%;231;99,57%
MULTIPOLYGON (((-58.376900359370872 -34.597585126713298,-58.375401530686851 -34.597499975911354,-58.375257949846414 -34.597491844631072,-58.374254002136759 -34.5974252734921,-58.374248099271014 -34.597530554939659,-58.374227672329496 -34.597920062089521,-58.374199685494631 -34.598451188854575,-58.374187239663598 -34.598622594819247,-58.375368161693814 -34.598705279818901,-58.376838973729157 -34.598808228901483,-58.376838608539799 -34.598666533097692,-58.376886591910818 -34.597722164538844,-58.376900359370872 -34.597585126713298)));;210;1_7_11;COMUNA 1;7;11;213;110;103;106,80%;362;362;100,00%;0;0,00%;140;2;1,43%;138;98,57%
MULTIPOLYGON (((-58.374254002136759 -34.5974252734921,-58.373069603100603 -34.597346730243068,-58.372954476807699 -34.597330447822301,-58.372879904994498 -34.597853441157639,-58.372870286491484 -34.597927662268859,-58.372863072337509 -34.597983574589279,-58.372794279384109 -34.598517065427778,-58.374187239663598 -34.598622594819247,-58.374199685494631 -34.598451188854575,-58.374227672329496 -34.597920062089521,-58.374248099271014 -34.597530554939659,-58.374254002136759 -34.5974252734921)));;211;1_7_12;COMUNA 1;7;12;507;268;239;112,13%;404;400;99,01%;4;1,00%;175;2;1,14%;173;98,86%
MULTIPOLYGON (((-58.373352468590973 -34.59449707734526,-58.37304048688172 -34.594518960575222,-58.373909271349319 -34.59364501789063,-58.37266897058683 -34.59214968455948,-58.372625425209037 -34.592097185580855,-58.372189171576551 -34.591762835613181,-58.370478477094679 -34.595927632361004,-58.369982331613514 -34.597135542288214,-58.369512342616247 -34.598321285979864,-58.370930129208716 -34.598381095112558,-58.371085551071744 -34.59838762059546,-58.371237560894308 -34.598399073088537,-58.371337623326951 -34.598406683547232,-58.371479924924742 -34.59841749464227,-58.372794279384109 -34.598517065427778,-58.372863072337509 -34.597983574589279,-58.372870286491484 -34.597927662268859,-58.372879904994498 -34.597853441157639,-58.372954476807699 -34.597330447822301,-58.37310095807765 -34.596302558211896,-58.373118209640467 -34.596178199888946,-58.373137607564779 -34.596037715753909,-58.373286557293561 -34.595086238920352,-58.373297025139564 -34.595013497293941,-58.373352468590973 -34.59449707734526)));;212;1_7_13;COMUNA 1;7;13;1425;922;503;183,30%;254;249;98,03%;5;2,01%;64;2;3,13%;62;96,88%
MULTIPOLYGON (((-58.375693675098837 -34.592900851542687,-58.37550819052916 -34.592904592547377,-58.375041072633962 -34.592913906166075,-58.375148022178806 -34.592844825309733,-58.375287013771612 -34.592754991854171,-58.375439895610661 -34.592656224159747,-58.374431443699883 -34.591427915534652,-58.374153045168192 -34.591112180170157,-58.373974541729943 -34.591130973987106,-58.373750269203882 -34.591153518884397,-58.373690762625685 -34.591164829576144,-58.373411454519491 -34.591297089796178,-58.372623878948012 -34.591682549694418,-58.372611919516402 -34.591512716052641,-58.372489764082054 -34.591546570810728,-58.372350541104318 -34.591534565939853,-58.372289866312663 -34.591614178227424,-58.372189171576572 -34.591762835613089,-58.372625425209023 -34.592097185580862,-58.372668970586844 -34.59214968455948,-58.373909271349298 -34.59364501789063,-58.374441843390649 -34.59447825352435,-58.374399498218366 -34.595059935590541,-58.374346892319046 -34.595781142450981,-58.374320080090442 -34.596148722989945,-58.374317598148771 -34.59624062614327,-58.374415872436579 -34.596245767899724,-58.375413489183899 -34.596245006641652,-58.375413272397026 -34.59624804768201,-58.375575094304224 -34.596499791685872,-58.375735634508409 -34.596515079771436,-58.375863536249469 -34.596453716041765,-58.376259400717281 -34.596270680178449,-58.376586513026965 -34.596274855269627,-58.376954163113673 -34.596279550952289,-58.377060360215957 -34.596282442538012,-58.378312544679403 -34.596355289507258,-58.378437809097896 -34.596367770912764,-58.378435974128969 -34.596245159283349,-58.378496703385025 -34.595309812935504,-58.378501172884022 -34.595100371284474,-58.377685296916979 -34.595028605671509,-58.37768840267583 -34.594905856596206,-58.377658845116621 -34.594828156931619,-58.377634235384015 -34.594742291377003,-58.37747129056374 -34.594603158199732,-58.377249001984993 -34.59453349300437,-58.377031492492272 -34.594537425167047,-58.376864722513297 -34.594558294707177,-58.376668092452768 -34.594465406159422,-58.375734260620803 -34.593344278074163,-58.37594914855827 -34.593237736717406,-58.375693675098837 -34.592900851542687)));;213;1_7_2;COMUNA 1;7;2;770;430;340;126,47%;281;277;98,58%;4;1,44%;117;0;0,00%;117;100,00%
MULTIPOLYGON (((-58.373909271349319 -34.59364501789063,-58.37304048688172 -34.594518960575222,-58.373352468590973 -34.59449707734526,-58.373297025139564 -34.595013497293941,-58.373286557293561 -34.595086238920352,-58.373137607564779 -34.596037715753909,-58.373118209640467 -34.596178199888946,-58.374317598148792 -34.596240626143278,-58.374320080090456 -34.596148722989945,-58.374346892319046 -34.595781142450981,-58.374399498218395 -34.595059935590577,-58.374441843390663 -34.594478253524372,-58.373909271349319 -34.59364501789063)));;214;1_7_3;COMUNA 1;7;3;261;142;119;119,33%;295;293;99,32%;2;0,68%;126;1;0,79%;125;99,21%
MULTIPOLYGON (((-58.374317598148792 -34.596240626143278,-58.373118209640467 -34.596178199888946,-58.37310095807765 -34.596302558211896,-58.372954476807699 -34.597330447822301,-58.373069603100603 -34.597346730243068,-58.374254002136759 -34.5974252734921,-58.374315291528127 -34.596327810930539,-58.374317598148792 -34.596240626143278)));;215;1_7_4;COMUNA 1;7;4;560;265;295;89,83%;597;595;99,66%;2;0,34%;278;4;1,44%;274;98,56%
MULTIPOLYGON (((-58.375413489183899 -34.596245006641652,-58.374415872436579 -34.596245767899724,-58.374317598148792 -34.596240626143278,-58.374315291528127 -34.596327810930539,-58.374254002136759 -34.5974252734921,-58.375257949846414 -34.597491844631072,-58.375401530686851 -34.597499975911354,-58.375403439630588 -34.59738483201604,-58.37541327239704 -34.596248047682025,-58.375413489183899 -34.596245006641652)));;216;1_7_5;COMUNA 1;7;5;403;200;203;98,52%;457;455;99,56%;2;0,44%;147;2;1,36%;145;98,64%
MULTIPOLYGON (((-58.375863536249469 -34.596453716041772,-58.37573563450843 -34.596515079771429,-58.375575094304224 -34.596499791685879,-58.37541327239704 -34.596248047682025,-58.375403439630588 -34.59738483201604,-58.375401530686851 -34.597499975911354,-58.376900359370872 -34.597585126713298,-58.376910340182434 -34.59748632712455,-58.376954163113673 -34.596279550952282,-58.376586513026979 -34.596274855269641,-58.376259400717281 -34.596270680178449,-58.375863536249469 -34.596453716041772)));;217;1_7_6;COMUNA 1;7;6;300;148;152;97,37%;400;398;99,50%;2;0,50%;80;0;0,00%;80;100,00%
MULTIPOLYGON (((-58.378437809097903 -34.596367770912778,-58.378312544679417 -34.596355289507279,-58.377060360215985 -34.596282442538012,-58.376954163113673 -34.596279550952282,-58.376910340182434 -34.59748632712455,-58.376900359370872 -34.597585126713298,-58.377571682393572 -34.59762320396765,-58.378361984869436 -34.597659176637222,-58.378439644569639 -34.596489889563323,-58.378437809097903 -34.596367770912778)));;218;1_7_7;COMUNA 1;7;7;592;264;328;80,49%;641;639;99,69%;2;0,31%;249;2;0,80%;247;99,20%
MULTIPOLYGON (((-58.379900706382259 -34.596513284912547,-58.378437809097903 -34.596367770912778,-58.378439644569639 -34.596489889563323,-58.378361984869436 -34.597659176637222,-58.379834095396333 -34.597726173651928,-58.379894889233036 -34.596625257111356,-58.379900706382259 -34.596513284912547)));;219;1_7_8;COMUNA 1;7;8;597;281;316;88,92%;469;467;99,57%;2;0,43%;240;4;1,67%;236;98,33%
MULTIPOLYGON (((-58.379834095396333 -34.597726173651928,-58.378361984869436 -34.597659176637222,-58.37827904625447 -34.598909026237131,-58.379742070288479 -34.598971581289369,-58.379752112876595 -34.59880742692345,-58.379828804173826 -34.59782293433171,-58.379834095396333 -34.597726173651928)));;220;1_7_9;COMUNA 1;7;9;330;147;183;80,33%;571;570;99,82%;1;0,18%;183;2;1,09%;181;98,91%
MULTIPOLYGON (((-58.387156256726662 -34.59572824346391,-58.385990139124523 -34.595693852714476,-58.385748031660931 -34.595679333526988,-58.385742740561767 -34.595875887096071,-58.385669275939755 -34.596856089867828,-58.385649325976225 -34.596971433829893,-58.385804660524208 -34.596978715188271,-58.386922651400717 -34.597042022615597,-58.387062822959166 -34.597053518470346,-58.387061485400061 -34.596931893236992,-58.387130691734001 -34.595933798974734,-58.387156256726662 -34.59572824346391)));;221;1_8_1;COMUNA 1;8;1;352;148;204;72,55%;364;363;99,73%;1;0,28%;188;1;0,53%;187;99,47%
MULTIPOLYGON (((-58.381340480620146 -34.597844022785473,-58.379920109084345 -34.597730105420275,-58.379834095396333 -34.597726173651928,-58.379828804173826 -34.59782293433171,-58.379752112876595 -34.59880742692345,-58.379742070288479 -34.598971581289369,-58.381020552377421 -34.59902054419598,-58.381249897323784 -34.599031261281318,-58.381331237028625 -34.597978176693772,-58.381340480620146 -34.597844022785473)));;222;1_8_10;COMUNA 1;8;10;445;215;230;93,48%;395;392;99,24%;3;0,77%;186;0;0,00%;186;100,00%
MULTIPOLYGON (((-58.385748031660931 -34.595679333526988,-58.384299987243686 -34.595592492972067,-58.384179948166206 -34.596815139085827,-58.384174074834583 -34.596902392189179,-58.385441446802446 -34.596961724559243,-58.385649325976225 -34.596971433829893,-58.385669275939755 -34.596856089867828,-58.385742740561767 -34.595875887096071,-58.385748031660931 -34.595679333526988)));;223;1_8_2;COMUNA 1;8;2;1324;599;725;82,62%;908;907;99,89%;1;0,11%;567;3;0,53%;564;99,47%
MULTIPOLYGON (((-58.381331237028625 -34.597978176693772,-58.381249897323784 -34.599031261281318,-58.381645566587686 -34.599049624029035,-58.382088927577001 -34.599070200191086,-58.382520876847764 -34.599090274267901,-58.382771853796669 -34.599101918232769,-58.384028613288962 -34.599160131523107,-58.384041483612101 -34.59896879448975,-58.384088403805258 -34.598162596708818,-58.384093931743223 -34.598080554872574,-58.384174074834583 -34.596902392189179,-58.384179948166206 -34.596815139085827,-58.384299987243686 -34.595592492972067,-58.382717424831064 -34.595466461119742,-58.38241128652453 -34.595440554859969,-58.382023057451342 -34.595407691911518,-58.381972304155177 -34.595403362405484,-58.381484527489278 -34.595362051241757,-58.381439983375728 -34.596240294992057,-58.381417233121098 -34.596689099966589,-58.381410458539271 -34.596824311929772,-58.381340480620146 -34.597844022785473,-58.381331237028625 -34.597978176693772)));;224;1_8_3;COMUNA 1;8;3;1104;520;584;89,04%;813;812;99,88%;1;0,12%;448;3;0,67%;445;99,33%
MULTIPOLYGON (((-58.381484527489278 -34.595362051241757,-58.381225992464749 -34.595340117495908,-58.379953931156962 -34.595228200922008,-58.37995792064779 -34.595413281219791,-58.379900706382259 -34.596513284912547,-58.380007577529632 -34.596523921168419,-58.381209960321051 -34.596670158184097,-58.381417233121098 -34.596689099966589,-58.381439983375728 -34.596240294992057,-58.381484527489278 -34.595362051241757)));;225;1_8_4;COMUNA 1;8;4;592;249;343;72,59%;704;703;99,86%;1;0,14%;295;4;1,36%;291;98,64%
MULTIPOLYGON (((-58.381417233121098 -34.596689099966589,-58.381209960321051 -34.596670158184097,-58.380007577529632 -34.596523921168419,-58.379900706382259 -34.596513284912547,-58.379894889233036 -34.596625257111356,-58.379834095396333 -34.597726173651928,-58.379920109084345 -34.597730105420275,-58.381340480620146 -34.597844022785473,-58.381410458539271 -34.596824311929772,-58.381417233121098 -34.596689099966589)));;226;1_8_5;COMUNA 1;8;5;589;266;323;82,35%;458;456;99,56%;2;0,44%;214;2;0,93%;212;99,07%
MULTIPOLYGON (((-58.385649325976225 -34.596971433829893,-58.385441446802446 -34.596961724559243,-58.384174074834583 -34.596902392189179,-58.384093931743223 -34.598080554872574,-58.385542265690965 -34.598177046307804,-58.385623296894657 -34.597121775294298,-58.385649325976225 -34.596971433829893)));;227;1_8_6;COMUNA 1;8;6;1144;512;632;81,01%;1024;1022;99,80%;2;0,20%;572;24;4,20%;548;95,80%
MULTIPOLYGON (((-58.387062822959166 -34.597053518470346,-58.386922651400717 -34.597042022615597,-58.385804660524208 -34.596978715188271,-58.385649325976225 -34.596971433829893,-58.385623296894657 -34.597121775294298,-58.385542265690965 -34.598177046307804,-58.385674181141709 -34.598184946849102,-58.386819593411069 -34.598268343717073,-58.386959254737612 -34.598281247877281,-58.386972123088327 -34.59817836459677,-58.387064165054234 -34.597170143511583,-58.387062822959166 -34.597053518470346)));;228;1_8_7;COMUNA 1;8;7;1334;543;791;68,65%;953;952;99,90%;1;0,11%;561;3;0,53%;558;99,47%
MULTIPOLYGON (((-58.386959254737612 -34.598281247877281,-58.386819593411069 -34.598268343717073,-58.385674181141709 -34.598184946849102,-58.385542265690965 -34.598177046307804,-58.385532869686237 -34.598299087295544,-58.38547171230671 -34.59922767565061,-58.386805889025105 -34.599290134824294,-58.386863459810989 -34.599292846776159,-58.386943898301546 -34.598404200801241,-58.386959254737612 -34.598281247877281)));;229;1_8_8;COMUNA 1;8;8;446;194;252;76,98%;346;345;99,71%;1;0,29%;189;1;0,53%;188;99,47%
MULTIPOLYGON (((-58.385542265690965 -34.598177046307804,-58.384093931743223 -34.598080554872574,-58.384088403805258 -34.598162596708818,-58.384041483612101 -34.59896879448975,-58.384028613288962 -34.599160131523107,-58.384203028523757 -34.599168201898216,-58.38547171230671 -34.59922767565061,-58.385532869686237 -34.598299087295544,-58.385542265690965 -34.598177046307804)));;230;1_8_9;COMUNA 1;8;9;691;270;421;64,13%;481;477;99,17%;4;0,84%;257;0;0,00%;257;100,00%
MULTIPOLYGON (((-58.386805889025105 -34.599290134824294,-58.38547171230671 -34.59922767565061,-58.385352396083952 -34.60051018408091,-58.386566165253086 -34.600571794815316,-58.386704641944775 -34.600580402587937,-58.386805889025105 -34.599290134824294)));;231;1_9_1;COMUNA 1;9;1;292;125;167;74,85%;410;410;100,00%;0;0,00%;161;4;2,48%;157;97,52%
MULTIPOLYGON (((-58.373993638539858 -34.600961557091146,-58.374102305639937 -34.600969875789275,-58.375172552885665 -34.601040932534858,-58.375330362426027 -34.601049707931445,-58.375339693294968 -34.600923090111444,-58.375372565525083 -34.600030967195472,-58.375363531605615 -34.599874053368509,-58.375354999142409 -34.599726295173078,-58.375358712949065 -34.598944789229613,-58.375368161693814 -34.598705279818901,-58.374187239663598 -34.598622594819247,-58.372794279384109 -34.598517065427778,-58.372666981803583 -34.599676241036306,-58.372660529918633 -34.599735816001711,-58.37258990999176 -34.600854327342162,-58.373993638539858 -34.600961557091146)));;232;1_9_10;COMUNA 1;9;10;369;185;184;100,54%;366;360;98,36%;6;1,67%;108;1;0,93%;107;99,07%
MULTIPOLYGON (((-58.372794279384109 -34.598517065427778,-58.371479924924742 -34.59841749464227,-58.371395889783187 -34.599484866789858,-58.371389577976522 -34.599571273798574,-58.37149670813421 -34.599581283872226,-58.372666981803583 -34.599676241036306,-58.372794279384109 -34.598517065427778)));;233;1_9_11;COMUNA 1;9;11;422;242;180;134,44%;383;380;99,22%;3;0,79%;116;4;3,45%;112;96,55%
MULTIPOLYGON (((-58.372666981803583 -34.599676241036306,-58.37149670813421 -34.599581283872226,-58.371389577976522 -34.599571273798574,-58.371380500164548 -34.59969479282011,-58.371278193110086 -34.600646090262636,-58.371268891226009 -34.600740664330836,-58.371354134529717 -34.600750587701853,-58.372480221243691 -34.600845936116649,-58.37258990999176 -34.600854327342162,-58.372660529918633 -34.599735816001711,-58.372666981803583 -34.599676241036306)));;234;1_9_12;COMUNA 1;9;12;378;196;182;107,69%;238;234;98,32%;4;1,71%;76;2;2,63%;74;97,37%
MULTIPOLYGON (((-58.370506639246479 -34.600654031200307,-58.37066111741936 -34.600670556889675,-58.370700120173836 -34.60067474138927,-58.371268891226009 -34.600740664330836,-58.371278193110086 -34.600646090262636,-58.371380500164548 -34.59969479282011,-58.371389577976522 -34.599571273798574,-58.371395889783187 -34.599484866789858,-58.371479924924742 -34.59841749464227,-58.371337623326951 -34.598406683547232,-58.371237560894308 -34.598399073088537,-58.371085551071744 -34.59838762059546,-58.370930129208716 -34.598381095112558,-58.369512342616247 -34.598321285979864,-58.369129874784022 -34.599219196507612,-58.369072405725632 -34.599354087128624,-58.368631465797833 -34.600435901670906,-58.369315625224864 -34.600512556822288,-58.370343647371413 -34.600634681863937,-58.370506639246479 -34.600654031200307)));;235;1_9_13;COMUNA 1;9;13;590;307;283;108,48%;449;449;100,00%;0;0,00%;201;0;0,00%;201;100,00%
MULTIPOLYGON (((-58.368313374938417 -34.601703168589822,-58.368185702732582 -34.602832971276086,-58.368185638342432 -34.602833179357269,-58.368185678807876 -34.602833183049391,-58.369010841053985 -34.602908469590133,-58.369182869304694 -34.602924165520427,-58.369931111022126 -34.602989527852699,-58.370074445900947 -34.602997101812974,-58.370263429936813 -34.603007104651574,-58.370472513266215 -34.603018178768842,-58.370614996532318 -34.603025751450453,-58.371094050620243 -34.603057310396608,-58.371168823473525 -34.602055075432609,-58.371177122043903 -34.601943669021821,-58.371305974385677 -34.601952991301005,-58.372392662799655 -34.602030423006141,-58.372521856932565 -34.6020389695774,-58.372528198815623 -34.601923829092151,-58.372583410871961 -34.600957495451929,-58.37258990999176 -34.600854327342155,-58.372480221243677 -34.600845936116649,-58.37135413452971 -34.600750587701839,-58.371268891225981 -34.600740664330836,-58.370700120173836 -34.600674741389263,-58.370661117419353 -34.600670556889654,-58.370506639246479 -34.600654031200307,-58.370343647371399 -34.600634681863923,-58.369315625224836 -34.600512556822281,-58.368631465797804 -34.600435901670906,-58.368389511862567 -34.601029540132984,-58.368313374938417 -34.601703168589822)));;236;1_9_14;COMUNA 1;9;14;253;128;125;102,40%;435;435;100,00%;0;0,00%;148;26;17,57%;122;82,43%
MULTIPOLYGON (((-58.375330362426027 -34.601049707931445,-58.375172552885665 -34.601040932534858,-58.374102305639937 -34.600969875789275,-58.373993638539858 -34.600961557091146,-58.37258990999176 -34.600854327342162,-58.372583410871961 -34.600957495451929,-58.372528198815651 -34.601923829092165,-58.372521856932572 -34.6020389695774,-58.37390611749602 -34.602130974100085,-58.375122777231127 -34.602211856413305,-58.375266278869013 -34.602222030126299,-58.375320080724528 -34.601189635428639,-58.375330362426027 -34.601049707931445)));;237;1_9_15;COMUNA 1;9;15;238;124;114;108,77%;608;607;99,84%;1;0,16%;118;13;11,02%;105;88,98%
MULTIPOLYGON (((-58.381101817270007 -34.601356109740415,-58.380886089976265 -34.601348570641221,-58.379713196652247 -34.601285452286014,-58.379593112631532 -34.601280370367945,-58.378176462931485 -34.601220451387213,-58.378045392673457 -34.601214937784214,-58.376873967688006 -34.601135877063889,-58.376750904948409 -34.60112902962382,-58.375330362426027 -34.601049707931445,-58.375320080724528 -34.601189635428639,-58.375266278869013 -34.602222030126299,-58.375408928911341 -34.602232132636139,-58.376702766653501 -34.602302842733067,-58.377972504694199 -34.602372184300954,-58.378114647017405 -34.60237960713836,-58.379537263628428 -34.602454249770162,-58.379665183427647 -34.602460956855253,-58.380819628876395 -34.60250603444775,-58.381035440535832 -34.602517447106663,-58.381046202295472 -34.602312517028366,-58.381101817270007 -34.601356109740415)));;238;1_9_16;COMUNA 1;9;16;997;513;484;105,99%;647;636;98,30%;11;1,73%;337;124;36,80%;213;63,20%
MULTIPOLYGON (((-58.379537263628428 -34.602454249770162,-58.378114647017405 -34.60237960713836,-58.378108309237327 -34.602498269173282,-58.378071018883702 -34.603491519965146,-58.379471157948714 -34.603577274952826,-58.380975118304811 -34.603669421722294,-58.381022942206847 -34.602756180100393,-58.381035440535832 -34.602517447106663,-58.380819628876395 -34.60250603444775,-58.379665183427647 -34.602460956855253,-58.379537263628428 -34.602454249770162)));;239;1_9_17;COMUNA 1;9;17;360;170;190;89,47%;516;516;100,00%;0;0,00%;207;24;11,59%;183;88,41%
MULTIPOLYGON (((-58.376653446346211 -34.60340471379682,-58.376694981091212 -34.602302417282232,-58.375408928911341 -34.602232132636132,-58.375266278869013 -34.602222030126299,-58.375122777231127 -34.602211856413291,-58.37390611749602 -34.602130974100085,-58.372521856932565 -34.6020389695774,-58.372392662799655 -34.602030423006141,-58.371305974385677 -34.601952991301005,-58.371177122043903 -34.601943669021821,-58.371168823473525 -34.602055075432609,-58.371094050620243 -34.603057310396608,-58.371274260267313 -34.603069136136284,-58.372460613102795 -34.603147205272002,-58.372575160556714 -34.603154755001292,-58.373849753508658 -34.603232875776051,-58.375216328330616 -34.603316612809458,-58.376653446346211 -34.60340471379682)));;240;1_9_19;COMUNA 1;9;19;119;55;64;85,94%;405;405;100,00%;0;0,00%;61;6;9,84%;55;90,16%
MULTIPOLYGON (((-58.385132649433665 -34.603911581128436,-58.38634220079723 -34.603982487531539,-58.386522330570898 -34.603993093474372,-58.386590974483823 -34.603998559049224,-58.386640298030507 -34.602774529848098,-58.386678555952983 -34.601822193885575,-58.386693784718851 -34.601653535034053,-58.386790402184417 -34.600585667435034,-58.386704641944775 -34.600580402587937,-58.386566165253086 -34.600571794815316,-58.385352396083952 -34.60051018408091,-58.38528465121469 -34.60146651535419,-58.38527964582255 -34.601537148649427,-58.385276452320817 -34.60158264129894,-58.385197831735312 -34.602692281075505,-58.385032101191705 -34.602679147037023,-58.383797934767777 -34.602630113962633,-58.383771915975331 -34.602854190058387,-58.383712378880332 -34.6036663650656,-58.383711459095991 -34.603828201507511,-58.385132649433665 -34.603911581128436)));;241;1_9_2;COMUNA 1;9;2;388;169;219;77,17%;742;742;100,00%;0;0,00%;193;4;2,07%;189;97,93%
MULTIPOLYGON (((-58.382088927577001 -34.599070200191086,-58.381645566587686 -34.599049624029035,-58.381249897323784 -34.599031261281318,-58.3812330768965 -34.599249216109278,-58.381182883832878 -34.600063861466801,-58.381173368195284 -34.600214424205625,-58.381111518317326 -34.601190405742315,-58.381101817270007 -34.601356109740415,-58.381046202295472 -34.602312517028366,-58.381035440535832 -34.602517447106663,-58.381022942206847 -34.602756180100393,-58.380975118304811 -34.603669421722294,-58.381173224662199 -34.603673216359397,-58.381269888264789 -34.603802492577785,-58.38135887617527 -34.603805896615853,-58.38144786246427 -34.603810972929132,-58.381836820345903 -34.603827677786704,-58.38200120590119 -34.603736233901458,-58.382205530228347 -34.603739819699364,-58.383711459095991 -34.603828201507511,-58.383712378880332 -34.6036663650656,-58.383771915975331 -34.602854190058387,-58.383797934767777 -34.602630113962633,-58.385032101191705 -34.602679147037023,-58.385197831735312 -34.602692281075505,-58.385276452320817 -34.60158264129894,-58.38527964582255 -34.601537148649427,-58.38528465121469 -34.60146651535419,-58.385352396083952 -34.60051018408091,-58.38547171230671 -34.59922767565061,-58.384203028523757 -34.599168201898216,-58.384028613288962 -34.599160131523107,-58.382771853796669 -34.599101918232769,-58.382520876847764 -34.599090274267901,-58.382088927577001 -34.599070200191086)));;242;1_9_3;COMUNA 1;9;3;449;251;198;126,77%;715;713;99,72%;2;0,28%;195;13;6,67%;182;93,33%
MULTIPOLYGON (((-58.381249897323784 -34.599031261281318,-58.381020552377421 -34.59902054419598,-58.379742070288479 -34.598971581289369,-58.37973046852683 -34.599162003196618,-58.37966724535088 -34.600132490057653,-58.379792019540638 -34.600129969166879,-58.381005004583407 -34.600199663157049,-58.381173368195284 -34.600214424205625,-58.381182883832878 -34.600063861466801,-58.3812330768965 -34.599249216109278,-58.381249897323784 -34.599031261281318)));;243;1_9_4;COMUNA 1;9;4;256;119;137;86,86%;567;567;100,00%;0;0,00%;134;2;1,49%;132;98,51%
MULTIPOLYGON (((-58.381173368195284 -34.600214424205625,-58.381005004583407 -34.600199663157049,-58.379792019540638 -34.600129969166879,-58.37966724535088 -34.600132490057653,-58.379660239122813 -34.600240587982881,-58.379651161140984 -34.600376502451802,-58.37959842006827 -34.601167834520851,-58.379593112631532 -34.601280370367945,-58.379713196652247 -34.601285452286014,-58.380886089976265 -34.601348570641221,-58.381101817270007 -34.601356109740415,-58.381111518317326 -34.601190405742315,-58.381173368195284 -34.600214424205625)));;244;1_9_5;COMUNA 1;9;5;409;205;204;100,49%;455;455;100,00%;0;0,00%;192;28;14,58%;164;85,42%
MULTIPOLYGON (((-58.37905583979483 -34.600114254902273,-58.378327765780604 -34.600084245484211,-58.378207941077676 -34.600077190476831,-58.37806444104762 -34.600068710428509,-58.376943302857512 -34.599968768953701,-58.376799041127853 -34.599955920519108,-58.376750904948409 -34.60112902962382,-58.376873967688006 -34.601135877063889,-58.378045392673457 -34.601214937784214,-58.378176462931485 -34.601220451387213,-58.379593112631532 -34.601280370367945,-58.37959842006827 -34.601167834520851,-58.379651161140984 -34.600376502451802,-58.379660239122813 -34.600240587982881,-58.37966724535088 -34.600132490057653,-58.379555161445545 -34.600134808192955,-58.37905583979483 -34.600114254902273)));;245;1_9_6;COMUNA 1;9;6;354;168;186;90,32%;558;556;99,64%;2;0,36%;175;5;2,86%;170;97,14%
MULTIPOLYGON (((-58.379742070288479 -34.598971581289369,-58.37827904625447 -34.598909026237131,-58.378265900099031 -34.599107404985773,-58.378217418883864 -34.599885147495336,-58.378207941077676 -34.600077190476831,-58.378327765780604 -34.600084245484211,-58.37905583979483 -34.600114254902273,-58.379555161445545 -34.600134808192955,-58.37966724535088 -34.600132490057653,-58.37973046852683 -34.599162003196618,-58.379742070288479 -34.598971581289369)));;246;1_9_7;COMUNA 1;9;7;588;282;306;92,16%;868;864;99,54%;4;0,46%;288;19;6,60%;269;93,40%
MULTIPOLYGON (((-58.37827904625447 -34.598909026237131,-58.376838973729157 -34.598808228901483,-58.376839401475301 -34.598971897414479,-58.376799041127853 -34.599955920519108,-58.376943302857512 -34.599968768953701,-58.37806444104762 -34.600068710428509,-58.378207941077676 -34.600077190476831,-58.378217418883864 -34.599885147495336,-58.378265900099031 -34.599107404985773,-58.37827904625447 -34.598909026237131)));;247;1_9_8;COMUNA 1;9;8;261;132;129;102,33%;405;405;100,00%;0;0,00%;149;2;1,34%;147;98,66%
MULTIPOLYGON (((-58.376838973729157 -34.598808228901483,-58.375368161693814 -34.598705279818901,-58.375358712949065 -34.598944789229613,-58.375354999142409 -34.599726295173078,-58.375363531605615 -34.599874053368509,-58.375372565525083 -34.600030967195472,-58.375339693294968 -34.600923090111444,-58.375330362426027 -34.601049707931445,-58.376750904948409 -34.60112902962382,-58.376799041127853 -34.599955920519108,-58.376839401475301 -34.598971897414479,-58.376838973729157 -34.598808228901483)));;248;1_9_9;COMUNA 1;9;9;628;347;281;123,49%;851;848;99,65%;3;0,35%;237;3;1,27%;234;98,73%
MULTIPOLYGON (((-58.386863459810989 -34.599292846776159,-58.386805889025105 -34.599290134824294,-58.386704641944775 -34.600580402587937,-58.386790402184417 -34.600585667435034,-58.386977252188601 -34.600597192415329,-58.388096324306453 -34.600649503424592,-58.388101697719009 -34.600545559103445,-58.388147220017892 -34.599354626113765,-58.387951599743658 -34.599343801804551,-58.386863459810989 -34.599292846776159)));;249;1_10_1;COMUNA 1;10;1;318;132;186;70,97%;524;523;99,81%;1;0,19%;120;3;2,50%;117;97,50%
MULTIPOLYGON (((-58.390896718375487 -34.601889540192381,-58.389663860806394 -34.601814087346028,-58.389528708452737 -34.601799710059495,-58.389459167876119 -34.603011474538128,-58.389604969765507 -34.603024520201828,-58.3908473084091 -34.603089274596101,-58.391180398902371 -34.603106654033859,-58.391285907342528 -34.602034351516181,-58.391298956595904 -34.601913579946128,-58.391165671682003 -34.601906036809275,-58.390896718375487 -34.601889540192381)));;250;1_10_10;COMUNA 1;10;10;680;304;376;80,85%;617;617;100,00%;0;0,00%;296;11;3,72%;285;96,28%
MULTIPOLYGON (((-58.392592289973102 -34.601986727003279,-58.391298956595904 -34.601913579946128,-58.391285907342528 -34.602034351516181,-58.391180398902371 -34.603106654033859,-58.392150203215891 -34.603157220503363,-58.392387066654969 -34.603155385322069,-58.392572931270642 -34.602117847588659,-58.392592289973102 -34.601986727003279)));;251;1_10_11;COMUNA 1;10;11;612;269;343;78,43%;725;725;100,00%;0;0,00%;351;2;0,57%;349;99,43%
MULTIPOLYGON (((-58.391180398902371 -34.603106654033859,-58.3908473084091 -34.603089274596101,-58.390819491991657 -34.604334093572071,-58.392286335032786 -34.604436079428034,-58.392387066654969 -34.603155385322069,-58.392150203215891 -34.603157220503363,-58.391180398902371 -34.603106654033859)));;252;1_10_12;COMUNA 1;10;12;584;271;313;86,58%;606;605;99,83%;1;0,17%;291;11;3,78%;280;96,22%
MULTIPOLYGON (((-58.389459167876119 -34.603011474538128,-58.389307489710461 -34.602997861764372,-58.387951214774269 -34.602910485889993,-58.387943089786809 -34.603043161951327,-58.387901155089942 -34.603931972373218,-58.38790159785075 -34.604103105802665,-58.389227131516527 -34.604205605128001,-58.389391673224374 -34.604218873603841,-58.390819491991657 -34.604334093572071,-58.3908473084091 -34.603089274596101,-58.389604969765507 -34.603024520201828,-58.389459167876119 -34.603011474538128)));;253;1_10_13;COMUNA 1;10;13;678;300;378;79,37%;798;795;99,62%;3;0,38%;339;18;5,31%;321;94,69%
MULTIPOLYGON (((-58.387951214774269 -34.602910485889993,-58.3878123937155 -34.602901527195357,-58.386640298030507 -34.602774529848098,-58.386590974483823 -34.603998559049224,-58.38790159785075 -34.604103105802665,-58.387901155089942 -34.603931972373218,-58.387943089786809 -34.603043161951327,-58.387951214774269 -34.602910485889993)));;254;1_10_14;COMUNA 1;10;14;218;109;109;100,00%;537;537;100,00%;0;0,00%;111;3;2,70%;108;97,30%
MULTIPOLYGON (((-58.38966414981784 -34.599440828432165,-58.389480283447483 -34.599428675528962,-58.388147220017892 -34.599354626113765,-58.388101697719009 -34.600545559103445,-58.388096324306453 -34.600649503424592,-58.388208912903487 -34.600654783674663,-58.38959106811798 -34.600713297866633,-58.38966414981784 -34.599440828432165)));;255;1_10_2;COMUNA 1;10;2;504;220;284;77,46%;570;568;99,65%;2;0,35%;278;0;0,00%;278;100,00%
MULTIPOLYGON (((-58.390140209930728 -34.599472169968394,-58.38966414981784 -34.599440828432165,-58.38959106811798 -34.600713297866633,-58.389791718819552 -34.600721798521391,-58.389989222116469 -34.600725930607901,-58.390991643171624 -34.600746947131412,-58.391270737029203 -34.600752815270013,-58.391423952663096 -34.600756848675715,-58.391552893462041 -34.59956434334326,-58.39137549820525 -34.599553464722582,-58.390140209930728 -34.599472169968394)));;256;1_10_3;COMUNA 1;10;3;980;448;532;84,21%;839;838;99,88%;1;0,12%;515;26;5,05%;489;94,95%
MULTIPOLYGON (((-58.392930847848312 -34.59963711357576,-58.391552893462041 -34.59956434334326,-58.391423952663096 -34.600756848675715,-58.391569758789871 -34.600760666294384,-58.392765578327278 -34.600807063480339,-58.392930847848312 -34.59963711357576)));;257;1_10_4;COMUNA 1;10;4;427;171;256;66,80%;422;422;100,00%;0;0,00%;223;1;0,45%;222;99,55%
MULTIPOLYGON (((-58.391423952663096 -34.600756848675715,-58.391270737029203 -34.600752815270013,-58.390991643171624 -34.600746947131412,-58.390896718375487 -34.601889540192381,-58.391165671682003 -34.601906036809275,-58.391298956595904 -34.601913579946128,-58.392592289973102 -34.601986727003279,-58.39274741490452 -34.600935367795941,-58.392765578327278 -34.600807063480339,-58.391569758789871 -34.600760666294384,-58.391423952663096 -34.600756848675715)));;258;1_10_5;COMUNA 1;10;5;507;237;270;87,78%;455;455;100,00%;0;0,00%;236;10;4,24%;226;95,76%
MULTIPOLYGON (((-58.389989222116469 -34.600725930607901,-58.389791718819552 -34.600721798521391,-58.38959106811798 -34.600713297866633,-58.389528708452737 -34.601799710059495,-58.389663860806394 -34.601814087346028,-58.390896718375487 -34.601889540192381,-58.390991643171624 -34.600746947131412,-58.389989222116469 -34.600725930607901)));;259;1_10_6;COMUNA 1;10;6;541;256;285;89,82%;605;605;100,00%;0;0,00%;265;12;4,53%;253;95,47%
MULTIPOLYGON (((-58.38959106811798 -34.600713297866633,-58.388208912903487 -34.600654783674663,-58.388096324306453 -34.600649503424592,-58.388048649946867 -34.601578734801386,-58.388031836588823 -34.601712884511038,-58.389398580682993 -34.601785899043392,-58.389528708452737 -34.601799710059495,-58.38959106811798 -34.600713297866633)));;260;1_10_7;COMUNA 1;10;7;312;149;163;91,41%;442;442;100,00%;0;0,00%;159;28;17,61%;131;82,39%
MULTIPOLYGON (((-58.388096324306453 -34.600649503424592,-58.386977252188601 -34.600597192415329,-58.386790402184417 -34.600585667435034,-58.386693784718851 -34.601653535034053,-58.386678555952983 -34.601822193885575,-58.386640298030507 -34.602774529848098,-58.3878123937155 -34.602901527195357,-58.387951214774269 -34.602910485889993,-58.388016824546142 -34.601832739003726,-58.388031836588823 -34.601712884511038,-58.388048649946867 -34.601578734801386,-58.388096324306453 -34.600649503424592)));;261;1_10_8;COMUNA 1;10;8;279;140;139;100,72%;716;716;100,00%;0;0,00%;153;2;1,31%;151;98,69%
MULTIPOLYGON (((-58.389528708452737 -34.601799710059495,-58.389398580682993 -34.601785899043392,-58.388031836588823 -34.601712884511038,-58.388016824546142 -34.601832739003726,-58.387951214774269 -34.602910485889993,-58.389307489710461 -34.602997861764372,-58.389459167876119 -34.603011474538128,-58.389528708452737 -34.601799710059495)));;262;1_10_9;COMUNA 1;10;9;341;170;171;99,42%;660;659;99,85%;1;0,15%;161;7;4,35%;154;95,65%
MULTIPOLYGON (((-58.392286335032786 -34.604436079428034,-58.390819491991657 -34.604334093572071,-58.390815061796573 -34.604533182902827,-58.390793510107116 -34.605425879511969,-58.390786944495872 -34.605533062724795,-58.390893236203816 -34.605539252313747,-58.391983638235736 -34.605633132062579,-58.392193921096819 -34.605647057086962,-58.392205640693057 -34.60548621281054,-58.392286335032786 -34.604436079428034)));;263;1_11_1;COMUNA 1;11;1;512;239;273;87,55%;385;379;98,44%;6;1,58%;219;44;20,09%;175;79,91%
MULTIPOLYGON (((-58.389307445413401 -34.606630109764581,-58.387939441899483 -34.606543360542283,-58.38781194899947 -34.606527788825964,-58.387808909074728 -34.606593282338856,-58.387735509076037 -34.607707362845872,-58.387876635287626 -34.607719210470151,-58.38915760572452 -34.607808443268382,-58.389267391253945 -34.607815974456493,-58.389273257073214 -34.607732101662528,-58.389304722695982 -34.606723632710029,-58.389307445413401 -34.606630109764581)));;264;1_11_10;COMUNA 1;11;10;621;308;313;98,40%;453;449;99,12%;4;0,89%;272;44;16,18%;228;83,82%
MULTIPOLYGON (((-58.38781194899947 -34.606527788825964,-58.387712816272682 -34.606515685241412,-58.386534489994908 -34.606440586416561,-58.386376664345654 -34.606436966535234,-58.386366742864141 -34.606575064024696,-58.386308226069197 -34.607506822323423,-58.386309408571691 -34.607610700124752,-58.387632283401999 -34.607698707513578,-58.387735509076037 -34.607707362845872,-58.387808909074728 -34.606593282338856,-58.38781194899947 -34.606527788825964)));;265;1_11_11;COMUNA 1;11;11;266;111;155;71,61%;180;180;100,00%;0;0,00%;126;12;9,52%;114;90,48%
MULTIPOLYGON (((-58.389267391253945 -34.607815974456493,-58.38915760572452 -34.607808443268382,-58.387876635287626 -34.607719210470151,-58.387735509076037 -34.607707362845872,-58.387632283401999 -34.607698707513578,-58.386309408571691 -34.607610700124752,-58.386275794889301 -34.608785510904191,-58.387229460149726 -34.60885638880265,-58.387317772409659 -34.608874753927132,-58.387656481035471 -34.608920950325086,-58.387801178704812 -34.608941744221418,-58.388173286281415 -34.608978029742509,-58.388507577667141 -34.609011755834665,-58.388679876258998 -34.609029114639327,-58.389172243463065 -34.609078780360015,-58.389267391253945 -34.607815974456493)));;266;1_11_12;COMUNA 1;11;12;933;414;519;79,77%;535;533;99,63%;2;0,38%;407;61;14,99%;346;85,01%
MULTIPOLYGON (((-58.390670502498324 -34.607911039682271,-58.390565996121737 -34.607905273505992,-58.389267391253945 -34.607815974456493,-58.389172243463065 -34.609078780360015,-58.389555508410346 -34.609117462842704,-58.389758127997162 -34.609137866578322,-58.390552786538819 -34.60919376363708,-58.390670502498324 -34.607911039682271)));;267;1_11_13;COMUNA 1;11;13;666;324;342;94,74%;437;433;99,08%;4;0,92%;291;7;2,41%;284;97,59%
MULTIPOLYGON (((-58.392033515417324 -34.607986557795435,-58.390670502498324 -34.607911039682271,-58.390552786538819 -34.60919376363708,-58.391409877647725 -34.609254058373033,-58.391951660757499 -34.609292121598571,-58.39196062340968 -34.609169305403668,-58.392033515417324 -34.607986557795435)));;268;1_11_14;COMUNA 1;11;14;774;322;452;71,24%;506;503;99,41%;3;0,60%;289;3;1,04%;286;98,96%
MULTIPOLYGON (((-58.390819491991657 -34.604334093572071,-58.389391673224374 -34.604218873603841,-58.389338626569177 -34.605363039292342,-58.389338806714235 -34.60544874681149,-58.390786944495872 -34.605533062724795,-58.390793510107116 -34.605425879511969,-58.390815061796573 -34.604533182902827,-58.390819491991657 -34.604334093572071)));;269;1_11_2;COMUNA 1;11;2;428;203;225;90,22%;655;655;100,00%;0;0,00%;284;20;7,04%;264;92,96%
MULTIPOLYGON (((-58.389391673224374 -34.604218873603841,-58.389227131516527 -34.604205605128001,-58.38790159785075 -34.604103105802665,-58.387901978677959 -34.60424832272858,-58.387899865993589 -34.605274627280131,-58.387891609371096 -34.60536378046168,-58.388022601329723 -34.605369635567158,-58.389205686867456 -34.605440990358197,-58.389338806714235 -34.60544874681149,-58.389338626569177 -34.605363039292342,-58.389391673224374 -34.604218873603841)));;270;1_11_3;COMUNA 1;11;3;354;187;167;111,98%;321;320;99,69%;1;0,31%;198;106;53,54%;92;46,46%
MULTIPOLYGON (((-58.386590974483823 -34.603998559049224,-58.386522330570898 -34.603993093474372,-58.386495104114609 -34.605173754289858,-58.38647593187769 -34.605275929211338,-58.386450768208881 -34.605410073402638,-58.386376664345654 -34.606436966535234,-58.386534489994908 -34.606440586416561,-58.387712816272682 -34.606515685241412,-58.38781194899947 -34.606527788825964,-58.387817504382703 -34.606411731605654,-58.387881459957761 -34.605474060026047,-58.387891609371096 -34.60536378046168,-58.387899865993589 -34.605274627280131,-58.387901978677959 -34.60424832272858,-58.38790159785075 -34.604103105802665,-58.386590974483823 -34.603998559049224)));;271;1_11_4;COMUNA 1;11;4;667;323;344;93,90%;984;982;99,80%;2;0,20%;336;55;16,37%;281;83,63%
MULTIPOLYGON (((-58.389338806714235 -34.60544874681149,-58.389205686867456 -34.605440990358197,-58.388022601329723 -34.605369635567158,-58.387891609371096 -34.60536378046168,-58.387881459957761 -34.605474060026047,-58.387817504382703 -34.606411731605654,-58.38781194899947 -34.606527788825964,-58.387939441899483 -34.606543360542283,-58.389307445413401 -34.606630109764581,-58.389338960846302 -34.605564032877204,-58.389338806714235 -34.60544874681149)));;272;1_11_5;COMUNA 1;11;5;529;254;275;92,36%;481;480;99,79%;1;0,21%;251;90;35,86%;161;64,14%
MULTIPOLYGON (((-58.390786944495872 -34.605533062724795,-58.389338806714235 -34.60544874681149,-58.389338960846302 -34.605564032877204,-58.389307445413401 -34.606630109764581,-58.389442014461821 -34.606638641653269,-58.390611076427462 -34.606697157018964,-58.390743178377129 -34.606702516883708,-58.390776146320015 -34.605708696686605,-58.390786944495872 -34.605533062724795)));;273;1_11_6;COMUNA 1;11;6;447;199;248;80,24%;522;520;99,62%;2;0,38%;209;3;1,44%;206;98,56%
MULTIPOLYGON (((-58.392193921096819 -34.605647057086962,-58.391983638235736 -34.605633132062579,-58.390893236203816 -34.605539252313747,-58.390786944495872 -34.605533062724795,-58.390776146320015 -34.605708696686605,-58.390743178377129 -34.606702516883708,-58.390891633349952 -34.606708590482341,-58.391916323526992 -34.60676933231796,-58.392112124877315 -34.60678867181602,-58.392121960875414 -34.606639728336887,-58.392193921096819 -34.605647057086962)));;274;1_11_7;COMUNA 1;11;7;525;253;272;93,01%;497;497;100,00%;0;0,00%;296;38;12,84%;258;87,16%
MULTIPOLYGON (((-58.392112124877315 -34.60678867181602,-58.391916323526992 -34.60676933231796,-58.390891633349952 -34.606708590482341,-58.390743178377129 -34.606702516883708,-58.390738720165068 -34.606834983938441,-58.390670502498324 -34.607911039682271,-58.392033515417324 -34.607986557795435,-58.392042317535122 -34.6078518396288,-58.392112124877315 -34.60678867181602)));;275;1_11_8;COMUNA 1;11;8;817;382;435;87,82%;609;608;99,84%;1;0,16%;353;2;0,57%;351;99,43%
MULTIPOLYGON (((-58.390743178377129 -34.606702516883708,-58.390611076427462 -34.606697157018964,-58.389442014461821 -34.606638641653269,-58.389307445413401 -34.606630109764581,-58.389304722695982 -34.606723632710029,-58.389273257073214 -34.607732101662528,-58.389267391253945 -34.607815974456493,-58.390565996121737 -34.607905273505992,-58.390670502498324 -34.607911039682271,-58.390738720165068 -34.606834983938441,-58.390743178377129 -34.606702516883708)));;276;1_11_9;COMUNA 1;11;9;455;209;246;84,96%;431;431;100,00%;0;0,00%;219;1;0,46%;218;99,54%
MULTIPOLYGON (((-58.530221119226304 -34.61351410107126,-58.530488773181794 -34.613300158944789,-58.5293631166574 -34.610902756054003,-58.529091261467563 -34.611104682695093,-58.528552630576336 -34.611504758378629,-58.528553668768915 -34.61150698448396,-58.528159429371023 -34.611799038196004,-58.527756926728564 -34.61209370075629,-58.527348461964721 -34.612392731490317,-58.52694374007325 -34.61268894187004,-58.526537397774383 -34.612986348968548,-58.526804771755877 -34.613193892299435,-58.527138373140311 -34.613452810371705,-58.527631022817509 -34.613835168530457,-58.528178482972933 -34.614260102426208,-58.528725607807239 -34.614684822738674,-58.529120954443115 -34.614377977464464,-58.529517064361144 -34.614070567076922,-58.52969157993487 -34.613935114413692,-58.529692345661338 -34.61393675729709,-58.530221119226304 -34.61351410107126)));;277;10_1_1;COMUNA 10;1;1;641;301;340;88,53%;300;300;100,00%;0;0,00%;250;7;2,80%;243;97,20%
MULTIPOLYGON (((-58.526271209178411 -34.614890711139033,-58.52537909215512 -34.615583239658534,-58.526400631563313 -34.616489362439843,-58.527365964410585 -34.615740166035216,-58.528725607807239 -34.614684822738674,-58.528178482972933 -34.614260102426208,-58.527631022817509 -34.613835168530457,-58.527138373140311 -34.613452810371705,-58.526804771755877 -34.613193892299435,-58.526537397774383 -34.612986348968548,-58.525848490776006 -34.613490669278896,-58.525716021015114 -34.613587924362996,-58.525614369794816 -34.613662486542751,-58.52542561450035 -34.613787024820923,-58.52511417785049 -34.614001276730264,-58.52527244767861 -34.614115636377655,-58.525404813643242 -34.614218388999745,-58.525781627937924 -34.61451081084568,-58.526271209178411 -34.614890711139033)));;278;10_1_2;COMUNA 10;1;2;883;384;499;76,95%;404;404;100,00%;0;0,00%;353;2;0,57%;351;99,43%
MULTIPOLYGON (((-58.52311986843555 -34.615508531702723,-58.521958156667452 -34.61638842854174,-58.522080819592929 -34.616503161700436,-58.522344291585576 -34.616733534295776,-58.522575203719391 -34.61693547058676,-58.522696413960588 -34.617041611975232,-58.523074111143892 -34.61737235282407,-58.52322132092246 -34.617501228094262,-58.524100244723243 -34.618274618954437,-58.52524406523353 -34.617386964409015,-58.526400631563313 -34.616489362439843,-58.52537909215512 -34.615583239658534,-58.526271209178411 -34.614890711139033,-58.525781627937924 -34.61451081084568,-58.525404813643242 -34.614218388999745,-58.52527244767861 -34.614115636377655,-58.52511417785049 -34.614001276730264,-58.525060483891302 -34.613962570405278,-58.52427037536858 -34.614599755071694,-58.524121137868718 -34.614720045861397,-58.52311986843555 -34.615508531702723)));;279;10_1_3;COMUNA 10;1;3;927;454;473;95,98%;397;397;100,00%;0;0,00%;341;2;0,59%;339;99,41%
MULTIPOLYGON (((-58.521205125794914 -34.618822962359829,-58.521354815998066 -34.618966487062991,-58.521674656995209 -34.619273245017688,-58.52218400352551 -34.619761747196257,-58.523168227951338 -34.618997856329202,-58.524100244723243 -34.618274618954437,-58.52322132092246 -34.617501228094262,-58.523074111143892 -34.61737235282407,-58.522696413960588 -34.617041611975232,-58.522575203719391 -34.61693547058676,-58.522344291585576 -34.616733534295776,-58.522080819592929 -34.616503161700436,-58.521958156667452 -34.61638842854174,-58.521013277878659 -34.617109613596632,-58.520890420315638 -34.617203407968255,-58.52012245212957 -34.617795905442094,-58.520273580279515 -34.617929993869161,-58.520510981517745 -34.618155875470499,-58.520675502871363 -34.61831523962254,-58.52084530886119 -34.618478051854957,-58.521205125794914 -34.618822962359829)));;280;10_1_4;COMUNA 10;1;4;837;380;457;83,15%;344;343;99,71%;1;0,29%;294;1;0,34%;293;99,66%
MULTIPOLYGON (((-58.51934127497239 -34.61839713686458,-58.518899551288072 -34.618733550151418,-58.518673749831812 -34.618905631830621,-58.5185393921764 -34.619007668811207,-58.519043519207202 -34.61949167932309,-58.519112822250037 -34.619558269342747,-58.519533245850411 -34.61996196154643,-58.520013089547206 -34.620422739034971,-58.520513372714987 -34.62086716631763,-58.521344521306574 -34.620317173004175,-58.52218400352551 -34.619761747196257,-58.521674656995209 -34.619273245017688,-58.521354815998066 -34.618966487062991,-58.521205125794914 -34.618822962359829,-58.52084530886119 -34.618478051854957,-58.520675502871363 -34.61831523962254,-58.520510981517745 -34.618155875470499,-58.520273580279515 -34.617929993869161,-58.52012245212957 -34.617795905442094,-58.519480313305387 -34.618291223437438,-58.51934127497239 -34.61839713686458)));;281;10_1_5;COMUNA 10;1;5;695;349;346;100,87%;279;279;100,00%;0;0,00%;258;1;0,39%;257;99,61%
MULTIPOLYGON (((-58.52218400352551 -34.619761747196257,-58.521344521306574 -34.620317173004175,-58.520513372714987 -34.62086716631763,-58.520841066120411 -34.621067158370408,-58.520942912994428 -34.621131689492209,-58.521677082113918 -34.621497194507327,-58.522176365836117 -34.621116305102419,-58.522289776837432 -34.621029767881389,-58.522847719157134 -34.620605535669647,-58.522968196109396 -34.620514346278284,-58.52309888987692 -34.620415404960184,-58.523480326368109 -34.620126332210091,-58.523880150747502 -34.61982337531115,-58.524004371502187 -34.619729154733655,-58.524948661507167 -34.619013017720071,-58.525980116500378 -34.618230699055168,-58.52609811740983 -34.61814112760063,-58.525994205359581 -34.618049769893325,-58.525672241241317 -34.617766475834429,-58.525345591007451 -34.617479098666749,-58.52524406523353 -34.617386964409015,-58.524100244723243 -34.618274618954437,-58.523168227951338 -34.618997856329202,-58.52218400352551 -34.619761747196257)));;282;10_1_6;COMUNA 10;1;6;811;377;434;86,87%;315;315;100,00%;0;0,00%;309;0;0,00%;309;100,00%
MULTIPOLYGON (((-58.523480326368109 -34.620126332210091,-58.52309888987692 -34.620415404960184,-58.522968196109396 -34.620514346278284,-58.522847719157134 -34.620605535669647,-58.522289776837432 -34.621029767881389,-58.522176365836117 -34.621116305102419,-58.521677082113918 -34.621497194507327,-58.521819228298561 -34.62156614217556,-58.522199483112878 -34.621756315997807,-58.522765351826422 -34.622039287906937,-58.523777211653822 -34.621292210358888,-58.523905097772634 -34.621197847218717,-58.524322981868252 -34.620889386708811,-58.524870534729601 -34.620485151185129,-58.525824035516997 -34.619781327162883,-58.525954896882695 -34.61968470671367,-58.526987048999793 -34.618924140585847,-58.52654292113818 -34.618531684002271,-58.52609811740983 -34.61814112760063,-58.525980116500378 -34.618230699055168,-58.524948661507167 -34.619013017720071,-58.524004371502187 -34.619729154733655,-58.523880150747502 -34.61982337531115,-58.523480326368109 -34.620126332210091)));;283;10_1_7;COMUNA 10;1;7;754;362;392;92,35%;306;306;100,00%;0;0,00%;258;9;3,49%;249;96,51%
MULTIPOLYGON (((-58.517741498648121 -34.619613897706948,-58.516950149852178 -34.620215188669739,-58.517431834984983 -34.620645622311237,-58.517907559196729 -34.621072112916814,-58.518291824199878 -34.621416175701782,-58.51839471011467 -34.621508103790141,-58.518889026035758 -34.621949864231738,-58.519381471794738 -34.622389862880439,-58.519896086231959 -34.622849779377901,-58.52028863587703 -34.623200522249974,-58.520694742876678 -34.623563440908605,-58.520849032782088 -34.623450757960292,-58.521630861611861 -34.622876278531393,-58.521775271408544 -34.622770148694052,-58.522765351826422 -34.622039287906937,-58.522199483112878 -34.621756315997807,-58.521819228298561 -34.62156614217556,-58.521677082113918 -34.621497194507327,-58.520942912994428 -34.621131689492209,-58.520841066120411 -34.621067158370408,-58.520513372714987 -34.62086716631763,-58.520013089547206 -34.620422739034971,-58.519533245850411 -34.61996196154643,-58.519112822250037 -34.619558269342747,-58.519043519207202 -34.61949167932309,-58.5185393921764 -34.619007668811207,-58.518208264824636 -34.619259307614612,-58.517741498648121 -34.619613897706948)));;284;10_1_8;COMUNA 10;1;8;976;466;510;91,37%;442;442;100,00%;0;0,00%;353;5;1,42%;348;98,58%
MULTIPOLYGON (((-58.496143750078346 -34.621418131369353,-58.497121385150123 -34.622226197337056,-58.497663019708554 -34.621796873491022,-58.497856507933498 -34.621643502699811,-58.498200901583736 -34.621370506153113,-58.497220965812502 -34.620562026824679,-58.496319107587631 -34.619817816046542,-58.495446409160735 -34.619097746460227,-58.494907079832728 -34.619524595168905,-58.494491742267634 -34.61985337761179,-58.494369278110121 -34.619950736818318,-58.494578482422931 -34.620123786979342,-58.494790244114505 -34.620299019278647,-58.4950000467176 -34.620472631948886,-58.495125315127865 -34.620576264308369,-58.495240613447407 -34.620671589048143,-58.49547964738678 -34.620869208003207,-58.495691071911807 -34.621043945831879,-58.495903349531048 -34.621219457731506,-58.496143750078346 -34.621418131369353)));;285;10_10_1;COMUNA 10;10;1;745;358;387;92,51%;333;333;100,00%;0;0,00%;281;0;0,00%;281;100,00%
MULTIPOLYGON (((-58.488043041781886 -34.623456632664436,-58.487898675393204 -34.623570610159994,-58.487089534945639 -34.624209458562362,-58.486971145544366 -34.624308640510023,-58.485924099345439 -34.625143802532229,-58.486584761036283 -34.625380091489198,-58.487252413161862 -34.625618910748926,-58.487916854320389 -34.625087630299667,-58.488036522657495 -34.624991898003493,-58.488991135303486 -34.624232444615885,-58.489528821235339 -34.623804707213196,-58.489632218459818 -34.623722428077016,-58.490071867274516 -34.623372459011534,-58.489135102976377 -34.622593624621999,-58.488920389012492 -34.622763535993222,-58.488585753567733 -34.623027841945458,-58.488043041781886 -34.623456632664436)));;286;10_10_10;COMUNA 10;10;10;726;318;408;77,94%;292;292;100,00%;0;0,00%;262;4;1,53%;258;98,47%
MULTIPOLYGON (((-58.489135102976377 -34.622593624621999,-58.489662132225249 -34.622176663849743,-58.490212321974141 -34.621741385056779,-58.489467642898425 -34.621120261513063,-58.489331728247215 -34.621004935127694,-58.488477647398469 -34.620279952424411,-58.488337389533427 -34.620160329907293,-58.488203845904913 -34.620266629224361,-58.487264176752745 -34.621016144004521,-58.486184383807498 -34.621877442960177,-58.485112574827653 -34.622732322101854,-58.485231444314316 -34.622833500886642,-58.486103844159963 -34.623575193217157,-58.487174035969197 -34.622723052382284,-58.487910790701243 -34.623348416900669,-58.488043041781886 -34.623456632664436,-58.488585753567733 -34.623027841945458,-58.488920389012492 -34.622763535993222,-58.489135102976377 -34.622593624621999)));;287;10_10_11;COMUNA 10;10;11;810;380;430;88,37%;342;342;100,00%;0;0,00%;304;22;7,24%;282;92,76%
MULTIPOLYGON (((-58.486103844159963 -34.623575193217157,-58.485231444314316 -34.622833500886642,-58.485112574827653 -34.622732322101854,-58.484970505688125 -34.622845661899298,-58.484038274583867 -34.623592262743792,-58.483426629919244 -34.624082103366064,-58.483368114026518 -34.624128945890149,-58.484722144333965 -34.624675277009118,-58.485564630742942 -34.625015204069037,-58.485924099345439 -34.625143802532229,-58.486971145544366 -34.624308640510023,-58.487089534945639 -34.624209458562362,-58.487898675393204 -34.623570610159994,-58.488043041781886 -34.623456632664436,-58.487910790701243 -34.623348416900669,-58.487174035969197 -34.622723052382284,-58.486103844159963 -34.623575193217157)));;288;10_10_12;COMUNA 10;10;12;900;410;490;83,67%;438;438;100,00%;0;0,00%;346;6;1,73%;340;98,27%
MULTIPOLYGON (((-58.493441459015116 -34.619177707589444,-58.49424350026176 -34.619846610828006,-58.494369278110121 -34.619950736818318,-58.494491742267634 -34.61985337761179,-58.494907079832728 -34.619524595168905,-58.495446409160735 -34.619097746460227,-58.494657831975935 -34.618446946752243,-58.49451637566316 -34.618327190768781,-58.493792994796074 -34.617714538728016,-58.49363441281205 -34.617579362989112,-58.492778283505068 -34.616849621605127,-58.492636406118862 -34.616728314161804,-58.491561749877647 -34.617588744507813,-58.490616180504588 -34.618345751870372,-58.490488774564383 -34.618447263412996,-58.490614120573781 -34.61855406954983,-58.491483370740774 -34.619293471049104,-58.491590654053759 -34.619384786925693,-58.492364903628619 -34.620033215399552,-58.493313203340996 -34.61927915185651,-58.493441459015116 -34.619177707589444)));;289;10_10_2;COMUNA 10;10;2;1127;452;675;66,96%;424;423;99,76%;1;0,24%;350;11;3,14%;339;96,86%
MULTIPOLYGON (((-58.495691071911807 -34.621043945831879,-58.49547964738678 -34.620869208003207,-58.495240613447407 -34.620671589048143,-58.495125315127865 -34.620576264308369,-58.4950000467176 -34.620472631948886,-58.494790244114505 -34.620299019278647,-58.494578482422931 -34.620123786979342,-58.494369278110121 -34.619950736818318,-58.49424350026176 -34.619846610828006,-58.493441459015116 -34.619177707589444,-58.493313203340996 -34.61927915185651,-58.492364903628619 -34.620033215399552,-58.492503121163217 -34.620149030835641,-58.493295532934596 -34.620804632228406,-58.493505333700277 -34.620978247455909,-58.493716583986824 -34.621152988748676,-58.493926812561789 -34.621326884832044,-58.494165589671738 -34.621524435981868,-58.494406072284882 -34.621723465138899,-58.494617411565443 -34.621898275251077,-58.494830115246778 -34.62207428185706,-58.495070089667735 -34.622272746420258,-58.496044997638343 -34.62307934270062,-58.497121385150123 -34.622226197337056,-58.496143750078346 -34.621418131369353,-58.495903349531048 -34.621219457731506,-58.495691071911807 -34.621043945831879)));;290;10_10_3;COMUNA 10;10;3;967;462;505;91,49%;342;342;100,00%;0;0,00%;318;10;3,14%;308;96,86%
MULTIPOLYGON (((-58.493926812561789 -34.621326884832044,-58.493716583986824 -34.621152988748676,-58.493505333700277 -34.620978247455909,-58.493295532934596 -34.620804632228406,-58.493143854456292 -34.620925308185875,-58.492211716762036 -34.621668309583185,-58.49231814709632 -34.621745751268463,-58.49242798982138 -34.621836009374682,-58.492639495218995 -34.622009696071267,-58.4928508310906 -34.622183312012865,-58.492994079803964 -34.622300956656332,-58.493090289507656 -34.622380512946457,-58.493330601540201 -34.622579262538338,-58.49354194071195 -34.622754004064269,-58.493755240781958 -34.622930364493847,-58.493994874238304 -34.623128549531323,-58.494234423588701 -34.623326593263094,-58.494444403044206 -34.623500206755153,-58.494654809498591 -34.623674242318437,-58.494967821577298 -34.623933042061694,-58.495507604697345 -34.623505277738381,-58.496044997638343 -34.62307934270062,-58.495070089667735 -34.622272746420258,-58.494830115246778 -34.62207428185706,-58.494617411565443 -34.621898275251077,-58.494406072284882 -34.621723465138899,-58.494165589671738 -34.621524435981868,-58.493926812561789 -34.621326884832044)));;291;10_10_4;COMUNA 10;10;4;780;377;403;93,55%;328;328;100,00%;0;0,00%;284;5;1,76%;279;98,24%
MULTIPOLYGON (((-58.489331728247215 -34.621004935127694,-58.489467642898425 -34.621120261513063,-58.490212321974141 -34.621741385056779,-58.489662132225249 -34.622176663849743,-58.489135102976377 -34.622593624621999,-58.490071867274516 -34.623372459011534,-58.490602813713096 -34.622949929776915,-58.491144400747672 -34.622518803876062,-58.491280839957135 -34.622410247101669,-58.492211716762036 -34.621668309583185,-58.493143854456292 -34.620925308185875,-58.493295532934596 -34.620804632228406,-58.492503121163217 -34.620149030835641,-58.492364903628619 -34.620033215399552,-58.491590654053759 -34.619384786925693,-58.491483370740774 -34.619293471049104,-58.490614120573781 -34.61855406954983,-58.490488774564383 -34.618447263412996,-58.489412454348319 -34.619304294572785,-58.488337389533427 -34.620160329907293,-58.488477647398469 -34.620279952424411,-58.489331728247215 -34.621004935127694)));;292;10_10_5;COMUNA 10;10;5;889;412;477;86,37%;350;349;99,71%;1;0,29%;313;7;2,24%;306;97,76%
MULTIPOLYGON (((-58.4928508310906 -34.622183312012865,-58.492639495218995 -34.622009696071267,-58.49242798982138 -34.621836009374682,-58.49231814709632 -34.621745751268463,-58.492211716762036 -34.621668309583185,-58.491280839957135 -34.622410247101669,-58.491144400747672 -34.622518803876062,-58.49125731148613 -34.622613076532978,-58.491353008503054 -34.622691930059865,-58.491560508926696 -34.622863013819675,-58.49177482751093 -34.623039729593927,-58.49201428592005 -34.623237143886932,-58.49225468285227 -34.623435332150358,-58.492466277418366 -34.623609793753651,-58.492680429406889 -34.62378636710487,-58.492920147760373 -34.623983990805286,-58.49315892981901 -34.624180769162244,-58.493370954291009 -34.624355651616234,-58.493581701335295 -34.624529407220663,-58.493892497289416 -34.624785604524966,-58.494056786652919 -34.624655135402676,-58.494201486973758 -34.624540375880329,-58.494927026764451 -34.623965377900518,-58.494967821577298 -34.623933042061694,-58.494654809498591 -34.623674242318437,-58.494444403044206 -34.623500206755153,-58.494234423588701 -34.623326593263094,-58.493994874238304 -34.623128549531323,-58.493755240781958 -34.622930364493847,-58.49354194071195 -34.622754004064269,-58.493330601540201 -34.622579262538338,-58.493090289507656 -34.622380512946457,-58.492994079803964 -34.622300956656332,-58.4928508310906 -34.622183312012865)));;293;10_10_6;COMUNA 10;10;6;908;425;483;87,99%;338;338;100,00%;0;0,00%;314;6;1,91%;308;98,09%
MULTIPOLYGON (((-58.492381796790866 -34.624412447551038,-58.491844632677861 -34.624839986084389,-58.492816981429385 -34.625640411041026,-58.493355253151478 -34.625212656728763,-58.493892497289416 -34.624785604524966,-58.493581701335295 -34.624529407220663,-58.493370954291009 -34.624355651616234,-58.49315892981901 -34.624180769162244,-58.492920147760373 -34.623983990805286,-58.492680429406889 -34.62378636710487,-58.492466277418366 -34.623609793753651,-58.49225468285227 -34.623435332150358,-58.49201428592005 -34.623237143886932,-58.49177482751093 -34.623039729593927,-58.491560508926696 -34.622863013819675,-58.491353008503054 -34.622691930059865,-58.49125731148613 -34.622613076532978,-58.491144400747672 -34.622518803876062,-58.490602813713096 -34.622949929776915,-58.491474742806766 -34.623666723767876,-58.492381796790866 -34.624412447551038)));;294;10_10_7;COMUNA 10;10;7;824;387;437;88,56%;349;349;100,00%;0;0,00%;308;2;0,65%;306;99,35%
MULTIPOLYGON (((-58.489863660577896 -34.624950024517879,-58.489968988422675 -34.625036694123658,-58.490315566333329 -34.625321978018775,-58.490769521359439 -34.625695619548708,-58.491741273143241 -34.626495278431051,-58.492756425512376 -34.625688526208336,-58.492816981429385 -34.625640411041026,-58.491844632677861 -34.624839986084389,-58.492381796790866 -34.624412447551038,-58.491474742806766 -34.623666723767876,-58.490602813713096 -34.622949929776915,-58.490071867274516 -34.623372459011534,-58.489632218459818 -34.623722428077016,-58.489528821235339 -34.623804707213196,-58.488991135303486 -34.624232444615885,-58.489110436463378 -34.624330027828741,-58.489425904681802 -34.624589686336336,-58.489863660577896 -34.624950024517879)));;295;10_10_8;COMUNA 10;10;8;733;328;405;80,99%;285;285;100,00%;0;0,00%;254;8;3,15%;246;96,85%
MULTIPOLYGON (((-58.490315566333329 -34.625321978018775,-58.489968988422675 -34.625036694123658,-58.489863660577896 -34.624950024517879,-58.489425904681802 -34.624589686336336,-58.489110436463378 -34.624330027828741,-58.488991135303486 -34.624232444615885,-58.488036522657495 -34.624991898003493,-58.487916854320389 -34.625087630299667,-58.487252413161862 -34.625618910748926,-58.48786017078455 -34.62583632953271,-58.488225866355023 -34.625967103082274,-58.488476962626216 -34.626055011019915,-58.48911684722929 -34.626278895825543,-58.489755712809576 -34.626502425366802,-58.491095668147828 -34.627011011295558,-58.49135629622949 -34.626803689800376,-58.491741273143241 -34.626495278431051,-58.490769521359439 -34.625695619548708,-58.490315566333329 -34.625321978018775)));;296;10_10_9;COMUNA 10;10;9;957;425;532;79,89%;404;404;100,00%;0;0,00%;350;3;0,86%;347;99,14%
MULTIPOLYGON (((-58.489755712809576 -34.626502425366802,-58.48911684722929 -34.626278895825543,-58.488476962626216 -34.626055011019915,-58.487706388608899 -34.626668924678526,-58.487766288426705 -34.626693420257986,-58.487660115302852 -34.626912886092207,-58.487603920796715 -34.627029028274137,-58.487408095776559 -34.627452462708909,-58.487361693519873 -34.627552968454076,-58.487193622745643 -34.62791695826958,-58.486790298036262 -34.628790589125536,-58.48673282548264 -34.628915041261472,-58.486253710466649 -34.629952141277961,-58.486176056051534 -34.63011885195526,-58.486946055387911 -34.63030976403607,-58.487717690974073 -34.629695644046265,-58.488083359996132 -34.629404643268977,-58.488233953887928 -34.629284748667018,-58.489285969716654 -34.628447523973186,-58.490221701752986 -34.627702784299601,-58.491095668147828 -34.627011011295558,-58.489755712809576 -34.626502425366802)));;297;10_11_1;COMUNA 10;11;1;850;416;434;95,85%;406;406;100,00%;0;0,00%;309;7;2,27%;302;97,73%
MULTIPOLYGON (((-58.482862741152999 -34.627968175281758,-58.481707151579478 -34.627684478001946,-58.481435103332039 -34.627614940274434,-58.48128855195872 -34.62793680455065,-58.480892576001125 -34.628803794853603,-58.482311201196438 -34.629158305236267,-58.482775715828062 -34.628158548167598,-58.482862741152999 -34.627968175281758)));;298;10_11_10;COMUNA 10;11;10;678;295;383;77,02%;354;354;100,00%;0;0,00%;296;8;2,70%;288;97,30%
MULTIPOLYGON (((-58.480369492992601 -34.627342061887873,-58.479296647075572 -34.627064667968433,-58.479126928146506 -34.627020816216032,-58.478198162823588 -34.626778746443442,-58.478135484008838 -34.626914674495666,-58.477638475071473 -34.627994843338463,-58.478741742212662 -34.628269008256126,-58.479821074899355 -34.628537180426406,-58.48060569993681 -34.628732144753094,-58.480892576001125 -34.628803794853603,-58.48128855195872 -34.62793680455065,-58.481435103332039 -34.627614940274434,-58.480538105617271 -34.627385630370995,-58.480369492992601 -34.627342061887873)));;299;10_11_11;COMUNA 10;11;11;645;297;348;85,34%;291;291;100,00%;0;0,00%;251;5;1,99%;246;98,01%
MULTIPOLYGON (((-58.486420944171265 -34.626618264206627,-58.486221707380992 -34.627045641225457,-58.48617547429177 -34.627146076068783,-58.48595954829171 -34.62761578120756,-58.48588232179803 -34.62778375932826,-58.485585844001683 -34.628428273657185,-58.485499163859473 -34.628613718662621,-58.484939054437191 -34.62981217210546,-58.486176056051534 -34.63011885195526,-58.486253710466649 -34.629952141277961,-58.48673282548264 -34.628915041261472,-58.486790298036262 -34.628790589125536,-58.487193622745643 -34.62791695826958,-58.487361693519873 -34.627552968454076,-58.487408095776559 -34.627452462708909,-58.487603920796715 -34.627029028274137,-58.487660115302852 -34.626912886092207,-58.487766288426705 -34.626693420257986,-58.487706388608899 -34.626668924678526,-58.488476962626216 -34.626055011019915,-58.488225866355023 -34.625967103082274,-58.48786017078455 -34.62583632953271,-58.487252413161862 -34.625618910748926,-58.487034025578495 -34.625793537928175,-58.486552450081696 -34.626195125591835,-58.486607662946604 -34.626217721185611,-58.486420944171265 -34.626618264206627)));;300;10_11_2;COMUNA 10;11;2;1113;531;582;91,24%;503;503;100,00%;0;0,00%;433;39;9,01%;394;90,99%
MULTIPOLYGON (((-58.485924099345439 -34.625143802532229,-58.485564630742942 -34.625015204069037,-58.484722144333965 -34.624675277009118,-58.483368114026518 -34.624128945890149,-58.482742662809734 -34.624629842096923,-58.482338910990386 -34.625629237722855,-58.483631560658317 -34.625945160295871,-58.483770777435609 -34.625978799445669,-58.484949353349641 -34.626263599866178,-58.485157413338776 -34.626313845138355,-58.486219272953626 -34.626570273458448,-58.486420944171265 -34.626618264206627,-58.486607662946604 -34.626217721185611,-58.486552450081696 -34.626195125591835,-58.487034025578495 -34.625793537928175,-58.487252413161862 -34.625618910748926,-58.486584761036283 -34.625380091489198,-58.485924099345439 -34.625143802532229)));;301;10_11_3;COMUNA 10;11;3;856;386;470;82,13%;425;425;100,00%;0;0,00%;354;6;1,69%;348;98,31%
MULTIPOLYGON (((-58.48020901847817 -34.625075951573443,-58.480158351742581 -34.625188779596165,-58.479821049632754 -34.625925683545951,-58.479754371761189 -34.626070486551434,-58.479967200123525 -34.62612588103206,-58.480822094843283 -34.626348581502562,-58.480977499753124 -34.626389052650296,-58.481886075845466 -34.626624061960115,-58.482338910990386 -34.625629237722855,-58.482742662809734 -34.624629842096923,-58.481920381922862 -34.624287145767099,-58.481787297214353 -34.624229911176421,-58.481733194320221 -34.624206608970191,-58.480740092183275 -34.623779350816456,-58.48020901847817 -34.625075951573443)));;302;10_11_4;COMUNA 10;11;4;1021;497;524;94,85%;427;427;100,00%;0;0,00%;394;39;9,90%;355;90,10%
MULTIPOLYGON (((-58.478006281066882 -34.622487778452324,-58.477807255551937 -34.622384278548552,-58.477414587249783 -34.623223087956482,-58.477014501990382 -34.62407774247189,-58.476950546041571 -34.624217543497878,-58.477917022879339 -34.624476379316114,-58.478068759433668 -34.624516079965886,-58.479113112994554 -34.624789403996473,-58.479055887935289 -34.624917021687899,-58.478656239822875 -34.625784569054019,-58.478845892615496 -34.625833982403705,-58.479754371761189 -34.626070486551434,-58.479821049632754 -34.625925683545951,-58.480158351742581 -34.625188779596165,-58.48020901847817 -34.625075951573443,-58.480740092183275 -34.623779350816456,-58.479755690570542 -34.623355745428015,-58.479376126929601 -34.623192411986764,-58.478799152457313 -34.622910437499669,-58.478116103146753 -34.622544879277399,-58.478006281066882 -34.622487778452324)));;303;10_11_5;COMUNA 10;11;5;944;438;506;86,56%;310;310;100,00%;0;0,00%;301;7;2,33%;294;97,67%
MULTIPOLYGON (((-58.478198162823588 -34.626778746443442,-58.479126928146506 -34.627020816216032,-58.479296647075572 -34.627064667968433,-58.479754371761189 -34.626070486551434,-58.478845892615496 -34.625833982403705,-58.478656239822875 -34.625784569054019,-58.479055887935289 -34.624917021687899,-58.479113112994554 -34.624789403996473,-58.478068759433668 -34.624516079965886,-58.477917022879339 -34.624476379316114,-58.476950546041571 -34.624217543497878,-58.476490159030675 -34.625223616815802,-58.476036488976646 -34.626215039111301,-58.475468683569524 -34.627455634925276,-58.476590680469947 -34.62773446540735,-58.477638475071473 -34.627994843338463,-58.478135484008838 -34.626914674495666,-58.478198162823588 -34.626778746443442)));;304;10_11_6;COMUNA 10;11;6;510;241;269;89,59%;262;262;100,00%;0;0,00%;183;23;12,57%;160;87,43%
MULTIPOLYGON (((-58.481886075845466 -34.626624061960115,-58.480977499753124 -34.626389052650296,-58.480822094843283 -34.626348581502562,-58.479967200123525 -34.62612588103206,-58.479754371761189 -34.626070486551434,-58.479296647075572 -34.627064667968433,-58.480369492992601 -34.627342061887873,-58.480538105617271 -34.627385630370995,-58.481435103332039 -34.627614940274434,-58.481707151579478 -34.627684478001946,-58.482862741152999 -34.627968175281758,-58.48424233609272 -34.628306894520662,-58.48469864561951 -34.627313328836259,-58.483457603921757 -34.627015648930524,-58.48331429566813 -34.626980108647928,-58.482045230551051 -34.62666523540495,-58.481886075845466 -34.626624061960115)));;305;10_11_7;COMUNA 10;11;7;1079;505;574;87,98%;410;410;100,00%;0;0,00%;377;39;10,34%;338;89,66%
MULTIPOLYGON (((-58.486420944171265 -34.626618264206627,-58.486219272953626 -34.626570273458448,-58.485157413338776 -34.626313845138355,-58.484949353349641 -34.626263599866178,-58.483770777435609 -34.625978799445669,-58.483631560658317 -34.625945160295871,-58.482338910990386 -34.625629237722855,-58.481886075845466 -34.626624061960115,-58.482045230551051 -34.62666523540495,-58.48331429566813 -34.626980108647928,-58.483457603921757 -34.627015648930524,-58.48469864561951 -34.627313328836259,-58.48595954829171 -34.62761578120756,-58.48617547429177 -34.627146076068783,-58.486221707380992 -34.627045641225457,-58.486420944171265 -34.626618264206627)));;306;10_11_8;COMUNA 10;11;8;839;394;445;88,54%;390;390;100,00%;0;0,00%;344;36;10,47%;308;89,53%
MULTIPOLYGON (((-58.483691752255723 -34.629502875745466,-58.484939054437191 -34.62981217210546,-58.485499163859473 -34.628613718662621,-58.485585844001683 -34.628428273657185,-58.48588232179803 -34.62778375932826,-58.48595954829171 -34.62761578120756,-58.48469864561951 -34.627313328836259,-58.48424233609272 -34.628306894520662,-58.482862741152999 -34.627968175281758,-58.482775715828062 -34.628158548167598,-58.482311201196438 -34.629158305236267,-58.483478061409997 -34.629449882389423,-58.483691752255723 -34.629502875745466)));;307;10_11_9;COMUNA 10;11;9;1085;529;556;95,14%;391;389;99,49%;2;0,51%;381;45;11,81%;336;88,19%
MULTIPOLYGON (((-58.486946055387911 -34.63030976403607,-58.486176056051534 -34.63011885195526,-58.484939054437191 -34.62981217210546,-58.483691752255723 -34.629502875745466,-58.48320161013271 -34.630559684545588,-58.483456969070282 -34.630624080122594,-58.484444325968134 -34.630870676876178,-58.485679978781612 -34.631179192987993,-58.485573539878501 -34.631402389415065,-58.486027726983892 -34.631040812522336,-58.486725610314046 -34.630485165614218,-58.486862238673872 -34.630376473032591,-58.486946055387911 -34.63030976403607)));;308;10_12_1;COMUNA 10;12;1;1006;462;544;84,93%;412;411;99,76%;1;0,24%;347;23;6,63%;324;93,37%
MULTIPOLYGON (((-58.485679978781612 -34.631179192987993,-58.484444325968134 -34.630870676876178,-58.484362068695255 -34.631046683278392,-58.483975984359262 -34.631878821080143,-58.483905902487514 -34.632029824194916,-58.483582142227078 -34.632723987474442,-58.483469650275055 -34.632962746939207,-58.483469861122998 -34.632962787829413,-58.483712194187362 -34.632884121630731,-58.484731511551487 -34.632072777876409,-58.485573539878501 -34.631402389415065,-58.485679978781612 -34.631179192987993)));;309;10_12_10;COMUNA 10;12;10;612;277;335;82,69%;306;306;100,00%;0;0,00%;246;4;1,63%;242;98,37%
MULTIPOLYGON (((-58.483691752255723 -34.629502875745466,-58.483478061409997 -34.629449882389423,-58.482311201196438 -34.629158305236267,-58.482221362520441 -34.629351635987753,-58.481825132549517 -34.630212502191945,-58.481366047382153 -34.631210000880785,-58.481498711483908 -34.631243009772071,-58.482737343199304 -34.631560921725281,-58.483975984359262 -34.631878821080143,-58.484362068695255 -34.631046683278392,-58.484444325968134 -34.630870676876178,-58.483456969070282 -34.630624080122594,-58.48320161013271 -34.630559684545588,-58.483691752255723 -34.629502875745466)));;310;10_12_2;COMUNA 10;12;2;875;402;473;84,99%;443;442;99,77%;1;0,23%;370;13;3,51%;357;96,49%
MULTIPOLYGON (((-58.480408707778132 -34.629863338192273,-58.48035607933803 -34.62997856093989,-58.480024040730051 -34.630709407572844,-58.479956933899039 -34.630856675507573,-58.481132671304742 -34.631152006275975,-58.481366047382153 -34.631210000880785,-58.481825132549517 -34.630212502191945,-58.482221362520441 -34.629351635987753,-58.482311201196438 -34.629158305236267,-58.480892576001125 -34.628803794853603,-58.480408707778132 -34.629863338192273)));;311;10_12_3;COMUNA 10;12;3;807;371;436;85,09%;295;294;99,66%;1;0,34%;309;85;27,51%;224;72,49%
MULTIPOLYGON (((-58.480892576001125 -34.628803794853603,-58.48060569993681 -34.628732144753094,-58.479821074899355 -34.628537180426406,-58.478741742212662 -34.628269008256126,-58.478251886090888 -34.629329741146137,-58.478190397700658 -34.62946285202235,-58.477802470273573 -34.63029715391373,-58.478881914568589 -34.630581602435605,-58.478930031957695 -34.630477155942472,-58.479333361157565 -34.629599184958472,-58.480408707778132 -34.629863338192273,-58.480892576001125 -34.628803794853603)));;312;10_12_4;COMUNA 10;12;4;629;282;347;81,27%;300;299;99,67%;1;0,33%;243;31;12,76%;212;87,24%
MULTIPOLYGON (((-58.476110936899261 -34.62878441363349,-58.475672488413252 -34.629742943899949,-58.476716984100861 -34.630011992270262,-58.476870263708797 -34.630051482921566,-58.477802470273573 -34.63029715391373,-58.478190397700658 -34.62946285202235,-58.478251886090888 -34.629329741146137,-58.478741742212662 -34.628269008256126,-58.477638475071473 -34.627994843338463,-58.476590680469947 -34.62773446540735,-58.476502278553433 -34.627928707353789,-58.476110936899261 -34.62878441363349)));;313;10_12_5;COMUNA 10;12;5;605;291;314;92,68%;239;238;99,58%;1;0,42%;189;12;6,35%;177;93,65%
MULTIPOLYGON (((-58.475348840858523 -34.630450395885823,-58.476378441676317 -34.630763605066377,-58.476493296662802 -34.630798522872254,-58.477433101603282 -34.631091310038855,-58.477802470273573 -34.63029715391373,-58.476870263708797 -34.630051482921566,-58.476716984100861 -34.630011992270262,-58.475672488413252 -34.629742943899949,-58.476110936899261 -34.62878441363349,-58.476502278553433 -34.627928707353789,-58.476590680469947 -34.62773446540735,-58.475468683569524 -34.627455634925276,-58.474990119596882 -34.628501282749944,-58.474553703757188 -34.629454808668356,-58.474253725974876 -34.630110352338484,-58.475208766660209 -34.630407732851879,-58.475348840858523 -34.630450395885823)));;314;10_12_6;COMUNA 10;12;6;601;279;322;86,65%;242;242;100,00%;0;0,00%;214;9;4,21%;205;95,79%
MULTIPOLYGON (((-58.478881914568589 -34.630581602435605,-58.477802470273573 -34.63029715391373,-58.477433101603282 -34.631091310038855,-58.477595161107672 -34.631141784991598,-58.478494841840138 -34.631421047277854,-58.47955037039641 -34.631748663367844,-58.479594655078436 -34.631651541348361,-58.479768130780897 -34.63127094119271,-58.479956933899039 -34.630856675507573,-58.480024040730051 -34.630709407572844,-58.48035607933803 -34.62997856093989,-58.480408707778132 -34.629863338192273,-58.479333361157565 -34.629599184958472,-58.478930031957695 -34.630477155942472,-58.478881914568589 -34.630581602435605)));;315;10_12_7;COMUNA 10;12;7;659;294;365;80,55%;282;282;100,00%;0;0,00%;238;28;11,76%;210;88,24%
MULTIPOLYGON (((-58.479768130780897 -34.63127094119271,-58.479594655078436 -34.631651541348361,-58.47955037039641 -34.631748663367844,-58.479475852677766 -34.631912129755818,-58.479445449350926 -34.631978755856537,-58.479406274139265 -34.632064679563562,-58.479381150040041 -34.632115670603696,-58.480769424971555 -34.632547177235118,-58.480795739306082 -34.63248759390337,-58.482013952876329 -34.632867912584103,-58.482117225107231 -34.632900432469853,-58.482135619434892 -34.632860639497416,-58.482197614973757 -34.6327263998284,-58.482259695498016 -34.632592089686462,-58.480919384704663 -34.632180523102924,-58.480968266870143 -34.632074244672665,-58.481156385451207 -34.631665470428423,-58.481366047382153 -34.631210000880785,-58.481132671304742 -34.631152006275975,-58.479956933899039 -34.630856675507573,-58.479768130780897 -34.63127094119271)));;316;10_12_8;COMUNA 10;12;8;753;352;401;87,78%;352;352;100,00%;0;0,00%;311;2;0,64%;309;99,36%
MULTIPOLYGON (((-58.482737343199304 -34.631560921725281,-58.481498711483908 -34.631243009772071,-58.481366047382153 -34.631210000880785,-58.481156385451207 -34.631665470428423,-58.480968266870143 -34.632074244672665,-58.480919384704663 -34.632180523102924,-58.482259695498016 -34.632592089686462,-58.482197614973757 -34.6327263998284,-58.482135619434892 -34.632860639497416,-58.482117225107231 -34.632900432469853,-58.483062016426622 -34.633198105102664,-58.483320135563595 -34.633278988759407,-58.483469861122998 -34.632962787829413,-58.483469650275055 -34.632962746939207,-58.483582142227078 -34.632723987474442,-58.483905902487514 -34.632029824194916,-58.483975984359262 -34.631878821080143,-58.482737343199304 -34.631560921725281)));;317;10_12_9;COMUNA 10;12;9;737;323;414;78,02%;390;390;100,00%;0;0,00%;308;9;2,92%;299;97,08%
MULTIPOLYGON (((-58.494707110285503 -34.624986245438905,-58.494617967458773 -34.624907604134641,-58.494201486973758 -34.624540375880329,-58.494056786652919 -34.624655135402676,-58.493892497289416 -34.624785604524966,-58.493355253151478 -34.625212656728763,-58.492816981429385 -34.625640411041026,-58.492756425512376 -34.625688526208336,-58.492603535198683 -34.626020335647404,-58.493857208102327 -34.626557997894068,-58.494213638283334 -34.626710869265878,-58.49507919900023 -34.627082063608576,-58.495236582086577 -34.627149136677033,-58.496428594694578 -34.627657280779985,-58.496532553344025 -34.627703802856182,-58.496951371306622 -34.627890664107355,-58.497508971970724 -34.627453519682817,-58.496939144845001 -34.626955635951049,-58.496845225431883 -34.626873546820704,-58.495888654429763 -34.626034345723212,-58.495771641145673 -34.625931697954343,-58.495577159350567 -34.625760970065109,-58.495510854707376 -34.625701901398081,-58.494775714565769 -34.625046722444267,-58.494707110285503 -34.624986245438905)));;318;10_13_1;COMUNA 10;13;1;718;333;385;86,49%;249;248;99,60%;1;0,40%;226;13;5,75%;213;94,25%
MULTIPOLYGON (((-58.489334481449532 -34.633886919300508,-58.488775399970571 -34.633406108845101,-58.488510520315224 -34.633178270375659,-58.488291663309298 -34.632990000441303,-58.487790375442934 -34.632558893206578,-58.487699953287262 -34.632481162730947,-58.486993882131493 -34.631873890976919,-58.486896047053627 -34.631789471010222,-58.486804433391001 -34.631710472449249,-58.486436850039389 -34.63251078225214,-58.485923737113573 -34.633627678327478,-58.486398008122137 -34.633744210642682,-58.487168120345295 -34.633913571177189,-58.48732064350164 -34.63394713313329,-58.488207490238104 -34.634124562334989,-58.488432098408637 -34.634165643260879,-58.488909849180558 -34.634218148885651,-58.489077659308769 -34.634090995875688,-58.489334481449532 -34.633886919300508)));;319;10_13_10;COMUNA 10;13;10;593;290;303;95,71%;282;281;99,65%;1;0,36%;230;6;2,61%;224;97,39%
MULTIPOLYGON (((-58.486027726983892 -34.631040812522336,-58.485573539878501 -34.631402389415065,-58.484731511551487 -34.632072777876409,-58.484997271859271 -34.632140971274872,-58.485203132044852 -34.632193892964494,-58.486436850039389 -34.63251078225214,-58.486804433391001 -34.631710472449249,-58.486027726983892 -34.631040812522336)));;320;10_13_11;COMUNA 10;13;11;619;264;355;74,37%;344;344;100,00%;0;0,00%;287;3;1,05%;284;98,95%
MULTIPOLYGON (((-58.484731511551487 -34.632072777876409,-58.483712194187362 -34.632884121630731,-58.483469861122998 -34.632962787829413,-58.483320135563595 -34.633278988759407,-58.483320369586686 -34.633279331975451,-58.483465991701493 -34.633325153846172,-58.484537322555141 -34.633638075609952,-58.484659001300209 -34.633673618310517,-58.485775573252326 -34.633948069061312,-58.48580673886552 -34.633880737012184,-58.485853487190916 -34.633779738922186,-58.485923737113573 -34.633627678327478,-58.486436850039389 -34.63251078225214,-58.485203132044852 -34.632193892964494,-58.484997271859271 -34.632140971274872,-58.484731511551487 -34.632072777876409)));;321;10_13_12;COMUNA 10;13;12;601;254;347;73,20%;316;316;100,00%;0;0,00%;267;1;0,37%;266;99,63%
MULTIPOLYGON (((-58.494213638283334 -34.626710869265878,-58.493857208102327 -34.626557997894068,-58.493794980920981 -34.626693793027179,-58.493354874407032 -34.627657528580663,-58.494040561033124 -34.627950462808514,-58.49473946022335 -34.628249094113905,-58.495875416381296 -34.62873437014639,-58.496277677688902 -34.628418897366963,-58.496429876978901 -34.628299555587702,-58.496951371306622 -34.627890664107355,-58.496532553344025 -34.627703802856182,-58.496428594694578 -34.627657280779985,-58.495236582086577 -34.627149136677033,-58.49507919900023 -34.627082063608576,-58.494213638283334 -34.626710869265878)));;322;10_13_2;COMUNA 10;13;2;753;346;407;85,01%;316;315;99,68%;1;0,32%;255;1;0,39%;254;99,61%
MULTIPOLYGON (((-58.494040561033124 -34.627950462808514,-58.493354874407032 -34.627657528580663,-58.493794980920981 -34.626693793027179,-58.493857208102327 -34.626557997894068,-58.492603535198683 -34.626020335647404,-58.492756425512376 -34.625688526208336,-58.491741273143241 -34.626495278431051,-58.49135629622949 -34.626803689800376,-58.491095668147828 -34.627011011295558,-58.491899000057366 -34.627554642852424,-58.492834600510619 -34.628187746518918,-58.493046708647313 -34.628332276264302,-58.493671447580084 -34.628757767344382,-58.494083057834978 -34.62903816450536,-58.49431443003548 -34.629195786097299,-58.494874732292502 -34.629518889844341,-58.495406888341797 -34.629101621669122,-58.495875416381296 -34.62873437014639,-58.49473946022335 -34.628249094113905,-58.494040561033124 -34.627950462808514)));;323;10_13_3;COMUNA 10;13;3;725;354;371;95,42%;322;322;100,00%;0;0,00%;261;23;8,81%;238;91,19%
MULTIPOLYGON (((-58.491899000057366 -34.627554642852424,-58.491095668147828 -34.627011011295558,-58.490221701752986 -34.627702784299601,-58.490498545834654 -34.627823922795024,-58.491167435015925 -34.628102299039298,-58.491337427451604 -34.628173458828925,-58.491574820837172 -34.62827270198148,-58.492446687843334 -34.628636025826246,-58.493567718074345 -34.629099143118673,-58.49391573794658 -34.629281812983891,-58.494083057834978 -34.62903816450536,-58.493671447580084 -34.628757767344382,-58.493046708647313 -34.628332276264302,-58.492834600510619 -34.628187746518918,-58.491899000057366 -34.627554642852424)));;324;10_13_4;COMUNA 10;13;4;605;287;318;90,25%;287;287;100,00%;0;0,00%;248;4;1,61%;244;98,39%
MULTIPOLYGON (((-58.494614784885798 -34.629723119891736,-58.494773802380458 -34.629597440178749,-58.494874732292502 -34.629518889844341,-58.49431443003548 -34.629195786097299,-58.494083057834978 -34.62903816450536,-58.49391573794658 -34.629281812983891,-58.493567718074345 -34.629099143118673,-58.492446687843334 -34.628636025826246,-58.491574820837172 -34.62827270198148,-58.491337427451604 -34.628173458828925,-58.491167435015925 -34.628102299039298,-58.490498545834654 -34.627823922795024,-58.490221701752986 -34.627702784299601,-58.489285969716654 -34.628447523973186,-58.490379825064913 -34.628980819702583,-58.491407569322092 -34.62948186654944,-58.49248304562196 -34.630006133258924,-58.493579924400485 -34.630540878327309,-58.49434913004896 -34.629933055275494,-58.494614784885798 -34.629723119891736)));;325;10_13_5;COMUNA 10;13;5;810;391;419;93,32%;377;376;99,73%;1;0,27%;315;4;1,27%;311;98,73%
MULTIPOLYGON (((-58.49248304562196 -34.630006133258924,-58.491407569322092 -34.62948186654944,-58.490379825064913 -34.628980819702583,-58.489285969716654 -34.628447523973186,-58.488233953887928 -34.629284748667018,-58.488083359996132 -34.629404643268977,-58.489207047348337 -34.629961605980945,-58.489379432052935 -34.630047064209052,-58.490214942807491 -34.630455413343995,-58.491091279241992 -34.630883677470173,-58.491266564967994 -34.630970259140007,-58.492350413274373 -34.63150586332879,-58.492572896228943 -34.631336648505851,-58.492995197959353 -34.631002941727097,-58.493579924400485 -34.630540878327309,-58.49248304562196 -34.630006133258924)));;326;10_13_6;COMUNA 10;13;6;840;382;458;83,41%;321;320;99,69%;1;0,31%;278;2;0,72%;276;99,28%
MULTIPOLYGON (((-58.491266564967994 -34.630970259140007,-58.491091279241992 -34.630883677470173,-58.490214942807491 -34.630455413343995,-58.489499880133046 -34.631034465048316,-58.489379182720832 -34.631131184860202,-58.488520323424751 -34.63181906854706,-58.488664692691323 -34.631944675858591,-58.489330209953806 -34.632518354134689,-58.489446030836199 -34.632618191238898,-58.490154940852015 -34.633234603309205,-58.490779391043105 -34.632737895519604,-58.491018061758695 -34.632548045354604,-58.491840964811367 -34.631893393297226,-58.491988748813014 -34.631781030240511,-58.492180564749511 -34.631863169846405,-58.492251607391132 -34.631581030641854,-58.492350413274373 -34.63150586332879,-58.491266564967994 -34.630970259140007)));;327;10_13_7;COMUNA 10;13;7;722;307;415;73,98%;299;296;99,00%;3;1,01%;254;13;5,12%;241;94,88%
MULTIPOLYGON (((-58.487717690974073 -34.629695644046265,-58.486946055387911 -34.63030976403607,-58.486862238673872 -34.630376473032591,-58.487727834241305 -34.631129562987212,-58.488520323424751 -34.63181906854706,-58.489379182720832 -34.631131184860202,-58.489499880133046 -34.631034465048316,-58.490214942807491 -34.630455413343995,-58.489379432052935 -34.630047064209052,-58.489207047348337 -34.629961605980945,-58.488083359996132 -34.629404643268977,-58.487717690974073 -34.629695644046265)));;328;10_13_8;COMUNA 10;13;8;785;357;428;83,41%;331;331;100,00%;0;0,00%;290;1;0,34%;289;99,66%
MULTIPOLYGON (((-58.486862238673872 -34.630376473032591,-58.486725610314046 -34.630485165614218,-58.486027726983892 -34.631040812522336,-58.486804433391001 -34.631710472449249,-58.486896047053627 -34.631789471010222,-58.486993882131493 -34.631873890976919,-58.487699953287262 -34.632481162730947,-58.487790375442934 -34.632558893206578,-58.488291663309298 -34.632990000441303,-58.488510520315224 -34.633178270375659,-58.488775399970571 -34.633406108845101,-58.489334481449532 -34.633886919300508,-58.489447431664004 -34.633797102909391,-58.490154940852015 -34.633234603309205,-58.489446030836199 -34.632618191238898,-58.489330209953806 -34.632518354134689,-58.488664692691323 -34.631944675858591,-58.488520323424751 -34.63181906854706,-58.487727834241305 -34.631129562987212,-58.486862238673872 -34.630376473032591)));;329;10_13_9;COMUNA 10;13;9;726;323;403;80,15%;327;326;99,69%;1;0,31%;281;34;12,10%;247;87,90%
MULTIPOLYGON (((-58.499479936167049 -34.631581389178223,-58.499977339003401 -34.631776526323534,-58.500552717506096 -34.632003539721076,-58.501042120642218 -34.632207759798007,-58.501537647139351 -34.631834492111572,-58.500417572690402 -34.630838543008203,-58.500296881494791 -34.630731464035428,-58.500799128667666 -34.630348056006376,-58.500349011970876 -34.629951140287815,-58.4995452732431 -34.629242347946487,-58.49904933219981 -34.629627016650751,-58.49893060549384 -34.629719167727743,-58.498080862423208 -34.630387467617709,-58.497928559697321 -34.630265535807879,-58.497172951611681 -34.629704606221281,-58.496398395319559 -34.630298081899682,-58.49620333616263 -34.630415181785665,-58.49640359479514 -34.630514496119595,-58.497444372103338 -34.630877244330236,-58.498586306302947 -34.631275307200021,-58.499271333874027 -34.631509900238868,-58.499479936167049 -34.631581389178223)));;330;10_14_1;COMUNA 10;14;1;902;420;482;87,14%;389;389;100,00%;0;0,00%;334;8;2,40%;326;97,60%
MULTIPOLYGON (((-58.49213305336999 -34.63629191772668,-58.491775587112322 -34.636206578169649,-58.491063383594266 -34.636036599521894,-58.48967145076 -34.63570429886169,-58.489425871600034 -34.635644914373309,-58.489118963218822 -34.636985165439576,-58.490682367942441 -34.637369265763233,-58.490961784867316 -34.637442795251751,-58.49171192669818 -34.637640090253285,-58.491902467335628 -34.637692511253142,-58.492270848303519 -34.637782707080767,-58.49331978480302 -34.636963548666401,-58.493116233633501 -34.636513373804036,-58.49213305336999 -34.63629191772668)));;331;10_14_10;COMUNA 10;14;10;839;379;460;82,39%;439;439;100,00%;0;0,00%;341;3;0,88%;338;99,12%
MULTIPOLYGON (((-58.489425871600034 -34.635644914373309,-58.487648969485164 -34.635215558521338,-58.487336006919691 -34.636343475631037,-58.487314385634512 -34.636414186508844,-58.48728033635237 -34.636525746278096,-58.488179835379789 -34.636750498520591,-58.489118963218822 -34.636985165439576,-58.489425871600034 -34.635644914373309)));;332;10_14_11;COMUNA 10;14;11;709;339;370;91,62%;301;301;100,00%;0;0,00%;267;68;25,47%;199;74,53%
MULTIPOLYGON (((-58.498212785174935 -34.628068407970275,-58.497919428960408 -34.627812075935381,-58.497508971970724 -34.627453519682817,-58.496951371306622 -34.627890664107355,-58.496429876978901 -34.628299555587702,-58.496277677688902 -34.628418897366963,-58.495875416381296 -34.62873437014639,-58.495406888341797 -34.629101621669122,-58.494874732292502 -34.629518889844341,-58.495516716424717 -34.629987044315527,-58.495699431055883 -34.630108689220158,-58.496032307148084 -34.630330366662463,-58.49620333616263 -34.630415181785665,-58.496398395319559 -34.630298081899682,-58.497172951611681 -34.629704606221281,-58.497928559697321 -34.630265535807879,-58.498080862423208 -34.630387467617709,-58.49893060549384 -34.629719167727743,-58.49904933219981 -34.629627016650751,-58.4995452732431 -34.629242347946487,-58.498336793062009 -34.628176755733506,-58.498212785174935 -34.628068407970275)));;333;10_14_2;COMUNA 10;14;2;925;449;476;94,33%;376;376;100,00%;0;0,00%;315;10;3,17%;305;96,83%
MULTIPOLYGON (((-58.499479936167049 -34.631581389178223,-58.499271333874027 -34.631509900238868,-58.498586306302947 -34.631275307200021,-58.497444372103338 -34.630877244330236,-58.49640359479514 -34.630514496119595,-58.49620333616263 -34.630415181785665,-58.496032307148084 -34.630330366662463,-58.495699431055883 -34.630108689220158,-58.495516716424717 -34.629987044315527,-58.494874732292502 -34.629518889844341,-58.494773802380458 -34.629597440178749,-58.494614784885798 -34.629723119891736,-58.49434913004896 -34.629933055275494,-58.493579924400485 -34.630540878327309,-58.494657208766384 -34.630820891846014,-58.494779231053322 -34.630863044315184,-58.494955021759068 -34.630923774621934,-58.495368392009325 -34.631091346231401,-58.496558832657463 -34.631573995334989,-58.498276261413785 -34.632270219652661,-58.498985601284176 -34.632556639854911,-58.499700869843558 -34.63198471597353,-58.499977339003401 -34.631776526323534,-58.499479936167049 -34.631581389178223)));;334;10_14_3;COMUNA 10;14;3;813;371;442;83,94%;408;408;100,00%;0;0,00%;322;3;0,93%;319;99,07%
MULTIPOLYGON (((-58.494533639626844 -34.63208195185392,-58.494466883387588 -34.632414022470201,-58.49431040734278 -34.633190426702299,-58.49470457206332 -34.633240959376401,-58.495775873799431 -34.633377016065737,-58.496084918556846 -34.633416299355083,-58.497246033266094 -34.633564361157845,-58.497640627452135 -34.633614672943175,-58.498314609192157 -34.633084531040495,-58.498936286474624 -34.632595458610659,-58.498985601284176 -34.632556639854911,-58.498276261413785 -34.632270219652661,-58.496558832657463 -34.631573995334989,-58.495368392009325 -34.631091346231401,-58.494955021759068 -34.630923774621934,-58.494779231053322 -34.630863044315184,-58.494660943013045 -34.631449432851113,-58.494642234395478 -34.631541976028487,-58.494533639626844 -34.63208195185392)));;335;10_14_4;COMUNA 10;14;4;832;400;432;92,59%;364;364;100,00%;0;0,00%;296;1;0,34%;295;99,66%
MULTIPOLYGON (((-58.494779231053322 -34.630863044315184,-58.494657208766384 -34.630820891846014,-58.493579924400485 -34.630540878327309,-58.492995197959353 -34.631002941727097,-58.492572896228943 -34.631336648505851,-58.492350413274373 -34.63150586332879,-58.492251607391132 -34.631581030641854,-58.492180564749511 -34.631863169846405,-58.491988748813014 -34.631781030240511,-58.491840964811367 -34.631893393297226,-58.491018061758695 -34.632548045354604,-58.490779391043105 -34.632737895519604,-58.49192336081618 -34.632884533038691,-58.492892321527052 -34.633008737743722,-58.493477090530504 -34.633083664478356,-58.49431040734278 -34.633190426702299,-58.494466883387588 -34.632414022470201,-58.494533639626844 -34.63208195185392,-58.494642234395478 -34.631541976028487,-58.494660943013045 -34.631449432851113,-58.494779231053322 -34.630863044315184)));;336;10_14_5;COMUNA 10;14;5;719;330;389;84,83%;312;312;100,00%;0;0,00%;262;1;0,38%;261;99,62%
MULTIPOLYGON (((-58.490154940852015 -34.633234603309205,-58.489447431664004 -34.633797102909391,-58.489334481449532 -34.633886919300508,-58.489077659308769 -34.634090995875688,-58.488909849180558 -34.634218148885651,-58.489803245935548 -34.634343591538411,-58.491489161505967 -34.634580255238824,-58.491473503838876 -34.634637584747495,-58.491460786431553 -34.634684273767995,-58.491410267093876 -34.634883703316106,-58.492431235037323 -34.635010719697412,-58.492485177558642 -34.634779107070322,-58.492576285917437 -34.634374916671341,-58.492618566434977 -34.634192294706985,-58.492754849435102 -34.633603016559107,-58.492892321527052 -34.633008737743722,-58.49192336081618 -34.632884533038691,-58.490779391043105 -34.632737895519604,-58.490154940852015 -34.633234603309205)));;337;10_14_6;COMUNA 10;14;6;593;283;310;91,29%;243;243;100,00%;0;0,00%;205;2;0,98%;203;99,02%
MULTIPOLYGON (((-58.495597130165088 -34.635210234580832,-58.495599738464811 -34.635209133751211,-58.495597262345683 -34.635210131004527,-58.495598696592886 -34.63520900713285,-58.496087278478463 -34.634840570615687,-58.496310867373893 -34.634663883731754,-58.497161433452717 -34.633991723025098,-58.497640627452135 -34.633614672943175,-58.497246033266094 -34.633564361157845,-58.496084918556846 -34.633416299355083,-58.495775873799431 -34.633377016065737,-58.49470457206332 -34.633240959376401,-58.49431040734278 -34.633190426702299,-58.493477090530504 -34.633083664478356,-58.492892321527052 -34.633008737743722,-58.492754849435102 -34.633603016559107,-58.492618566434977 -34.634192294706985,-58.492576285917437 -34.634374916671341,-58.492485177558642 -34.634779107070322,-58.492431235037323 -34.635010719697412,-58.492431235061112 -34.635010786361725,-58.492521731567265 -34.63502157082462,-58.493821064558496 -34.63517230745849,-58.493915900004176 -34.635180734202251,-58.494009203063172 -34.635192541657268,-58.495394787880905 -34.635368788893572,-58.495597130165088 -34.635210234580832)));;338;10_14_7;COMUNA 10;14;7;835;385;450;85,56%;301;301;100,00%;0;0,00%;291;18;6,19%;273;93,81%
MULTIPOLYGON (((-58.492351780190184 -34.635347327080325,-58.492324471572665 -34.635465436145083,-58.49213305336999 -34.63629191772668,-58.493116233633501 -34.636513373804036,-58.4936613337183 -34.636620916178458,-58.493799206165342 -34.636646727005413,-58.494566074066242 -34.636021297571119,-58.494760112688759 -34.63586912911601,-58.495396908729994 -34.635369718513239,-58.495394787880905 -34.635368788893572,-58.494009203063172 -34.635192541657268,-58.493915900004176 -34.635180734202251,-58.493821064558496 -34.63517230745849,-58.492521731567265 -34.63502157082462,-58.492431235061112 -34.635010786361725,-58.492351780190184 -34.635347327080325)));;339;10_14_8;COMUNA 10;14;8;599;282;317;88,96%;310;310;100,00%;0;0,00%;253;10;3,95%;243;96,05%
MULTIPOLYGON (((-58.491063383594266 -34.636036599521894,-58.491775587112322 -34.636206578169649,-58.49213305336999 -34.63629191772668,-58.492324471572665 -34.635465436145083,-58.492351780190184 -34.635347327080325,-58.492431235061112 -34.635010786361725,-58.492431235037323 -34.635010719697412,-58.491410267093876 -34.634883703316106,-58.491460786431553 -34.634684273767995,-58.491473503838876 -34.634637584747495,-58.491489161505967 -34.634580255238824,-58.489803245935548 -34.634343591538411,-58.488909849180558 -34.634218148885651,-58.488714524362088 -34.63436615328547,-58.488596119301114 -34.634455125050124,-58.488513577227174 -34.634520003820377,-58.488425242418707 -34.634588897971561,-58.488317144908081 -34.634673078399153,-58.487648969485164 -34.635215558521338,-58.489425871600034 -34.635644914373309,-58.48967145076 -34.63570429886169,-58.491063383594266 -34.636036599521894)));;340;10_14_9;COMUNA 10;14;9;887;407;480;84,79%;388;388;100,00%;0;0,00%;337;18;5,34%;319;94,66%
MULTIPOLYGON (((-58.501865927496951 -34.632925761129464,-58.501621533865666 -34.634128695673596,-58.502843508249761 -34.634286685055322,-58.502990152306779 -34.634305651406663,-58.50419764790847 -34.634464899643909,-58.505457300072457 -34.634638413887885,-58.505123381657711 -34.634293378396194,-58.505071380323947 -34.63423966232498,-58.504574131471692 -34.633725732749795,-58.504257280762687 -34.633591470524372,-58.503887509288646 -34.633434830254771,-58.503594265555314 -34.633308164208827,-58.503395531856491 -34.633222312368339,-58.502408175774107 -34.63279586322745,-58.501865927496951 -34.632925761129464)));;341;10_15_1;COMUNA 10;15;1;633;289;344;84,01%;304;304;100,00%;0;0,00%;263;12;4,56%;251;95,44%
MULTIPOLYGON (((-58.499977339003401 -34.631776526323534,-58.499700869843558 -34.63198471597353,-58.498985601284176 -34.632556639854911,-58.498936286474624 -34.632595458610659,-58.498705719390053 -34.633751691613668,-58.500164901445252 -34.633940342819095,-58.501621533865666 -34.634128695673596,-58.501865927496951 -34.632925761129464,-58.502408175774107 -34.63279586322745,-58.50117412270847 -34.632262860894507,-58.501042120642218 -34.632207759798007,-58.500552717506096 -34.632003539721076,-58.499977339003401 -34.631776526323534)));;342;10_15_2;COMUNA 10;15;2;918;403;515;78,25%;417;417;100,00%;0;0,00%;347;10;2,88%;337;97,12%
MULTIPOLYGON (((-58.498936286474624 -34.632595458610659,-58.498314609192157 -34.633084531040495,-58.497640627452135 -34.633614672943175,-58.497161433452717 -34.633991723025098,-58.496310867373893 -34.634663883731754,-58.496087278478463 -34.634840570615687,-58.495596990955526 -34.63521029333404,-58.495597045024127 -34.635210301297029,-58.495394787880905 -34.635368788893572,-58.495396908729994 -34.635369718513239,-58.495559062960886 -34.635395661694218,-58.496848702070658 -34.635566228471909,-58.496927435291283 -34.635576347576325,-58.496955237905013 -34.635432109737359,-58.497759932806034 -34.635488713906675,-58.497772856147172 -34.635422792558266,-58.497949155252044 -34.63544893976718,-58.497961398530578 -34.635387103234635,-58.498292350519186 -34.635429191572413,-58.498207752177223 -34.635851835570364,-58.498174422739652 -34.636018329533407,-58.498252042541381 -34.636013588469723,-58.49908226038594 -34.635966933686596,-58.49963280396441 -34.636043460838764,-58.499640028881181 -34.636003950329901,-58.499740321235798 -34.636017441476973,-58.499754349503746 -34.635948702596622,-58.499770929070969 -34.635869117516812,-58.499922525129399 -34.635143132298737,-58.498465025636655 -34.634952153724932,-58.498490701910107 -34.63482333918305,-58.49868352943205 -34.633862758135209,-58.498705719390053 -34.633751691613668,-58.498936286474624 -34.632595458610659)));;343;10_15_3;COMUNA 10;15;3;557;265;292;90,75%;247;247;100,00%;0;0,00%;202;15;7,43%;187;92,57%
MULTIPOLYGON (((-58.499922525129399 -34.635143132298737,-58.499770929070969 -34.635869117516812,-58.499855458404539 -34.635882683784466,-58.49993026003451 -34.635482718431597,-58.500300752693676 -34.635534507867298,-58.500293271500126 -34.635571764902984,-58.500949812114115 -34.635656774801177,-58.500962908023425 -34.635600994237201,-58.501215128428555 -34.635632676442931,-58.501312440318991 -34.635650251878715,-58.501377048284418 -34.635332263345596,-58.501621533865666 -34.634128695673596,-58.500164901445252 -34.633940342819095,-58.498705719390053 -34.633751691613668,-58.49868352943205 -34.633862758135209,-58.498490701910107 -34.63482333918305,-58.498465025636655 -34.634952153724932,-58.499922525129399 -34.635143132298737)));;344;10_15_4;COMUNA 10;15;4;676;313;363;86,23%;301;301;100,00%;0;0,00%;247;2;0,81%;245;99,19%
MULTIPOLYGON (((-58.502843508249761 -34.634286685055322,-58.501621533865666 -34.634128695673596,-58.501377048284418 -34.635332263345596,-58.501312440318991 -34.635650251878715,-58.501215128428555 -34.635632676442931,-58.500962908023425 -34.635600994237201,-58.500949812114115 -34.635656774801177,-58.500293271500126 -34.635571764902984,-58.500300752693676 -34.635534507867298,-58.49993026003451 -34.635482718431597,-58.499855458404539 -34.635882683784466,-58.499770929070969 -34.635869117516812,-58.499754349503746 -34.635948702596622,-58.499740321235798 -34.636017441476973,-58.499826640084301 -34.636031148070352,-58.499810998986895 -34.636113409012964,-58.500482373372208 -34.636207853828857,-58.500621096858509 -34.636228304396056,-58.500610638943421 -34.636277393740706,-58.501098632836822 -34.636327101844977,-58.50117906769016 -34.636329189238978,-58.501213150265713 -34.636330094003831,-58.501254215935816 -34.636322897698768,-58.501271349975312 -34.636339653386145,-58.501745543950626 -34.636394926824678,-58.50187600110673 -34.636411082696434,-58.502211560027213 -34.636452736361548,-58.502306319262637 -34.636475241565073,-58.502391789667861 -34.636494651026645,-58.502621602024035 -34.636521689571119,-58.502808213084244 -34.636544164284501,-58.503112587363709 -34.636585051047668,-58.503201980131003 -34.636609810926537,-58.503554069417049 -34.636649413086182,-58.503561036045937 -34.636608141815962,-58.503644031103619 -34.63661776218062,-58.503636978167478 -34.636656709465868,-58.50367250978109 -34.636658387729845,-58.503772373239698 -34.636663143027526,-58.503957110399035 -34.636685616613299,-58.504289177284399 -34.636725786819902,-58.504552138108423 -34.636757106330251,-58.50462132792314 -34.636762434852997,-58.504805299033592 -34.636785611664827,-58.504897240847157 -34.636794875963254,-58.504992591165809 -34.636804631984077,-58.505368287221586 -34.636850206824384,-58.505491445992902 -34.636754808491681,-58.505606311224163 -34.636769909469351,-58.505671514295521 -34.636718460367433,-58.505735515827936 -34.636667959255178,-58.505869574828864 -34.636562133820036,-58.506443367382978 -34.636109238704123,-58.506819391014595 -34.635812403524604,-58.506551646358403 -34.635591647861808,-58.506217840914523 -34.635315772557213,-58.505859822802726 -34.635007227777848,-58.505457300072457 -34.634638413887885,-58.50419764790847 -34.634464899643909,-58.502990152306779 -34.634305651406663,-58.502843508249761 -34.634286685055322)));;345;10_15_5;COMUNA 10;15;5;820;425;395;107,59%;357;357;100,00%;0;0,00%;298;0;0,00%;298;100,00%
MULTIPOLYGON (((-58.503418829653071 -34.638006755445993,-58.503939228591683 -34.638085808480064,-58.50470408480421 -34.637482147836259,-58.505037619943231 -34.637218855042192,-58.50544210086462 -34.636899548765335,-58.505606311224163 -34.636769909469351,-58.505491445992902 -34.636754808491681,-58.505368287221586 -34.636850206824384,-58.504992591165809 -34.636804631984077,-58.504897240847157 -34.636794875963254,-58.504805299033592 -34.636785611664827,-58.50462132792314 -34.636762434852997,-58.504552138108423 -34.636757106330251,-58.504289177284399 -34.636725786819902,-58.503957110399035 -34.636685616613299,-58.503772373239698 -34.636663143027526,-58.50367250978109 -34.636658387729845,-58.503636978167478 -34.636656709465868,-58.503644031103619 -34.63661776218062,-58.503561036045937 -34.636608141815962,-58.503554069417049 -34.636649413086182,-58.503201980131003 -34.636609810926537,-58.503112587363709 -34.636585051047668,-58.502808213084244 -34.636544164284501,-58.502621602024035 -34.636521689571119,-58.502391789667861 -34.636494651026645,-58.502306319262637 -34.636475241565073,-58.502211560027213 -34.636452736361548,-58.50187600110673 -34.636411082696434,-58.501745543950626 -34.636394926824678,-58.501271349975312 -34.636339653386145,-58.501254215935816 -34.636322897698768,-58.501213150265713 -34.636330094003831,-58.50117906769016 -34.636329189238978,-58.501103323681093 -34.636706690084047,-58.500920985953442 -34.637641143616236,-58.502048772987919 -34.637801846474332,-58.502397292874747 -34.637851523860888,-58.503418829653071 -34.638006755445993)));;346;10_15_6;COMUNA 10;15;6;613;273;340;80,29%;324;323;99,69%;1;0,31%;248;10;4,03%;238;95,97%
MULTIPOLYGON (((-58.49945849129292 -34.637433840020471,-58.499681405157766 -34.637464477844013,-58.500920985953442 -34.637641143616236,-58.501103323681093 -34.636706690084047,-58.50117906769016 -34.636329189238978,-58.501098632836822 -34.636327101844977,-58.500610638943421 -34.636277393740706,-58.500621096858509 -34.636228304396056,-58.500482373372208 -34.636207853828857,-58.499810998986895 -34.636113409012964,-58.499826640084301 -34.636031148070352,-58.499740321235798 -34.636017441476973,-58.499640028881181 -34.636003950329901,-58.49963280396441 -34.636043460838764,-58.49908226038594 -34.635966933686596,-58.498252042541381 -34.636013588469723,-58.498188529492239 -34.63633087074939,-58.498007424911492 -34.637234473572519,-58.49945849129292 -34.637433840020471)));;347;10_15_7;COMUNA 10;15;7;526;254;272;93,38%;285;285;100,00%;0;0,00%;225;15;6,67%;210;93,33%
MULTIPOLYGON (((-58.49331978480302 -34.636963548666401,-58.492270848303519 -34.637782707080767,-58.493380893188728 -34.637931592602612,-58.493618888854307 -34.637965054701397,-58.494213152647802 -34.638043567093042,-58.494842610477647 -34.638128123849604,-58.49631157574558 -34.638320832633539,-58.496556621020865 -34.637034948929049,-58.496740166023912 -34.637061940963669,-58.497818426362656 -34.637208541388496,-58.498007424911492 -34.637234473572519,-58.498188529492239 -34.63633087074939,-58.498252042541381 -34.636013588469723,-58.498174422739652 -34.636018329533407,-58.498207752177223 -34.635851835570364,-58.498292350519186 -34.635429191572413,-58.497961398530578 -34.635387103234635,-58.497949155252044 -34.63544893976718,-58.497772856147172 -34.635422792558266,-58.497759932806034 -34.635488713906675,-58.496955237905013 -34.635432109737359,-58.496927435291283 -34.635576347576325,-58.496848702070658 -34.635566228471909,-58.495559062960886 -34.635395661694218,-58.495396908729994 -34.635369718513239,-58.494760112688759 -34.63586912911601,-58.494566074066242 -34.636021297571119,-58.493799206165342 -34.636646727005413,-58.4936613337183 -34.636620916178458,-58.493116233633501 -34.636513373804036,-58.49331978480302 -34.636963548666401)));;348;10_15_8;COMUNA 10;15;8;1073;517;556;92,99%;384;383;99,74%;1;0,26%;375;27;7,20%;348;92,80%
MULTIPOLYGON (((-58.498007424911492 -34.637234473572519,-58.497818426362656 -34.637208541388496,-58.496740166023912 -34.637061940963669,-58.496556621020865 -34.637034948929049,-58.49631157574558 -34.638320832633539,-58.497789580691489 -34.638515633859335,-58.497803072592042 -34.638382456705017,-58.498007424911492 -34.637234473572519)));;349;10_15_9;COMUNA 10;15;9;1223;566;657;86,15%;544;544;100,00%;0;0,00%;459;31;6,75%;428;93,25%
MULTIPOLYGON (((-58.50895833087359 -34.637883508700078,-58.509135331527546 -34.637180447655822,-58.50905580953912 -34.637169108379901,-58.508798812588189 -34.637134999383932,-58.508555290777096 -34.637101680278334,-58.508306956843448 -34.637068362485763,-58.508073060485664 -34.637035834314865,-58.507831464178224 -34.63700251304688,-58.50777020793975 -34.63699438897514,-58.507580243441303 -34.636969194842059,-58.50734538560851 -34.636937461126493,-58.507103790723683 -34.636905729411446,-58.50685353302903 -34.63687240935834,-58.506594612130158 -34.636836705416137,-58.506370342941807 -34.636806557006381,-58.506354276905654 -34.636805005990411,-58.506230779124301 -34.636793083435542,-58.505977634735736 -34.636759762614552,-58.50578127894665 -34.636732785204472,-58.505671514295521 -34.636718460367433,-58.505606311224163 -34.636769909469351,-58.50544210086462 -34.636899548765335,-58.505037619943231 -34.637218855042192,-58.50470408480421 -34.637482147836259,-58.503939228591683 -34.638085808480064,-58.504515017508091 -34.638173361713385,-58.504635168965763 -34.638191630904416,-58.505933156964865 -34.638404494372971,-58.507349775062579 -34.638644062061559,-58.508700449492281 -34.638882159252738,-58.50895833087359 -34.637883508700078)));;350;10_16_1;COMUNA 10;16;1;671;308;363;84,85%;303;302;99,67%;1;0,33%;270;27;10,00%;243;90,00%
MULTIPOLYGON (((-58.510052663372029 -34.639116719636547,-58.510315556649914 -34.638118346012206,-58.51049356496263 -34.637369858269018,-58.510244548070659 -34.637334909803485,-58.509997175236322 -34.63730159507967,-58.509762314652619 -34.637268275026301,-58.509517828709598 -34.637233367220126,-58.509283931863273 -34.637201636870635,-58.509135331527546 -34.637180447655822,-58.50895833087359 -34.637883508700078,-58.508700449492281 -34.638882159252738,-58.507349775062579 -34.638644062061559,-58.505933156964865 -34.638404494372971,-58.505706361642275 -34.639282278588688,-58.505692670383993 -34.639335172421475,-58.505693931087109 -34.639336063644123,-58.505937829113513 -34.639434793391388,-58.506044237981676 -34.639472982627936,-58.506995327452529 -34.639636969377079,-58.508137554096415 -34.639840120238567,-58.508236745092155 -34.639848622512446,-58.508332171550066 -34.639832581856226,-58.508441168675418 -34.639819537885877,-58.508441335375224 -34.639819540013839,-58.508441655292245 -34.639819710035454,-58.508750295310854 -34.639946631279365,-58.509725181322359 -34.64012596286851,-58.509788549740229 -34.640077697454849,-58.509822253348069 -34.640008316043975,-58.510052663372029 -34.639116719636547)));;351;10_16_2;COMUNA 10;16;2;1077;492;585;84,10%;482;482;100,00%;0;0,00%;408;15;3,68%;393;96,32%
MULTIPOLYGON (((-58.505933156964865 -34.638404494372971,-58.504635168965763 -34.638191630904416,-58.504515017508091 -34.638173361713385,-58.503939228591683 -34.638085808480064,-58.503019170125022 -34.638808181436382,-58.504292459134376 -34.639032831443608,-58.505706361642275 -34.639282278588688,-58.505933156964865 -34.638404494372971)));;352;10_16_3;COMUNA 10;16;3;778;361;417;86,57%;331;330;99,70%;1;0,30%;282;12;4,26%;270;95,74%
MULTIPOLYGON (((-58.505692670383993 -34.639335172421475,-58.505706361642275 -34.639282278588688,-58.504292459134376 -34.639032831443608,-58.503019170125022 -34.638808181436382,-58.502594312119832 -34.639140514835667,-58.501819286828187 -34.639746911923538,-58.502471583622672 -34.640330029294482,-58.502585303296492 -34.640434925053263,-58.503204884723516 -34.641006922016054,-58.50335671070237 -34.64114349552051,-58.503484724621124 -34.641026688533962,-58.504326101989825 -34.640368355311054,-58.504534790416947 -34.64021919467946,-58.504730019910234 -34.640079686519371,-58.505692670383993 -34.639335172421475)));;353;10_16_4;COMUNA 10;16;4;873;403;470;85,74%;413;413;100,00%;0;0,00%;344;2;0,58%;342;99,42%
MULTIPOLYGON (((-58.506995327452529 -34.639636969377079,-58.506044237981676 -34.639472982627936,-58.505937829113513 -34.639434793391388,-58.505693931087109 -34.639336063644123,-58.505692670383993 -34.639335172421475,-58.504730019910234 -34.640079686519371,-58.504534790416947 -34.64021919467946,-58.504671278505697 -34.64035394078131,-58.505323261722467 -34.640942043098221,-58.50608599488514 -34.641630035237547,-58.506847461877847 -34.642316896186486,-58.506965602736848 -34.642227484367481,-58.508031752343584 -34.641415658821209,-58.509210650901068 -34.64051786270236,-58.509725181322359 -34.64012596286851,-58.508750295310854 -34.639946631279365,-58.508441655292245 -34.639819710035454,-58.508441335375224 -34.639819540013839,-58.508441168675418 -34.639819537885877,-58.508332171550066 -34.639832581856226,-58.508236745092155 -34.639848622512446,-58.508137554096415 -34.639840120238567,-58.506995327452529 -34.639636969377079)));;354;10_16_5;COMUNA 10;16;5;1051;460;591;77,83%;500;499;99,80%;1;0,20%;389;5;1,29%;384;98,71%
MULTIPOLYGON (((-58.50335671070237 -34.64114349552051,-58.503229718504308 -34.641259386509262,-58.502220765835574 -34.642028615046314,-58.502941996277009 -34.64273966906314,-58.503704469585543 -34.643425563239255,-58.504470706533866 -34.644114831663799,-58.505659821047033 -34.643215306119195,-58.506847461877847 -34.642316896186486,-58.50608599488514 -34.641630035237547,-58.505323261722467 -34.640942043098221,-58.504671278505697 -34.64035394078131,-58.504534790416947 -34.64021919467946,-58.504326101989825 -34.640368355311054,-58.503484724621124 -34.641026688533962,-58.50335671070237 -34.64114349552051)));;355;10_16_6;COMUNA 10;16;6;1006;488;518;94,21%;429;428;99,77%;1;0,23%;356;4;1,12%;352;98,88%
MULTIPOLYGON (((-58.50335671070237 -34.64114349552051,-58.503204884723516 -34.641006922016054,-58.502585303296492 -34.640434925053263,-58.502471583622672 -34.640330029294482,-58.501819286828187 -34.639746911923538,-58.501661878398188 -34.639870064810005,-58.501188117067521 -34.640240649517537,-58.500658388700188 -34.640655124421741,-58.500290582571374 -34.640942923484701,-58.499819620011706 -34.641311318784965,-58.499488861928867 -34.641570018697251,-58.499872038357644 -34.641915335896606,-58.500255644211187 -34.64226107428761,-58.500890902520347 -34.642833641404891,-58.501015960825306 -34.642947197274381,-58.502220765835574 -34.642028615046314,-58.503229718504308 -34.641259386509262,-58.50335671070237 -34.64114349552051)));;356;10_16_7;COMUNA 10;16;7;782;374;408;91,67%;348;347;99,71%;1;0,29%;289;0;0,00%;289;100,00%
MULTIPOLYGON (((-58.503843599922462 -34.644588791917059,-58.504349323406451 -34.644206636588024,-58.504470706533866 -34.644114831663799,-58.503704469585543 -34.643425563239255,-58.502941996277009 -34.64273966906314,-58.502220765835574 -34.642028615046314,-58.501015960825306 -34.642947197274381,-58.50145447747412 -34.643345451416153,-58.50164577571541 -34.643519198703729,-58.501768020619608 -34.643625430515442,-58.501271673482286 -34.644031798318373,-58.500782221266 -34.644432598370194,-58.500248980461656 -34.644869256101849,-58.501275181546241 -34.64535071124557,-58.502299513093412 -34.645818143803389,-58.502835730906774 -34.645379786002522,-58.503327309116138 -34.64497890663975,-58.503843599922462 -34.644588791917059)));;357;10_16_8;COMUNA 10;16;8;853;401;452;88,72%;370;370;100,00%;0;0,00%;312;1;0,32%;311;99,68%
MULTIPOLYGON (((-58.498473320497425 -34.642364500674738,-58.497137635111649 -34.643409424840989,-58.498186130520487 -34.64390132266734,-58.499221768455293 -34.644387299610379,-58.499663267006007 -34.64459442653208,-58.500248980461656 -34.644869256101849,-58.500782221266 -34.644432598370194,-58.501271673482286 -34.644031798318373,-58.501768020619608 -34.643625430515442,-58.50164577571541 -34.643519198703729,-58.50145447747412 -34.643345451416153,-58.501015960825306 -34.642947197274381,-58.500890902520347 -34.642833641404891,-58.500255644211187 -34.64226107428761,-58.499872038357644 -34.641915335896606,-58.499488861928867 -34.641570018697251,-58.498540614992436 -34.642311873634434,-58.498473320497425 -34.642364500674738)));;358;10_16_9;COMUNA 10;16;9;953;442;511;86,50%;400;400;100,00%;0;0,00%;338;13;3,85%;325;96,15%
MULTIPOLYGON (((-58.503418829653071 -34.638006755445993,-58.502397292874747 -34.637851523860888,-58.502048772987919 -34.637801846474332,-58.501819550317549 -34.63903780478239,-58.500681270870295 -34.638886892155533,-58.500443255820279 -34.640139259373356,-58.500290582571374 -34.640942923484701,-58.500658388700188 -34.640655124421741,-58.501188117067521 -34.640240649517537,-58.501661878398188 -34.639870064810005,-58.501819286828187 -34.639746911923538,-58.502594312119832 -34.639140514835667,-58.503019170125022 -34.638808181436382,-58.503939228591683 -34.638085808480064,-58.503418829653071 -34.638006755445993)));;359;10_17_1;COMUNA 10;17;1;748;336;412;81,55%;391;391;100,00%;0;0,00%;313;0;0,00%;313;100,00%
MULTIPOLYGON (((-58.490954664079837 -34.642575354167633,-58.490647385184985 -34.64255986110409,-58.490586052660902 -34.642619454474399,-58.490878887966666 -34.642759743668599,-58.491636122425383 -34.643122676290005,-58.492331744145083 -34.643455970360968,-58.493665134119027 -34.644094884327671,-58.494840784298859 -34.644658259598401,-58.49496401506417 -34.644687805438508,-58.495082056954722 -34.644740733537191,-58.49530220667296 -34.644847931720662,-58.495398467973146 -34.644769875365199,-58.496419860704663 -34.643970840063474,-58.496676952160541 -34.643769776542833,-58.497137635111649 -34.643409424840989,-58.49675936736373 -34.643387769830092,-58.495374494824325 -34.643177860490667,-58.493890521846581 -34.642952889908187,-58.492603427077832 -34.64281320792395,-58.492421489915856 -34.642786631848935,-58.490954664079837 -34.642575354167633)));;360;10_17_10;COMUNA 10;17;10;741;346;395;87,59%;326;326;100,00%;0;0,00%;269;6;2,23%;263;97,77%
MULTIPOLYGON (((-58.502048772987919 -34.637801846474332,-58.500920985953442 -34.637641143616236,-58.499681405157766 -34.637464477844013,-58.49945849129292 -34.637433840020471,-58.499224814133171 -34.638701133910502,-58.498989839995531 -34.639941454790943,-58.500443255820279 -34.640139259373356,-58.500681270870295 -34.638886892155533,-58.501819550317549 -34.63903780478239,-58.502048772987919 -34.637801846474332)));;361;10_17_2;COMUNA 10;17;2;844;405;439;92,26%;456;456;100,00%;0;0,00%;372;7;1,88%;365;98,12%
MULTIPOLYGON (((-58.49945849129292 -34.637433840020471,-58.498007424911492 -34.637234473572519,-58.497803072592042 -34.638382456705017,-58.497789580691489 -34.638515633859335,-58.497774815968455 -34.638661487836494,-58.497542907285549 -34.639744476124243,-58.497281056729136 -34.640967335844742,-58.498757494179877 -34.641167407541396,-58.499819620011706 -34.641311318784965,-58.500290582571374 -34.640942923484701,-58.500443255820279 -34.640139259373356,-58.498989839995531 -34.639941454790943,-58.499224814133171 -34.638701133910502,-58.49945849129292 -34.637433840020471)));;362;10_17_3;COMUNA 10;17;3;944;437;507;86,19%;436;436;100,00%;0;0,00%;360;4;1,11%;356;98,89%
MULTIPOLYGON (((-58.497789580691489 -34.638515633859335,-58.49631157574558 -34.638320832633539,-58.496289041746529 -34.638434856573419,-58.496065389824317 -34.639543333591874,-58.497542907285549 -34.639744476124243,-58.497774815968455 -34.638661487836494,-58.497789580691489 -34.638515633859335)));;363;10_17_4;COMUNA 10;17;4;1083;519;564;92,02%;445;445;100,00%;0;0,00%;378;0;0,00%;378;100,00%
MULTIPOLYGON (((-58.49631157574558 -34.638320832633539,-58.494842610477647 -34.638128123849604,-58.494213152647802 -34.638043567093042,-58.493618888854307 -34.637965054701397,-58.493380893188728 -34.637931592602612,-58.493139263409041 -34.639145213076034,-58.493066404670536 -34.639597217459389,-58.492690119542246 -34.640061339393071,-58.492525386609714 -34.640233638774127,-58.49243236076169 -34.640297536752357,-58.492491839927666 -34.640305832359736,-58.492892001396811 -34.640355031288031,-58.494363050516611 -34.640558397084327,-58.495821413606535 -34.640769495297569,-58.497281056729136 -34.640967335844742,-58.497542907285549 -34.639744476124243,-58.496065389824317 -34.639543333591874,-58.496289041746529 -34.638434856573419,-58.49631157574558 -34.638320832633539)));;364;10_17_5;COMUNA 10;17;5;1061;497;564;88,12%;368;368;100,00%;0;0,00%;367;29;7,90%;338;92,10%
MULTIPOLYGON (((-58.491435703108408 -34.640158757166148,-58.49243236076169 -34.640297536752357,-58.492525386609714 -34.640233638774127,-58.492690119542246 -34.640061339393071,-58.493066404670536 -34.639597217459389,-58.493139263409041 -34.639145213076034,-58.493380893188728 -34.637931592602612,-58.492270848303519 -34.637782707080767,-58.491823634237178 -34.638131910395934,-58.490911476302095 -34.638844189834458,-58.490387242529934 -34.639253618802989,-58.490059275626209 -34.639513630672084,-58.489566725161787 -34.639904245544962,-58.488738102079431 -34.640561347509454,-58.488231056872046 -34.640962946280126,-58.489731844916726 -34.641169812501893,-58.491032045254116 -34.641348748382782,-58.491214915450549 -34.641373284001787,-58.491435703108408 -34.640158757166148)));;365;10_17_6;COMUNA 10;17;6;872;405;467;86,72%;372;372;100,00%;0;0,00%;308;10;3,25%;298;96,75%
MULTIPOLYGON (((-58.490647385184985 -34.64255986110409,-58.490954664079837 -34.642575354167633,-58.492421489915856 -34.642786631848935,-58.492603427077832 -34.64281320792395,-58.493890521846581 -34.642952889908187,-58.494125939015412 -34.641759763907942,-58.49427307141157 -34.641014279887557,-58.494363050516611 -34.640558397084327,-58.492892001396811 -34.640355031288031,-58.492491839927666 -34.640305832359736,-58.49243236076169 -34.640297536752357,-58.491435703108408 -34.640158757166148,-58.491214915450549 -34.641373284001787,-58.491032045254116 -34.641348748382782,-58.489731844916726 -34.641169812501893,-58.488231056872046 -34.640962946280126,-58.487805619012541 -34.641299946644139,-58.488044498279223 -34.641412647268389,-58.488711540242242 -34.641728502687357,-58.489544007507575 -34.642122630458374,-58.489623521843043 -34.642160290169308,-58.489993566976871 -34.642335495103836,-58.490176289401873 -34.642423062453886,-58.490586052660902 -34.642619454474399,-58.490647385184985 -34.64255986110409)));;366;10_17_7;COMUNA 10;17;7;875;410;465;88,17%;345;345;100,00%;0;0,00%;289;21;7,27%;268;92,73%
MULTIPOLYGON (((-58.495374494824325 -34.643177860490667,-58.49675936736373 -34.643387769830092,-58.497022767947641 -34.642167305715844,-58.49576583247913 -34.641996450433176,-58.495602217579318 -34.641972620695554,-58.495629173198793 -34.641830144156188,-58.49573800513221 -34.641229602864215,-58.495821413606535 -34.640769495297569,-58.494363050516611 -34.640558397084327,-58.49427307141157 -34.641014279887557,-58.494125939015412 -34.641759763907942,-58.493890521846581 -34.642952889908187,-58.495374494824325 -34.643177860490667)));;367;10_17_8;COMUNA 10;17;8;694;319;375;85,07%;286;286;100,00%;0;0,00%;246;4;1,63%;242;98,37%
MULTIPOLYGON (((-58.499819620011706 -34.641311318784965,-58.498757494179877 -34.641167407541396,-58.497281056729136 -34.640967335844742,-58.495821413606535 -34.640769495297569,-58.49573800513221 -34.641229602864215,-58.495629173198793 -34.641830144156188,-58.495602217579318 -34.641972620695554,-58.49576583247913 -34.641996450433176,-58.497022767947641 -34.642167305715844,-58.49675936736373 -34.643387769830092,-58.497137635111649 -34.643409424840989,-58.498473320497425 -34.642364500674738,-58.498540614992436 -34.642311873634434,-58.499488861928867 -34.641570018697251,-58.499819620011706 -34.641311318784965)));;368;10_17_9;COMUNA 10;17;9;638;306;332;92,17%;258;258;100,00%;0;0,00%;239;2;0,84%;237;99,16%
MULTIPOLYGON (((-58.492270848303519 -34.637782707080767,-58.491902467335628 -34.637692511253142,-58.49171192669818 -34.637640090253285,-58.490961784867316 -34.637442795251751,-58.490682367942441 -34.637369265763233,-58.489118963218822 -34.636985165439576,-58.488853491498716 -34.638167725454863,-58.488818182848966 -34.63833478062601,-58.488715403951637 -34.638820592776547,-58.488691746772318 -34.638918769969536,-58.488637624489208 -34.639143718246167,-58.488610393040467 -34.63925689665637,-58.488525984080944 -34.639636785809202,-58.489566725161787 -34.639904245544962,-58.490059275626209 -34.639513630672084,-58.490387242529934 -34.639253618802989,-58.490911476302095 -34.638844189834458,-58.491823634237178 -34.638131910395934,-58.492270848303519 -34.637782707080767)));;369;10_18_1;COMUNA 10;18;1;736;349;387;90,18%;311;311;100,00%;0;0,00%;280;5;1,79%;275;98,21%
MULTIPOLYGON (((-58.479695075880507 -34.636096180105085,-58.479200794059565 -34.636492669264591,-58.478904836089384 -34.636730040561922,-58.478787270269834 -34.636824284521346,-58.47854557344094 -34.636994251224777,-58.480048751990644 -34.637682519542459,-58.480403331910566 -34.637844868173588,-58.48146401219033 -34.638330570254162,-58.481745396626103 -34.638459404004777,-58.482881936125786 -34.638979730825959,-58.48310599116477 -34.638807082396042,-58.483317776543927 -34.638639224510179,-58.483436392333999 -34.638323349219391,-58.482028357606715 -34.637667150975844,-58.4822844058572 -34.636950326481951,-58.48098906492546 -34.636385368498154,-58.480889258436036 -34.636634123861974,-58.479695075880507 -34.636096180105085)));;370;10_18_10;COMUNA 10;18;10;516;239;277;86,28%;212;212;100,00%;0;0,00%;191;14;7,33%;177;92,67%
MULTIPOLYGON (((-58.484023068503298 -34.6380801416746,-58.483317776543927 -34.638639224510179,-58.48310599116477 -34.638807082396042,-58.482881936125786 -34.638979730825959,-58.483900805722172 -34.639456967556697,-58.48460633536515 -34.639790374609248,-58.484879975675689 -34.63991962503448,-58.485319540444507 -34.640127297376125,-58.485516484584508 -34.640220362235198,-58.486065646452005 -34.640479350978083,-58.486129149343213 -34.640253556991432,-58.486487981305075 -34.639112887872081,-58.486303406809675 -34.639065457430306,-58.485221955665445 -34.638791991223229,-58.484023068503298 -34.6380801416746)));;371;10_18_11;COMUNA 10;18;11;663;303;360;84,17%;247;246;99,60%;1;0,41%;224;15;6,70%;209;93,30%
MULTIPOLYGON (((-58.486967799666182 -34.640904822068336,-58.487805619012541 -34.641299946644139,-58.488231056872046 -34.640962946280126,-58.488738102079431 -34.640561347509454,-58.489566725161787 -34.639904245544962,-58.488525984080944 -34.639636785809202,-58.488610393040467 -34.63925689665637,-58.488637624489208 -34.639143718246167,-58.486699019340648 -34.638442191294807,-58.486487981305075 -34.639112887872081,-58.486129149343213 -34.640253556991432,-58.486065646452005 -34.640479350978083,-58.486967799666182 -34.640904822068336)));;372;10_18_12;COMUNA 10;18;12;808;362;446;81,17%;325;325;100,00%;0;0,00%;297;6;2,02%;291;97,98%
MULTIPOLYGON (((-58.489118963218822 -34.636985165439576,-58.488179835379789 -34.636750498520591,-58.48728033635237 -34.636525746278096,-58.486937710155232 -34.637647541142798,-58.486880850509458 -34.637848967349775,-58.486839737751509 -34.637994613970882,-58.486699019340648 -34.638442191294807,-58.488637624489208 -34.639143718246167,-58.488691746772318 -34.638918769969536,-58.488715403951637 -34.638820592776547,-58.488818182848966 -34.63833478062601,-58.488853491498716 -34.638167725454863,-58.489118963218822 -34.636985165439576)));;373;10_18_2;COMUNA 10;18;2;755;352;403;87,34%;292;292;100,00%;0;0,00%;270;3;1,11%;267;98,89%
MULTIPOLYGON (((-58.486290689694542 -34.636282623985757,-58.485885372062647 -34.636603979705264,-58.484937659396394 -34.637355236746266,-58.484023068503298 -34.6380801416746,-58.485221955665445 -34.638791991223229,-58.486303406809675 -34.639065457430306,-58.486487981305075 -34.639112887872081,-58.486699019340648 -34.638442191294807,-58.486839737751509 -34.637994613970882,-58.486880850509458 -34.637848967349775,-58.486937710155232 -34.637647541142798,-58.48728033635237 -34.636525746278096,-58.487314385634512 -34.636414186508844,-58.487336006919691 -34.636343475631037,-58.487648969485164 -34.635215558521338,-58.486290689694542 -34.636282623985757)));;374;10_18_3;COMUNA 10;18;3;780;329;451;72,95%;397;397;100,00%;0;0,00%;337;19;5,64%;318;94,36%
MULTIPOLYGON (((-58.483904886054923 -34.6370754820854,-58.483436392333999 -34.638323349219391,-58.483317776543927 -34.638639224510179,-58.484023068503298 -34.6380801416746,-58.484937659396394 -34.637355236746266,-58.485885372062647 -34.636603979705264,-58.486290689694542 -34.636282623985757,-58.487648969485164 -34.635215558521338,-58.486680300117285 -34.634981519845034,-58.485436154181251 -34.634680832812279,-58.484856476089725 -34.634540794074674,-58.484371407413107 -34.635832895110887,-58.483904886054923 -34.6370754820854)));;375;10_18_4;COMUNA 10;18;4;1114;491;623;78,81%;466;465;99,79%;1;0,22%;396;43;10,86%;353;89,14%
MULTIPOLYGON (((-58.486680300117285 -34.634981519845034,-58.487648969485164 -34.635215558521338,-58.488317144908081 -34.634673078399153,-58.488425242418707 -34.634588897971561,-58.488513577227174 -34.634520003820377,-58.488596119301114 -34.634455125050124,-58.488714524362088 -34.63436615328547,-58.488909849180558 -34.634218148885651,-58.488432098408637 -34.634165643260879,-58.488207490238104 -34.634124562334989,-58.48732064350164 -34.63394713313329,-58.487168120345295 -34.633913571177189,-58.486398008122137 -34.633744210642682,-58.485923737113573 -34.633627678327478,-58.485853487190916 -34.633779738922186,-58.48580673886552 -34.633880737012184,-58.485775573252326 -34.633948069061312,-58.484659001300209 -34.633673618310517,-58.484537322555141 -34.633638075609952,-58.484186223041675 -34.63437879601905,-58.484856476089725 -34.634540794074674,-58.485436154181251 -34.634680832812279,-58.486680300117285 -34.634981519845034)));;376;10_18_5;COMUNA 10;18;5;779;337;442;76,24%;352;349;99,15%;3;0,86%;277;6;2,17%;271;97,83%
MULTIPOLYGON (((-58.483320135563595 -34.633278988759407,-58.483107899064358 -34.633382216692091,-58.482380319030881 -34.633942396354868,-58.48293885718688 -34.634077309372728,-58.483276707637451 -34.634159016082272,-58.484186223041675 -34.63437879601905,-58.484537322555141 -34.633638075609952,-58.483465991701493 -34.633325153846172,-58.483320369586686 -34.633279331975451,-58.483320135563595 -34.633278988759407)));;377;10_18_6;COMUNA 10;18;6;606;259;347;74,64%;362;362;100,00%;0;0,00%;280;23;8,21%;257;91,79%
MULTIPOLYGON (((-58.484186223041675 -34.63437879601905,-58.483276707637451 -34.634159016082272,-58.482848684142191 -34.635370253811168,-58.482813859082214 -34.635467797941843,-58.484371407413107 -34.635832895110887,-58.484856476089725 -34.634540794074674,-58.484186223041675 -34.63437879601905)));;378;10_18_7;COMUNA 10;18;7;785;347;438;79,22%;428;428;100,00%;0;0,00%;365;35;9,59%;330;90,41%
MULTIPOLYGON (((-58.4822844058572 -34.636950326481951,-58.482028357606715 -34.637667150975844,-58.483436392333999 -34.638323349219391,-58.483904886054923 -34.6370754820854,-58.484371407413107 -34.635832895110887,-58.482813859082214 -34.635467797941843,-58.482488934738498 -34.636377669332781,-58.4822844058572 -34.636950326481951)));;379;10_18_8;COMUNA 10;18;8;596;278;318;87,42%;243;239;98,35%;4;1,67%;184;1;0,54%;183;99,46%
MULTIPOLYGON (((-58.48293885718688 -34.634077309372728,-58.482380319030881 -34.633942396354868,-58.481006663399199 -34.635044195551508,-58.47992713626153 -34.635910085177166,-58.479695075880507 -34.636096180105085,-58.480889258436036 -34.636634123861974,-58.48098906492546 -34.636385368498154,-58.4822844058572 -34.636950326481951,-58.482488934738498 -34.636377669332781,-58.482813859082214 -34.635467797941843,-58.482848684142191 -34.635370253811168,-58.483276707637451 -34.634159016082272,-58.48293885718688 -34.634077309372728)));;380;10_18_9;COMUNA 10;18;9;1284;575;709;81,10%;469;466;99,36%;3;0,64%;458;15;3,28%;443;96,72%
MULTIPOLYGON (((-58.480795739306082 -34.63248759390337,-58.480769424971555 -34.632547177235118,-58.480368914914408 -34.633456209492572,-58.481709905182214 -34.633780314274411,-58.482380319030881 -34.633942396354868,-58.483107899064358 -34.633382216692091,-58.483320135563595 -34.633278988759407,-58.483062016426622 -34.633198105102664,-58.482117225107231 -34.632900432469853,-58.482013952876329 -34.632867912584103,-58.480795739306082 -34.63248759390337)));;381;10_19_1;COMUNA 10;19;1;563;247;316;78,16%;310;310;100,00%;0;0,00%;265;46;17,36%;219;82,64%
MULTIPOLYGON (((-58.473995339046922 -34.633413866261428,-58.472874298755755 -34.633151209809135,-58.472280251249735 -34.634475808395472,-58.473352501783111 -34.634864041997865,-58.474336997434449 -34.635220442530148,-58.474399710967226 -34.635243183749893,-58.475399476975852 -34.635663660806365,-58.475726887221604 -34.634917263955501,-58.476163567072945 -34.633921902306739,-58.475045324900201 -34.633659899346924,-58.473995339046922 -34.633413866261428)));;382;10_19_10;COMUNA 10;19;10;1008;440;568;77,46%;480;478;99,58%;2;0,42%;400;85;21,25%;315;78,75%
MULTIPOLYGON (((-58.474336997434449 -34.635220442530148,-58.473352501783111 -34.634864041997865,-58.472280251249735 -34.634475808395472,-58.471755950747252 -34.635644971059662,-58.47283860856475 -34.636030391338323,-58.473889408030928 -34.636404536937746,-58.474745681929548 -34.636709324388839,-58.474914142659443 -34.636769943396494,-58.475923378361536 -34.637132948460504,-58.47688907962506 -34.637480315917045,-58.476290542079212 -34.63876197449369,-58.47677837721762 -34.638375991310888,-58.477591226950111 -34.637732845966966,-58.47835678173336 -34.637127096791957,-58.47854557344094 -34.636994251224777,-58.477351832693891 -34.636489384159752,-58.476392777423918 -34.636083778239346,-58.475399476975852 -34.635663660806365,-58.474399710967226 -34.635243183749893,-58.474336997434449 -34.635220442530148)));;383;10_19_11;COMUNA 10;19;11;919;450;469;95,95%;400;399;99,75%;1;0,25%;344;14;4,07%;330;95,93%
MULTIPOLYGON (((-58.47283860856475 -34.636030391338323,-58.471755950747252 -34.635644971059662,-58.471302936456219 -34.636655177440893,-58.472416954968679 -34.636987498876536,-58.473492297167716 -34.637308334303214,-58.474415423686423 -34.637916930675196,-58.475323133371226 -34.638474463621471,-58.476072352400536 -34.638934680188051,-58.476290542079212 -34.63876197449369,-58.47688907962506 -34.637480315917045,-58.475923378361536 -34.637132948460504,-58.474914142659443 -34.636769943396494,-58.474745681929548 -34.636709324388839,-58.473889408030928 -34.636404536937746,-58.47283860856475 -34.636030391338323)));;384;10_19_12;COMUNA 10;19;12;1137;517;620;83,39%;510;510;100,00%;0;0,00%;429;6;1,40%;423;98,60%
MULTIPOLYGON (((-58.478342733094721 -34.631736077323787,-58.477288658180569 -34.631410352079342,-58.476748770416073 -34.632581158419725,-58.477844425500862 -34.632846036035126,-58.478930629661043 -34.633108581033653,-58.480368914914408 -34.633456209492572,-58.480769424971555 -34.632547177235118,-58.479381150040041 -34.632115670603696,-58.479406274139265 -34.632064679563562,-58.478342733094721 -34.631736077323787)));;385;10_19_2;COMUNA 10;19;2;1094;518;576;89,93%;474;474;100,00%;0;0,00%;436;98;22,48%;338;77,52%
MULTIPOLYGON (((-58.476378441676317 -34.630763605066377,-58.475348840858523 -34.630450395885823,-58.475208766660209 -34.630407732851879,-58.474253725974876 -34.630110352338484,-58.474103650134403 -34.630438264728532,-58.473483829423579 -34.631791816790667,-58.474604513728664 -34.632062777869706,-58.475654911586354 -34.632316693308056,-58.476748770416073 -34.632581158419725,-58.477288658180569 -34.631410352079342,-58.478342733094721 -34.631736077323787,-58.479406274139265 -34.632064679563562,-58.479445449350926 -34.631978755856537,-58.479475852677766 -34.631912129755818,-58.47955037039641 -34.631748663367844,-58.478494841840138 -34.631421047277854,-58.477595161107672 -34.631141784991598,-58.477433101603282 -34.631091310038855,-58.476493296662802 -34.630798522872254,-58.476378441676317 -34.630763605066377)));;386;10_19_3;COMUNA 10;19;3;1100;491;609;80,62%;364;361;99,18%;3;0,83%;355;65;18,31%;290;81,69%
MULTIPOLYGON (((-58.476748770416073 -34.632581158419725,-58.475654911586354 -34.632316693308056,-58.474604513728664 -34.632062777869706,-58.473483829423579 -34.631791816790667,-58.472874298755755 -34.633151209809135,-58.473995339046922 -34.633413866261428,-58.475045324900201 -34.633659899346924,-58.476163567072945 -34.633921902306739,-58.476748770416073 -34.632581158419725)));;387;10_19_4;COMUNA 10;19;4;788;361;427;84,54%;416;416;100,00%;0;0,00%;340;36;10,59%;304;89,41%
MULTIPOLYGON (((-58.478930629661043 -34.633108581033653,-58.477844425500862 -34.632846036035126,-58.476748770416073 -34.632581158419725,-58.476163567072945 -34.633921902306739,-58.477086863440718 -34.634138142006769,-58.477246711017735 -34.6341750960881,-58.478316994698233 -34.634422295775302,-58.478930629661043 -34.633108581033653)));;388;10_19_5;COMUNA 10;19;5;822;381;441;86,39%;420;420;100,00%;0;0,00%;348;24;6,90%;324;93,10%
MULTIPOLYGON (((-58.480368914914408 -34.633456209492572,-58.478930629661043 -34.633108581033653,-58.478316994698233 -34.634422295775302,-58.477851368755587 -34.635419429269255,-58.479335018973515 -34.63577009240651,-58.479786823818721 -34.634761828121611,-58.480368914914408 -34.633456209492572)));;389;10_19_6;COMUNA 10;19;6;858;416;442;94,12%;350;350;100,00%;0;0,00%;347;33;9,51%;314;90,49%
MULTIPOLYGON (((-58.481709905182214 -34.633780314274411,-58.480368914914408 -34.633456209492572,-58.479786823818721 -34.634761828121611,-58.480806849650165 -34.634997392867312,-58.481006663399199 -34.635044195551508,-58.482380319030881 -34.633942396354868,-58.481709905182214 -34.633780314274411)));;390;10_19_7;COMUNA 10;19;7;775;324;451;71,84%;419;419;100,00%;0;0,00%;328;0;0,00%;328;100,00%
MULTIPOLYGON (((-58.479335018973515 -34.63577009240651,-58.477851368755587 -34.635419429269255,-58.477351832693891 -34.636489384159752,-58.47854557344094 -34.636994251224777,-58.478787270269834 -34.636824284521346,-58.478904836089384 -34.636730040561922,-58.479200794059565 -34.636492669264591,-58.479695075880507 -34.636096180105085,-58.47992713626153 -34.635910085177166,-58.481006663399199 -34.635044195551508,-58.480806849650165 -34.634997392867312,-58.479786823818721 -34.634761828121611,-58.479335018973515 -34.63577009240651)));;391;10_19_8;COMUNA 10;19;8;512;230;282;81,56%;260;260;100,00%;0;0,00%;215;9;4,19%;206;95,81%
MULTIPOLYGON (((-58.475726887221604 -34.634917263955501,-58.475399476975852 -34.635663660806365,-58.476392777423918 -34.636083778239346,-58.477351832693891 -34.636489384159752,-58.477851368755587 -34.635419429269255,-58.478316994698233 -34.634422295775302,-58.477246711017735 -34.6341750960881,-58.477086863440718 -34.634138142006769,-58.476163567072945 -34.633921902306739,-58.475726887221604 -34.634917263955501)));;392;10_19_9;COMUNA 10;19;9;729;354;375;94,40%;327;325;99,39%;2;0,62%;276;25;9,06%;251;90,94%
MULTIPOLYGON (((-58.528725607807239 -34.614684822738674,-58.527365964410585 -34.615740166035216,-58.527850104964379 -34.616115837289129,-58.528304161155368 -34.61646814166825,-58.528779871614454 -34.616837264188334,-58.529286272124899 -34.617230101313019,-58.529700959931574 -34.61755192787146,-58.530121958610984 -34.617878538414487,-58.530371646808888 -34.61788036350675,-58.53034390716013 -34.618134072558426,-58.531199055635668 -34.619023335065634,-58.531248298951539 -34.618194471138686,-58.531518752862922 -34.615493660087026,-58.530488773181794 -34.613300158944789,-58.530221119226304 -34.61351410107126,-58.529692345661338 -34.61393675729709,-58.52969157993487 -34.613935114413692,-58.529517064361144 -34.614070567076922,-58.529120954443115 -34.614377977464464,-58.528725607807239 -34.614684822738674)));;393;10_2_1;COMUNA 10;2;1;930;434;496;87,50%;402;402;100,00%;0;0,00%;353;1;0,28%;352;99,72%
MULTIPOLYGON (((-58.527850104964379 -34.616115837289129,-58.527365964410585 -34.615740166035216,-58.526400631563313 -34.616489362439843,-58.526841509676295 -34.616880342462792,-58.527264661103217 -34.617255625468438,-58.527602741767417 -34.617555527077187,-58.527707934731524 -34.617649418039086,-58.528060170928335 -34.617963818367336,-58.528165107980385 -34.618055948439981,-58.528576674931799 -34.618417359305106,-58.528682806581315 -34.618510544654875,-58.528968554566887 -34.61876293382884,-58.530121958610984 -34.617878538414487,-58.529700959931574 -34.61755192787146,-58.529286272124899 -34.617230101313019,-58.528779871614454 -34.616837264188334,-58.528304161155368 -34.61646814166825,-58.527850104964379 -34.616115837289129)));;394;10_2_2;COMUNA 10;2;2;600;273;327;83,49%;291;291;100,00%;0;0,00%;257;0;0,00%;257;100,00%
MULTIPOLYGON (((-58.528968554566887 -34.61876293382884,-58.528682806581315 -34.618510544654875,-58.528576674931799 -34.618417359305106,-58.528165107980385 -34.618055948439981,-58.528060170928335 -34.617963818367336,-58.527707934731524 -34.617649418039086,-58.527602741767417 -34.617555527077187,-58.527264661103217 -34.617255625468438,-58.526841509676295 -34.616880342462792,-58.526400631563313 -34.616489362439843,-58.52524406523353 -34.617386964409015,-58.525345591007451 -34.617479098666749,-58.525672241241317 -34.617766475834429,-58.525994205359581 -34.618049769893325,-58.52609811740983 -34.61814112760063,-58.52654292113818 -34.618531684002271,-58.526987048999793 -34.618924140585847,-58.527304167823075 -34.619209335156725,-58.527413541451217 -34.61930928068162,-58.527503819697699 -34.619391841278066,-58.527798865204872 -34.619660285114627,-58.527930572113704 -34.619558732344842,-58.528968554566887 -34.61876293382884)));;395;10_2_3;COMUNA 10;2;3;702;337;365;92,33%;279;279;100,00%;0;0,00%;245;2;0,82%;243;99,18%
MULTIPOLYGON (((-58.529005662188887 -34.620755236650723,-58.529671732098315 -34.621358555685639,-58.530127144344554 -34.621762684986081,-58.530128142370245 -34.621746208937608,-58.530994847857414 -34.622366168395963,-58.531008893547359 -34.622108333121922,-58.531111740600977 -34.620473782315628,-58.531152761777115 -34.619802538770564,-58.531199055635668 -34.619023335065634,-58.53034390716013 -34.618134072558426,-58.530371646808888 -34.61788036350675,-58.530121958610984 -34.617878538414487,-58.528968554566887 -34.61876293382884,-58.527930572113704 -34.619558732344842,-58.527798865204872 -34.619660285114627,-58.52804105799482 -34.619880656277566,-58.528535677379317 -34.620330617285141,-58.528661591337183 -34.620444074339979,-58.528766022606774 -34.62053817602893,-58.529005662188887 -34.620755236650723)));;396;10_2_4;COMUNA 10;2;4;875;433;442;97,96%;338;338;100,00%;0;0,00%;303;1;0,33%;302;99,67%
MULTIPOLYGON (((-58.528683690957791 -34.623933267166642,-58.529550641908919 -34.624714230240656,-58.529947420757402 -34.625071559520514,-58.529948299684861 -34.625048250548659,-58.530802051842798 -34.625815233626675,-58.530826489309426 -34.625431013529059,-58.530912709583255 -34.623873940498484,-58.530994847857414 -34.622366168395963,-58.530128142370245 -34.621746208937608,-58.530127144344554 -34.621762684986081,-58.529671732098315 -34.621358555685639,-58.529005662188887 -34.620755236650723,-58.528766022606774 -34.62053817602893,-58.528661591337183 -34.620444074339979,-58.52752559288998 -34.621318938985425,-58.526586415914998 -34.622042276346598,-58.527597915031215 -34.622955013291886,-58.527725281098256 -34.623069949414173,-58.528683690957791 -34.623933267166642)));;397;10_2_5;COMUNA 10;2;5;839;390;449;86,86%;350;350;100,00%;0;0,00%;297;12;4,04%;285;95,96%
MULTIPOLYGON (((-58.525824035516997 -34.619781327162883,-58.524870534729601 -34.620485151185129,-58.524322981868252 -34.620889386708811,-58.523905097772634 -34.621197847218717,-58.523777211653822 -34.621292210358888,-58.522765351826422 -34.622039287906937,-58.523191289854822 -34.622252253806387,-58.523355001695712 -34.622334640147173,-58.523944400994218 -34.62263111644571,-58.525079322073189 -34.623202392009205,-58.526166127501355 -34.623777062391866,-58.526381920171069 -34.623888503040511,-58.526905807826815 -34.624159012322316,-58.526502083098997 -34.623796248861794,-58.527597915031215 -34.622955013291886,-58.526586415914998 -34.622042276346598,-58.52752559288998 -34.621318938985425,-58.528661591337183 -34.620444074339979,-58.528535677379317 -34.620330617285141,-58.52804105799482 -34.619880656277566,-58.527798865204872 -34.619660285114627,-58.527503819697699 -34.619391841278066,-58.527413541451217 -34.61930928068162,-58.527304167823075 -34.619209335156725,-58.526987048999793 -34.618924140585847,-58.525954896882695 -34.61968470671367,-58.525824035516997 -34.619781327162883)));;398;10_2_6;COMUNA 10;2;6;1108;526;582;90,38%;458;458;100,00%;0;0,00%;393;1;0,25%;392;99,75%
MULTIPOLYGON (((-58.52584219861631 -34.624304009067984,-58.525283908384722 -34.624731353599458,-58.52584435668934 -34.625016074474466,-58.526347365644895 -34.625271525973034,-58.526844156112752 -34.625523879958379,-58.52785658155242 -34.626038079122161,-58.528360881314875 -34.626294225827273,-58.528864758030274 -34.626550159389581,-58.529376308540975 -34.626809960033434,-58.52981022129498 -34.627035645179028,-58.529810474566872 -34.62703177788034,-58.530676452141407 -34.627434100471802,-58.530736318287936 -34.626848717415534,-58.530802051842798 -34.625815233626675,-58.529948299684861 -34.625048250548659,-58.529947420757402 -34.625071559520514,-58.529550641908919 -34.624714230240656,-58.528683690957791 -34.623933267166642,-58.527725281098256 -34.623069949414173,-58.527597915031215 -34.622955013291886,-58.526502083098997 -34.623796248861794,-58.526905807826815 -34.624159012322316,-58.526381920171069 -34.623888503040511,-58.52584219861631 -34.624304009067984)));;399;10_2_7;COMUNA 10;2;7;973;464;509;91,16%;395;395;100,00%;0;0,00%;340;0;0,00%;340;100,00%
MULTIPOLYGON (((-58.521630861611861 -34.622876278531393,-58.520849032782088 -34.623450757960292,-58.520694742876678 -34.623563440908605,-58.521176637178755 -34.623994000257269,-58.521636713211493 -34.624405060504252,-58.52283207761851 -34.623486206239427,-58.523034313133415 -34.6235888563819,-58.523327653559789 -34.623737800556384,-58.523616478177395 -34.623884492678187,-58.523962574734149 -34.624060240864054,-58.524106263607671 -34.624133199281779,-58.524170011773215 -34.624165562647839,-58.525283908384722 -34.624731353599458,-58.52584219861631 -34.624304009067984,-58.526381920171069 -34.623888503040511,-58.526166127501355 -34.623777062391866,-58.525079322073189 -34.623202392009205,-58.523944400994218 -34.62263111644571,-58.523355001695712 -34.622334640147173,-58.523191289854822 -34.622252253806387,-58.522765351826422 -34.622039287906937,-58.521775271408544 -34.622770148694052,-58.521630861611861 -34.622876278531393)));;400;10_2_8;COMUNA 10;2;8;868;411;457;89,93%;362;362;100,00%;0;0,00%;316;0;0,00%;316;100,00%
MULTIPOLYGON (((-58.525283908384722 -34.624731353599458,-58.524170011773215 -34.624165562647839,-58.523731891715798 -34.625599070896079,-58.523364386145715 -34.626801407586377,-58.524572818907181 -34.62705489368075,-58.525180019633623 -34.627181278579847,-58.525548184034591 -34.625981330615865,-58.52584435668934 -34.625016074474466,-58.525283908384722 -34.624731353599458)));;401;10_3_1;COMUNA 10;3;1;612;282;330;85,45%;278;278;100,00%;0;0,00%;222;3;1,35%;219;98,65%
MULTIPOLYGON (((-58.529376308540975 -34.626809960033434,-58.528864758030274 -34.626550159389581,-58.528360881314875 -34.626294225827273,-58.52785658155242 -34.626038079122161,-58.526844156112752 -34.625523879958379,-58.526347365644895 -34.625271525973034,-58.52584435668934 -34.625016074474466,-58.525548184034591 -34.625981330615865,-58.525180019633623 -34.627181278579847,-58.525727745076878 -34.627294169617038,-58.526273684329816 -34.627408960595162,-58.526820391416507 -34.627523185323945,-58.527367526034894 -34.62763747779757,-58.527913810074111 -34.627751627418974,-58.528454982915491 -34.627864650547842,-58.528490162342756 -34.627748078372377,-58.528541151382662 -34.627584876367997,-58.529107544681402 -34.627701052109259,-58.529064293877695 -34.627844531165572,-58.529021890130203 -34.627982023626608,-58.529747207445816 -34.628133392745347,-58.529746265937916 -34.62814797111033,-58.530660389697523 -34.62831605067317,-58.530640385817769 -34.627786760161861,-58.530676452141407 -34.627434100471802,-58.529810474566872 -34.62703177788034,-58.52981022129498 -34.627035645179028,-58.529376308540975 -34.626809960033434)));;402;10_3_2;COMUNA 10;3;2;836;408;428;95,33%;340;340;100,00%;0;0,00%;290;0;0,00%;290;100,00%
MULTIPOLYGON (((-58.527367526034894 -34.62763747779757,-58.526820391416507 -34.627523185323945,-58.526273684329816 -34.627408960595162,-58.525727745076878 -34.627294169617038,-58.525180019633623 -34.627181278579847,-58.524754634414876 -34.628567427607308,-58.524754560472005 -34.628567598628322,-58.525301784910205 -34.628682674974158,-58.525848925604912 -34.628797678480417,-58.526394789624149 -34.628912398496475,-58.526941933327784 -34.629027397092237,-58.527487203907938 -34.62914204210113,-58.528033328076056 -34.629256825062001,-58.528592060298692 -34.629368077520311,-58.529127199121 -34.629485678506526,-58.529696970132171 -34.628911263248213,-58.529697488727287 -34.628903233437448,-58.530663980549789 -34.62897980829905,-58.530672865035108 -34.628646137024582,-58.530660389697523 -34.62831605067317,-58.529746265937916 -34.62814797111033,-58.529747207445816 -34.628133392745347,-58.529021890130203 -34.627982023626608,-58.529064293877695 -34.627844531165572,-58.529107544681402 -34.627701052109259,-58.528541151382662 -34.627584876367997,-58.528490162342756 -34.627748078372377,-58.528454982915491 -34.627864650547842,-58.527913810074111 -34.627751627418974,-58.527367526034894 -34.62763747779757)));;403;10_3_3;COMUNA 10;3;3;803;371;432;85,88%;345;345;100,00%;0;0,00%;293;1;0,34%;292;99,66%
MULTIPOLYGON (((-58.525848925604912 -34.628797678480417,-58.525301784910205 -34.628682674974158,-58.524754560472005 -34.628567598628322,-58.524730847945598 -34.628644937219363,-58.524370224461691 -34.629820159261094,-58.524327300722611 -34.629957579888618,-58.524877344953822 -34.630072234133621,-58.525424152653159 -34.630186253735729,-58.525969598390795 -34.630299919465642,-58.526517431624441 -34.630414144903263,-58.527061858325105 -34.630528299250038,-58.527612083811718 -34.630647236968699,-58.527733683937974 -34.630673299819463,-58.527936236428623 -34.63071551699781,-58.528808391693111 -34.629814102060756,-58.52900793339731 -34.629607860137689,-58.529127199121 -34.629485678506526,-58.528592060298692 -34.629368077520311,-58.528033328076056 -34.629256825062001,-58.527487203907938 -34.62914204210113,-58.526941933327784 -34.629027397092237,-58.526394789624149 -34.628912398496475,-58.525848925604912 -34.628797678480417)));;404;10_3_4;COMUNA 10;3;4;588;272;316;86,08%;246;246;100,00%;0;0,00%;218;1;0,46%;217;99,54%
MULTIPOLYGON (((-58.527936236428623 -34.63071551699781,-58.52743421719903 -34.631234393148219,-58.527311542030795 -34.631361152513726,-58.527397011839398 -34.631379065546888,-58.527215000424746 -34.632119045460058,-58.527112260576935 -34.633017227789871,-58.528433139494609 -34.633115610823594,-58.529442076670072 -34.633189501952231,-58.529441257454678 -34.633202591934101,-58.530402239912775 -34.63321751562605,-58.530432390750548 -34.632781618768767,-58.530476846305469 -34.632233547948708,-58.530523708192909 -34.631816325099138,-58.530586075101176 -34.631293315441013,-58.53063002771615 -34.630757569063285,-58.5306565101098 -34.630217113891362,-58.530652797905198 -34.629739494479658,-58.530660051817264 -34.629127357398737,-58.530663980549789 -34.62897980829905,-58.529697488727287 -34.628903233437448,-58.529696970132171 -34.628911263248213,-58.529127199121 -34.629485678506526,-58.52900793339731 -34.629607860137689,-58.528808391693111 -34.629814102060756,-58.527936236428623 -34.63071551699781)));;405;10_3_5;COMUNA 10;3;5;806;382;424;90,09%;322;322;100,00%;0;0,00%;283;3;1,06%;280;98,94%
MULTIPOLYGON (((-58.528433139494609 -34.633115610823594,-58.527112260576935 -34.633017227789871,-58.526998511714147 -34.634005559485452,-58.526925894797664 -34.634637730960549,-58.526920732223601 -34.634682946413093,-58.527077047812149 -34.634750260557432,-58.528206666526906 -34.634842338143663,-58.528296767786067 -34.634849730915001,-58.528564441596401 -34.634855506140816,-58.52875328885289 -34.634861394145751,-58.529336451179546 -34.634826469443169,-58.529970467148708 -34.634806345694024,-58.530257200971192 -34.63479787127347,-58.530370036987492 -34.634794536218763,-58.530374493893923 -34.634719671754986,-58.530354629634907 -34.63397057395018,-58.530384557846318 -34.633473146781299,-58.530402239912775 -34.63321751562605,-58.529441257454678 -34.633202591934101,-58.529442076670072 -34.633189501952231,-58.528433139494609 -34.633115610823594)));;406;10_3_6;COMUNA 10;3;6;717;310;407;76,17%;328;327;99,70%;1;0,31%;278;4;1,44%;274;98,56%
MULTIPOLYGON (((-58.525802717242854 -34.63291966968206,-58.525486778388917 -34.633245336331832,-58.524900613146919 -34.633851008535004,-58.524300391179821 -34.634470699505783,-58.525604858131331 -34.634585741679913,-58.526920732223601 -34.634682946413093,-58.526925894797664 -34.634637730960549,-58.526998511714147 -34.634005559485452,-58.527112260576935 -34.633017227789871,-58.527215000424746 -34.632119045460058,-58.527397011839398 -34.631379065546888,-58.527311542030795 -34.631361152513726,-58.52743421719903 -34.631234393148219,-58.527936236428623 -34.63071551699781,-58.527733683937974 -34.630673299819463,-58.527612083811718 -34.630647236968699,-58.527061858325105 -34.630528299250038,-58.526517431624441 -34.630414144903263,-58.525969598390795 -34.630299919465642,-58.525424152653159 -34.630186253735729,-58.524977267398924 -34.631647023972782,-58.525183741521552 -34.631691145183424,-58.526074912564454 -34.631878860604182,-58.526039825054021 -34.632010995851275,-58.525802717242854 -34.63291966968206)));;407;10_3_7;COMUNA 10;3;7;910;432;478;90,38%;428;428;100,00%;0;0,00%;342;9;2,63%;333;97,37%
MULTIPOLYGON (((-58.522286267088546 -34.632565722394887,-58.521591449068268 -34.632928113980576,-58.520748121107943 -34.633219865957948,-58.52081439416169 -34.633401697784429,-58.520788366993173 -34.633486139345884,-58.520788327072147 -34.633486221976597,-58.520769053795391 -34.633548184026722,-58.520732975387858 -34.633671089064123,-58.520706920492437 -34.633762437032729,-58.520686870937055 -34.633822229850772,-58.521016366161433 -34.633822072754676,-58.521082668192967 -34.633823701682523,-58.522168580232645 -34.633965403059392,-58.522344883962155 -34.63399165585664,-58.523037962864215 -34.634161461341087,-58.523274528954659 -34.634219374138191,-58.524231619514111 -34.634453832262565,-58.524300391179821 -34.634470699505783,-58.524900613146919 -34.633851008535004,-58.525486778388917 -34.633245336331832,-58.525802717242854 -34.63291966968206,-58.526039825054021 -34.632010995851275,-58.526074912564454 -34.631878860604182,-58.525183741521552 -34.631691145183424,-58.524977267398924 -34.631647023972782,-58.525424152653159 -34.630186253735729,-58.524877344953822 -34.630072234133621,-58.524327300722611 -34.629957579888618,-58.523873235613564 -34.631411518561812,-58.523709540168177 -34.631376599396347,-58.523599785883022 -34.631354329565021,-58.523507616667501 -34.631495084417026,-58.523428879164669 -34.631595126942486,-58.523215791663098 -34.631828479972214,-58.523139081920093 -34.631905914921589,-58.523031718011296 -34.632008647510389,-58.522991784962365 -34.632044865630178,-58.522856057834296 -34.632160218127467,-58.522794578603687 -34.632210109227465,-58.522719729712023 -34.63226972550499,-58.522670085184231 -34.632308342741396,-58.522621631250864 -34.632343931103996,-58.522544478948021 -34.632399745462649,-58.522475754962983 -34.632446470836456,-58.522375859179995 -34.632509972540021,-58.522286267088546 -34.632565722394887)));;408;10_3_8;COMUNA 10;3;8;1006;466;540;86,30%;434;433;99,77%;1;0,23%;344;8;2,33%;336;97,67%
MULTIPOLYGON (((-58.523034313133415 -34.6235888563819,-58.52283207761851 -34.623486206239427,-58.521636713211493 -34.624405060504252,-58.52061928319462 -34.62518719420725,-58.520095106419113 -34.625590131718958,-58.519537205014295 -34.626018858194747,-58.520168064882085 -34.626130890362276,-58.520945667445183 -34.626293132674903,-58.522155023417909 -34.626547698684142,-58.523364386145715 -34.626801407586377,-58.523731891715798 -34.625599070896079,-58.524170011773215 -34.624165562647839,-58.524106263607671 -34.624133199281779,-58.523962574734149 -34.624060240864054,-58.523616478177395 -34.623884492678187,-58.523327653559789 -34.623737800556384,-58.523034313133415 -34.6235888563819)));;409;10_4_1;COMUNA 10;4;1;1036;472;564;83,69%;427;427;100,00%;0;0,00%;370;2;0,54%;368;99,46%
MULTIPOLYGON (((-58.524149220230235 -34.628437987298163,-58.524220701766787 -34.628394393654006,-58.524287308124407 -34.628375070242072,-58.524384035349527 -34.628369109974813,-58.524478890655189 -34.628376684551434,-58.524608776832032 -34.628420331872569,-58.524686721029383 -34.628463227647728,-58.524754634414876 -34.628567427607308,-58.525180019633623 -34.627181278579847,-58.524572818907181 -34.62705489368075,-58.523364386145715 -34.626801407586377,-58.522155023417909 -34.626547698684142,-58.520945667445183 -34.626293132674903,-58.520168064882085 -34.626130890362276,-58.519537205014295 -34.626018858194747,-58.51897563718402 -34.626451598003534,-58.518469241970848 -34.626841914188688,-58.518580913773697 -34.626939542435331,-58.51882625726428 -34.627162324635755,-58.518657060590805 -34.627293111002686,-58.51929825240304 -34.627426833772091,-58.520519717727929 -34.627681410321777,-58.521730454157989 -34.627933796646118,-58.522940771816778 -34.628186030295431,-58.524149220230235 -34.628437987298163)));;410;10_4_2;COMUNA 10;4;2;1105;519;586;88,57%;477;477;100,00%;0;0,00%;402;3;0,75%;399;99,25%
MULTIPOLYGON (((-58.51882625726428 -34.627162324635755,-58.518580913773697 -34.626939542435331,-58.518469241970848 -34.626841914188688,-58.517955774336549 -34.627237654170962,-58.517413094230228 -34.627655941044836,-58.516961693972853 -34.628003830430856,-58.517484850064555 -34.628464597965021,-58.517435978808599 -34.628513353932846,-58.518885560782529 -34.62881580356769,-58.520094178629506 -34.629067925356978,-58.521118407888864 -34.629281601194506,-58.521303060109886 -34.629321091402815,-58.521475697767059 -34.629358051825434,-58.522513399616543 -34.629577484282628,-58.523723490596034 -34.629833372287749,-58.523881729209549 -34.629866815259881,-58.524182696008985 -34.629927440592809,-58.524327300722611 -34.629957579888618,-58.524370224461691 -34.629820159261094,-58.524730847945598 -34.628644937219363,-58.524754560472005 -34.628567598628322,-58.524754634414876 -34.628567427607308,-58.524686721029383 -34.628463227647728,-58.524608776832032 -34.628420331872569,-58.524478890655189 -34.628376684551434,-58.524384035349527 -34.628369109974813,-58.524287308124407 -34.628375070242072,-58.524220701766787 -34.628394393654006,-58.524149220230235 -34.628437987298163,-58.522940771816778 -34.628186030295431,-58.521730454157989 -34.627933796646118,-58.520519717727929 -34.627681410321777,-58.51929825240304 -34.627426833772091,-58.518657060590805 -34.627293111002686,-58.51882625726428 -34.627162324635755)));;411;10_4_3;COMUNA 10;4;3;879;393;486;80,86%;341;339;99,41%;2;0,59%;300;0;0,00%;300;100,00%
MULTIPOLYGON (((-58.519644822614566 -34.630532057928924,-58.519288370061439 -34.631693670680015,-58.520240993653466 -34.632797204948417,-58.52024099011696 -34.632797216443294,-58.520340672128114 -34.632910698800508,-58.520388930652224 -34.63296879863055,-58.520528584209821 -34.633004348491433,-58.520748121107943 -34.633219865957948,-58.521591449068268 -34.632928113980576,-58.522286267088546 -34.632565722394887,-58.522375859179995 -34.632509972540021,-58.522475754962983 -34.632446470836456,-58.522544478948021 -34.632399745462649,-58.522621631250864 -34.632343931103996,-58.522670085184231 -34.632308342741396,-58.522719729712023 -34.63226972550499,-58.522794578603687 -34.632210109227465,-58.522856057834296 -34.632160218127467,-58.522991784962365 -34.632044865630178,-58.523031718011296 -34.632008647510389,-58.523139081920093 -34.631905914921589,-58.523215791663098 -34.631828479972214,-58.523428879164669 -34.631595126942486,-58.523507616667501 -34.631495084417026,-58.523599785883022 -34.631354329565021,-58.523709540168177 -34.631376599396347,-58.523873235613564 -34.631411518561812,-58.524327300722611 -34.629957579888618,-58.524182696008985 -34.629927440592809,-58.523881729209549 -34.629866815259881,-58.523723490596034 -34.629833372287749,-58.522513399616543 -34.629577484282628,-58.521475697767059 -34.629358051825434,-58.521303060109886 -34.629321091402815,-58.521118407888864 -34.629281601194506,-58.520094178629506 -34.629067925356978,-58.520060940833567 -34.629176324892725,-58.519644822614566 -34.630532057928924)));;412;10_4_4;COMUNA 10;4;4;814;372;442;84,16%;332;332;100,00%;0;0,00%;288;1;0,35%;287;99,65%
MULTIPOLYGON (((-58.520094178629506 -34.629067925356978,-58.518885560782529 -34.62881580356769,-58.517435978808599 -34.628513353932846,-58.517484850064555 -34.628464597965021,-58.516961693972853 -34.628003830430856,-58.516382302005468 -34.6284502989554,-58.5159146283928 -34.6288107272171,-58.515648090622847 -34.629016976864563,-58.516232859729094 -34.629369198183682,-58.51640152872848 -34.629464831459458,-58.517209168044978 -34.629922868760936,-58.517348349378636 -34.630001611921244,-58.518292539581203 -34.630536203007942,-58.519288370061439 -34.631693670680015,-58.519644822614566 -34.630532057928924,-58.520060940833567 -34.629176324892725,-58.520094178629506 -34.629067925356978)));;413;10_4_5;COMUNA 10;4;5;789;387;402;96,27%;334;334;100,00%;0;0,00%;286;1;0,35%;285;99,65%
MULTIPOLYGON (((-58.514653672581076 -34.630812886785513,-58.51509133656463 -34.631208135207395,-58.51541059198324 -34.631494063451086,-58.516170846468647 -34.632175022600798,-58.517218801903788 -34.631365236224056,-58.517746518916994 -34.630957520940498,-58.518116522305348 -34.63067156928156,-58.518292539581203 -34.630536203007942,-58.517348349378636 -34.630001611921244,-58.517209168044978 -34.629922868760936,-58.51640152872848 -34.629464831459458,-58.516232859729094 -34.629369198183682,-58.515648090622847 -34.629016976864563,-58.515248451735197 -34.629326103672412,-58.515127018194562 -34.629420102724836,-58.514907738097698 -34.629588653101777,-58.514037847471705 -34.630257495291715,-58.514152674261005 -34.630360337650863,-58.514653672581076 -34.630812886785513)));;414;10_4_6;COMUNA 10;4;6;655;329;326;100,92%;253;253;100,00%;0;0,00%;235;1;0,43%;234;99,57%
MULTIPOLYGON (((-58.517218801903788 -34.631365236224056,-58.516170846468647 -34.632175022600798,-58.517062294768067 -34.632985862780039,-58.517092929432366 -34.633013726943865,-58.51817209130828 -34.633003803981836,-58.518380238472105 -34.633001878092131,-58.518803434080155 -34.632997951648036,-58.518888294702812 -34.632997137911055,-58.519082565111781 -34.633011767052643,-58.519254075570935 -34.633010067876739,-58.519425325958423 -34.633001819070302,-58.519746695441043 -34.63298371084997,-58.519896298827582 -34.632967302223278,-58.520067738126244 -34.632946245312418,-58.520173616165458 -34.632912449445008,-58.52023767993218 -34.632803313334065,-58.52024099011696 -34.632797216443294,-58.520240993653466 -34.632797204948417,-58.519288370061439 -34.631693670680015,-58.518292539581203 -34.630536203007942,-58.518116522305348 -34.63067156928156,-58.517746518916994 -34.630957520940498,-58.517218801903788 -34.631365236224056)));;415;10_4_7;COMUNA 10;4;7;775;349;426;81,92%;352;352;100,00%;0;0,00%;301;0;0,00%;301;100,00%
MULTIPOLYGON (((-58.513425840936463 -34.633022701786842,-58.513913123010155 -34.63345779410362,-58.514073609696794 -34.633401457164908,-58.514911877741802 -34.633204334198318,-58.515369383832834 -34.633157375398255,-58.515932788653195 -34.633099523283249,-58.516820846202855 -34.633093709749154,-58.516833308619269 -34.633095070192162,-58.517062294768067 -34.632985862780039,-58.516170846468647 -34.632175022600798,-58.51541059198324 -34.631494063451086,-58.51509133656463 -34.631208135207395,-58.514653672581076 -34.630812886785513,-58.514152674261005 -34.630360337650863,-58.514037847471705 -34.630257495291715,-58.513023340698112 -34.631037591828914,-58.512907948175084 -34.631126304290476,-58.512044923578188 -34.631789847422262,-58.512666284459215 -34.632344612748049,-58.513425840936463 -34.633022701786842)));;416;10_4_8;COMUNA 10;4;8;717;348;369;94,31%;324;324;100,00%;0;0,00%;264;4;1,52%;260;98,48%
MULTIPOLYGON (((-58.510104813815587 -34.633281370137993,-58.509204441687238 -34.63397357037411,-58.50908682708603 -34.634064674473024,-58.508681518985192 -34.634378781848952,-58.508388369859041 -34.634599392154165,-58.50876363238141 -34.634646013090112,-58.50922298732285 -34.634685347066522,-58.509405246820535 -34.634700982145482,-58.509597902429562 -34.634718725699805,-58.510670759602945 -34.63481746660581,-58.511327512167128 -34.634527760494066,-58.511446681743628 -34.634476161949465,-58.511864668566595 -34.634295284064116,-58.512532996506287 -34.633998946839199,-58.51262303327718 -34.63396088060901,-58.513322966228195 -34.633664878225353,-58.513913123010155 -34.63345779410362,-58.513425840936463 -34.633022701786842,-58.512666284459215 -34.632344612748049,-58.512044923578188 -34.631789847422262,-58.511042983638248 -34.632560133169413,-58.510104813815587 -34.633281370137993)));;417;10_4_9;COMUNA 10;4;9;774;363;411;88,32%;355;355;100,00%;0;0,00%;305;0;0,00%;305;100,00%
MULTIPOLYGON (((-58.51839471011467 -34.621508103790141,-58.518291824199878 -34.621416175701782,-58.517907559196729 -34.621072112916814,-58.516908018480748 -34.621844489346771,-58.516794431174347 -34.621932218858994,-58.516462691290165 -34.622184909457985,-58.516560121140607 -34.622272545564122,-58.51734407860215 -34.622967713842115,-58.517447219809313 -34.623057881967483,-58.517561868679351 -34.623157974748118,-58.51846577666182 -34.623954493626336,-58.518784486373043 -34.623706733390868,-58.518907695701593 -34.623611532572951,-58.519315141456097 -34.623944524582903,-58.51970037872821 -34.624312104238484,-58.520154586235371 -34.62474542707929,-58.52061928319462 -34.62518719420725,-58.521636713211493 -34.624405060504252,-58.521176637178755 -34.623994000257269,-58.520694742876678 -34.623563440908605,-58.52028863587703 -34.623200522249974,-58.519896086231959 -34.622849779377901,-58.519381471794738 -34.622389862880439,-58.518889026035758 -34.621949864231738,-58.51839471011467 -34.621508103790141)));;418;10_5_1;COMUNA 10;5;1;700;307;393;78,12%;263;263;100,00%;0;0,00%;243;7;2,88%;236;97,12%
MULTIPOLYGON (((-58.513688387873593 -34.624313920275895,-58.513583881570469 -34.624216354939819,-58.512752098463409 -34.62343399616811,-58.512209842539413 -34.623851626156387,-58.512115236714557 -34.623924483916312,-58.511651570390562 -34.62427862665416,-58.51177644293081 -34.624388509818957,-58.512489717008656 -34.625020566311555,-58.512617317928644 -34.625130377062554,-58.512713125374034 -34.625212805417966,-58.513561862033654 -34.625966282931685,-58.513672931158773 -34.626064901889173,-58.514107661336922 -34.626447901452302,-58.514439678571208 -34.626740447033853,-58.514561916095118 -34.626848215669597,-58.514846694850576 -34.626663369702364,-58.515675049247676 -34.626124825525565,-58.515137085821266 -34.625651027794802,-58.514624697185255 -34.625194048327224,-58.513802270981877 -34.624420143860945,-58.513688387873593 -34.624313920275895)));;419;10_5_10;COMUNA 10;5;10;805;377;428;88,08%;327;326;99,69%;1;0,31%;296;4;1,35%;292;98,65%
MULTIPOLYGON (((-58.515702583730558 -34.624409050919915,-58.514796137220792 -34.623469479619018,-58.51390539629066 -34.622546092578311,-58.513785077509844 -34.622638329303427,-58.51329485984774 -34.623015940983791,-58.512752098463409 -34.62343399616811,-58.513583881570469 -34.624216354939819,-58.513688387873593 -34.624313920275895,-58.513802270981877 -34.624420143860945,-58.514624697185255 -34.625194048327224,-58.515137085821266 -34.625651027794802,-58.515675049247676 -34.626124825525565,-58.516116224391091 -34.625781663744199,-58.516215851679029 -34.625703166706941,-58.516615976869126 -34.625387979796912,-58.516724800115817 -34.625303210455407,-58.515702583730558 -34.624409050919915)));;420;10_5_11;COMUNA 10;5;11;703;345;358;96,37%;296;296;100,00%;0;0,00%;248;3;1,21%;245;98,79%
MULTIPOLYGON (((-58.514280741559062 -34.622258459729856,-58.51390539629066 -34.622546092578311,-58.514796137220792 -34.623469479619018,-58.515702583730558 -34.624409050919915,-58.516724800115817 -34.625303210455407,-58.517133186958318 -34.624990623893325,-58.51725767691569 -34.624893804415159,-58.517661713871284 -34.62457966866134,-58.517791567029548 -34.624478691144233,-58.516910928408905 -34.623699199837404,-58.516774457221977 -34.623578904168177,-58.515786864123278 -34.622708181235637,-58.515629256840562 -34.622569160419943,-58.514962944887657 -34.621976751180149,-58.514816336282877 -34.621847865779614,-58.514686993700153 -34.621947149756018,-58.514280741559062 -34.622258459729856)));;421;10_5_12;COMUNA 10;5;12;767;348;419;83,05%;305;305;100,00%;0;0,00%;265;4;1,51%;261;98,49%
MULTIPOLYGON (((-58.517505546102527 -34.62599232221411,-58.518341118001786 -34.626729785811442,-58.518469241970848 -34.626841914188688,-58.51897563718402 -34.626451598003534,-58.519537205014295 -34.626018858194747,-58.520095106419113 -34.625590131718958,-58.52061928319462 -34.62518719420725,-58.520154586235371 -34.62474542707929,-58.51970037872821 -34.624312104238484,-58.519315141456097 -34.623944524582903,-58.518907695701593 -34.623611532572951,-58.518784486373043 -34.623706733390868,-58.51846577666182 -34.623954493626336,-58.518348101362236 -34.624045958946454,-58.517791567029548 -34.624478691144233,-58.517661713871284 -34.62457966866134,-58.51725767691569 -34.624893804415159,-58.517133186958318 -34.624990623893325,-58.516724800115817 -34.625303210455407,-58.517505546102527 -34.62599232221411)));;422;10_5_13;COMUNA 10;5;13;820;388;432;89,81%;333;333;100,00%;0;0,00%;288;8;2,78%;280;97,22%
MULTIPOLYGON (((-58.517955774336549 -34.627237654170962,-58.518469241970848 -34.626841914188688,-58.518341118001786 -34.626729785811442,-58.517505546102527 -34.62599232221411,-58.516724800115817 -34.625303210455407,-58.516615976869126 -34.625387979796912,-58.516215851679029 -34.625703166706941,-58.516116224391091 -34.625781663744199,-58.515675049247676 -34.626124825525565,-58.514846694850576 -34.626663369702364,-58.514561916095118 -34.626848215669597,-58.514678783614386 -34.626951197575053,-58.515422616253247 -34.627605830000668,-58.515547157830078 -34.627715498109083,-58.516382302005468 -34.6284502989554,-58.516961693972853 -34.628003830430856,-58.517413094230228 -34.627655941044836,-58.517955774336549 -34.627237654170962)));;423;10_5_14;COMUNA 10;5;14;737;358;379;94,46%;332;332;100,00%;0;0,00%;269;4;1,49%;265;98,51%
MULTIPOLYGON (((-58.517431834984983 -34.620645622311237,-58.516950149852178 -34.620215188669739,-58.51683767075528 -34.620300593727052,-58.515937746831959 -34.620987492551855,-58.515811301622662 -34.621084029894305,-58.515492676308412 -34.621328683732258,-58.514816336282877 -34.621847865779614,-58.514962944887657 -34.621976751180149,-58.515629256840562 -34.622569160419943,-58.515786864123278 -34.622708181235637,-58.516774457221977 -34.623578904168177,-58.516910928408905 -34.623699199837404,-58.517791567029548 -34.624478691144233,-58.518348101362236 -34.624045958946454,-58.51846577666182 -34.623954493626336,-58.517561868679351 -34.623157974748118,-58.517447219809313 -34.623057881967483,-58.51734407860215 -34.622967713842115,-58.516560121140607 -34.622272545564122,-58.516462691290165 -34.622184909457985,-58.516794431174347 -34.621932218858994,-58.516908018480748 -34.621844489346771,-58.517907559196729 -34.621072112916814,-58.517431834984983 -34.620645622311237)));;424;10_5_2;COMUNA 10;5;2;723;331;392;84,44%;348;348;100,00%;0;0,00%;292;3;1,03%;289;98,97%
MULTIPOLYGON (((-58.516527113539915 -34.619837686826095,-58.516412383842201 -34.619735339451232,-58.515695798258371 -34.619095841727876,-58.515013743796182 -34.618487171075046,-58.514473834221086 -34.618909317640259,-58.513941412085615 -34.619325542944267,-58.512881064796666 -34.620154533828781,-58.513061248347064 -34.620310662209299,-58.513154749813566 -34.620391823587504,-58.513559869850127 -34.620746315598048,-58.514175952231071 -34.621285582977144,-58.514286588972737 -34.621382722712106,-58.514680468097581 -34.621728553420297,-58.514816336282877 -34.621847865779614,-58.515492676308412 -34.621328683732258,-58.515811301622662 -34.621084029894305,-58.515937746831959 -34.620987492551855,-58.51683767075528 -34.620300593727052,-58.516950149852178 -34.620215188669739,-58.516527113539915 -34.619837686826095)));;425;10_5_3;COMUNA 10;5;3;936;432;504;85,71%;425;425;100,00%;0;0,00%;355;10;2,82%;345;97,18%
MULTIPOLYGON (((-58.513650772768294 -34.617270803608001,-58.513046734697554 -34.616731669086143,-58.512658299158637 -34.617032191530789,-58.512530749988372 -34.617130838737509,-58.512298470773082 -34.617311644014997,-58.512175348793392 -34.617407542469962,-58.511895385863404 -34.617625832413822,-58.511741524809246 -34.617745757750853,-58.511012828156751 -34.61831268821021,-58.510904604235705 -34.618396959339883,-58.51150805437495 -34.618953429108906,-58.512156413339596 -34.619521004790386,-58.512780063403071 -34.620066966642057,-58.512881064796666 -34.620154533828781,-58.513941412085615 -34.619325542944267,-58.514473834221086 -34.618909317640259,-58.515013743796182 -34.618487171075046,-58.514943936440972 -34.618424804429694,-58.514333318709127 -34.617879904354112,-58.513650772768294 -34.617270803608001)));;426;10_5_4;COMUNA 10;5;4;921;409;512;79,88%;364;363;99,73%;1;0,28%;323;1;0,31%;322;99,69%
MULTIPOLYGON (((-58.510904604235705 -34.618396959339883,-58.510466512031265 -34.618737707023172,-58.510338957376703 -34.618835858940031,-58.509848493132786 -34.619217471325157,-58.509443512594949 -34.619526229539908,-58.509185417119525 -34.619723518164086,-58.509083575051477 -34.619801306128402,-58.508832033659921 -34.61999183070489,-58.508672797326845 -34.620112458411299,-58.508405243276201 -34.620311650406414,-58.508301014660056 -34.620389790729639,-58.508149014271744 -34.620503795090848,-58.50787123864869 -34.620709750509697,-58.507756105997828 -34.620790147999408,-58.508377471217607 -34.621399233880055,-58.509023868896307 -34.621967460542997,-58.510013693807281 -34.621206490886266,-58.510117067855354 -34.62112468734351,-58.51045477769965 -34.620857433641277,-58.511164931959122 -34.620295303008199,-58.511259788795961 -34.620220262668674,-58.511608732617866 -34.619946874288416,-58.51204912412053 -34.619601966564936,-58.512156413339596 -34.619521004790386,-58.51150805437495 -34.618953429108906,-58.510904604235705 -34.618396959339883)));;427;10_5_5;COMUNA 10;5;5;826;374;452;82,74%;345;345;100,00%;0;0,00%;299;4;1,34%;295;98,66%
MULTIPOLYGON (((-58.508056932532661 -34.622710243931273,-58.50856212959949 -34.623195987283275,-58.50864779284499 -34.623278211399139,-58.509645813317228 -34.622514072672345,-58.509023868896307 -34.621967460542997,-58.508377471217607 -34.621399233880055,-58.507756105997828 -34.620790147999408,-58.507612462504134 -34.620922318244816,-58.506958639548827 -34.621417926545519,-58.506839846670609 -34.621507409312194,-58.506684436267442 -34.621624511762128,-58.506285902572557 -34.621925158185064,-58.506928460220287 -34.622500439775344,-58.507574606537744 -34.623078956151218,-58.508056932532661 -34.622710243931273)));;428;10_5_6;COMUNA 10;5;6;853;378;475;79,58%;399;399;100,00%;0;0,00%;339;2;0,59%;337;99,41%
MULTIPOLYGON (((-58.50864779284499 -34.623278211399139,-58.50856212959949 -34.623195987283275,-58.508056932532661 -34.622710243931273,-58.507574606537744 -34.623078956151218,-58.50880427817404 -34.624179873459923,-58.510184511859478 -34.62541558339209,-58.510563112939202 -34.625115213925675,-58.510735722089962 -34.624978239996757,-58.51121268042494 -34.624613883875163,-58.511651570390562 -34.62427862665416,-58.511278914998464 -34.623950384097668,-58.511026445283022 -34.623728152808638,-58.510954591406907 -34.623664939645984,-58.510596346411397 -34.623349647459598,-58.510499434089319 -34.623264400849173,-58.51040610184004 -34.623182321883583,-58.510268788759156 -34.623061667125597,-58.509936289868108 -34.62276946231308,-58.509645813317228 -34.622514072672345,-58.50864779284499 -34.623278211399139)));;429;10_5_7;COMUNA 10;5;7;855;404;451;89,58%;366;365;99,73%;1;0,27%;306;21;6,86%;285;93,14%
MULTIPOLYGON (((-58.512610275804342 -34.621479268474964,-58.512830134808617 -34.621309454123988,-58.513559869850127 -34.620746315598048,-58.513154749813566 -34.620391823587504,-58.513061248347064 -34.620310662209299,-58.512881064796666 -34.620154533828781,-58.512780063403071 -34.620066966642057,-58.512156413339596 -34.619521004790386,-58.51204912412053 -34.619601966564936,-58.511608732617866 -34.619946874288416,-58.511259788795961 -34.620220262668674,-58.511164931959122 -34.620295303008199,-58.51045477769965 -34.620857433641277,-58.510117067855354 -34.62112468734351,-58.510013693807281 -34.621206490886266,-58.509023868896307 -34.621967460542997,-58.509645813317228 -34.622514072672345,-58.509936289868108 -34.62276946231308,-58.510268788759156 -34.623061667125597,-58.51040610184004 -34.623182321883583,-58.511500238303036 -34.622336930365307,-58.512610275804342 -34.621479268474964)));;430;10_5_8;COMUNA 10;5;8;962;466;496;93,95%;407;407;100,00%;0;0,00%;357;9;2,52%;348;97,48%
MULTIPOLYGON (((-58.511500238303036 -34.622336930365307,-58.51040610184004 -34.623182321883583,-58.510499434089319 -34.623264400849173,-58.510596346411397 -34.623349647459598,-58.510954591406907 -34.623664939645984,-58.511026445283022 -34.623728152808638,-58.511278914998464 -34.623950384097668,-58.511651570390562 -34.62427862665416,-58.512115236714557 -34.623924483916312,-58.512209842539413 -34.623851626156387,-58.512752098463409 -34.62343399616811,-58.51329485984774 -34.623015940983791,-58.513785077509844 -34.622638329303427,-58.51390539629066 -34.622546092578311,-58.514280741559062 -34.622258459729856,-58.514686993700153 -34.621947149756018,-58.514816336282877 -34.621847865779614,-58.514680468097581 -34.621728553420297,-58.514286588972737 -34.621382722712106,-58.514175952231071 -34.621285582977144,-58.513559869850127 -34.620746315598048,-58.512830134808617 -34.621309454123988,-58.512610275804342 -34.621479268474964,-58.511500238303036 -34.622336930365307)));;431;10_5_9;COMUNA 10;5;9;693;322;371;86,79%;314;313;99,68%;1;0,32%;263;8;3,04%;255;96,96%
MULTIPOLYGON (((-58.510307170626369 -34.618069224647556,-58.509693751344017 -34.618540957969948,-58.508971586896394 -34.619096394378765,-58.509084347580803 -34.619199312915548,-58.509326489375425 -34.6194192987451,-58.509443512594949 -34.619526229539908,-58.509848493132786 -34.619217471325157,-58.510338957376703 -34.618835858940031,-58.510466512031265 -34.618737707023172,-58.510904604235705 -34.618396959339883,-58.511012828156751 -34.61831268821021,-58.511741524809246 -34.617745757750853,-58.511895385863404 -34.617625832413822,-58.512175348793392 -34.617407542469962,-58.512298470773082 -34.617311644014997,-58.512530749988372 -34.617130838737509,-58.512658299158637 -34.617032191530789,-58.513046734697554 -34.616731669086143,-58.512573873780568 -34.616451853379296,-58.512137487433392 -34.616192796436522,-58.511677840314434 -34.615919943952896,-58.511351864465524 -34.616255368006065,-58.511045891448582 -34.616568247234312,-58.510718888338516 -34.616903740394818,-58.510601997447743 -34.6170235793264,-58.509838072362051 -34.617812144210767,-58.510307170626369 -34.618069224647556)));;432;10_6_1;COMUNA 10;6;1;662;312;350;89,14%;270;270;100,00%;0;0,00%;231;7;3,03%;224;96,97%
MULTIPOLYGON (((-58.502844200565498 -34.615203989959966,-58.501932913630903 -34.614680746546156,-58.501809208852272 -34.614822551909803,-58.501078299979753 -34.61567147635462,-58.500960637366752 -34.615806729405463,-58.500825520685737 -34.615961988508857,-58.50009960998559 -34.616793580817323,-58.501201155387633 -34.61737445594256,-58.502428738722251 -34.618021620450477,-58.503212824040041 -34.617200840604497,-58.503312270661276 -34.617097282742947,-58.503433683777068 -34.616970899755344,-58.503789832105028 -34.616599429107133,-58.504230521882342 -34.616139756494164,-58.504319663800963 -34.616046553783313,-58.50352100483132 -34.615590751033494,-58.50299927811308 -34.61529302652459,-58.502844200565498 -34.615203989959966)));;433;10_6_10;COMUNA 10;6;10;1100;492;608;80,92%;450;450;100,00%;0;0,00%;422;36;8,53%;386;91,47%
MULTIPOLYGON (((-58.507022774625995 -34.616265468636712,-58.506914302436144 -34.616205435438161,-58.506451441697294 -34.61594474795362,-58.506301387899867 -34.615860995871657,-58.505125337770487 -34.615204415235141,-58.505033558382166 -34.615300436464224,-58.504770308600172 -34.615575607776549,-58.504319663800963 -34.616046553783313,-58.504230521882342 -34.616139756494164,-58.503789832105028 -34.616599429107133,-58.503433683777068 -34.616970899755344,-58.503312270661276 -34.617097282742947,-58.503547870212159 -34.61722178596397,-58.503801107226415 -34.617352902738972,-58.504245892867424 -34.617583182764832,-58.504442551169063 -34.617680020467887,-58.504674230264939 -34.617794170363467,-58.50500236907282 -34.617963288348435,-58.50511808311439 -34.618023461561513,-58.50549675394231 -34.618220660211058,-58.505686685828124 -34.618318272931973,-58.50597882083526 -34.618045624820553,-58.506682712970566 -34.617389082278414,-58.50681741076923 -34.617263395391085,-58.507456579706471 -34.616664197672854,-58.507562581907379 -34.61656478901169,-58.507386708003892 -34.616468371259593,-58.507145136206979 -34.616333173008144,-58.507022774625995 -34.616265468636712)));;434;10_6_11;COMUNA 10;6;11;786;356;430;82,79%;317;317;100,00%;0;0,00%;280;0;0,00%;280;100,00%
MULTIPOLYGON (((-58.506682712970566 -34.617389082278414,-58.50597882083526 -34.618045624820553,-58.505686685828124 -34.618318272931973,-58.505875766105468 -34.618415533531753,-58.50673460487242 -34.618866510030486,-58.506916020578871 -34.618963490074577,-58.507904909630653 -34.619491878586182,-58.508046107439313 -34.619567251359655,-58.508832033659921 -34.61999183070489,-58.509083575051477 -34.619801306128402,-58.509185417119525 -34.619723518164086,-58.509443512594949 -34.619526229539908,-58.509326489375425 -34.6194192987451,-58.509084347580803 -34.619199312915548,-58.508971586896394 -34.619096394378765,-58.509693751344017 -34.618540957969948,-58.510307170626369 -34.618069224647556,-58.509838072362051 -34.617812144210767,-58.508820211443279 -34.617254203665354,-58.508028002098101 -34.616819907722558,-58.507562581907379 -34.61656478901169,-58.507456579706471 -34.616664197672854,-58.50681741076923 -34.617263395391085,-58.506682712970566 -34.617389082278414)));;435;10_6_12;COMUNA 10;6;12;717;324;393;82,44%;317;315;99,37%;2;0,63%;266;3;1,13%;263;98,87%
MULTIPOLYGON (((-58.506916020578871 -34.618963490074577,-58.50673460487242 -34.618866510030486,-58.505875766105468 -34.618415533531753,-58.505686685828124 -34.618318272931973,-58.50549675394231 -34.618220660211058,-58.50511808311439 -34.618023461561513,-58.50500236907282 -34.617963288348435,-58.504674230264939 -34.617794170363467,-58.504442551169063 -34.617680020467887,-58.504245892867424 -34.617583182764832,-58.503801107226415 -34.617352902738972,-58.503547870212159 -34.61722178596397,-58.503312270661276 -34.617097282742947,-58.503212824040041 -34.617200840604497,-58.502428738722251 -34.618021620450477,-58.503049650425716 -34.618344737926407,-58.503527586156075 -34.618593460917324,-58.504362638432028 -34.619027912187278,-58.504599522223394 -34.619151215671494,-58.504753837822058 -34.619231376655492,-58.505968774439744 -34.619862100657436,-58.506894006457145 -34.620342490000787,-58.507756105997828 -34.620790147999408,-58.50787123864869 -34.620709750509697,-58.508149014271744 -34.620503795090848,-58.508301014660056 -34.620389790729639,-58.508405243276201 -34.620311650406414,-58.508672797326845 -34.620112458411299,-58.508832033659921 -34.61999183070489,-58.508046107439313 -34.619567251359655,-58.507904909630653 -34.619491878586182,-58.506916020578871 -34.618963490074577)));;436;10_6_13;COMUNA 10;6;13;1043;476;567;83,95%;479;478;99,79%;1;0,21%;395;0;0,00%;395;100,00%
MULTIPOLYGON (((-58.510841296078731 -34.615421597181715,-58.510703590772017 -34.61533833861052,-58.510575855564042 -34.61526085082459,-58.51042860629741 -34.615170764455563,-58.510344415302747 -34.615119246226016,-58.510138112786422 -34.614991364298206,-58.510018388919669 -34.614919225112502,-58.509744090060437 -34.614754114012975,-58.509580739749559 -34.614658328390306,-58.50871930892351 -34.61547953079792,-58.50858895940609 -34.61560183778181,-58.507562581907379 -34.61656478901169,-58.508028002098101 -34.616819907722558,-58.508820211443279 -34.617254203665354,-58.509838072362051 -34.617812144210767,-58.510601997447743 -34.6170235793264,-58.510718888338516 -34.616903740394818,-58.511045891448582 -34.616568247234312,-58.511351864465524 -34.616255368006065,-58.511677840314434 -34.615919943952896,-58.511250662670697 -34.61566644369411,-58.511003628509776 -34.615519775957928,-58.510841296078731 -34.615421597181715)));;437;10_6_2;COMUNA 10;6;2;682;328;354;92,66%;299;299;100,00%;0;0,00%;247;18;7,29%;229;92,71%
MULTIPOLYGON (((-58.506171164771587 -34.614109500790434,-58.50564076260499 -34.614664778974387,-58.505125337770487 -34.615204415235141,-58.506301387899867 -34.615860995871657,-58.506451441697294 -34.61594474795362,-58.506914302436144 -34.616205435438161,-58.507022774625995 -34.616265468636712,-58.507145136206979 -34.616333173008144,-58.507386708003892 -34.616468371259593,-58.507562581907379 -34.61656478901169,-58.50858895940609 -34.61560183778181,-58.50871930892351 -34.61547953079792,-58.509580739749559 -34.614658328390306,-58.509205896210972 -34.614438745671265,-58.509056181293481 -34.614351757274939,-58.508847756861314 -34.614230705184724,-58.508724969479751 -34.614160115229943,-58.508467721655904 -34.614012248945365,-58.508308464793537 -34.613919699623665,-58.508015600146905 -34.613749591367302,-58.507868103436657 -34.61366443172998,-58.507625002903566 -34.613524023474206,-58.507521814679123 -34.613463143740788,-58.50705470024679 -34.613187529868974,-58.506941215367384 -34.613305110525388,-58.506607315688441 -34.613653764835355,-58.506282522782641 -34.613992907575735,-58.506171164771587 -34.614109500790434)));;438;10_6_3;COMUNA 10;6;3;1071;480;591;81,22%;429;429;100,00%;0;0,00%;388;3;0,77%;385;99,23%
MULTIPOLYGON (((-58.503721680286823 -34.611224047405507,-58.503408127267392 -34.611036399110276,-58.503253225987585 -34.610944123387085,-58.503102074033222 -34.610854099827499,-58.502369409968473 -34.61041939479059,-58.502261802801016 -34.610543730047915,-58.501670047318079 -34.611237185222684,-58.50154353986656 -34.611386738051458,-58.502299810209784 -34.61183644086239,-58.50246391426839 -34.611934348790619,-58.50350410091287 -34.612554802482897,-58.503688656958154 -34.612664251622824,-58.503912323156442 -34.612796857128053,-58.504401748383309 -34.613084025142598,-58.5045597209918 -34.613175382793436,-58.504747516242816 -34.613283913681968,-58.506002789809315 -34.614005542847295,-58.506171164771587 -34.614109500790434,-58.506282522782641 -34.613992907575735,-58.506607315688441 -34.613653764835355,-58.506941215367384 -34.613305110525388,-58.50705470024679 -34.613187529868974,-58.505564419699724 -34.612308312456058,-58.505412245191494 -34.612227236125989,-58.505249676171594 -34.612140740498738,-58.504665073826281 -34.611787479453419,-58.504527040103738 -34.611704495669294,-58.504278835677532 -34.611555208883971,-58.504139525198894 -34.611472577218549,-58.50386064949538 -34.611307243067643,-58.503721680286823 -34.611224047405507)));;439;10_6_4;COMUNA 10;6;4;868;400;468;85,47%;386;386;100,00%;0;0,00%;319;4;1,25%;315;98,75%
MULTIPOLYGON (((-58.502679899192735 -34.613820543570903,-58.502549045431017 -34.613970310079111,-58.502039079704083 -34.614558947428151,-58.501932913630903 -34.614680746546156,-58.502844200565498 -34.615203989959966,-58.50299927811308 -34.61529302652459,-58.50352100483132 -34.615590751033494,-58.504319663800963 -34.616046553783313,-58.504770308600172 -34.615575607776549,-58.505033558382166 -34.615300436464224,-58.505125337770487 -34.615204415235141,-58.50564076260499 -34.614664778974387,-58.506171164771587 -34.614109500790434,-58.506002789809315 -34.614005542847295,-58.504747516242816 -34.613283913681968,-58.5045597209918 -34.613175382793436,-58.504401748383309 -34.613084025142598,-58.503912323156442 -34.612796857128053,-58.503688656958154 -34.612664251622824,-58.503550145330067 -34.612823881315805,-58.502679899192735 -34.613820543570903)));;440;10_6_5;COMUNA 10;6;5;876;411;465;88,39%;394;394;100,00%;0;0,00%;353;5;1,42%;348;98,58%
MULTIPOLYGON (((-58.502679899192735 -34.613820543570903,-58.503550145330067 -34.612823881315805,-58.503688656958154 -34.612664251622824,-58.50350410091287 -34.612554802482897,-58.50246391426839 -34.611934348790619,-58.502299810209784 -34.61183644086239,-58.50154353986656 -34.611386738051458,-58.501393496682375 -34.611297557129426,-58.500601876986529 -34.610826520837172,-58.500477577547628 -34.610964240467794,-58.499544893657472 -34.611999140813587,-58.498768164490912 -34.612861094280433,-58.499627182914097 -34.613356700280569,-58.499793074463355 -34.613451935083056,-58.500799252797528 -34.614029674001863,-58.501932913630903 -34.614680746546156,-58.502039079704083 -34.614558947428151,-58.502549045431017 -34.613970310079111,-58.502679899192735 -34.613820543570903)));;441;10_6_6;COMUNA 10;6;6;851;419;432;96,99%;351;351;100,00%;0;0,00%;298;2;0,67%;296;99,33%
MULTIPOLYGON (((-58.499351372059856 -34.610080396744593,-58.498443895053732 -34.611110210642657,-58.498299756709621 -34.611275963050183,-58.498158512533585 -34.611438474887457,-58.497533077625661 -34.612149666815334,-58.498609517304608 -34.61276958847165,-58.498768164490912 -34.612861094280433,-58.499544893657472 -34.611999140813587,-58.500477577547628 -34.610964240467794,-58.500601876986529 -34.610826520837172,-58.501393496682375 -34.611297557129426,-58.50154353986656 -34.611386738051458,-58.501670047318079 -34.611237185222684,-58.502261802801016 -34.610543730047915,-58.502369409968473 -34.61041939479059,-58.502207098525552 -34.610323105906872,-58.501459958393689 -34.609877484161025,-58.501327384255134 -34.609798438800524,-58.500192507163966 -34.609125739943693,-58.499351372059856 -34.610080396744593)));;442;10_6_7;COMUNA 10;6;7;831;394;437;90,16%;350;349;99,71%;1;0,29%;284;1;0,35%;283;99,65%
MULTIPOLYGON (((-58.496560425897577 -34.613263854203836,-58.496439694107067 -34.613402343354451,-58.495573016670065 -34.614391066256644,-58.496801451495394 -34.615043287684408,-58.497775582879029 -34.613962479751898,-58.498005802799916 -34.614096432251358,-58.498659314729018 -34.614469423803023,-58.498849065231461 -34.614579794225037,-58.498958894633738 -34.614448982290277,-58.499665453669202 -34.613603176452635,-58.499793074463355 -34.613451935083056,-58.499627182914097 -34.613356700280569,-58.498768164490912 -34.612861094280433,-58.498609517304608 -34.61276958847165,-58.497533077625661 -34.612149666815334,-58.497404089923315 -34.612296328611841,-58.496560425897577 -34.613263854203836)));;443;10_6_8;COMUNA 10;6;8;866;388;478;81,17%;392;392;100,00%;0;0,00%;339;2;0,59%;337;99,41%
MULTIPOLYGON (((-58.498849065231461 -34.614579794225037,-58.498659314729018 -34.614469423803023,-58.498005802799916 -34.614096432251358,-58.497775582879029 -34.613962479751898,-58.496801451495394 -34.615043287684408,-58.497945894914508 -34.615650801054919,-58.499056954859022 -34.616240707316287,-58.499916588588995 -34.616697013637442,-58.50009960998559 -34.616793580817323,-58.500825520685737 -34.615961988508857,-58.500960637366752 -34.615806729405463,-58.501078299979753 -34.61567147635462,-58.501809208852272 -34.614822551909803,-58.501932913630903 -34.614680746546156,-58.500799252797528 -34.614029674001863,-58.499793074463355 -34.613451935083056,-58.499665453669202 -34.613603176452635,-58.498958894633738 -34.614448982290277,-58.498849065231461 -34.614579794225037)));;444;10_6_9;COMUNA 10;6;9;965;442;523;84,51%;459;459;100,00%;0;0,00%;357;5;1,40%;352;98,60%
MULTIPOLYGON (((-58.50880427817404 -34.624179873459923,-58.508696213822887 -34.624262381869485,-58.507987021204265 -34.624805623544937,-58.506855959460303 -34.623781425654911,-58.506764248351502 -34.623698357372412,-58.505769593072763 -34.624458738681355,-58.50476214541203 -34.625228764420285,-58.505869525267549 -34.626269187600336,-58.505962603632867 -34.626356481530252,-58.507178095397528 -34.62749636463316,-58.507293759286142 -34.6275943538772,-58.508181058061595 -34.626928862961371,-58.508312802296906 -34.62683085270821,-58.509256123160654 -34.626129627496809,-58.509362315758949 -34.626048316555497,-58.510082750652629 -34.62549632993619,-58.510184511859478 -34.62541558339209,-58.50880427817404 -34.624179873459923)));;445;10_7_1;COMUNA 10;7;1;1142;509;633;80,41%;438;436;99,54%;2;0,46%;381;3;0,79%;378;99,21%
MULTIPOLYGON (((-58.502054272008102 -34.622021459192112,-58.501660266197391 -34.622936053905036,-58.501580936752369 -34.623084464615275,-58.501754257637032 -34.623171243227731,-58.502697302971129 -34.623642503187405,-58.503492083494592 -34.624032394243372,-58.504030215681667 -34.623626494942094,-58.504456783294486 -34.623304789310176,-58.505479629913239 -34.622534267483836,-58.505853047425745 -34.622251661403027,-58.505051814585293 -34.621893690367983,-58.503916398521667 -34.621386315180722,-58.503763108329714 -34.621318970168694,-58.502572753313146 -34.620796177829796,-58.50211681865018 -34.621876433971785,-58.502054272008102 -34.622021459192112)));;446;10_7_10;COMUNA 10;7;10;1115;531;584;90,92%;439;439;100,00%;0;0,00%;402;4;1,00%;398;99,00%
MULTIPOLYGON (((-58.506928460220287 -34.622500439775344,-58.506285902572557 -34.621925158185064,-58.505853047425745 -34.622251661403027,-58.505479629913239 -34.622534267483836,-58.504456783294486 -34.623304789310176,-58.504030215681667 -34.623626494942094,-58.503492083494592 -34.624032394243372,-58.504669921786565 -34.62514203266263,-58.50476214541203 -34.625228764420285,-58.505769593072763 -34.624458738681355,-58.506764248351502 -34.623698357372412,-58.506855959460303 -34.623781425654911,-58.507987021204265 -34.624805623544937,-58.508696213822887 -34.624262381869485,-58.50880427817404 -34.624179873459923,-58.507574606537744 -34.623078956151218,-58.506928460220287 -34.622500439775344)));;447;10_7_2;COMUNA 10;7;2;1068;490;578;84,78%;521;521;100,00%;0;0,00%;407;3;0,74%;404;99,26%
MULTIPOLYGON (((-58.50426859857 -34.620238690907541,-58.503187149812568 -34.619763685883882,-58.503038631493766 -34.619691690308279,-58.502629935793983 -34.620660731869847,-58.502572753313146 -34.620796177829796,-58.503763108329714 -34.621318970168694,-58.503916398521667 -34.621386315180722,-58.505051814585293 -34.621893690367983,-58.505853047425745 -34.622251661403027,-58.506285902572557 -34.621925158185064,-58.506684436267442 -34.621624511762128,-58.506839846670609 -34.621507409312194,-58.506958639548827 -34.621417926545519,-58.507612462504134 -34.620922318244816,-58.507756105997828 -34.620790147999408,-58.506894006457145 -34.620342490000787,-58.505968774439744 -34.619862100657436,-58.504753837822058 -34.619231376655492,-58.504659604427232 -34.6193697238159,-58.504435897100947 -34.619873268898552,-58.504330552037537 -34.620110355438044,-58.50426859857 -34.620238690907541)));;448;10_7_3;COMUNA 10;7;3;1223;519;704;73,72%;522;521;99,81%;1;0,19%;471;18;3,82%;453;96,18%
MULTIPOLYGON (((-58.501264913295344 -34.620220803550588,-58.501445551105398 -34.620301030806722,-58.502074717267234 -34.620577388302699,-58.502572753313146 -34.620796177829796,-58.502629935793983 -34.620660731869847,-58.503038631493766 -34.619691690308279,-58.503187149812568 -34.619763685883882,-58.50426859857 -34.620238690907541,-58.504330552037537 -34.620110355438044,-58.504435897100947 -34.619873268898552,-58.504659604427232 -34.6193697238159,-58.504753837822058 -34.619231376655492,-58.504599522223394 -34.619151215671494,-58.504362638432028 -34.619027912187278,-58.503527586156075 -34.618593460917324,-58.503049650425716 -34.618344737926407,-58.502428738722251 -34.618021620450477,-58.501201155387633 -34.61737445594256,-58.50009960998559 -34.616793580817323,-58.499411813036666 -34.61735169684821,-58.500318870512011 -34.618100249811597,-58.50130008577667 -34.618910042251507,-58.500476194652734 -34.619569478236365,-58.500361401898743 -34.619660291559384,-58.500232387466887 -34.619762306724823,-58.501264913295344 -34.620220803550588)));;449;10_7_4;COMUNA 10;7;4;1133;511;622;82,15%;533;531;99,62%;2;0,38%;434;4;0,92%;430;99,08%
MULTIPOLYGON (((-58.499411813036666 -34.61735169684821,-58.50009960998559 -34.616793580817323,-58.499916588588995 -34.616697013637442,-58.499056954859022 -34.616240707316287,-58.497945894914508 -34.615650801054919,-58.496801451495394 -34.615043287684408,-58.495573016670065 -34.614391066256644,-58.494785655369235 -34.615016016597579,-58.495623975526875 -34.615734762614146,-58.495779744347836 -34.615865429367553,-58.496526725620718 -34.616491866580418,-58.496675594511274 -34.616615773282099,-58.497601538030636 -34.617381806696805,-58.498472363941204 -34.618104115218287,-58.498596099072607 -34.618206195152908,-58.49937652322491 -34.61884908427016,-58.500361401898743 -34.619660291559384,-58.500476194652734 -34.619569478236365,-58.50130008577667 -34.618910042251507,-58.500318870512011 -34.618100249811597,-58.499411813036666 -34.61735169684821)));;450;10_7_5;COMUNA 10;7;5;843;380;463;82,07%;444;444;100,00%;0;0,00%;366;13;3,55%;353;96,45%
MULTIPOLYGON (((-58.495982156222617 -34.61867371331688,-58.496527520840672 -34.618241998799164,-58.495598678682441 -34.617469338169528,-58.496559098372096 -34.616707569496185,-58.496675594511274 -34.616615773282099,-58.496526725620718 -34.616491866580418,-58.495779744347836 -34.615865429367553,-58.495623975526875 -34.615734762614146,-58.494785655369235 -34.615016016597579,-58.49382932605257 -34.615773122422922,-58.493710018254831 -34.615868649174637,-58.492636406118862 -34.616728314161804,-58.492778283505068 -34.616849621605127,-58.49363441281205 -34.617579362989112,-58.493792994796074 -34.617714538728016,-58.49451637566316 -34.618327190768781,-58.494657831975935 -34.618446946752243,-58.495446409160735 -34.619097746460227,-58.495982156222617 -34.61867371331688)));;451;10_7_6;COMUNA 10;7;6;960;452;508;88,98%;412;411;99,76%;1;0,24%;342;4;1,17%;338;98,83%
MULTIPOLYGON (((-58.497601538030636 -34.617381806696805,-58.496675594511274 -34.616615773282099,-58.496559098372096 -34.616707569496185,-58.495598678682441 -34.617469338169528,-58.496527520840672 -34.618241998799164,-58.497397154257094 -34.618965371599835,-58.497512282773357 -34.619061187241002,-58.498295093722916 -34.619708448855505,-58.49937652322491 -34.61884908427016,-58.498596099072607 -34.618206195152908,-58.498472363941204 -34.618104115218287,-58.497601538030636 -34.617381806696805)));;452;10_7_7;COMUNA 10;7;7;1514;697;817;85,31%;556;555;99,82%;1;0,18%;515;2;0,39%;513;99,61%
MULTIPOLYGON (((-58.496319107587631 -34.619817816046542,-58.497220965812502 -34.620562026824679,-58.498200901583736 -34.621370506153113,-58.499151549249923 -34.620617030543357,-58.499275371545984 -34.620519032315883,-58.500232387466887 -34.619762306724823,-58.500361401898743 -34.619660291559384,-58.49937652322491 -34.61884908427016,-58.498295093722916 -34.619708448855505,-58.497512282773357 -34.619061187241002,-58.497397154257094 -34.618965371599835,-58.496527520840672 -34.618241998799164,-58.495982156222617 -34.61867371331688,-58.495446409160735 -34.619097746460227,-58.496319107587631 -34.619817816046542)));;453;10_7_8;COMUNA 10;7;8;1047;490;557;87,97%;419;418;99,76%;1;0,24%;384;0;0,00%;384;100,00%
MULTIPOLYGON (((-58.500270049429659 -34.622428021726158,-58.501580936752369 -34.623084464615275,-58.501660266197391 -34.622936053905036,-58.502054272008102 -34.622021459192112,-58.50211681865018 -34.621876433971785,-58.502572753313146 -34.620796177829796,-58.502074717267234 -34.620577388302699,-58.501445551105398 -34.620301030806722,-58.501264913295344 -34.620220803550588,-58.500232387466887 -34.619762306724823,-58.499275371545984 -34.620519032315883,-58.499151549249923 -34.620617030543357,-58.498200901583736 -34.621370506153113,-58.49917314274122 -34.621878124298973,-58.499343902551878 -34.621964132445981,-58.500270049429659 -34.622428021726158)));;454;10_7_9;COMUNA 10;7;9;959;453;506;89,53%;395;395;100,00%;0;0,00%;339;14;4,13%;325;95,87%
MULTIPOLYGON (((-58.511285770229357 -34.625772626676472,-58.511137511214194 -34.625884097875613,-58.511684580989055 -34.626377769408528,-58.5122696748818 -34.626905649507755,-58.512430795079361 -34.626788044740522,-58.512865955923871 -34.627182034795183,-58.512941906709287 -34.62725024527473,-58.513367608380932 -34.627632406019174,-58.513472201685119 -34.627726309352681,-58.513834060396285 -34.628050957850249,-58.514213567504392 -34.628391372980751,-58.514303415681169 -34.628472534908987,-58.515422616253247 -34.627605830000668,-58.514678783614386 -34.626951197575053,-58.514561916095118 -34.626848215669597,-58.514439678571208 -34.626740447033853,-58.514107661336922 -34.626447901452302,-58.513672931158773 -34.626064901889173,-58.513561862033654 -34.625966282931685,-58.512713125374034 -34.625212805417966,-58.512617317928644 -34.625130377062554,-58.512489717008656 -34.625020566311555,-58.51177644293081 -34.624388509818957,-58.511651570390562 -34.62427862665416,-58.51121268042494 -34.624613883875163,-58.510735722089962 -34.624978239996757,-58.510563112939202 -34.625115213925675,-58.510696855859713 -34.625243123483223,-58.511285770229357 -34.625772626676472)));;455;10_8_1;COMUNA 10;8;1;1085;503;582;86,43%;468;468;100,00%;0;0,00%;406;5;1,23%;401;98,77%
MULTIPOLYGON (((-58.513834060396285 -34.628050957850249,-58.513472201685119 -34.627726309352681,-58.513367608380932 -34.627632406019174,-58.51324999954528 -34.627710767311029,-58.512127689086242 -34.628545832762434,-58.512015107614374 -34.62862954310777,-58.511108316495829 -34.629304506395123,-58.51009088411957 -34.630061762170939,-58.51109973191398 -34.63095343791106,-58.511931461499209 -34.631688481473901,-58.512044923578188 -34.631789847422262,-58.512907948175084 -34.631126304290476,-58.513023340698112 -34.631037591828914,-58.514037847471705 -34.630257495291715,-58.514907738097698 -34.629588653101777,-58.515127018194562 -34.629420102724836,-58.515248451735197 -34.629326103672412,-58.515648090622847 -34.629016976864563,-58.5159146283928 -34.6288107272171,-58.516382302005468 -34.6284502989554,-58.515547157830078 -34.627715498109083,-58.515422616253247 -34.627605830000668,-58.514303415681169 -34.628472534908987,-58.514213567504392 -34.628391372980751,-58.513834060396285 -34.628050957850249)));;456;10_8_2;COMUNA 10;8;2;1208;578;630;91,75%;489;487;99,59%;2;0,41%;428;11;2,57%;417;97,43%
MULTIPOLYGON (((-58.5122696748818 -34.626905649507755,-58.511684580989055 -34.626377769408528,-58.511137511214194 -34.625884097875613,-58.511285770229357 -34.625772626676472,-58.510696855859713 -34.625243123483223,-58.510563112939202 -34.625115213925675,-58.510184511859478 -34.62541558339209,-58.510082750652629 -34.62549632993619,-58.509362315758949 -34.626048316555497,-58.509494179065761 -34.626167354590699,-58.510068689333082 -34.626688136415119,-58.510297983986447 -34.626895941513311,-58.510620021308924 -34.627187797120179,-58.510705091396659 -34.627264949374165,-58.511185252748248 -34.627697450102062,-58.511707358155014 -34.628167609384242,-58.512035371265782 -34.628463050457867,-58.512127689086242 -34.628545832762434,-58.51324999954528 -34.627710767311029,-58.513367608380932 -34.627632406019174,-58.512941906709287 -34.62725024527473,-58.512865955923871 -34.627182034795183,-58.512430795079361 -34.626788044740522,-58.5122696748818 -34.626905649507755)));;457;10_8_3;COMUNA 10;8;3;800;363;437;83,07%;362;362;100,00%;0;0,00%;319;3;0,94%;316;99,06%
MULTIPOLYGON (((-58.510620021308924 -34.627187797120179,-58.510297983986447 -34.626895941513311,-58.510068689333082 -34.626688136415119,-58.509494179065761 -34.626167354590699,-58.509362315758949 -34.626048316555497,-58.509256123160654 -34.626129627496809,-58.508312802296906 -34.62683085270821,-58.508181058061595 -34.626928862961371,-58.507293759286142 -34.6275943538772,-58.508164528902277 -34.62833236712688,-58.508256928049313 -34.628415363608916,-58.509153141234741 -34.629220545534253,-58.509620007510726 -34.629640028742465,-58.510002573664757 -34.62998369525824,-58.51009088411957 -34.630061762170939,-58.511108316495829 -34.629304506395123,-58.512015107614374 -34.62862954310777,-58.512127689086242 -34.628545832762434,-58.512035371265782 -34.628463050457867,-58.511707358155014 -34.628167609384242,-58.511185252748248 -34.627697450102062,-58.510705091396659 -34.627264949374165,-58.510620021308924 -34.627187797120179)));;458;10_8_4;COMUNA 10;8;4;1021;509;512;99,41%;458;457;99,78%;1;0,22%;367;11;3,00%;356;97,00%
MULTIPOLYGON (((-58.509620007510726 -34.629640028742465,-58.509153141234741 -34.629220545534253,-58.508256928049313 -34.628415363608916,-58.508164528902277 -34.62833236712688,-58.507293759286142 -34.6275943538772,-58.507160991151004 -34.627693983164527,-58.506304499020651 -34.628324172698775,-58.507242632459132 -34.62917174947313,-58.508019594622283 -34.629873740240669,-58.508139101282111 -34.629980037351295,-58.509080418807144 -34.630817527802471,-58.509974444954089 -34.63161277428766,-58.510102139790398 -34.631725967904927,-58.511042983638248 -34.632560133169413,-58.512044923578188 -34.631789847422262,-58.511931461499209 -34.631688481473901,-58.51109973191398 -34.63095343791106,-58.51009088411957 -34.630061762170939,-58.510002573664757 -34.62998369525824,-58.509620007510726 -34.629640028742465)));;459;10_8_5;COMUNA 10;8;5;848;403;445;90,56%;327;327;100,00%;0;0,00%;302;6;1,99%;296;98,01%
MULTIPOLYGON (((-58.510104813815587 -34.633281370137993,-58.511042983638248 -34.632560133169413,-58.510102139790398 -34.631725967904927,-58.509974444954089 -34.63161277428766,-58.509080418807144 -34.630817527802471,-58.508139101282111 -34.629980037351295,-58.507314960908595 -34.630595291621106,-58.507198709940845 -34.630682167957502,-58.508029813889294 -34.63143167549979,-58.508135002399491 -34.631525653555585,-58.507103723264258 -34.632301622329543,-58.50815391206104 -34.633234998559516,-58.508256289619588 -34.633325878836352,-58.50908682708603 -34.634064674473024,-58.509204441687238 -34.63397357037411,-58.510104813815587 -34.633281370137993)));;460;10_8_6;COMUNA 10;8;6;882;421;461;91,32%;326;326;100,00%;0;0,00%;290;1;0,34%;289;99,66%
MULTIPOLYGON (((-58.506159168730747 -34.631459399513425,-58.505981424486556 -34.631592284009251,-58.505015446371509 -34.632314055223006,-58.505943051904694 -34.633171856680015,-58.506993687262252 -34.632384481967826,-58.507103723264258 -34.632301622329543,-58.508135002399491 -34.631525653555585,-58.508029813889294 -34.63143167549979,-58.507198709940845 -34.630682167957502,-58.507314960908595 -34.630595291621106,-58.508139101282111 -34.629980037351295,-58.508019594622283 -34.629873740240669,-58.507242632459132 -34.62917174947313,-58.506304499020651 -34.628324172698775,-58.505357036890665 -34.629021291655761,-58.504316045218957 -34.629787310664341,-58.504430092830795 -34.629890655429698,-58.505166636058213 -34.630558522051146,-58.505267644344961 -34.63065032087917,-58.505595390097191 -34.630948244119978,-58.506040855677554 -34.631353874737954,-58.506159168730747 -34.631459399513425)));;461;10_8_7;COMUNA 10;8;7;1154;539;615;87,64%;487;485;99,59%;2;0,41%;425;6;1,41%;419;98,59%
MULTIPOLYGON (((-58.502507060441644 -34.631118169969014,-58.502170126414384 -34.631366104579335,-58.502052335429944 -34.631453046925429,-58.501641896238539 -34.63175600557544,-58.501537647139351 -34.631834492111572,-58.501042120642218 -34.632207759798007,-58.50117412270847 -34.632262860894507,-58.502408175774107 -34.63279586322745,-58.503395531856491 -34.633222312368339,-58.503594265555314 -34.633308164208827,-58.503887509288646 -34.633434830254771,-58.504257280762687 -34.633591470524372,-58.504574131471692 -34.633725732749795,-58.503923484293395 -34.633129948948408,-58.505015446371509 -34.632314055223006,-58.505981424486556 -34.631592284009251,-58.506159168730747 -34.631459399513425,-58.506040855677554 -34.631353874737954,-58.505595390097191 -34.630948244119978,-58.505267644344961 -34.63065032087917,-58.505166636058213 -34.630558522051146,-58.504430092830795 -34.629890655429698,-58.504316045218957 -34.629787310664341,-58.503179559835736 -34.630623425180318,-58.502507060441644 -34.631118169969014)));;462;10_8_8;COMUNA 10;8;8;1121;504;617;81,69%;469;468;99,79%;1;0,21%;408;11;2,70%;397;97,30%
MULTIPOLYGON (((-58.50815391206104 -34.633234998559516,-58.507103723264258 -34.632301622329543,-58.506993687262252 -34.632384481967826,-58.505943051904694 -34.633171856680015,-58.505015446371509 -34.632314055223006,-58.503923484293395 -34.633129948948408,-58.504574131471692 -34.633725732749795,-58.505071380323947 -34.63423966232498,-58.505123381657711 -34.634293378396194,-58.505457300072457 -34.634638413887885,-58.505859822802726 -34.635007227777848,-58.506217840914523 -34.635315772557213,-58.506551646358403 -34.635591647861808,-58.506819391014595 -34.635812403524604,-58.506961724858407 -34.635890946046281,-58.507092429253106 -34.635890968967615,-58.507651629372411 -34.635891116273221,-58.508275922389274 -34.635728766662339,-58.508545633808119 -34.635643521976391,-58.508830508400195 -34.635553411646498,-58.509542244384846 -34.635289399428373,-58.509977873843475 -34.635103521090329,-58.510670759602945 -34.63481746660581,-58.509597902429562 -34.634718725699805,-58.509405246820535 -34.634700982145482,-58.50922298732285 -34.634685347066522,-58.50876363238141 -34.634646013090112,-58.508388369859041 -34.634599392154165,-58.508681518985192 -34.634378781848952,-58.50908682708603 -34.634064674473024,-58.508256289619588 -34.633325878836352,-58.50815391206104 -34.633234998559516)));;463;10_8_9;COMUNA 10;8;9;800;360;440;81,82%;333;327;98,20%;6;1,83%;264;2;0,76%;262;99,24%
MULTIPOLYGON (((-58.504963311794313 -34.627122843710474,-58.504503261531397 -34.627478577630683,-58.504155879269881 -34.627747226370232,-58.504043292642677 -34.627834521043638,-58.504517883617083 -34.628264444156315,-58.504616245734383 -34.628353145771165,-58.505357036890665 -34.629021291655761,-58.506304499020651 -34.628324172698775,-58.507160991151004 -34.627693983164527,-58.507293759286142 -34.6275943538772,-58.507178095397528 -34.62749636463316,-58.505962603632867 -34.626356481530252,-58.505869525267549 -34.626269187600336,-58.50476214541203 -34.625228764420285,-58.503727767731057 -34.62601942531343,-58.504842875344487 -34.627014994408356,-58.504963311794313 -34.627122843710474)));;464;10_9_1;COMUNA 10;9;1;838;389;449;86,64%;403;403;100,00%;0;0,00%;329;5;1,52%;324;98,48%
MULTIPOLYGON (((-58.501454416561479 -34.629109075809204,-58.5013319347742 -34.628996364407108,-58.500663019169266 -34.6283761310724,-58.500507894906342 -34.62823230117602,-58.499377545951553 -34.627176061368544,-58.499251157238241 -34.627272299742096,-58.49833495508598 -34.626866923315148,-58.497094193674812 -34.626317965073547,-58.495845864936754 -34.625765615816228,-58.495771641145673 -34.625931697954343,-58.495888654429763 -34.626034345723212,-58.496845225431883 -34.626873546820704,-58.496939144845001 -34.626955635951049,-58.497508971970724 -34.627453519682817,-58.497919428960408 -34.627812075935381,-58.498212785174935 -34.628068407970275,-58.498336793062009 -34.628176755733506,-58.4995452732431 -34.629242347946487,-58.500349011970876 -34.629951140287815,-58.500799128667666 -34.630348056006376,-58.500910870968845 -34.630262666097259,-58.501887409816369 -34.629507542353217,-58.501454416561479 -34.629109075809204)));;465;10_9_10;COMUNA 10;9;10;801;394;407;96,81%;298;298;100,00%;0;0,00%;279;4;1,43%;275;98,57%
MULTIPOLYGON (((-58.501967258563567 -34.625205329115502,-58.501510780371945 -34.625552740569987,-58.50188127340779 -34.625878407866487,-58.50281268617784 -34.626719964694715,-58.502908999146555 -34.62680697818589,-58.503630075188951 -34.627460211154464,-58.504043292642677 -34.627834521043638,-58.504155879269881 -34.627747226370232,-58.504503261531397 -34.627478577630683,-58.504963311794313 -34.627122843710474,-58.504842875344487 -34.627014994408356,-58.503727767731057 -34.62601942531343,-58.50476214541203 -34.625228764420285,-58.504669921786565 -34.62514203266263,-58.503492083494592 -34.624032394243372,-58.503331724344449 -34.624153296979145,-58.502651455141752 -34.624679173483273,-58.50242373167449 -34.624855239788182,-58.502198221450456 -34.625029544323063,-58.502081633023757 -34.625118317443672,-58.501967258563567 -34.625205329115502)));;466;10_9_2;COMUNA 10;9;2;899;413;486;84,98%;363;363;100,00%;0;0,00%;321;5;1,56%;316;98,44%
MULTIPOLYGON (((-58.499842079577959 -34.623452836031404,-58.49966552710427 -34.623375774329439,-58.498623941863634 -34.6229200838807,-58.498534053956448 -34.623093426157986,-58.498351060078015 -34.623487718712795,-58.498154275839511 -34.623911593458111,-58.498089591495365 -34.624057884870467,-58.499151893833435 -34.624522306297472,-58.499333390438466 -34.624601550416308,-58.500425274413487 -34.625078135335116,-58.500573115200162 -34.625142810042888,-58.501510780371945 -34.625552740569987,-58.501967258563567 -34.625205329115502,-58.502081633023757 -34.625118317443672,-58.502198221450456 -34.625029544323063,-58.50242373167449 -34.624855239788182,-58.502651455141752 -34.624679173483273,-58.503331724344449 -34.624153296979145,-58.503492083494592 -34.624032394243372,-58.502697302971129 -34.623642503187405,-58.501754257637032 -34.623171243227731,-58.501580936752369 -34.623084464615275,-58.501154068235593 -34.623883571083738,-58.501099258535795 -34.624001620571654,-58.499842079577959 -34.623452836031404)));;467;10_9_3;COMUNA 10;9;3;831;396;435;91,03%;349;349;100,00%;0;0,00%;303;2;0,66%;301;99,34%
MULTIPOLYGON (((-58.498200901583736 -34.621370506153113,-58.497856507933498 -34.621643502699811,-58.497663019708554 -34.621796873491022,-58.497121385150123 -34.622226197337056,-58.497375229181635 -34.622370707915493,-58.497865425461875 -34.622588180751102,-58.498623941863634 -34.6229200838807,-58.49966552710427 -34.623375774329439,-58.499842079577959 -34.623452836031404,-58.501099258535795 -34.624001620571654,-58.501154068235593 -34.623883571083738,-58.501580936752369 -34.623084464615275,-58.500270049429659 -34.622428021726158,-58.499343902551878 -34.621964132445981,-58.49917314274122 -34.621878124298973,-58.498200901583736 -34.621370506153113)));;468;10_9_4;COMUNA 10;9;4;840;390;450;86,67%;360;358;99,44%;2;0,56%;310;3;0,97%;307;99,03%
MULTIPOLYGON (((-58.498351060078015 -34.623487718712795,-58.498534053956448 -34.623093426157986,-58.498623941863634 -34.6229200838807,-58.497865425461875 -34.622588180751102,-58.497375229181635 -34.622370707915493,-58.497121385150123 -34.622226197337056,-58.496044997638343 -34.62307934270062,-58.495507604697345 -34.623505277738381,-58.494967821577298 -34.623933042061694,-58.494927026764451 -34.623965377900518,-58.495110832672601 -34.62408145995159,-58.495301014409257 -34.624161341593997,-58.49635027250617 -34.624637058892787,-58.49651140290937 -34.624710045006069,-58.497425527863015 -34.625115506299984,-58.497590152643305 -34.6251874336131,-58.498659453765271 -34.625654674234063,-58.498834221175599 -34.625732019590593,-58.499333390438466 -34.624601550416308,-58.499151893833435 -34.624522306297472,-58.498089591495365 -34.624057884870467,-58.498154275839511 -34.623911593458111,-58.498351060078015 -34.623487718712795)));;469;10_9_5;COMUNA 10;9;5;1001;460;541;85,03%;354;350;98,87%;4;1,14%;302;3;0,99%;299;99,01%
MULTIPOLYGON (((-58.500377744139136 -34.62641495610103,-58.501678290513091 -34.627413031949764,-58.50179207175465 -34.627507294495757,-58.501895540408697 -34.627592897984229,-58.502520641544052 -34.628158630074388,-58.502604938088552 -34.628235224821218,-58.502935477629663 -34.628535830566591,-58.503028980252886 -34.628620661691421,-58.503145656839685 -34.628529986213408,-58.504043292642677 -34.627834521043638,-58.503630075188951 -34.627460211154464,-58.502908999146555 -34.62680697818589,-58.50281268617784 -34.626719964694715,-58.50188127340779 -34.625878407866487,-58.501510780371945 -34.625552740569987,-58.500573115200162 -34.625142810042888,-58.500425274413487 -34.625078135335116,-58.499333390438466 -34.624601550416308,-58.498834221175599 -34.625732019590593,-58.500073451508356 -34.626280326829544,-58.500377744139136 -34.62641495610103)));;470;10_9_6;COMUNA 10;9;6;992;469;523;89,67%;384;384;100,00%;0;0,00%;343;15;4,37%;328;95,63%
MULTIPOLYGON (((-58.500799128667666 -34.630348056006376,-58.500296881494791 -34.630731464035428,-58.500417572690402 -34.630838543008203,-58.501537647139351 -34.631834492111572,-58.501641896238539 -34.63175600557544,-58.502052335429944 -34.631453046925429,-58.502170126414384 -34.631366104579335,-58.502507060441644 -34.631118169969014,-58.503179559835736 -34.630623425180318,-58.504316045218957 -34.629787310664341,-58.505357036890665 -34.629021291655761,-58.504616245734383 -34.628353145771165,-58.504517883617083 -34.628264444156315,-58.504043292642677 -34.627834521043638,-58.503145656839685 -34.628529986213408,-58.503028980252886 -34.628620661691421,-58.502001448901581 -34.629419333700483,-58.501887409816369 -34.629507542353217,-58.500910870968845 -34.630262666097259,-58.500799128667666 -34.630348056006376)));;471;10_9_7;COMUNA 10;9;7;885;407;478;85,15%;361;361;100,00%;0;0,00%;312;14;4,49%;298;95,51%
MULTIPOLYGON (((-58.500663019169266 -34.6283761310724,-58.5013319347742 -34.628996364407108,-58.501454416561479 -34.629109075809204,-58.501887409816369 -34.629507542353217,-58.502001448901581 -34.629419333700483,-58.503028980252886 -34.628620661691421,-58.502935477629663 -34.628535830566591,-58.502604938088552 -34.628235224821218,-58.502520641544052 -34.628158630074388,-58.501895540408697 -34.627592897984229,-58.50179207175465 -34.627507294495757,-58.501678290513091 -34.627413031949764,-58.500377744139136 -34.62641495610103,-58.500073451508356 -34.626280326829544,-58.498834221175599 -34.625732019590593,-58.498768685521618 -34.625880283469684,-58.49833495508598 -34.626866923315148,-58.499251157238241 -34.627272299742096,-58.499377545951553 -34.627176061368544,-58.500507894906342 -34.62823230117602,-58.500663019169266 -34.6283761310724)));;472;10_9_8;COMUNA 10;9;8;737;355;382;92,93%;300;299;99,67%;1;0,33%;259;6;2,32%;253;97,68%
MULTIPOLYGON (((-58.495110832672601 -34.62408145995159,-58.494927026764451 -34.623965377900518,-58.494201486973758 -34.624540375880329,-58.494617967458773 -34.624907604134641,-58.494707110285503 -34.624986245438905,-58.494775714565769 -34.625046722444267,-58.495510854707376 -34.625701901398081,-58.495577159350567 -34.625760970065109,-58.495771641145673 -34.625931697954343,-58.495845864936754 -34.625765615816228,-58.497094193674812 -34.626317965073547,-58.49833495508598 -34.626866923315148,-58.498768685521618 -34.625880283469684,-58.498834221175599 -34.625732019590593,-58.498659453765271 -34.625654674234063,-58.497590152643305 -34.6251874336131,-58.497425527863015 -34.625115506299984,-58.49651140290937 -34.624710045006069,-58.49635027250617 -34.624637058892787,-58.495301014409257 -34.624161341593997,-58.495110832672601 -34.62408145995159)));;473;10_9_9;COMUNA 10;9;9;685;337;348;96,84%;286;286;100,00%;0;0,00%;250;1;0,40%;249;99,60%
MULTIPOLYGON (((-58.517182826672418 -34.585732653458805,-58.517432247281889 -34.585483419611187,-58.515456641906539 -34.581272669581701,-58.51510512303409 -34.581304644615471,-58.515104145709721 -34.58130253802193,-58.515028924732583 -34.58130994913757,-58.514969678324327 -34.581314504385219,-58.514696763671182 -34.581558978997769,-58.514571566576834 -34.581684123532369,-58.51392103617416 -34.58239830088857,-58.513813818901596 -34.582516097153842,-58.513272541255958 -34.583117403635086,-58.512468056118358 -34.584011221586472,-58.512357261522858 -34.584134370332727,-58.511810258914039 -34.584737785270114,-58.513147143792892 -34.585562625659314,-58.513805105329304 -34.584834716719421,-58.515142010514801 -34.585658056292246,-58.515809450719615 -34.58606905193988,-58.516471445477649 -34.586476736312932,-58.516698053865959 -34.586232541886012,-58.516693111565409 -34.586221996038503,-58.517182826672418 -34.585732653458805)));;474;11_1_1;COMUNA 11;1;1;1032;472;560;84,29%;370;369;99,73%;1;0,27%;324;0;0,00%;324;100,00%
MULTIPOLYGON (((-58.50411684460164 -34.593241542455445,-58.503471839545547 -34.593953548200965,-58.504006392421708 -34.594278169902452,-58.505123086717447 -34.593863052226574,-58.505910854014459 -34.593570229123777,-58.506257857975342 -34.593441145290988,-58.506257990978824 -34.593441227405663,-58.506545355199272 -34.593334430159516,-58.507393564594331 -34.593018546656651,-58.506762314470265 -34.592628338287909,-58.507412130608827 -34.591907510082969,-58.506071964145583 -34.591081763810038,-58.50542231186769 -34.591800049609482,-58.505284856192397 -34.591952075499179,-58.504768647671447 -34.592521924944414,-58.50411684460164 -34.593241542455445)));;475;11_1_10;COMUNA 11;1;10;822;385;437;88,10%;416;416;100,00%;0;0,00%;340;1;0,29%;339;99,71%
MULTIPOLYGON (((-58.503543789060693 -34.594450092905667,-58.503543782400641 -34.594450117761816,-58.503181207085568 -34.594582220964853,-58.504779011883691 -34.594820492944834,-58.505092106688281 -34.594877340154149,-58.506623857554175 -34.595082850735622,-58.507255309765441 -34.595179949558045,-58.508453063038075 -34.595364231874086,-58.509627444007954 -34.595533023920815,-58.509259596635147 -34.595313546840636,-58.509275375206059 -34.595315890748495,-58.508783296321667 -34.594999797620844,-58.507446388247487 -34.594174629058273,-58.506257990978824 -34.593441227405663,-58.506257857975342 -34.593441145290988,-58.505910854014459 -34.593570229123777,-58.505123086717447 -34.593863052226574,-58.504006392421708 -34.594278169902452,-58.503471839545547 -34.593953548200965,-58.503083537468683 -34.594382215249922,-58.503543789060693 -34.594450092905667)));;476;11_1_11;COMUNA 11;1;11;895;390;505;77,23%;494;494;100,00%;0;0,00%;402;1;0,25%;401;99,75%
MULTIPOLYGON (((-58.511660338824576 -34.595828427866913,-58.511646095305899 -34.59573260176456,-58.511645100323221 -34.595693217450837,-58.511597131575655 -34.595613910223314,-58.511596083609241 -34.595612177607656,-58.511379470680801 -34.594373272179247,-58.511329227605813 -34.594085816163783,-58.511161651500927 -34.593099153937622,-58.511058680762794 -34.59249262159031,-58.510926829217752 -34.591716093785543,-58.510674036130098 -34.591796830418254,-58.509662122757206 -34.592173647357455,-58.509049776648368 -34.592401707367308,-58.508529041459354 -34.592595714501705,-58.507393564594331 -34.593018546656651,-58.506545355199272 -34.593334430159516,-58.506257990978824 -34.593441227405663,-58.507446388247487 -34.594174629058273,-58.508783296321667 -34.594999797620844,-58.509275375206059 -34.595315890748495,-58.509259596635147 -34.595313546840636,-58.509627444007954 -34.595533023920815,-58.509651836815813 -34.59553652973603,-58.5100846205221 -34.595804260205696,-58.511679258820152 -34.595996666253534,-58.511660338824576 -34.595828427866913)));;477;11_1_12;COMUNA 11;1;12;676;301;375;80,27%;353;350;99,15%;3;0,86%;266;5;1,88%;261;98,12%
MULTIPOLYGON (((-58.518882438916542 -34.589345616585753,-58.519203097668097 -34.589257369327555,-58.517432247281889 -34.585483419611187,-58.517182826672418 -34.585732653458805,-58.516693111565409 -34.586221996038503,-58.516698053865959 -34.586232541886012,-58.516471445477649 -34.586476736312932,-58.515817242639208 -34.587207052253383,-58.51571521389122 -34.587320974443983,-58.515165154909539 -34.587933631151486,-58.514581559372033 -34.588583625023212,-58.514534755607457 -34.588635759675576,-58.514515608607908 -34.588657106689524,-58.514480293011147 -34.588696489452822,-58.515260660410995 -34.590305093322591,-58.515372677777293 -34.590359131684878,-58.516667617184751 -34.589995452861984,-58.517814383701577 -34.589651123833512,-58.517886184245789 -34.589670176654344,-58.518270856777825 -34.589564927485142,-58.518250900887523 -34.589521343282101,-58.518250111215877 -34.589519634034986,-58.518882438916542 -34.589345616585753)));;478;11_1_2;COMUNA 11;1;2;933;420;513;81,87%;392;392;100,00%;0;0,00%;339;1;0,29%;338;99,71%
MULTIPOLYGON (((-58.515809450719615 -34.58606905193988,-58.515142010514801 -34.585658056292246,-58.513805105329304 -34.584834716719421,-58.513147143792892 -34.585562625659314,-58.512491893873481 -34.586287431147213,-58.513407049569423 -34.586852570158271,-58.513680244213084 -34.587021265972389,-58.513832217986021 -34.587114656867527,-58.513757672691113 -34.587197367466246,-58.51443689429064 -34.588609462117937,-58.514515608607908 -34.588657106689524,-58.514534755607457 -34.588635759675576,-58.514581559372033 -34.588583625023212,-58.515165154909539 -34.587933631151486,-58.51571521389122 -34.587320974443983,-58.515817242639208 -34.587207052253383,-58.516471445477649 -34.586476736312932,-58.515809450719615 -34.58606905193988)));;479;11_1_3;COMUNA 11;1;3;720;325;395;82,28%;287;286;99,65%;1;0,35%;247;1;0,40%;246;99,60%
MULTIPOLYGON (((-58.509788291073207 -34.586971982554495,-58.509021855735092 -34.587819633954389,-58.510359019048643 -34.588646405837622,-58.51112612921689 -34.587798041636276,-58.511728300669219 -34.587132140598776,-58.511830250140392 -34.58701934857325,-58.512491893873481 -34.586287431147213,-58.513147143792892 -34.585562625659314,-58.511810258914039 -34.584737785270114,-58.511154407074812 -34.585461386688053,-58.511040629589793 -34.585586859433704,-58.510492757902263 -34.586192874414373,-58.509788291073207 -34.586971982554495)));;480;11_1_4;COMUNA 11;1;4;846;399;447;89,26%;371;371;100,00%;0;0,00%;316;3;0,95%;313;99,05%
MULTIPOLYGON (((-58.513407049569423 -34.586852570158271,-58.512491893873481 -34.586287431147213,-58.511830250140392 -34.58701934857325,-58.511728300669219 -34.587132140598776,-58.51112612921689 -34.587798041636276,-58.510359019048643 -34.588646405837622,-58.511138823122906 -34.589128512501148,-58.511703023925548 -34.589477385720244,-58.511808040258913 -34.589361705084549,-58.512469445830632 -34.588627393686615,-58.513173474339759 -34.587845876005289,-58.513278400958669 -34.587729419433302,-58.513757672691113 -34.587197367466246,-58.513832217986021 -34.587114656867527,-58.513680244213084 -34.587021265972389,-58.513407049569423 -34.586852570158271)));;481;11_1_5;COMUNA 11;1;5;587;272;315;86,35%;268;268;100,00%;0;0,00%;221;8;3,62%;213;96,38%
MULTIPOLYGON (((-58.513490644238239 -34.590586065231797,-58.513880052943982 -34.590828165688407,-58.514829653885563 -34.590545780715019,-58.515372677777293 -34.590359131684878,-58.515260660410995 -34.590305093322591,-58.514480293011147 -34.588696489452822,-58.514515608607908 -34.588657106689524,-58.51443689429064 -34.588609462117937,-58.513757672691113 -34.587197367466246,-58.513278400958669 -34.587729419433302,-58.513173474339759 -34.587845876005289,-58.512469445830632 -34.588627393686615,-58.511808040258913 -34.589361705084549,-58.511703023925548 -34.589477385720244,-58.512213815824488 -34.589793178078097,-58.512368093447392 -34.589888541727298,-58.512488806808548 -34.589963213827311,-58.513032233627165 -34.590301102969299,-58.513490644238239 -34.590586065231797)));;482;11_1_6;COMUNA 11;1;6;802;384;418;91,87%;322;322;100,00%;0;0,00%;278;1;0,36%;277;99,64%
MULTIPOLYGON (((-58.510187063480146 -34.591148333208849,-58.510777511398949 -34.591511567137019,-58.511034195900429 -34.591681824601508,-58.511374005300645 -34.591573304968385,-58.512433799962722 -34.59125821731233,-58.513880052943982 -34.590828165688407,-58.513490644238239 -34.590586065231797,-58.513032233627165 -34.590301102969299,-58.512488806808548 -34.589963213827311,-58.512368093447392 -34.589888541727298,-58.512213815824488 -34.589793178078097,-58.511703023925548 -34.589477385720244,-58.511138823122906 -34.589128512501148,-58.510360635758339 -34.589986388350297,-58.509621921667055 -34.590800721096791,-58.510187063480146 -34.591148333208849)));;483;11_1_7;COMUNA 11;1;7;720;323;397;81,36%;336;335;99,70%;1;0,30%;252;1;0,40%;251;99,60%
MULTIPOLYGON (((-58.510360635758339 -34.589986388350297,-58.511138823122906 -34.589128512501148,-58.510359019048643 -34.588646405837622,-58.509021855735092 -34.587819633954389,-58.508244000678545 -34.58867982040578,-58.507504172463875 -34.589497943896262,-58.508843730586364 -34.590321984682163,-58.509621921667055 -34.590800721096791,-58.510360635758339 -34.589986388350297)));;484;11_1_8;COMUNA 11;1;8;675;336;339;99,12%;367;367;100,00%;0;0,00%;295;1;0,34%;294;99,66%
MULTIPOLYGON (((-58.508843730586364 -34.590321984682163,-58.507504172463875 -34.589497943896262,-58.506723817988949 -34.590360867940269,-58.506071964145583 -34.591081763810038,-58.507412130608827 -34.591907510082969,-58.506762314470265 -34.592628338287909,-58.507393564594331 -34.593018546656651,-58.508529041459354 -34.592595714501705,-58.509049776648368 -34.592401707367308,-58.509662122757206 -34.592173647357455,-58.510674036130098 -34.591796830418254,-58.510926829217752 -34.591716093785543,-58.511034195900429 -34.591681824601508,-58.510777511398949 -34.591511567137019,-58.510187063480146 -34.591148333208849,-58.509621921667055 -34.590800721096791,-58.508843730586364 -34.590321984682163)));;485;11_1_9;COMUNA 11;1;9;781;356;425;83,76%;401;401;100,00%;0;0,00%;304;2;0,66%;302;99,34%
MULTIPOLYGON (((-58.494715769031906 -34.596947684774236,-58.493417713175766 -34.597033373859873,-58.492908863143228 -34.597067445869691,-58.492758796115915 -34.597287773156651,-58.49271790781728 -34.597347782580613,-58.492029048651403 -34.598358766776087,-58.491507156696827 -34.599124836086652,-58.492604261490349 -34.599777836665886,-58.492691261613054 -34.59966203622627,-58.493161669909767 -34.599032881458719,-58.493940220100065 -34.597991658585279,-58.494715769031906 -34.596947684774236)));;486;11_10_1;COMUNA 11;10;1;724;324;400;81,00%;372;371;99,73%;1;0,27%;315;1;0,32%;314;99,68%
MULTIPOLYGON (((-58.480780260760007 -34.598831181376823,-58.4803223590066 -34.599028509481656,-58.479747274925536 -34.599276276763575,-58.478831289142441 -34.599670923492965,-58.478542837475196 -34.599734977826692,-58.4777284926517 -34.599910932656826,-58.477264343518208 -34.600011204049565,-58.4769147405461 -34.600086741128081,-58.47639233627887 -34.600199551665142,-58.47610464712109 -34.600261698663253,-58.476403359039573 -34.60020039792515,-58.476455754686818 -34.600238899007316,-58.476732020502283 -34.600391633107527,-58.4770020148014 -34.600447519393271,-58.478029616120189 -34.600511473753706,-58.479126236319914 -34.60058986301371,-58.479116892146358 -34.600713883096432,-58.479201897237282 -34.600746337659437,-58.479921210617761 -34.600628346431037,-58.480416815186246 -34.600659473854016,-58.480856719363572 -34.600689480761119,-58.48162154865291 -34.600741549650202,-58.481849387991844 -34.600794544301699,-58.482041523855479 -34.600770358145226,-58.4838060869712 -34.600890492819524,-58.484379541252089 -34.60092947827988,-58.484604711819571 -34.600865210261887,-58.484620842112385 -34.600667875884405,-58.484674056128597 -34.60060490616042,-58.483586770653574 -34.600527699793794,-58.483420600033369 -34.600502515892913,-58.483135109403158 -34.600482774549263,-58.482942880363041 -34.600469918773889,-58.483344968184603 -34.600150402560601,-58.48436143011962 -34.599732534284072,-58.483855929284466 -34.598947522378786,-58.482856428247601 -34.599388201474611,-58.482417227049382 -34.598702965171327,-58.482127383768947 -34.598250740693189,-58.480780260760007 -34.598831181376823)));;487;11_10_10;COMUNA 11;10;10;713;344;369;93,22%;324;324;100,00%;0;0,00%;281;5;1,78%;276;98,22%
MULTIPOLYGON (((-58.48952676783378 -34.597296554980588,-58.488544489606717 -34.597363952676851,-58.489212397958546 -34.597757275324618,-58.490357595966202 -34.598440427807851,-58.490515952332068 -34.598534902498614,-58.491507156696827 -34.599124836086652,-58.492029048651403 -34.598358766776087,-58.49271790781728 -34.597347782580613,-58.492758796115915 -34.597287773156651,-58.492908863143228 -34.597067445869691,-58.492489944005619 -34.597095460048536,-58.491217519354493 -34.597180885407859,-58.490186189136978 -34.597250068405124,-58.48952676783378 -34.597296554980588)));;488;11_10_2;COMUNA 11;10;2;956;434;522;83,14%;474;473;99,79%;1;0,21%;384;2;0,52%;382;99,48%
MULTIPOLYGON (((-58.491507156696827 -34.599124836086652,-58.490515952332068 -34.598534902498614,-58.490357595966202 -34.598440427807851,-58.489212397958546 -34.597757275324618,-58.488606291877709 -34.598645467960516,-58.489753114781237 -34.599327005889975,-58.49090319345418 -34.600010433689114,-58.491405177640246 -34.599274443332902,-58.491507156696827 -34.599124836086652)));;489;11_10_3;COMUNA 11;10;3;715;314;401;78,30%;406;406;100,00%;0;0,00%;317;2;0,63%;315;99,37%
MULTIPOLYGON (((-58.490690657079973 -34.600902206858962,-58.490790562748522 -34.600908733446097,-58.491605906085475 -34.600962207039593,-58.491707686600101 -34.600971549440423,-58.491958478157407 -34.600637603579209,-58.492604261490349 -34.599777836665886,-58.491507156696827 -34.599124836086652,-58.491405177640246 -34.599274443332902,-58.49090319345418 -34.600010433689114,-58.489753114781237 -34.599327005889975,-58.489650962087161 -34.599476893405523,-58.489266779521891 -34.600040520391957,-58.488709522517816 -34.600857925217362,-58.488271488365477 -34.600827946230524,-58.488404801969217 -34.600905597240875,-58.488983718089656 -34.601242740295604,-58.490014888761571 -34.601312868612339,-58.490073457287963 -34.601227007146321,-58.490198510921907 -34.601043732606357,-58.49025316314566 -34.600963505950631,-58.490311986596012 -34.600877362606859,-58.490690657079973 -34.600902206858962)));;490;11_10_4;COMUNA 11;10;4;956;423;533;79,36%;428;427;99,77%;1;0,23%;364;1;0,27%;363;99,73%
MULTIPOLYGON (((-58.488606291877709 -34.598645467960516,-58.487651401261743 -34.598077968992591,-58.487461191092422 -34.597964130098539,-58.486975354653424 -34.59867587489768,-58.488120291082531 -34.599357780674133,-58.487445375499263 -34.600346830560639,-58.488271488365477 -34.600827946230524,-58.488709522517816 -34.600857925217362,-58.489266779521891 -34.600040520391957,-58.489650962087161 -34.599476893405523,-58.489753114781237 -34.599327005889975,-58.488606291877709 -34.598645467960516)));;491;11_10_5;COMUNA 11;10;5;942;423;519;81,50%;496;494;99,60%;2;0,40%;386;6;1,55%;380;98,45%
MULTIPOLYGON (((-58.487798284463594 -34.597416293557608,-58.487353643849318 -34.597447441741949,-58.487143374330792 -34.597462907175313,-58.486681104748648 -34.597496943874738,-58.486486930962769 -34.59751120778315,-58.486130519700119 -34.597537404511314,-58.485821322666006 -34.597988607702298,-58.486975354653424 -34.59867587489768,-58.487461191092422 -34.597964130098539,-58.487651401261743 -34.598077968992591,-58.488606291877709 -34.598645467960516,-58.489212397958546 -34.597757275324618,-58.488544489606717 -34.597363952676851,-58.487798284463594 -34.597416293557608)));;492;11_10_6;COMUNA 11;10;6;982;445;537;82,87%;570;570;100,00%;0;0,00%;458;1;0,22%;457;99,78%
MULTIPOLYGON (((-58.488120291082531 -34.599357780674133,-58.486975354653424 -34.59867587489768,-58.485821322666006 -34.597988607702298,-58.485132512946961 -34.598993704609853,-58.485522641185376 -34.599221176229861,-58.486295493216737 -34.599671821193702,-58.486512537246817 -34.599798333181255,-58.487265127785804 -34.600241933388027,-58.487445375499263 -34.600346830560639,-58.488120291082531 -34.599357780674133)));;493;11_10_7;COMUNA 11;10;7;982;454;528;85,98%;417;417;100,00%;0;0,00%;401;1;0,25%;400;99,75%
MULTIPOLYGON (((-58.48303701540528 -34.597771278181284,-58.482915261924937 -34.597911233402215,-58.482127383768947 -34.598250740693189,-58.482417227049382 -34.598702965171327,-58.482856428247601 -34.599388201474611,-58.483855929284466 -34.598947522378786,-58.48436143011962 -34.599732534284072,-58.485522641185376 -34.599221176229861,-58.485132512946961 -34.598993704609853,-58.485821322666006 -34.597988607702298,-58.486130519700119 -34.597537404511314,-58.484855152351585 -34.59763462318368,-58.484853484884169 -34.597634759471646,-58.48303701540528 -34.597771278181284)));;494;11_10_8;COMUNA 11;10;8;748;322;426;75,59%;406;403;99,26%;3;0,74%;318;1;0,31%;317;99,69%
MULTIPOLYGON (((-58.487445375499263 -34.600346830560639,-58.487265127785804 -34.600241933388027,-58.486512537246817 -34.599798333181255,-58.486295493216737 -34.599671821193702,-58.485522641185376 -34.599221176229861,-58.48436143011962 -34.599732534284072,-58.483344968184603 -34.600150402560601,-58.482942880363041 -34.600469918773889,-58.483135109403158 -34.600482774549263,-58.483420600033369 -34.600502515892913,-58.483586770653574 -34.600527699793794,-58.484674056128597 -34.60060490616042,-58.484620842112385 -34.600667875884405,-58.484604711819571 -34.600865210261887,-58.484379541252089 -34.60092947827988,-58.486372795192175 -34.601065098959893,-58.488415540113479 -34.601204057065267,-58.488983718089656 -34.601242740295604,-58.488404801969217 -34.600905597240875,-58.488271488365477 -34.600827946230524,-58.487445375499263 -34.600346830560639)));;495;11_10_9;COMUNA 11;10;9;757;376;381;98,69%;401;401;100,00%;0;0,00%;319;2;0,63%;317;99,37%
MULTIPOLYGON (((-58.480856719363572 -34.600689480761119,-58.480416815186246 -34.600659473854016,-58.479921210617761 -34.600628346431037,-58.480591063331609 -34.601021504510783,-58.481068243576459 -34.601301725991895,-58.481274806872754 -34.601422966948824,-58.481732570086251 -34.601690653078776,-58.481892200122637 -34.601783871059062,-58.482589320217734 -34.602152928377812,-58.48261982458245 -34.602208770592519,-58.482923847842621 -34.602764798003982,-58.483816343183889 -34.60439724363092,-58.483959991427511 -34.604247283469078,-58.484691321388027 -34.603421700202219,-58.485018367406745 -34.603052542364857,-58.485125906482793 -34.602932025131295,-58.485004998817722 -34.602746406463218,-58.484493424759151 -34.601954497031159,-58.48407848093472 -34.601312222049692,-58.483871437399529 -34.600991612118818,-58.4838060869712 -34.600890492819524,-58.482041523855479 -34.600770358145226,-58.481849387991844 -34.600794544301699,-58.48162154865291 -34.600741549650202,-58.480856719363572 -34.600689480761119)));;496;11_11_1;COMUNA 11;11;1;827;376;451;83,37%;295;295;100,00%;0;0,00%;293;0;0,00%;293;100,00%
MULTIPOLYGON (((-58.483816343183889 -34.60439724363092,-58.482923847842621 -34.602764798003982,-58.48261982458245 -34.602208770592519,-58.482589320217734 -34.602152928377812,-58.481892200122637 -34.601783871059062,-58.481794112343863 -34.601906989720177,-58.481051120675637 -34.602833195198734,-58.480466575718829 -34.603561689531965,-58.480325653310629 -34.603737350400017,-58.481589422859372 -34.604427750685865,-58.481245164193439 -34.604854932217656,-58.481148945181715 -34.604975866834337,-58.481939593059145 -34.605273924915778,-58.482728376798811 -34.605588809779853,-58.483286371950236 -34.604981088515672,-58.483654816266352 -34.604579672700474,-58.483816343183889 -34.60439724363092)));;497;11_11_2;COMUNA 11;11;2;888;425;463;91,79%;361;361;100,00%;0;0,00%;309;1;0,32%;308;99,68%
MULTIPOLYGON (((-58.479921210617761 -34.600628346431037,-58.479201897237282 -34.600746337659437,-58.479075623328981 -34.600908262263964,-58.478638131094243 -34.601469186653631,-58.478055366617149 -34.602216261623077,-58.479171223665794 -34.602838886189232,-58.480466575718829 -34.603561689531965,-58.481051120675637 -34.602833195198734,-58.481794112343863 -34.601906989720177,-58.481892200122637 -34.601783871059062,-58.481732570086251 -34.601690653078776,-58.481274806872754 -34.601422966948824,-58.481068243576459 -34.601301725991895,-58.480591063331609 -34.601021504510783,-58.479921210617761 -34.600628346431037)));;498;11_11_3;COMUNA 11;11;3;953;471;482;97,72%;332;332;100,00%;0;0,00%;325;9;2,77%;316;97,23%
MULTIPOLYGON (((-58.476924548303316 -34.602662964926999,-58.477472847193276 -34.602963192839077,-58.477947821425666 -34.602354167667947,-58.478055366617149 -34.602216261623077,-58.478638131094243 -34.601469186653631,-58.479075623328981 -34.600908262263964,-58.479201897237282 -34.600746337659437,-58.479116892146358 -34.600713883096432,-58.479126236319914 -34.60058986301371,-58.478029616120189 -34.600511473753706,-58.4770020148014 -34.600447519393271,-58.476732020502283 -34.600391633107527,-58.477498785852312 -34.600825080226478,-58.47697146327441 -34.601583904373477,-58.47638161959793 -34.602365691792485,-58.476924548303316 -34.602662964926999)));;499;11_11_4;COMUNA 11;11;4;294;141;153;92,16%;119;119;100,00%;0;0,00%;102;1;0,98%;101;99,02%
MULTIPOLYGON (((-58.479886533573485 -34.604284687180773,-58.480325653310629 -34.603737350400017,-58.480466575718829 -34.603561689531965,-58.479171223665794 -34.602838886189232,-58.478055366617149 -34.602216261623077,-58.477947821425666 -34.602354167667947,-58.477472847193276 -34.602963192839077,-58.47714109397316 -34.603391769885647,-58.476807292557453 -34.603816472851861,-58.477743598101561 -34.604332014230927,-58.477930485627709 -34.604433966712747,-58.477281785390879 -34.60527041538716,-58.477174063818424 -34.605403602216143,-58.477864380320938 -34.605777898578836,-58.478438683400768 -34.606089316360517,-58.47920753429748 -34.605131009899736,-58.479886533573485 -34.604284687180773)));;500;11_11_5;COMUNA 11;11;5;952;450;502;89,64%;373;373;100,00%;0;0,00%;335;0;0,00%;335;100,00%
MULTIPOLYGON (((-58.480325653310629 -34.603737350400017,-58.479886533573485 -34.604284687180773,-58.47920753429748 -34.605131009899736,-58.479838570494515 -34.605475442841964,-58.480327439728541 -34.605742284587315,-58.480476513009847 -34.60582923804153,-58.481224590320522 -34.606176886223423,-58.481723510748338 -34.606408719511961,-58.481899756482747 -34.606491371042956,-58.482386576305409 -34.605961203268521,-58.482728376798811 -34.605588809779853,-58.481939593059145 -34.605273924915778,-58.481148945181715 -34.604975866834337,-58.481245164193439 -34.604854932217656,-58.481589422859372 -34.604427750685865,-58.480325653310629 -34.603737350400017)));;501;11_11_6;COMUNA 11;11;6;1017;472;545;86,61%;417;417;100,00%;0;0,00%;396;11;2,78%;385;97,22%
MULTIPOLYGON (((-58.481899756482747 -34.606491371042956,-58.481723510748338 -34.606408719511961,-58.481224590320522 -34.606176886223423,-58.480476513009847 -34.60582923804153,-58.480327439728541 -34.605742284587315,-58.479838570494515 -34.605475442841964,-58.47920753429748 -34.605131009899736,-58.478438683400768 -34.606089316360517,-58.47746475749922 -34.607303004418576,-58.477618424665927 -34.607359677972134,-58.478723476346666 -34.607703705548552,-58.478945116099624 -34.607762340385584,-58.479203724599508 -34.607830758919434,-58.479669236189253 -34.607944995071598,-58.47980816587318 -34.607979061439025,-58.480206812088355 -34.60807689583676,-58.48041030939298 -34.608126727467543,-58.480552944129983 -34.607958390591349,-58.480996011122954 -34.607475842284458,-58.481517840883654 -34.606907431946148,-58.481899756482747 -34.606491371042956)));;502;11_11_7;COMUNA 11;11;7;878;401;477;84,07%;345;345;100,00%;0;0,00%;305;2;0,66%;303;99,34%
MULTIPOLYGON (((-58.476050692974233 -34.604786312786295,-58.47521871117241 -34.605852778965264,-58.475111667671769 -34.605990823228083,-58.475263802891057 -34.606082078671797,-58.476201836419449 -34.606650661654804,-58.476364707328138 -34.606749379593829,-58.476895395814701 -34.607026512416915,-58.477328978582307 -34.607252878066483,-58.47746475749922 -34.607303004418576,-58.478438683400768 -34.606089316360517,-58.477864380320938 -34.605777898578836,-58.477174063818424 -34.605403602216143,-58.477281785390879 -34.60527041538716,-58.477930485627709 -34.604433966712747,-58.477743598101561 -34.604332014230927,-58.476807292557453 -34.603816472851861,-58.476658784135353 -34.604006849220013,-58.476050692974233 -34.604786312786295)));;503;11_11_8;COMUNA 11;11;8;867;385;482;79,88%;372;372;100,00%;0;0,00%;315;6;1,90%;309;98,10%
MULTIPOLYGON (((-58.474341283712633 -34.605512853116863,-58.474953995948631 -34.605896117316242,-58.475111667671769 -34.605990823228083,-58.47521871117241 -34.605852778965264,-58.476050692974233 -34.604786312786295,-58.476658784135353 -34.604006849220013,-58.476807292557453 -34.603816472851861,-58.47714109397316 -34.603391769885647,-58.477472847193276 -34.602963192839077,-58.476924548303316 -34.602662964926999,-58.47638161959793 -34.602365691792485,-58.475736321879637 -34.603170863364525,-58.475705240325283 -34.60320967096559,-58.474932449839223 -34.604174012623481,-58.474016658573369 -34.605311115537432,-58.474162317943545 -34.605400894036833,-58.474341283712633 -34.605512853116863)));;504;11_11_9;COMUNA 11;11;9;906;397;509;78,00%;313;313;100,00%;0;0,00%;296;1;0,34%;295;99,66%
MULTIPOLYGON (((-58.490740939433124 -34.602265979592836,-58.49132020421893 -34.601490960451059,-58.489955894496248 -34.601399434396328,-58.490014888761571 -34.601312868612339,-58.488983718089656 -34.601242740295604,-58.488415540113479 -34.601204057065267,-58.486372795192175 -34.601065098959893,-58.486647937958246 -34.601224347118617,-58.487804911949382 -34.601893787936355,-58.488982178881592 -34.602574974345657,-58.489191567445836 -34.602696130838346,-58.489999653390477 -34.603165336669008,-58.490740939433124 -34.602265979592836)));;505;11_12_1;COMUNA 11;12;1;580;261;319;81,82%;279;279;100,00%;0;0,00%;233;2;0,86%;231;99,14%
MULTIPOLYGON (((-58.484402186792934 -34.607768252573671,-58.483428639875534 -34.608865575082966,-58.48367345467679 -34.608925817156745,-58.484057117841246 -34.609020261125835,-58.484354491479323 -34.609093521268619,-58.484654591490639 -34.609167414021222,-58.484993194900099 -34.609250806397561,-58.485645862090024 -34.608450867177602,-58.48575689515993 -34.608314784880832,-58.486364251862391 -34.607577458207551,-58.485158662411443 -34.606914633290778,-58.4850392828615 -34.607050082776311,-58.484402186792934 -34.607768252573671)));;506;11_12_10;COMUNA 11;12;10;604;273;331;82,48%;312;312;100,00%;0;0,00%;261;2;0,77%;259;99,23%
MULTIPOLYGON (((-58.488982178881592 -34.602574974345657,-58.487804911949382 -34.601893787936355,-58.486647937958246 -34.601224347118617,-58.485836524933603 -34.602135172117173,-58.48699461359174 -34.602809127518228,-58.488172143597232 -34.603494406248089,-58.488982178881592 -34.602574974345657)));;507;11_12_2;COMUNA 11;12;2;587;259;328;78,96%;263;263;100,00%;0;0,00%;236;0;0,00%;236;100,00%
MULTIPOLYGON (((-58.485125906482793 -34.602932025131295,-58.485018367406745 -34.603052542364857,-58.484691321388027 -34.603421700202219,-58.48544512611069 -34.603860733509705,-58.485871899226304 -34.604077774062354,-58.486013828589961 -34.604192540079197,-58.48703453918435 -34.604785532085039,-58.488172143597232 -34.603494406248089,-58.48699461359174 -34.602809127518228,-58.485836524933603 -34.602135172117173,-58.486647937958246 -34.601224347118617,-58.486372795192175 -34.601065098959893,-58.484379541252089 -34.60092947827988,-58.4838060869712 -34.600890492819524,-58.483871437399529 -34.600991612118818,-58.48407848093472 -34.601312222049692,-58.484493424759151 -34.601954497031159,-58.485004998817722 -34.602746406463218,-58.485125906482793 -34.602932025131295)));;508;11_12_3;COMUNA 11;12;3;1009;484;525;92,19%;425;424;99,76%;1;0,24%;360;5;1,39%;355;98,61%
MULTIPOLYGON (((-58.489999653390477 -34.603165336669008,-58.489191567445836 -34.602696130838346,-58.488982178881592 -34.602574974345657,-58.488172143597232 -34.603494406248089,-58.48703453918435 -34.604785532085039,-58.488136534469312 -34.605425753862292,-58.488219973845275 -34.605324535467865,-58.489223954987914 -34.604106458733661,-58.489999653390477 -34.603165336669008)));;509;11_12_4;COMUNA 11;12;4;622;282;340;82,94%;336;336;100,00%;0;0,00%;272;1;0,37%;271;99,63%
MULTIPOLYGON (((-58.486188018120821 -34.605746367761419,-58.485158662411443 -34.606914633290778,-58.486364251862391 -34.607577458207551,-58.487337294451557 -34.606396165365595,-58.488136534469312 -34.605425753862292,-58.48703453918435 -34.604785532085039,-58.486188018120821 -34.605746367761419)));;510;11_12_5;COMUNA 11;12;5;655;307;348;88,22%;289;289;100,00%;0;0,00%;245;0;0,00%;245;100,00%
MULTIPOLYGON (((-58.483816343183889 -34.60439724363092,-58.483654816266352 -34.604579672700474,-58.483286371950236 -34.604981088515672,-58.482728376798811 -34.605588809779853,-58.483951729627464 -34.606252993847356,-58.48445266420191 -34.605685560438147,-58.484994547993544 -34.605071636829891,-58.486188018120821 -34.605746367761419,-58.48703453918435 -34.604785532085039,-58.486013828589961 -34.604192540079197,-58.485871899226304 -34.604077774062354,-58.48544512611069 -34.603860733509705,-58.484691321388027 -34.603421700202219,-58.483959991427511 -34.604247283469078,-58.483816343183889 -34.60439724363092)));;511;11_12_6;COMUNA 11;12;6;881;424;457;92,78%;370;369;99,73%;1;0,27%;320;1;0,31%;319;99,69%
MULTIPOLYGON (((-58.484994547993544 -34.605071636829891,-58.48445266420191 -34.605685560438147,-58.483951729627464 -34.606252993847356,-58.483838479828464 -34.606381257738718,-58.483576726690046 -34.606677651874314,-58.483197377142425 -34.607107027935314,-58.484402186792934 -34.607768252573671,-58.4850392828615 -34.607050082776311,-58.485158662411443 -34.606914633290778,-58.486188018120821 -34.605746367761419,-58.484994547993544 -34.605071636829891)));;512;11_12_7;COMUNA 11;12;7;664;301;363;82,92%;289;289;100,00%;0;0,00%;259;4;1,54%;255;98,46%
MULTIPOLYGON (((-58.481517840883654 -34.606907431946148,-58.480996011122954 -34.607475842284458,-58.482265293663986 -34.608164051129705,-58.482375652334923 -34.608035930051734,-58.482727335799055 -34.607638534170235,-58.483084210182689 -34.607235220669978,-58.483197377142425 -34.607107027935314,-58.483576726690046 -34.606677651874314,-58.483838479828464 -34.606381257738718,-58.483951729627464 -34.606252993847356,-58.482728376798811 -34.605588809779853,-58.482386576305409 -34.605961203268521,-58.481899756482747 -34.606491371042956,-58.481517840883654 -34.606907431946148)));;513;11_12_8;COMUNA 11;12;8;756;352;404;87,13%;302;302;100,00%;0;0,00%;272;1;0,37%;271;99,63%
MULTIPOLYGON (((-58.480996011122954 -34.607475842284458,-58.480552944129983 -34.607958390591349,-58.48041030939298 -34.608126727467543,-58.481318937599234 -34.608349135631826,-58.481969299074223 -34.608507420784299,-58.482213685705119 -34.608566891182235,-58.483428639875534 -34.608865575082966,-58.484402186792934 -34.607768252573671,-58.483197377142425 -34.607107027935314,-58.483084210182689 -34.607235220669978,-58.482727335799055 -34.607638534170235,-58.482375652334923 -34.608035930051734,-58.482265293663986 -34.608164051129705,-58.480996011122954 -34.607475842284458)));;514;11_12_9;COMUNA 11;12;9;596;259;337;76,85%;299;299;100,00%;0;0,00%;240;3;1,25%;237;98,75%
MULTIPOLYGON (((-58.494640634116834 -34.602236780583567,-58.495992697065724 -34.60304109751219,-58.496531625853798 -34.602322964355572,-58.496641010930077 -34.602177435503357,-58.496945584776469 -34.601772546303771,-58.497006448106511 -34.601691610639087,-58.497142730341302 -34.601510086473162,-58.497204955217924 -34.601427248840992,-58.495341137277634 -34.601302897751864,-58.495382167615766 -34.601248236800714,-58.49500969859541 -34.601189953489779,-58.494516464422453 -34.600920354504659,-58.49436813315581 -34.601008635893066,-58.494278973108571 -34.601040913751142,-58.494195338021044 -34.601044104502186,-58.494000465984598 -34.601031900657752,-58.493880364263468 -34.600997211773304,-58.49371918595218 -34.600894995432178,-58.493571234798559 -34.601092012295751,-58.492617740955204 -34.601029289658172,-58.491707686600101 -34.600971549440423,-58.491605906085475 -34.600962207039593,-58.490790562748522 -34.600908733446097,-58.490690657079973 -34.600902206858962,-58.490311986596012 -34.600877362606859,-58.49025316314566 -34.600963505950631,-58.490198510921907 -34.601043732606357,-58.490073457287963 -34.601227007146321,-58.490014888761571 -34.601312868612339,-58.489955894496248 -34.601399434396328,-58.49132020421893 -34.601490960451059,-58.491744564836083 -34.601517811196182,-58.491780997249855 -34.601540123753203,-58.492788053673785 -34.602138163201246,-58.493116565616063 -34.601696938236586,-58.49380684622971 -34.601743075282549,-58.494640634116834 -34.602236780583567)));;515;11_13_1;COMUNA 11;13;1;709;291;418;69,62%;429;429;100,00%;0;0,00%;346;6;1,73%;340;98,27%
MULTIPOLYGON (((-58.48988602481009 -34.607839480532157,-58.489752699747768 -34.607764929940373,-58.488616078238948 -34.607119448489385,-58.487627449045476 -34.608270823889328,-58.48872232758437 -34.608871110402923,-58.488885470739525 -34.608962064766182,-58.489389540147293 -34.608396512149596,-58.490651416416732 -34.609102945783945,-58.491055860835573 -34.608664526447413,-58.49116041995952 -34.60855203316428,-58.491866782577524 -34.607791767833284,-58.491991177955477 -34.607657648559965,-58.491835614952507 -34.607567612047227,-58.490707155560351 -34.606918274725992,-58.48988602481009 -34.607839480532157)));;516;11_13_10;COMUNA 11;13;10;656;300;356;84,27%;292;292;100,00%;0;0,00%;250;1;0,40%;249;99,60%
MULTIPOLYGON (((-58.488885470739525 -34.608962064766182,-58.48872232758437 -34.608871110402923,-58.487627449045476 -34.608270823889328,-58.486887683526284 -34.609132413014258,-58.486473176538134 -34.60961511786909,-58.487821218222024 -34.609941479462542,-58.487983663298685 -34.609973841461183,-58.488157267528415 -34.610008313668949,-58.488654323809975 -34.610136030529858,-58.488897307815343 -34.610309717356742,-58.489142167216762 -34.6104848117903,-58.489274482529247 -34.610586336052513,-58.48971615239536 -34.610110728685001,-58.490135678746526 -34.609658928355231,-58.490549836335141 -34.609213043486776,-58.490651416416732 -34.609102945783945,-58.489389540147293 -34.608396512149596,-58.488885470739525 -34.608962064766182)));;517;11_13_11;COMUNA 11;13;11;846;394;452;87,17%;399;399;100,00%;0;0,00%;336;4;1,19%;332;98,81%
MULTIPOLYGON (((-58.49380684622971 -34.601743075282549,-58.493116565616063 -34.601696938236586,-58.492788053673785 -34.602138163201246,-58.494121099024738 -34.602929336063397,-58.495327063404147 -34.603645032496814,-58.495473763961094 -34.603732531691008,-58.495992697065724 -34.60304109751219,-58.494640634116834 -34.602236780583567,-58.49380684622971 -34.601743075282549)));;518;11_13_2;COMUNA 11;13;2;819;360;459;78,43%;454;454;100,00%;0;0,00%;387;22;5,68%;365;94,32%
MULTIPOLYGON (((-58.491780997249855 -34.601540123753203,-58.491744564836083 -34.601517811196182,-58.49132020421893 -34.601490960451059,-58.490740939433124 -34.602265979592836,-58.492102500417118 -34.603058787719263,-58.493439893178746 -34.60383750159594,-58.494121099024738 -34.602929336063397,-58.492788053673785 -34.602138163201246,-58.491780997249855 -34.601540123753203)));;519;11_13_3;COMUNA 11;13;3;717;297;420;70,71%;409;409;100,00%;0;0,00%;321;2;0,62%;319;99,38%
MULTIPOLYGON (((-58.493439893178746 -34.60383750159594,-58.492669740918544 -34.604715472672801,-58.494008272195323 -34.60549256004056,-58.494797757160718 -34.604628519729928,-58.495383103016373 -34.603853335206253,-58.495473763961094 -34.603732531691008,-58.495327063404147 -34.603645032496814,-58.494121099024738 -34.602929336063397,-58.493439893178746 -34.60383750159594)));;520;11_13_4;COMUNA 11;13;4;763;335;428;78,27%;447;447;100,00%;0;0,00%;345;7;2,03%;338;97,97%
MULTIPOLYGON (((-58.493439893178746 -34.60383750159594,-58.492102500417118 -34.603058787719263,-58.490740939433124 -34.602265979592836,-58.489999653390477 -34.603165336669008,-58.491341968435201 -34.603944635831745,-58.492669740918544 -34.604715472672801,-58.493439893178746 -34.60383750159594)));;521;11_13_5;COMUNA 11;13;5;892;378;514;73,54%;449;449;100,00%;0;0,00%;393;6;1,53%;387;98,47%
MULTIPOLYGON (((-58.491851208222954 -34.605635212459461,-58.49079391642244 -34.606820856792339,-58.490707155560351 -34.606918274725992,-58.491835614952507 -34.607567612047227,-58.491991177955477 -34.607657648559965,-58.493026768621924 -34.606540452665257,-58.493161548021234 -34.606396540493741,-58.494008272195323 -34.60549256004056,-58.492669740918544 -34.604715472672801,-58.491341968435201 -34.603944635831745,-58.489999653390477 -34.603165336669008,-58.489223954987914 -34.604106458733661,-58.490543703243382 -34.604874433006096,-58.491851208222954 -34.605635212459461)));;522;11_13_6;COMUNA 11;13;6;955;384;571;67,25%;436;433;99,31%;3;0,69%;373;2;0,54%;371;99,46%
MULTIPOLYGON (((-58.489426817280048 -34.606175294793466,-58.488616078238948 -34.607119448489385,-58.489752699747768 -34.607764929940373,-58.48988602481009 -34.607839480532157,-58.490707155560351 -34.606918274725992,-58.49079391642244 -34.606820856792339,-58.491851208222954 -34.605635212459461,-58.490543703243382 -34.604874433006096,-58.489426817280048 -34.606175294793466)));;523;11_13_7;COMUNA 11;13;7;813;344;469;73,35%;356;355;99,72%;1;0,28%;299;1;0,33%;298;99,67%
MULTIPOLYGON (((-58.490543703243382 -34.604874433006096,-58.489223954987914 -34.604106458733661,-58.488219973845275 -34.605324535467865,-58.488136534469312 -34.605425753862292,-58.487337294451557 -34.606396165365595,-58.488475173169903 -34.607039475365362,-58.488616078238948 -34.607119448489385,-58.489426817280048 -34.606175294793466,-58.490543703243382 -34.604874433006096)));;524;11_13_8;COMUNA 11;13;8;712;327;385;84,94%;344;344;100,00%;0;0,00%;281;0;0,00%;281;100,00%
MULTIPOLYGON (((-58.488616078238948 -34.607119448489385,-58.488475173169903 -34.607039475365362,-58.487337294451557 -34.606396165365595,-58.486364251862391 -34.607577458207551,-58.48575689515993 -34.608314784880832,-58.485645862090024 -34.608450867177602,-58.484993194900099 -34.609250806397561,-58.485163476469239 -34.609292748540398,-58.485381801748275 -34.609346653794532,-58.485736506382928 -34.609434196193199,-58.486086782209568 -34.609520682031423,-58.486282620102521 -34.609569026394986,-58.486473176538134 -34.60961511786909,-58.486887683526284 -34.609132413014258,-58.487627449045476 -34.608270823889328,-58.488616078238948 -34.607119448489385)));;525;11_13_9;COMUNA 11;13;9;994;464;530;87,55%;460;460;100,00%;0;0,00%;371;23;6,20%;348;93,80%
MULTIPOLYGON (((-58.496941995781881 -34.608590901134569,-58.49677287655107 -34.608486155883696,-58.496240057479788 -34.608181573958746,-58.495978589876891 -34.608029879383359,-58.495075584287669 -34.609218264745202,-58.494973935904127 -34.609357240446691,-58.495161111845249 -34.609460645296146,-58.495853588261376 -34.609838360285501,-58.496015378674251 -34.609930432267326,-58.497069393605905 -34.610592276811751,-58.497283071074499 -34.610708769984733,-58.497166264466976 -34.610852188555612,-58.496674854969299 -34.611455446966779,-58.496563409500659 -34.611591187114897,-58.497533077625661 -34.612149666815334,-58.498158512533585 -34.611438474887457,-58.498299756709621 -34.611275963050183,-58.498443895053732 -34.611110210642657,-58.499351372059856 -34.610080396744593,-58.49920831983691 -34.609994943545274,-58.498515207199404 -34.609562527479845,-58.498310385603702 -34.609437019442424,-58.498131380221075 -34.609327349216734,-58.496941995781881 -34.608590901134569)));;526;11_14_1;COMUNA 11;14;1;972;451;521;86,56%;421;421;100,00%;0;0,00%;364;3;0,82%;361;99,18%
MULTIPOLYGON (((-58.49394302744939 -34.606852838744572,-58.493788230314678 -34.606762522812957,-58.49334641646098 -34.606502977037735,-58.493161548021234 -34.606396540493741,-58.493026768621924 -34.606540452665257,-58.491991177955477 -34.607657648559965,-58.492161224230053 -34.607756132393746,-58.492682441899966 -34.608061298410114,-58.492814237458873 -34.608137465951707,-58.493590958654153 -34.608586372858589,-58.493763478034104 -34.608682670637961,-58.494829613934314 -34.609277486872394,-58.494973935904127 -34.609357240446691,-58.495075584287669 -34.609218264745202,-58.495978589876891 -34.608029879383359,-58.495752223958306 -34.607898598030395,-58.495055836512051 -34.607496375427367,-58.494890303111809 -34.607401626966642,-58.494740871871301 -34.607316170171721,-58.494097739690858 -34.606943013649918,-58.49394302744939 -34.606852838744572)));;527;11_14_2;COMUNA 11;14;2;819;384;435;88,28%;414;414;100,00%;0;0,00%;332;2;0,60%;330;99,40%
MULTIPOLYGON (((-58.493063148775633 -34.609610909251181,-58.493212155387454 -34.609693269468934,-58.49371225597497 -34.609974843849749,-58.493828037834142 -34.610040028022517,-58.494277108020867 -34.610288724552099,-58.494456617562626 -34.610388118218793,-58.495271022390462 -34.610848695008961,-58.495449427569312 -34.610949566427081,-58.496563409500659 -34.611591187114897,-58.496674854969299 -34.611455446966779,-58.497166264466976 -34.610852188555612,-58.497283071074499 -34.610708769984733,-58.497069393605905 -34.610592276811751,-58.496015378674251 -34.609930432267326,-58.495853588261376 -34.609838360285501,-58.495161111845249 -34.609460645296146,-58.494973935904127 -34.609357240446691,-58.494829613934314 -34.609277486872394,-58.493763478034104 -34.608682670637961,-58.493590958654153 -34.608586372858589,-58.492814237458873 -34.608137465951707,-58.492682441899966 -34.608061298410114,-58.492161224230053 -34.607756132393746,-58.491991177955477 -34.607657648559965,-58.491866782577524 -34.607791767833284,-58.49116041995952 -34.60855203316428,-58.491328506457762 -34.608646011392601,-58.492023944535113 -34.60903670570373,-58.492186495517807 -34.609128078342628,-58.492492342839398 -34.609295334142089,-58.492608974328078 -34.609359815020817,-58.493063148775633 -34.609610909251181)));;528;11_14_3;COMUNA 11;14;3;1008;490;518;94,59%;413;413;100,00%;0;0,00%;365;1;0,27%;364;99,73%
MULTIPOLYGON (((-58.494907820031983 -34.611296061265634,-58.494664831565963 -34.611595361418544,-58.494349131305071 -34.611984331102029,-58.49455735738961 -34.612101886812724,-58.495484164141203 -34.612640674913827,-58.495631135486313 -34.612726272234838,-58.495818577643895 -34.612835450800958,-58.496148305603292 -34.613024945168384,-58.496368210294754 -34.61315136812442,-58.496560425897577 -34.613263854203836,-58.497404089923315 -34.612296328611841,-58.497533077625661 -34.612149666815334,-58.496563409500659 -34.611591187114897,-58.495449427569312 -34.610949566427081,-58.495271022390462 -34.610848695008961,-58.494907820031983 -34.611296061265634)));;529;11_14_4;COMUNA 11;14;4;699;334;365;91,51%;335;335;100,00%;0;0,00%;279;0;0,00%;279;100,00%
MULTIPOLYGON (((-58.492023944535113 -34.60903670570373,-58.491328506457762 -34.608646011392601,-58.49116041995952 -34.60855203316428,-58.491055860835573 -34.608664526447413,-58.490651416416732 -34.609102945783945,-58.490549836335141 -34.609213043486776,-58.490135678746526 -34.609658928355231,-58.48971615239536 -34.610110728685001,-58.490632674309033 -34.610619836711763,-58.491040439457713 -34.610155852456423,-58.491683917280902 -34.610511207259009,-58.492184867695237 -34.61078792832852,-58.492732679503014 -34.611090481814536,-58.49339534112265 -34.611456386573508,-58.493606801127576 -34.611573238852813,-58.494147721698937 -34.611870646656904,-58.494349131305071 -34.611984331102029,-58.494664831565963 -34.611595361418544,-58.494907820031983 -34.611296061265634,-58.495271022390462 -34.610848695008961,-58.494456617562626 -34.610388118218793,-58.494277108020867 -34.610288724552099,-58.493828037834142 -34.610040028022517,-58.49371225597497 -34.609974843849749,-58.493212155387454 -34.609693269468934,-58.493063148775633 -34.609610909251181,-58.492608974328078 -34.609359815020817,-58.492492342839398 -34.609295334142089,-58.492186495517807 -34.609128078342628,-58.492023944535113 -34.60903670570373)));;530;11_14_5;COMUNA 11;14;5;970;420;550;76,36%;404;403;99,75%;1;0,25%;328;3;0,91%;325;99,09%
MULTIPOLYGON (((-58.491683917280902 -34.610511207259009,-58.491040439457713 -34.610155852456423,-58.490632674309033 -34.610619836711763,-58.48971615239536 -34.610110728685001,-58.489274482529247 -34.610586336052513,-58.490103313640859 -34.611222232271693,-58.490254460806703 -34.611338188372876,-58.490679871914566 -34.611660356809878,-58.490731504240259 -34.611699430887072,-58.491229341242068 -34.612076371448673,-58.491699491625205 -34.612432329862052,-58.492265415552573 -34.612860801106791,-58.493044806990071 -34.61351232343182,-58.493305176824769 -34.613193655340396,-58.493777135537158 -34.612646966964107,-58.494349131305071 -34.611984331102029,-58.494147721698937 -34.611870646656904,-58.493606801127576 -34.611573238852813,-58.49339534112265 -34.611456386573508,-58.492732679503014 -34.611090481814536,-58.492184867695237 -34.61078792832852,-58.491683917280902 -34.610511207259009)));;531;11_14_6;COMUNA 11;14;6;1045;476;569;83,66%;487;487;100,00%;0;0,00%;409;5;1,22%;404;98,78%
MULTIPOLYGON (((-58.494349131305071 -34.611984331102029,-58.493777135537158 -34.612646966964107,-58.493305176824769 -34.613193655340396,-58.493044806990071 -34.61351232343182,-58.493315858437136 -34.613750010765138,-58.493438475448173 -34.61385758944391,-58.494056333111992 -34.614389141476913,-58.494609778686453 -34.614865212249654,-58.494785655369235 -34.615016016597579,-58.495573016670065 -34.614391066256644,-58.496439694107067 -34.613402343354451,-58.496560425897577 -34.613263854203836,-58.496368210294754 -34.61315136812442,-58.496148305603292 -34.613024945168384,-58.495818577643895 -34.612835450800958,-58.495631135486313 -34.612726272234838,-58.495484164141203 -34.612640674913827,-58.49455735738961 -34.612101886812724,-58.494349131305071 -34.611984331102029)));;532;11_14_7;COMUNA 11;14;7;1649;735;914;80,42%;797;797;100,00%;0;0,00%;696;2;0,29%;694;99,71%
MULTIPOLYGON (((-58.491905467524873 -34.616104314182181,-58.49203890661223 -34.616217455212933,-58.492636406118862 -34.616728314161804,-58.493710018254831 -34.615868649174637,-58.49382932605257 -34.615773122422922,-58.494785655369235 -34.615016016597579,-58.494609778686453 -34.614865212249654,-58.494056333111992 -34.614389141476913,-58.493438475448173 -34.61385758944391,-58.493315858437136 -34.613750010765138,-58.493044806990071 -34.61351232343182,-58.492265415552573 -34.612860801106791,-58.491205977129383 -34.613748690942707,-58.492231793609847 -34.614614323160964,-58.491699375862346 -34.6150388322989,-58.491157755314582 -34.615470665437833,-58.491905467524873 -34.616104314182181)));;533;11_15_1;COMUNA 11;15;1;990;477;513;92,98%;437;437;100,00%;0;0,00%;349;5;1,43%;344;98,57%
MULTIPOLYGON (((-58.484779549770295 -34.61175150014634,-58.486038443655239 -34.612412205331353,-58.486264774162912 -34.612127433178863,-58.486452955940372 -34.611890486667264,-58.486639604032298 -34.611655723335453,-58.486837831264502 -34.611406168147589,-58.485565833851439 -34.610764488336244,-58.485226263032871 -34.610593277636497,-58.484927840524747 -34.610442693054978,-58.484626948594475 -34.610290910956472,-58.484291896662072 -34.610121880008485,-58.484002933558941 -34.609976080385998,-58.483748132324003 -34.609847528341241,-58.483494268957472 -34.609719468577502,-58.483384886454367 -34.609664273875339,-58.482979218232458 -34.609459123166914,-58.482597734762265 -34.609935682355385,-58.482487120773982 -34.610073874427961,-58.482221441758718 -34.610407591426664,-58.482726020310622 -34.61067364614842,-58.482977501358953 -34.610805722117533,-58.483228216467296 -34.610937304718405,-58.483515564366563 -34.611088036185407,-58.484150238085356 -34.611421177842992,-58.484779549770295 -34.61175150014634)));;534;11_15_10;COMUNA 11;15;10;917;409;508;80,51%;360;360;100,00%;0;0,00%;331;3;0,91%;328;99,09%
MULTIPOLYGON (((-58.486038443655239 -34.612412205331353,-58.484779549770295 -34.61175150014634,-58.484150238085356 -34.611421177842992,-58.483515564366563 -34.611088036185407,-58.483114661610841 -34.611589741936164,-58.482713584245815 -34.612093840811021,-58.48381605351571 -34.612673394327722,-58.483977749064813 -34.612758017189101,-58.485252150330716 -34.613401755227073,-58.486501962456082 -34.614076894262347,-58.487297528469504 -34.613075010164444,-58.488107891110161 -34.612054454987764,-58.487470302987965 -34.61172922215993,-58.486837831264502 -34.611406168147589,-58.486639604032298 -34.611655723335453,-58.486452955940372 -34.611890486667264,-58.486264774162912 -34.612127433178863,-58.486038443655239 -34.612412205331353)));;535;11_15_11;COMUNA 11;15;11;1057;519;538;96,47%;429;429;100,00%;0;0,00%;434;50;11,52%;384;88,48%
MULTIPOLYGON (((-58.491205977129383 -34.613748690942707,-58.490672367523331 -34.614174393163545,-58.490135175725342 -34.614602981255345,-58.48917872560969 -34.615366036843206,-58.489061542041263 -34.615459586693959,-58.490083098802693 -34.616327420833507,-58.490828340868994 -34.616963189396124,-58.491561749877647 -34.617588744507813,-58.492636406118862 -34.616728314161804,-58.49203890661223 -34.616217455212933,-58.491905467524873 -34.616104314182181,-58.491157755314582 -34.615470665437833,-58.491699375862346 -34.6150388322989,-58.492231793609847 -34.614614323160964,-58.491205977129383 -34.613748690942707)));;536;11_15_2;COMUNA 11;15;2;914;453;461;98,26%;371;371;100,00%;0;0,00%;324;13;4,01%;311;95,99%
MULTIPOLYGON (((-58.490679871914566 -34.611660356809878,-58.490254460806703 -34.611338188372876,-58.490103313640859 -34.611222232271693,-58.489628729956735 -34.611866938881782,-58.48908021624478 -34.612557365469819,-58.489538997607916 -34.612809457640694,-58.489695248728346 -34.612897524947819,-58.488965617657286 -34.613814337037709,-58.488877233276781 -34.613925627649351,-58.488080060232583 -34.614929423717271,-58.488696040836423 -34.615262122843689,-58.489061542041263 -34.615459586693959,-58.48917872560969 -34.615366036843206,-58.490135175725342 -34.614602981255345,-58.490672367523331 -34.614174393163545,-58.491205977129383 -34.613748690942707,-58.492265415552573 -34.612860801106791,-58.491699491625205 -34.612432329862052,-58.491229341242068 -34.612076371448673,-58.490731504240259 -34.611699430887072,-58.490679871914566 -34.611660356809878)));;537;11_15_3;COMUNA 11;15;3;1025;469;556;84,35%;416;416;100,00%;0;0,00%;368;5;1,36%;363;98,64%
MULTIPOLYGON (((-58.487297528469504 -34.613075010164444,-58.486501962456082 -34.614076894262347,-58.48701237213443 -34.614352648610797,-58.487461443425225 -34.614595243070134,-58.488080060232583 -34.614929423717271,-58.488877233276781 -34.613925627649351,-58.488965617657286 -34.613814337037709,-58.489695248728346 -34.612897524947819,-58.489538997607916 -34.612809457640694,-58.48908021624478 -34.612557365469819,-58.489628729956735 -34.611866938881782,-58.490103313640859 -34.611222232271693,-58.489274482529247 -34.610586336052513,-58.488768376883186 -34.611222524808234,-58.488648575935372 -34.611373400917017,-58.488107891110161 -34.612054454987764,-58.487297528469504 -34.613075010164444)));;538;11_15_4;COMUNA 11;15;4;972;468;504;92,86%;413;413;100,00%;0;0,00%;356;1;0,28%;355;99,72%
MULTIPOLYGON (((-58.489274482529247 -34.610586336052513,-58.489142167216762 -34.6104848117903,-58.488897307815343 -34.610309717356742,-58.488654323809975 -34.610136030529858,-58.488157267528415 -34.610008313668949,-58.487983663298685 -34.609973841461183,-58.487675941394016 -34.610351383464909,-58.487511692897357 -34.610558114683563,-58.487349827711014 -34.610761816913069,-58.487186343923803 -34.610967561574171,-58.487023029607386 -34.61117302427521,-58.486837831264502 -34.611406168147589,-58.487470302987965 -34.61172922215993,-58.488107891110161 -34.612054454987764,-58.488648575935372 -34.611373400917017,-58.488768376883186 -34.611222524808234,-58.489274482529247 -34.610586336052513)));;539;11_15_5;COMUNA 11;15;5;794;379;415;91,33%;384;384;100,00%;0;0,00%;329;6;1,82%;323;98,18%
MULTIPOLYGON (((-58.484354491479323 -34.609093521268619,-58.484057117841246 -34.609020261125835,-58.48367345467679 -34.608925817156745,-58.483428639875534 -34.608865575082966,-58.482979218232458 -34.609459123166914,-58.483384886454367 -34.609664273875339,-58.483494268957472 -34.609719468577502,-58.483748132324003 -34.609847528341241,-58.484002933558941 -34.609976080385998,-58.484291896662072 -34.610121880008485,-58.484626948594475 -34.610290910956472,-58.484927840524747 -34.610442693054978,-58.485226263032871 -34.610593277636497,-58.485565833851439 -34.610764488336244,-58.486837831264502 -34.611406168147589,-58.487023029607386 -34.61117302427521,-58.487186343923803 -34.610967561574171,-58.487349827711014 -34.610761816913069,-58.487511692897357 -34.610558114683563,-58.487675941394016 -34.610351383464909,-58.487983663298685 -34.609973841461183,-58.487821218222024 -34.609941479462542,-58.486473176538134 -34.60961511786909,-58.486282620102521 -34.609569026394986,-58.486086782209568 -34.609520682031423,-58.485736506382928 -34.609434196193199,-58.485381801748275 -34.609346653794532,-58.485163476469239 -34.609292748540398,-58.484993194900099 -34.609250806397561,-58.484654591490639 -34.609167414021222,-58.484354491479323 -34.609093521268619)));;540;11_15_6;COMUNA 11;15;6;887;444;443;100,23%;329;329;100,00%;0;0,00%;313;1;0,32%;312;99,68%
MULTIPOLYGON (((-58.482979218232458 -34.609459123166914,-58.483428639875534 -34.608865575082966,-58.482213685705119 -34.608566891182235,-58.481969299074223 -34.608507420784299,-58.481318937599234 -34.608349135631826,-58.48041030939298 -34.608126727467543,-58.480042356926134 -34.608586163498963,-58.47966426714688 -34.609059684822675,-58.479816410703471 -34.60914001864618,-58.480973937496998 -34.609748816825416,-58.481349979010062 -34.609276700313039,-58.482597734762265 -34.609935682355385,-58.482979218232458 -34.609459123166914)));;541;11_15_7;COMUNA 11;15;7;672;287;385;74,55%;367;367;100,00%;0;0,00%;281;24;8,54%;257;91,46%
MULTIPOLYGON (((-58.481349979010062 -34.609276700313039,-58.480973937496998 -34.609748816825416,-58.479816410703471 -34.60914001864618,-58.47966426714688 -34.609059684822675,-58.479261136990374 -34.609564688370781,-58.480571919206731 -34.610253542779731,-58.481821471652026 -34.610910137936962,-58.482221441758718 -34.610407591426664,-58.482487120773982 -34.610073874427961,-58.482597734762265 -34.609935682355385,-58.481349979010062 -34.609276700313039)));;542;11_15_8;COMUNA 11;15;8;843;403;440;91,59%;421;421;100,00%;0;0,00%;372;45;12,10%;327;87,90%
MULTIPOLYGON (((-58.482726020310622 -34.61067364614842,-58.482221441758718 -34.610407591426664,-58.481821471652026 -34.610910137936962,-58.480571919206731 -34.610253542779731,-58.479261136990374 -34.609564688370781,-58.478859534771104 -34.610067648014947,-58.480170917951746 -34.610757069995827,-58.481420474867036 -34.611414021329907,-58.482713584245815 -34.612093840811021,-58.483114661610841 -34.611589741936164,-58.483515564366563 -34.611088036185407,-58.483228216467296 -34.610937304718405,-58.482977501358953 -34.610805722117533,-58.482726020310622 -34.61067364614842)));;543;11_15_9;COMUNA 11;15;9;816;381;435;87,59%;418;418;100,00%;0;0,00%;337;4;1,19%;333;98,81%
MULTIPOLYGON (((-58.483639654196629 -34.615430988841368,-58.48354938750569 -34.615544529490343,-58.482840274449678 -34.616436300168886,-58.484103823703272 -34.617096812754475,-58.484509259479061 -34.61658630026205,-58.484906941072488 -34.616085506448819,-58.485306917080315 -34.615581823446689,-58.48570552578461 -34.615079829551831,-58.486105662453774 -34.614575932544355,-58.486501962456082 -34.614076894262347,-58.485252150330716 -34.613401755227073,-58.483977749064813 -34.612758017189101,-58.483857170717151 -34.612909311243328,-58.483179165608213 -34.613763190183455,-58.484438248098712 -34.614425953954111,-58.483639654196629 -34.615430988841368)));;544;11_16_1;COMUNA 11;16;1;897;423;474;89,24%;374;374;100,00%;0;0,00%;319;17;5,33%;302;94,67%
MULTIPOLYGON (((-58.482840274449678 -34.616436300168886,-58.481582111539986 -34.615774505936599,-58.481437195759945 -34.615698257947926,-58.480315193678976 -34.615107981438875,-58.479513562572869 -34.6161154545294,-58.480780573808644 -34.616778677249584,-58.482042578612955 -34.617439281803087,-58.483305540883045 -34.618101563265171,-58.483386698654272 -34.61799992621809,-58.483656569751368 -34.617660008971228,-58.484103823703272 -34.617096812754475,-58.482840274449678 -34.616436300168886)));;545;11_16_10;COMUNA 11;16;10;666;318;348;91,38%;276;276;100,00%;0;0,00%;236;5;2,12%;231;97,88%
MULTIPOLYGON (((-58.481914821232031 -34.613097667593422,-58.481114676457295 -34.614103249819564,-58.48238056303596 -34.614768921191853,-58.483639654196629 -34.615430988841368,-58.484438248098712 -34.614425953954111,-58.483179165608213 -34.613763190183455,-58.483857170717151 -34.612909311243328,-58.483977749064813 -34.612758017189101,-58.48381605351571 -34.612673394327722,-58.482713584245815 -34.612093840811021,-58.481914821232031 -34.613097667593422)));;546;11_16_2;COMUNA 11;16;2;889;400;489;81,80%;486;486;100,00%;0;0,00%;359;7;1,95%;352;98,05%
MULTIPOLYGON (((-58.482713584245815 -34.612093840811021,-58.481420474867036 -34.611414021329907,-58.480622043364015 -34.612417135460099,-58.479821548823402 -34.613422850220537,-58.480027115502374 -34.613531346244805,-58.481114676457295 -34.614103249819564,-58.481914821232031 -34.613097667593422,-58.482713584245815 -34.612093840811021)));;547;11_16_3;COMUNA 11;16;3;678;319;359;88,86%;331;331;100,00%;0;0,00%;267;5;1,87%;262;98,13%
MULTIPOLYGON (((-58.481420474867036 -34.611414021329907,-58.480170917951746 -34.610757069995827,-58.478859534771104 -34.610067648014947,-58.478060658976162 -34.611068210362021,-58.478207608222917 -34.611146011515004,-58.479372562712626 -34.611759330946427,-58.480622043364015 -34.612417135460099,-58.481420474867036 -34.611414021329907)));;548;11_16_4;COMUNA 11;16;4;667;303;364;83,24%;316;316;100,00%;0;0,00%;252;13;5,16%;239;94,84%
MULTIPOLYGON (((-58.47725963495477 -34.612071373301475,-58.477161272726569 -34.612194628916164,-58.476460039961594 -34.613075798309467,-58.477611549154716 -34.613685685046967,-58.477771195883754 -34.613769682545637,-58.478572399921717 -34.612763910773957,-58.479372562712626 -34.611759330946427,-58.478207608222917 -34.611146011515004,-58.478060658976162 -34.611068210362021,-58.47725963495477 -34.612071373301475)));;549;11_16_5;COMUNA 11;16;5;769;355;414;85,75%;333;333;100,00%;0;0,00%;288;12;4,17%;276;95,83%
MULTIPOLYGON (((-58.477771195883754 -34.613769682545637,-58.477611549154716 -34.613685685046967,-58.476460039961594 -34.613075798309467,-58.475660766406875 -34.614080006604418,-58.476971846169917 -34.614773195073326,-58.477771195883754 -34.613769682545637)));;550;11_16_6;COMUNA 11;16;6;810;391;419;93,32%;387;387;100,00%;0;0,00%;335;3;0,90%;332;99,10%
MULTIPOLYGON (((-58.478572399921717 -34.612763910773957,-58.477771195883754 -34.613769682545637,-58.476971846169917 -34.614773195073326,-58.478001642623809 -34.615317667254779,-58.478221012797839 -34.615433559187061,-58.479021801431486 -34.614427573514767,-58.479821548823402 -34.613422850220537,-58.480622043364015 -34.612417135460099,-58.479372562712626 -34.611759330946427,-58.478572399921717 -34.612763910773957)));;551;11_16_7;COMUNA 11;16;7;838;371;467;79,44%;425;425;100,00%;0;0,00%;350;31;8,86%;319;91,14%
MULTIPOLYGON (((-58.479021801431486 -34.614427573514767,-58.478221012797839 -34.615433559187061,-58.478910307642778 -34.615797567075944,-58.479357573001785 -34.616033782871362,-58.479513562572869 -34.6161154545294,-58.480315193678976 -34.615107981438875,-58.481114676457295 -34.614103249819564,-58.480027115502374 -34.613531346244805,-58.479821548823402 -34.613422850220537,-58.479021801431486 -34.614427573514767)));;552;11_16_8;COMUNA 11;16;8;1016;458;558;82,08%;458;458;100,00%;0;0,00%;393;7;1,78%;386;98,22%
MULTIPOLYGON (((-58.48238056303596 -34.614768921191853,-58.481114676457295 -34.614103249819564,-58.480315193678976 -34.615107981438875,-58.481437195759945 -34.615698257947926,-58.481582111539986 -34.615774505936599,-58.482840274449678 -34.616436300168886,-58.48354938750569 -34.615544529490343,-58.483639654196629 -34.615430988841368,-58.48238056303596 -34.614768921191853)));;553;11_16_9;COMUNA 11;16;9;646;295;351;84,05%;358;358;100,00%;0;0,00%;256;5;1,95%;251;98,05%
MULTIPOLYGON (((-58.491561749877647 -34.617588744507813,-58.490828340868994 -34.616963189396124,-58.490083098802693 -34.616327420833507,-58.489061542041263 -34.615459586693959,-58.488696040836423 -34.615262122843689,-58.488080060232583 -34.614929423717271,-58.487461443425225 -34.614595243070134,-58.487063443628287 -34.615096327091926,-58.486665353885101 -34.615597480217922,-58.487991548481233 -34.616313646512751,-58.489007313079149 -34.61718508241659,-58.489753150808383 -34.617820505204406,-58.490488774564383 -34.618447263412996,-58.490616180504588 -34.618345751870372,-58.491561749877647 -34.617588744507813)));;554;11_17_1;COMUNA 11;17;1;821;391;430;90,93%;341;340;99,71%;1;0,29%;290;0;0,00%;290;100,00%
MULTIPOLYGON (((-58.486105662453774 -34.614575932544355,-58.48570552578461 -34.615079829551831,-58.485306917080315 -34.615581823446689,-58.484906941072488 -34.616085506448819,-58.484509259479061 -34.61658630026205,-58.484103823703272 -34.617096812754475,-58.485072095452622 -34.617602995020079,-58.48586060875644 -34.618015186407497,-58.486378852179492 -34.617601410303543,-58.48691684896842 -34.617171782418581,-58.485866775681629 -34.616602740759575,-58.486266322644376 -34.616099758987325,-58.486665353885101 -34.615597480217922,-58.487063443628287 -34.615096327091926,-58.487461443425225 -34.614595243070134,-58.48701237213443 -34.614352648610797,-58.486501962456082 -34.614076894262347,-58.486105662453774 -34.614575932544355)));;555;11_17_2;COMUNA 11;17;2;815;388;427;90,87%;329;329;100,00%;0;0,00%;286;8;2,80%;278;97,20%
MULTIPOLYGON (((-58.489753150808383 -34.617820505204406,-58.489007313079149 -34.61718508241659,-58.487991548481233 -34.616313646512751,-58.486665353885101 -34.615597480217922,-58.486266322644376 -34.616099758987325,-58.485866775681629 -34.616602740759575,-58.48691684896842 -34.617171782418581,-58.487933123365849 -34.618041395992073,-58.488678279297929 -34.618677529653425,-58.487603726358131 -34.619534262751394,-58.487728559157553 -34.61964100151436,-58.488337389533427 -34.620160329907293,-58.489412454348319 -34.619304294572785,-58.490488774564383 -34.618447263412996,-58.489753150808383 -34.617820505204406)));;556;11_17_3;COMUNA 11;17;3;884;412;472;87,29%;378;378;100,00%;0;0,00%;336;5;1,49%;331;98,51%
MULTIPOLYGON (((-58.48586060875644 -34.618015186407497,-58.485260598261242 -34.618494329850847,-58.484782543791866 -34.618876050495601,-58.485782122654633 -34.619756037242304,-58.486403893420992 -34.620285725303376,-58.486528469961712 -34.620391479381134,-58.487264176752745 -34.621016144004521,-58.488203845904913 -34.620266629224361,-58.488337389533427 -34.620160329907293,-58.487728559157553 -34.61964100151436,-58.487603726358131 -34.619534262751394,-58.488678279297929 -34.618677529653425,-58.487933123365849 -34.618041395992073,-58.48691684896842 -34.617171782418581,-58.486378852179492 -34.617601410303543,-58.48586060875644 -34.618015186407497)));;557;11_17_4;COMUNA 11;17;4;933;441;492;89,63%;369;369;100,00%;0;0,00%;324;11;3,40%;313;96,60%
MULTIPOLYGON (((-58.483656569751368 -34.617660008971228,-58.483386698654272 -34.61799992621809,-58.483305540883045 -34.618101563265171,-58.482500765390654 -34.619109830694811,-58.483700623829719 -34.619739863453454,-58.484706844678747 -34.62061330821814,-58.484817908058936 -34.620524693486431,-58.485782122654633 -34.619756037242304,-58.484782543791866 -34.618876050495601,-58.485260598261242 -34.618494329850847,-58.48586060875644 -34.618015186407497,-58.485072095452622 -34.617602995020079,-58.484103823703272 -34.617096812754475,-58.483656569751368 -34.617660008971228)));;558;11_17_5;COMUNA 11;17;5;838;408;430;94,88%;302;302;100,00%;0;0,00%;297;19;6,40%;278;93,60%
MULTIPOLYGON (((-58.483299330426142 -34.622961522928051,-58.482654466535834 -34.623474183022495,-58.483426629919244 -34.624082103366064,-58.484038274583867 -34.623592262743792,-58.484970505688125 -34.622845661899298,-58.485112574827653 -34.622732322101854,-58.486184383807498 -34.621877442960177,-58.487264176752745 -34.621016144004521,-58.486528469961712 -34.620391479381134,-58.486403893420992 -34.620285725303376,-58.485782122654633 -34.619756037242304,-58.484817908058936 -34.620524693486431,-58.484706844678747 -34.62061330821814,-58.483631459681213 -34.621471696417863,-58.482558522592562 -34.622328032298029,-58.483299330426142 -34.622961522928051)));;559;11_17_6;COMUNA 11;17;6;1175;545;630;86,51%;470;469;99,79%;1;0,21%;408;12;2,94%;396;97,06%
MULTIPOLYGON (((-58.481696906919964 -34.620115486784151,-58.480894476825654 -34.62111902445109,-58.481544808281093 -34.621461120739916,-58.482558522592562 -34.622328032298029,-58.483631459681213 -34.621471696417863,-58.484706844678747 -34.62061330821814,-58.483700623829719 -34.619739863453454,-58.482500765390654 -34.619109830694811,-58.482371658863705 -34.619271617835999,-58.481696906919964 -34.620115486784151)));;560;11_17_7;COMUNA 11;17;7;916;425;491;86,56%;376;376;100,00%;0;0,00%;331;8;2,42%;323;97,58%
MULTIPOLYGON (((-58.481544808281093 -34.621461120739916,-58.480817665686061 -34.622041532764257,-58.480470061233163 -34.622319128735256,-58.479376126929601 -34.623192411986764,-58.479755690570542 -34.623355745428015,-58.480740092183275 -34.623779350816456,-58.481733194320221 -34.624206608970191,-58.481787297214353 -34.624229911176421,-58.481920381922862 -34.624287145767099,-58.482742662809734 -34.624629842096923,-58.483368114026518 -34.624128945890149,-58.483426629919244 -34.624082103366064,-58.482654466535834 -34.623474183022495,-58.483299330426142 -34.622961522928051,-58.482558522592562 -34.622328032298029,-58.481544808281093 -34.621461120739916)));;561;11_17_8;COMUNA 11;17;8;847;409;438;93,38%;341;341;100,00%;0;0,00%;322;7;2,17%;315;97,83%
MULTIPOLYGON (((-58.480433245295274 -34.619452696016708,-58.479633957588923 -34.620452422095958,-58.479473331216212 -34.620653225954712,-58.480817665686061 -34.622041532764257,-58.481544808281093 -34.621461120739916,-58.480894476825654 -34.62111902445109,-58.481696906919964 -34.620115486784151,-58.482371658863705 -34.619271617835999,-58.482500765390654 -34.619109830694811,-58.483305540883045 -34.618101563265171,-58.482042578612955 -34.617439281803087,-58.481938341098989 -34.617570429695583,-58.481639763010122 -34.617943799495798,-58.481237708841476 -34.618446625501271,-58.480836927286241 -34.618947830176467,-58.480433245295274 -34.619452696016708)));;562;11_18_1;COMUNA 11;18;1;854;380;474;80,17%;264;263;99,62%;1;0,38%;279;2;0,72%;277;99,28%
MULTIPOLYGON (((-58.481639763010122 -34.617943799495798,-58.481938341098989 -34.617570429695583,-58.482042578612955 -34.617439281803087,-58.480780573808644 -34.616778677249584,-58.479513562572869 -34.6161154545294,-58.479357573001785 -34.616033782871362,-58.478910307642778 -34.615797567075944,-58.478221012797839 -34.615433559187061,-58.477417138853518 -34.616443342764349,-58.477609504991726 -34.6165453652956,-58.478711741740099 -34.617122992638819,-58.479976206190713 -34.61778559011092,-58.481237708841476 -34.618446625501271,-58.481639763010122 -34.617943799495798)));;563;11_18_2;COMUNA 11;18;2;813;412;401;102,74%;358;357;99,72%;1;0,28%;303;0;0,00%;303;100,00%
MULTIPOLYGON (((-58.478711741740099 -34.617122992638819,-58.477609504991726 -34.6165453652956,-58.477417138853518 -34.616443342764349,-58.476618440723733 -34.61744671161145,-58.477781938443222 -34.618061313403572,-58.477911093890185 -34.618129116667681,-58.479172755959397 -34.618791229731137,-58.480433245295274 -34.619452696016708,-58.480836927286241 -34.618947830176467,-58.481237708841476 -34.618446625501271,-58.479976206190713 -34.61778559011092,-58.478711741740099 -34.617122992638819)));;564;11_18_3;COMUNA 11;18;3;880;406;474;85,65%;351;351;100,00%;0;0,00%;310;7;2,26%;303;97,74%
MULTIPOLYGON (((-58.4758156351891 -34.618455146109916,-58.476628486921676 -34.618878283127231,-58.476775771492093 -34.61886907661939,-58.477071180336672 -34.6191841484154,-58.477252289715821 -34.619280012267261,-58.478125635974685 -34.619735977321369,-58.478330960278974 -34.619843560594902,-58.47863596581437 -34.620003315467898,-58.479160044524697 -34.620423471862246,-58.479164168664816 -34.620426496383637,-58.479435962736098 -34.620699996508698,-58.479473331216212 -34.620653225954712,-58.479633957588923 -34.620452422095958,-58.480433245295274 -34.619452696016708,-58.479172755959397 -34.618791229731137,-58.477911093890185 -34.618129116667681,-58.477781938443222 -34.618061313403572,-58.476618440723733 -34.61744671161145,-58.476096355315931 -34.618102567936518,-58.4758156351891 -34.618455146109916)));;565;11_18_4;COMUNA 11;18;4;903;397;506;78,46%;386;386;100,00%;0;0,00%;370;38;10,27%;332;89,73%
MULTIPOLYGON (((-58.476168985364275 -34.615781068941757,-58.475368234381264 -34.616786260991645,-58.475173537063029 -34.617030655942308,-58.474567634426279 -34.617791165907185,-58.475619858833191 -34.61834974074236,-58.4758156351891 -34.618455146109916,-58.476096355315931 -34.618102567936518,-58.476618440723733 -34.61744671161145,-58.477417138853518 -34.616443342764349,-58.478221012797839 -34.615433559187061,-58.478001642623809 -34.615317667254779,-58.476971846169917 -34.614773195073326,-58.476168985364275 -34.615781068941757)));;566;11_18_5;COMUNA 11;18;5;804;371;433;85,68%;395;395;100,00%;0;0,00%;318;6;1,89%;312;98,11%
MULTIPOLYGON (((-58.474058584426686 -34.616093055387047,-58.473259593725238 -34.617096824883298,-58.473423246700193 -34.617183644679123,-58.473905688473394 -34.617439737172248,-58.474567634426279 -34.617791165907185,-58.475173537063029 -34.617030655942308,-58.475368234381264 -34.616786260991645,-58.476168985364275 -34.615781068941757,-58.476971846169917 -34.614773195073326,-58.475660766406875 -34.614080006604418,-58.47485977025881 -34.615086463273421,-58.474058584426686 -34.616093055387047)));;567;11_18_6;COMUNA 11;18;6;1348;647;701;92,30%;704;704;100,00%;0;0,00%;521;4;0,77%;517;99,23%
MULTIPOLYGON (((-58.474567634426279 -34.617791165907185,-58.473905688473394 -34.617439737172248,-58.473423246700193 -34.617183644679123,-58.473259593725238 -34.617096824883298,-58.472460924502194 -34.618100307257336,-58.471621181048953 -34.619155267935298,-58.472788840409514 -34.619773085998958,-58.472934266360618 -34.619848217367213,-58.474189694351523 -34.620497494529708,-58.475015876448502 -34.619459771902633,-58.476131000075441 -34.620054815958788,-58.476305481657903 -34.620146701252438,-58.477071180336672 -34.6191841484154,-58.476775771492093 -34.61886907661939,-58.476628486921676 -34.618878283127231,-58.4758156351891 -34.618455146109916,-58.475619858833191 -34.61834974074236,-58.474567634426279 -34.617791165907185)));;568;11_18_7;COMUNA 11;18;7;1009;462;547;84,46%;417;414;99,28%;3;0,72%;324;18;5,56%;306;94,44%
MULTIPOLYGON (((-58.478330960278974 -34.619843560594902,-58.478125635974685 -34.619735977321369,-58.477252289715821 -34.619280012267261,-58.477071180336672 -34.6191841484154,-58.476305481657903 -34.620146701252438,-58.476131000075441 -34.620054815958788,-58.475015876448502 -34.619459771902633,-58.474189694351523 -34.620497494529708,-58.474509432888013 -34.620662751464828,-58.475490041584536 -34.621176895895637,-58.475745547092245 -34.621310887594561,-58.476026442211953 -34.621458115881858,-58.476741761774299 -34.621830161260675,-58.477560431183328 -34.620806789192955,-58.478824941350098 -34.621464116311252,-58.479435346298764 -34.620700768043847,-58.479435962736098 -34.620699996508698,-58.479164168664816 -34.620426496383637,-58.479160044524697 -34.620423471862246,-58.47863596581437 -34.620003315467898,-58.478330960278974 -34.619843560594902)));;569;11_18_8;COMUNA 11;18;8;907;425;482;88,17%;366;366;100,00%;0;0,00%;346;50;14,45%;296;85,55%
MULTIPOLYGON (((-58.479473331216212 -34.620653225954712,-58.479435962736098 -34.620699996508698,-58.479435346298764 -34.620700768043847,-58.478824941350098 -34.621464116311252,-58.477560431183328 -34.620806789192955,-58.476741761774299 -34.621830161260675,-58.477807255551937 -34.622384278548552,-58.478006281066882 -34.622487778452324,-58.478116103146753 -34.622544879277399,-58.478799152457313 -34.622910437499669,-58.479376126929601 -34.623192411986764,-58.480470061233163 -34.622319128735256,-58.480817665686061 -34.622041532764257,-58.479473331216212 -34.620653225954712)));;570;11_18_9;COMUNA 11;18;9;815;396;419;94,51%;353;353;100,00%;0;0,00%;304;23;7,57%;281;92,43%
MULTIPOLYGON (((-58.475111667671769 -34.605990823228083,-58.474743612463463 -34.606465525713809,-58.475724054496361 -34.60697234528044,-58.475885645787152 -34.607058105762064,-58.477128299883923 -34.607717637517837,-58.4782834031489 -34.608330616740645,-58.478429410700649 -34.608407713530966,-58.479043854991716 -34.608732081369844,-58.47966426714688 -34.609059684822675,-58.480042356926134 -34.608586163498963,-58.48041030939298 -34.608126727467543,-58.480206812088355 -34.60807689583676,-58.47980816587318 -34.607979061439025,-58.479669236189253 -34.607944995071598,-58.479203724599508 -34.607830758919434,-58.478945116099624 -34.607762340385584,-58.478723476346666 -34.607703705548552,-58.477618424665927 -34.607359677972134,-58.47746475749922 -34.607303004418576,-58.477328978582307 -34.607252878066483,-58.476895395814701 -34.607026512416915,-58.476364707328138 -34.606749379593829,-58.476201836419449 -34.606650661654804,-58.475263802891057 -34.606082078671797,-58.475111667671769 -34.605990823228083)));;571;11_19_1;COMUNA 11;19;1;568;266;302;88,08%;259;259;100,00%;0;0,00%;221;14;6,33%;207;93,67%
MULTIPOLYGON (((-58.477128299883923 -34.607717637517837,-58.475885645787152 -34.607058105762064,-58.475724054496361 -34.60697234528044,-58.474743612463463 -34.606465525713809,-58.473964227690189 -34.607470778391239,-58.474107418292959 -34.607543162140288,-58.475099796950289 -34.608070901783272,-58.476148154283806 -34.60862834655741,-58.476323804776413 -34.608722203774974,-58.477128299883923 -34.607717637517837)));;572;11_19_2;COMUNA 11;19;2;871;396;475;83,37%;398;396;99,50%;2;0,51%;322;7;2,17%;315;97,83%
MULTIPOLYGON (((-58.478429410700649 -34.608407713530966,-58.4782834031489 -34.608330616740645,-58.477128299883923 -34.607717637517837,-58.476323804776413 -34.608722203774974,-58.477623392143137 -34.609416373096067,-58.478018354512109 -34.608911587246865,-58.478429410700649 -34.608407713530966)));;573;11_19_3;COMUNA 11;19;3;710;308;402;76,62%;338;338;100,00%;0;0,00%;279;2;0,72%;277;99,28%
MULTIPOLYGON (((-58.479043854991716 -34.608732081369844,-58.478429410700649 -34.608407713530966,-58.478018354512109 -34.608911587246865,-58.477623392143137 -34.609416373096067,-58.476323804776413 -34.608722203774974,-58.476151526017851 -34.608937301247018,-58.475523634207448 -34.609725637307854,-58.476825785028787 -34.610414532856382,-58.476974861627752 -34.61049339163317,-58.478060658976162 -34.611068210362021,-58.478859534771104 -34.610067648014947,-58.479261136990374 -34.609564688370781,-58.47966426714688 -34.609059684822675,-58.479043854991716 -34.608732081369844)));;574;11_19_4;COMUNA 11;19;4;1022;441;581;75,90%;402;400;99,50%;2;0,50%;339;22;6,49%;317;93,51%
MULTIPOLYGON (((-58.476023219378682 -34.611418885192009,-58.475222848682307 -34.612420414856082,-58.476460039961594 -34.613075798309467,-58.477161272726569 -34.612194628916164,-58.47725963495477 -34.612071373301475,-58.478060658976162 -34.611068210362021,-58.476974861627752 -34.61049339163317,-58.476825785028787 -34.610414532856382,-58.475523634207448 -34.609725637307854,-58.474722848416192 -34.610731037393641,-58.476023219378682 -34.611418885192009)));;575;11_19_5;COMUNA 11;19;5;791;353;438;80,59%;336;336;100,00%;0;0,00%;306;7;2,29%;299;97,71%
MULTIPOLYGON (((-58.475222848682307 -34.612420414856082,-58.476023219378682 -34.611418885192009,-58.474722848416192 -34.610731037393641,-58.473924598291489 -34.611733192271878,-58.473125562484341 -34.612736398207879,-58.473284691826464 -34.61282068333584,-58.474421181350699 -34.613424192834245,-58.474571709313381 -34.613504181170001,-58.475660766406875 -34.614080006604418,-58.476460039961594 -34.613075798309467,-58.475222848682307 -34.612420414856082)));;576;11_19_6;COMUNA 11;19;6;921;443;478;92,68%;390;390;100,00%;0;0,00%;341;4;1,17%;337;98,83%
MULTIPOLYGON (((-58.474421181350699 -34.613424192834245,-58.473284691826464 -34.61282068333584,-58.473125562484341 -34.612736398207879,-58.472324463363364 -34.613742063787853,-58.472219278287668 -34.613874189482871,-58.472339143742204 -34.613993128022017,-58.473080370894699 -34.615108036871376,-58.473184911070227 -34.615265216665378,-58.473443508809112 -34.615767324816382,-58.474058584426686 -34.616093055387047,-58.47485977025881 -34.615086463273421,-58.475660766406875 -34.614080006604418,-58.474571709313381 -34.613504181170001,-58.474421181350699 -34.613424192834245)));;577;11_19_7;COMUNA 11;19;7;916;444;472;94,07%;361;361;100,00%;0;0,00%;319;8;2,51%;311;97,49%
MULTIPOLYGON (((-58.471521726654366 -34.614749766388563,-58.471122608126798 -34.61525093933875,-58.470723314433208 -34.615752110953871,-58.4699233498458 -34.616756351698569,-58.471041807938413 -34.617346653445487,-58.471221730529919 -34.617442207781828,-58.472020152898203 -34.616439508105763,-58.473259593725238 -34.617096824883298,-58.474058584426686 -34.616093055387047,-58.473443508809112 -34.615767324816382,-58.473184911070227 -34.615265216665378,-58.473080370894699 -34.615108036871376,-58.472339143742204 -34.613993128022017,-58.472219278287668 -34.613874189482871,-58.471521726654366 -34.614749766388563)));;578;11_19_8;COMUNA 11;19;8;837;390;447;87,25%;359;359;100,00%;0;0,00%;301;5;1,66%;296;98,34%
MULTIPOLYGON (((-58.471221730529919 -34.617442207781828,-58.471041807938413 -34.617346653445487,-58.4699233498458 -34.616756351698569,-58.469093638786269 -34.617797843436996,-58.469339837755037 -34.617924736188115,-58.470386833093173 -34.618490680637116,-58.471399595231254 -34.619038026288798,-58.471621181048953 -34.619155267935298,-58.472460924502194 -34.618100307257336,-58.473259593725238 -34.617096824883298,-58.472020152898203 -34.616439508105763,-58.471221730529919 -34.617442207781828)));;579;11_19_9;COMUNA 11;19;9;889;387;502;77,09%;399;398;99,75%;1;0,25%;348;31;8,91%;317;91,09%
MULTIPOLYGON (((-58.51917772455247 -34.59538952944898,-58.520290686814434 -34.596071500586781,-58.520450522607547 -34.596169245745394,-58.521360324404881 -34.59676214462943,-58.521575946510048 -34.596740068105035,-58.522214799258798 -34.59666348764101,-58.522578933548253 -34.596620772645792,-58.522579502299038 -34.596622315807124,-58.522650457711009 -34.596603153524541,-58.519970166451031 -34.59089199398597,-58.51973660864823 -34.591168042821892,-58.519264074867309 -34.591726537411745,-58.519259410456833 -34.591716767769078,-58.518647867456295 -34.592429572632533,-58.517878229264831 -34.593277851570967,-58.517114660701495 -34.594119431293407,-58.517231378117501 -34.594188466403899,-58.517774508298388 -34.594522249637663,-58.517908014688665 -34.594607615184024,-58.51805464198624 -34.594701355240836,-58.51917772455247 -34.59538952944898)));;580;11_2_1;COMUNA 11;2;1;836;403;433;93,07%;340;340;100,00%;0;0,00%;286;8;2,80%;278;97,20%
MULTIPOLYGON (((-58.51821958967291 -34.600825953006968,-58.519489312281962 -34.601608285727878,-58.520755650398378 -34.602388493977983,-58.521408659242113 -34.601669492375166,-58.521514954033528 -34.601552464922271,-58.52205901618813 -34.600949925087271,-58.52091777071233 -34.600249532755576,-58.520789023407843 -34.600166703629831,-58.520660617178976 -34.600084085480631,-58.519663984382454 -34.599471010244613,-58.519522035137463 -34.599383185741189,-58.518333712070273 -34.598648282584911,-58.51825345182877 -34.598598669356946,-58.518193708849566 -34.598665037117115,-58.516806532758189 -34.598831018548317,-58.516508556181925 -34.598866715055209,-58.515979283516991 -34.5989308229899,-58.515286501489733 -34.599014859119791,-58.515684218202345 -34.599260400719182,-58.516952360702653 -34.600043535427233,-58.518102263813752 -34.600753679638274,-58.51821958967291 -34.600825953006968)));;581;11_2_10;COMUNA 11;2;10;1022;470;552;85,14%;431;430;99,77%;1;0,23%;348;1;0,29%;347;99,71%
MULTIPOLYGON (((-58.515979283516991 -34.5989308229899,-58.516093410873651 -34.598802951298175,-58.516256822207829 -34.598632521031085,-58.516334775420589 -34.598539736749778,-58.516428216910668 -34.5984284941851,-58.516984808850836 -34.597816675006825,-58.515715252692466 -34.597034456476074,-58.514927851848178 -34.596549284267496,-58.514799484774997 -34.596470175812001,-58.514796757065035 -34.596468724942888,-58.514421654377941 -34.596269206732423,-58.513805659660022 -34.596170801039932,-58.512040901009307 -34.595916383286749,-58.512040470874645 -34.595916027940504,-58.511660338824576 -34.595828427866913,-58.511679258820152 -34.595996666253534,-58.5100846205221 -34.595804260205696,-58.511385288487659 -34.596608709057946,-58.5118171461244 -34.59687579987321,-58.512051606178282 -34.597020781314541,-58.51268955670772 -34.59741018459377,-58.513363977708657 -34.59782175332758,-58.513501488755963 -34.597908882616871,-58.513630565412271 -34.597990733376776,-58.513722239768697 -34.598048795909726,-58.514414480765446 -34.598476337867467,-58.515286501489733 -34.599014859119791,-58.515979283516991 -34.5989308229899)));;582;11_2_11;COMUNA 11;2;11;837;400;437;91,53%;404;402;99,50%;2;0,50%;328;1;0,30%;327;99,70%
MULTIPOLYGON (((-58.519259410456833 -34.591716767769078,-58.519264074867309 -34.591726537411745,-58.51973660864823 -34.591168042821892,-58.519970166451031 -34.59089199398597,-58.519203097668097 -34.589257369327555,-58.518882438916542 -34.589345616585753,-58.518250111215877 -34.589519634034986,-58.518250900887523 -34.589521343282101,-58.518270856777825 -34.589564927485142,-58.517886184245789 -34.589670176654344,-58.517814383701577 -34.589651123833512,-58.516667617184751 -34.589995452861984,-58.515372677777293 -34.590359131684878,-58.514829653885563 -34.590545780715019,-58.513880052943982 -34.590828165688407,-58.514141591041188 -34.590990808662916,-58.51433293068505 -34.591107774754988,-58.515486687657386 -34.591812942896702,-58.515637138496743 -34.591905064468705,-58.516929359519246 -34.592696148027947,-58.517616032277147 -34.593116491306247,-58.517747489270967 -34.593197139476082,-58.517878229264831 -34.593277851570967,-58.518647867456295 -34.592429572632533,-58.519259410456833 -34.591716767769078)));;583;11_2_2;COMUNA 11;2;2;973;450;523;86,04%;404;404;100,00%;0;0,00%;361;3;0,83%;358;99,17%
MULTIPOLYGON (((-58.51433293068505 -34.591107774754988,-58.514141591041188 -34.590990808662916,-58.513880052943982 -34.590828165688407,-58.512433799962722 -34.59125821731233,-58.511374005300645 -34.591573304968385,-58.511034195900429 -34.591681824601508,-58.511317887569064 -34.59186995879589,-58.511513400552062 -34.591991082723872,-58.512808826965482 -34.592793828815857,-58.514107174831636 -34.59359825001593,-58.514871483905466 -34.592752892425629,-58.515540294833563 -34.592013138877512,-58.515637138496743 -34.591905064468705,-58.515486687657386 -34.591812942896702,-58.51433293068505 -34.591107774754988)));;584;11_2_3;COMUNA 11;2;3;739;348;391;89,00%;355;354;99,72%;1;0,28%;286;0;0,00%;286;100,00%
MULTIPOLYGON (((-58.511034195900429 -34.591681824601508,-58.510926829217752 -34.591716093785543,-58.511058680762794 -34.59249262159031,-58.511161651500927 -34.593099153937622,-58.511329227605813 -34.594085816163783,-58.511379470680801 -34.594373272179247,-58.511596083609241 -34.595612177607656,-58.511597131575655 -34.595613910223314,-58.511645100323221 -34.595693217450837,-58.511781283292301 -34.595703303992458,-58.512063627834571 -34.595747698878306,-58.512151695247361 -34.59576104402349,-58.512687872873691 -34.595168055991728,-58.513339956716337 -34.594446843479851,-58.514107174831636 -34.59359825001593,-58.512808826965482 -34.592793828815857,-58.511513400552062 -34.591991082723872,-58.511317887569064 -34.59186995879589,-58.511034195900429 -34.591681824601508)));;585;11_2_4;COMUNA 11;2;4;555;262;293;89,42%;280;280;100,00%;0;0,00%;223;0;0,00%;223;100,00%
MULTIPOLYGON (((-58.517114660701495 -34.594119431293407,-58.517878229264831 -34.593277851570967,-58.517747489270967 -34.593197139476082,-58.517616032277147 -34.593116491306247,-58.516929359519246 -34.592696148027947,-58.515637138496743 -34.591905064468705,-58.515540294833563 -34.592013138877512,-58.514871483905466 -34.592752892425629,-58.514107174831636 -34.59359825001593,-58.513339956716337 -34.594446843479851,-58.512687872873691 -34.595168055991728,-58.512151695247361 -34.59576104402349,-58.512063627834571 -34.595747698878306,-58.511781283292301 -34.595703303992458,-58.511645100323221 -34.595693217450837,-58.511646095305899 -34.59573260176456,-58.511660338824576 -34.595828427866913,-58.512040470874645 -34.595916027940504,-58.512040901009307 -34.595916383286749,-58.513805659660022 -34.596170801039932,-58.514421654377941 -34.596269206732423,-58.514796757065035 -34.596468724942888,-58.514796890255127 -34.596468576890771,-58.514903593787153 -34.596346194641136,-58.515038611568158 -34.596199893255651,-58.515038602387904 -34.596199927490801,-58.515217635174913 -34.596227316426152,-58.515575584667047 -34.595829540769451,-58.516342364779931 -34.594977623651388,-58.517114660701495 -34.594119431293407)));;586;11_2_5;COMUNA 11;2;5;1066;513;553;92,77%;468;468;100,00%;0;0,00%;389;3;0,77%;386;99,23%
MULTIPOLYGON (((-58.517908014688665 -34.594607615184024,-58.517774508298388 -34.594522249637663,-58.517231378117501 -34.594188466403899,-58.517114660701495 -34.594119431293407,-58.516342364779931 -34.594977623651388,-58.515575584667047 -34.595829540769451,-58.515217635174913 -34.596227316426152,-58.515038602387904 -34.596199927490801,-58.515038611568158 -34.596199893255651,-58.514903593787153 -34.596346194641136,-58.515153327494446 -34.59638701730146,-58.516164946950013 -34.596536776224688,-58.516911234620316 -34.596651099295194,-58.517900013561992 -34.596802563309708,-58.519471727429945 -34.597043682549376,-58.51962301794147 -34.59708507282334,-58.519621818722435 -34.597087839690197,-58.519694640365614 -34.597095622902877,-58.520163501053361 -34.597380273169449,-58.520285304607299 -34.597467660665465,-58.520802528667105 -34.597478755932073,-58.521298745313132 -34.597482906284391,-58.521775085120034 -34.597494296775707,-58.522074873324016 -34.597527183754053,-58.522461688600544 -34.597490863735537,-58.522527615214834 -34.597502522022154,-58.522647539480552 -34.597517745445494,-58.522781185713598 -34.597547187896069,-58.522940570404465 -34.597601970586396,-58.523157854761259 -34.59768421881153,-58.522650457711009 -34.596603153524541,-58.522579502299038 -34.596622315807124,-58.522578933548253 -34.596620772645792,-58.522214799258798 -34.59666348764101,-58.521575946510048 -34.596740068105035,-58.521360324404881 -34.59676214462943,-58.520450522607547 -34.596169245745394,-58.520290686814434 -34.596071500586781,-58.51917772455247 -34.59538952944898,-58.51805464198624 -34.594701355240836,-58.517908014688665 -34.594607615184024)));;587;11_2_6;COMUNA 11;2;6;981;466;515;90,49%;393;393;100,00%;0;0,00%;358;0;0,00%;358;100,00%
MULTIPOLYGON (((-58.516334775420589 -34.598539736749778,-58.516256822207829 -34.598632521031085,-58.516093410873651 -34.598802951298175,-58.515979283516991 -34.5989308229899,-58.516508556181925 -34.598866715055209,-58.516806532758189 -34.598831018548317,-58.518193708849566 -34.598665037117115,-58.51825345182877 -34.598598669356946,-58.518333712070273 -34.598648282584911,-58.519855264100094 -34.598466163969235,-58.520409823788484 -34.598399844081797,-58.521617980658434 -34.598255176675401,-58.520923747793084 -34.597830493545125,-58.520865404493719 -34.597741176288466,-58.520837929993426 -34.597674766773046,-58.520802528667105 -34.597478755932073,-58.520285304607299 -34.597467660665465,-58.520163501053361 -34.597380273169449,-58.519694640365614 -34.597095622902877,-58.519621818722435 -34.597087839690197,-58.51962301794147 -34.59708507282334,-58.519471727429945 -34.597043682549376,-58.517900013561992 -34.596802563309708,-58.516911234620316 -34.596651099295194,-58.516164946950013 -34.596536776224688,-58.515153327494446 -34.59638701730146,-58.514903593787153 -34.596346194641136,-58.514796890255127 -34.596468576890771,-58.514796757065035 -34.596468724942888,-58.514799484774997 -34.596470175812001,-58.514927851848178 -34.596549284267496,-58.515715252692466 -34.597034456476074,-58.516984808850836 -34.597816675006825,-58.516428216910668 -34.5984284941851,-58.516334775420589 -34.598539736749778)));;588;11_2_7;COMUNA 11;2;7;841;404;437;92,45%;389;388;99,74%;1;0,26%;312;3;0,96%;309;99,04%
MULTIPOLYGON (((-58.519855264100094 -34.598466163969235,-58.518333712070273 -34.598648282584911,-58.519522035137463 -34.599383185741189,-58.519663984382454 -34.599471010244613,-58.520660617178976 -34.600084085480631,-58.520789023407843 -34.600166703629831,-58.52091777071233 -34.600249532755576,-58.52205901618813 -34.600949925087271,-58.523193549432705 -34.601646225320323,-58.523330904957803 -34.601730949089706,-58.523747730804068 -34.601270442124211,-58.523752128552843 -34.601279903182814,-58.524220930218654 -34.60075869071953,-58.524470624341816 -34.60048107804004,-58.523157854761259 -34.59768421881153,-58.522940570404465 -34.597601970586396,-58.522781185713598 -34.597547187896069,-58.522647539480552 -34.597517745445494,-58.522527615214834 -34.597502522022154,-58.522461688600544 -34.597490863735537,-58.522074873324016 -34.597527183754053,-58.521775085120034 -34.597494296775707,-58.521298745313132 -34.597482906284391,-58.520802528667105 -34.597478755932073,-58.520837929993426 -34.597674766773046,-58.520865404493719 -34.597741176288466,-58.520923747793084 -34.597830493545125,-58.521617980658434 -34.598255176675401,-58.520409823788484 -34.598399844081797,-58.519855264100094 -34.598466163969235)));;589;11_2_8;COMUNA 11;2;8;883;417;466;89,48%;338;337;99,70%;1;0,30%;302;28;9,27%;274;90,73%
MULTIPOLYGON (((-58.521396859548624 -34.602774843447975,-58.522047460943099 -34.603154229086883,-58.522033244157477 -34.603153682935961,-58.523118658867574 -34.603844514308818,-58.523279110306852 -34.603943945527213,-58.524910999007545 -34.604955204515981,-58.525326417262058 -34.604652093364862,-58.525324791991061 -34.604648646720115,-58.525885835332673 -34.604272878971337,-58.526163304343022 -34.604087037453667,-58.524470624341816 -34.60048107804004,-58.524220930218654 -34.60075869071953,-58.523752128552843 -34.601279903182814,-58.523747730804068 -34.601270442124211,-58.523330904957803 -34.601730949089706,-58.523193549432705 -34.601646225320323,-58.52205901618813 -34.600949925087271,-58.521514954033528 -34.601552464922271,-58.521408659242113 -34.601669492375166,-58.520755650398378 -34.602388493977983,-58.521381841260897 -34.602774265339505,-58.521396859548624 -34.602774843447975)));;590;11_2_9;COMUNA 11;2;9;665;312;353;88,39%;284;283;99,65%;1;0,35%;238;28;11,76%;210;88,24%
MULTIPOLYGON (((-58.472438557406328 -34.605287307140266,-58.471237129838229 -34.604771250992158,-58.471081511787915 -34.604704569134995,-58.470304740582456 -34.605719235522557,-58.470986929084837 -34.606010821716318,-58.47166528932722 -34.60630085500933,-58.472817604483353 -34.60689127985728,-58.472987880607931 -34.606977747709252,-58.473964227690189 -34.607470778391239,-58.474743612463463 -34.606465525713809,-58.475111667671769 -34.605990823228083,-58.474953995948631 -34.605896117316242,-58.474341283712633 -34.605512853116863,-58.474162317943545 -34.605400894036833,-58.474016658573369 -34.605311115537432,-58.473038619408946 -34.604708433235409,-58.472983508219208 -34.604674352104979,-58.472438557406328 -34.605287307140266)));;591;11_20_1;COMUNA 11;20;1;895;395;500;79,00%;403;403;100,00%;0;0,00%;356;17;4,78%;339;95,22%
MULTIPOLYGON (((-58.467848237754026 -34.611303795593948,-58.467813998215654 -34.611348657825722,-58.468399545928108 -34.611660122105931,-58.468958691005469 -34.611957570322588,-58.469733577337927 -34.610940448768126,-58.469207146544647 -34.610661383266844,-58.468700566713842 -34.610392878273771,-58.468589744671419 -34.61033196594866,-58.469350482495962 -34.609334988825431,-58.468060165465545 -34.608657914694319,-58.467953617687257 -34.608797642796318,-58.466650207004697 -34.608202669971348,-58.466516221397271 -34.608143094566195,-58.465513311633032 -34.609467043908388,-58.465363745089299 -34.609652828746114,-58.46513172824762 -34.609941154042971,-58.465823135258077 -34.610306292544344,-58.465880883444925 -34.610226499394685,-58.46594212927171 -34.610286288707115,-58.466560968438088 -34.610616634907366,-58.467848237754026 -34.611303795593948)));;592;11_20_10;COMUNA 11;20;10;770;364;406;89,66%;332;332;100,00%;0;0,00%;292;6;2,05%;286;97,95%
MULTIPOLYGON (((-58.469507532752282 -34.612249593805025,-58.470038063541132 -34.612531756394212,-58.470824441731324 -34.611518571121628,-58.4716063721092 -34.610511014947278,-58.471050038603863 -34.610217733683854,-58.470946370698194 -34.61016302041827,-58.470501375806045 -34.609932336992486,-58.469455255660726 -34.609389985093905,-58.469350482495962 -34.609334988825431,-58.468589744671419 -34.61033196594866,-58.468700566713842 -34.610392878273771,-58.469207146544647 -34.610661383266844,-58.469733577337927 -34.610940448768126,-58.468958691005469 -34.611957570322588,-58.469507532752282 -34.612249593805025)));;593;11_20_11;COMUNA 11;20;11;698;303;395;76,71%;301;301;100,00%;0;0,00%;252;10;3,97%;242;96,03%
MULTIPOLYGON (((-58.469604132231915 -34.6040714688382,-58.468925715055292 -34.604962102210003,-58.468829819170651 -34.605088731534678,-58.470304740582456 -34.605719235522557,-58.471081511787915 -34.604704569134995,-58.471237129838229 -34.604771250992158,-58.472438557406328 -34.605287307140266,-58.472983508219208 -34.604674352104979,-58.472649264489768 -34.604467541056174,-58.471803525938768 -34.603941601366635,-58.471710085644737 -34.603883507520372,-58.471609660895197 -34.603821047750358,-58.470434117686743 -34.602937502985199,-58.469696108335931 -34.603950684399543,-58.469604132231915 -34.6040714688382)));;594;11_20_2;COMUNA 11;20;2;856;392;464;84,48%;394;394;100,00%;0;0,00%;317;3;0,95%;314;99,05%
MULTIPOLYGON (((-58.47166528932722 -34.60630085500933,-58.470986929084837 -34.606010821716318,-58.470304740582456 -34.605719235522557,-58.468829819170651 -34.605088731534678,-58.468058298065536 -34.606107256678982,-58.467287694989189 -34.607124649938442,-58.468752759921763 -34.607749820534359,-58.470116056636009 -34.608331527390177,-58.470896516198145 -34.607308552221262,-58.47166528932722 -34.60630085500933)));;595;11_20_3;COMUNA 11;20;3;1136;549;587;93,53%;408;408;100,00%;0;0,00%;389;43;11,05%;346;88,95%
MULTIPOLYGON (((-58.471272562368661 -34.608919924048486,-58.471435600579625 -34.609002873289576,-58.471827353744104 -34.609203556232998,-58.472395096786826 -34.609494438640709,-58.473179884675559 -34.608482435039647,-58.473964227690189 -34.607470778391239,-58.472987880607931 -34.606977747709252,-58.472817604483353 -34.60689127985728,-58.47166528932722 -34.60630085500933,-58.470896516198145 -34.607308552221262,-58.470116056636009 -34.608331527390177,-58.471272562368661 -34.608919924048486)));;596;11_20_4;COMUNA 11;20;4;893;406;487;83,37%;338;338;100,00%;0;0,00%;303;10;3,30%;293;96,70%
MULTIPOLYGON (((-58.476323804776413 -34.608722203774974,-58.476148154283806 -34.60862834655741,-58.475099796950289 -34.608070901783272,-58.474107418292959 -34.607543162140288,-58.473964227690189 -34.607470778391239,-58.473179884675559 -34.608482435039647,-58.472395096786826 -34.609494438640709,-58.472529260198215 -34.609563162828195,-58.473528723346803 -34.610095632985526,-58.474552732697738 -34.610641121171156,-58.474722848416192 -34.610731037393641,-58.475523634207448 -34.609725637307854,-58.476151526017851 -34.608937301247018,-58.476323804776413 -34.608722203774974)));;597;11_20_5;COMUNA 11;20;5;863;416;447;93,06%;378;378;100,00%;0;0,00%;328;8;2,44%;320;97,56%
MULTIPOLYGON (((-58.471958680652705 -34.612118864286643,-58.471170522005863 -34.613134380921089,-58.471359380269654 -34.613235005106361,-58.471645692785053 -34.613388792826953,-58.471821433622488 -34.613484487498241,-58.471959354427277 -34.613584128595498,-58.472093620134252 -34.613749546838555,-58.472219278287668 -34.613874189482871,-58.472324463363364 -34.613742063787853,-58.473125562484341 -34.612736398207879,-58.473924598291489 -34.611733192271878,-58.474722848416192 -34.610731037393641,-58.474552732697738 -34.610641121171156,-58.473528723346803 -34.610095632985526,-58.472741880443245 -34.611109610635758,-58.47257495384563 -34.611324702534105,-58.471958680652705 -34.612118864286643)));;598;11_20_6;COMUNA 11;20;6;711;336;375;89,60%;292;291;99,66%;1;0,34%;267;8;3,00%;259;97,00%
MULTIPOLYGON (((-58.4716063721092 -34.610511014947278,-58.470824441731324 -34.611518571121628,-58.470038063541132 -34.612531756394212,-58.470944011950621 -34.61301368784256,-58.471170522005863 -34.613134380921089,-58.471958680652705 -34.612118864286643,-58.47257495384563 -34.611324702534105,-58.472741880443245 -34.611109610635758,-58.473528723346803 -34.610095632985526,-58.472529260198215 -34.609563162828195,-58.472395096786826 -34.609494438640709,-58.472229450046491 -34.60970819194408,-58.4716063721092 -34.610511014947278)));;599;11_20_7;COMUNA 11;20;7;653;295;358;82,40%;259;259;100,00%;0;0,00%;232;2;0,86%;230;99,14%
MULTIPOLYGON (((-58.472395096786826 -34.609494438640709,-58.471827353744104 -34.609203556232998,-58.471435600579625 -34.609002873289576,-58.471272562368661 -34.608919924048486,-58.470116056636009 -34.608331527390177,-58.469350482495962 -34.609334988825431,-58.469455255660726 -34.609389985093905,-58.470501375806045 -34.609932336992486,-58.470946370698194 -34.61016302041827,-58.471050038603863 -34.610217733683854,-58.4716063721092 -34.610511014947278,-58.472229450046491 -34.60970819194408,-58.472395096786826 -34.609494438640709)));;600;11_20_8;COMUNA 11;20;8;502;240;262;91,60%;234;234;100,00%;0;0,00%;191;1;0,52%;190;99,48%
MULTIPOLYGON (((-58.470116056636009 -34.608331527390177,-58.468752759921763 -34.607749820534359,-58.467287694989189 -34.607124649938442,-58.466516221397271 -34.608143094566195,-58.466650207004697 -34.608202669971348,-58.467953617687257 -34.608797642796318,-58.468060165465545 -34.608657914694319,-58.469350482495962 -34.609334988825431,-58.470116056636009 -34.608331527390177)));;601;11_20_9;COMUNA 11;20;9;820;376;444;84,68%;299;299;100,00%;0;0,00%;260;1;0,38%;259;99,62%
MULTIPOLYGON (((-58.470434117686743 -34.602937502985199,-58.470194519069594 -34.60280610450927,-58.469292165288543 -34.602165075938004,-58.468912282203199 -34.601860365976052,-58.468766047455425 -34.601894107011063,-58.467492941229011 -34.602210161586854,-58.467334015191483 -34.602249535418416,-58.466082701622533 -34.602559588290077,-58.466852151948238 -34.602890281291806,-58.468277448301798 -34.603502712419392,-58.468428206938775 -34.603567496614247,-58.469604132231915 -34.6040714688382,-58.469696108335931 -34.603950684399543,-58.470434117686743 -34.602937502985199)));;602;11_21_1;COMUNA 11;21;1;794;342;452;75,66%;376;376;100,00%;0;0,00%;323;20;6,19%;303;93,81%
MULTIPOLYGON (((-58.465780283944113 -34.607827329021902,-58.465499538946304 -34.607708176439544,-58.465351074912078 -34.607645219674261,-58.465186853312922 -34.607574727558976,-58.464402062573718 -34.608607314467562,-58.464251722069008 -34.608447380985474,-58.464064074723673 -34.608287236461294,-58.463946018573566 -34.608208009440993,-58.463884435260454 -34.608166740921604,-58.463759650447663 -34.608083006575413,-58.462704653845897 -34.607372984849533,-58.462192911293833 -34.608406965769625,-58.463426363095046 -34.609050861670227,-58.46513172824762 -34.609941154042971,-58.465363745089299 -34.609652828746114,-58.465513311633032 -34.609467043908388,-58.466516221397271 -34.608143094566195,-58.465780283944113 -34.607827329021902)));;603;11_21_10;COMUNA 11;21;10;829;400;429;93,24%;336;336;100,00%;0;0,00%;292;25;8,56%;267;91,44%
MULTIPOLYGON (((-58.465186853312922 -34.607574727558976,-58.464419751330084 -34.607245714481181,-58.464303400391486 -34.607195784632637,-58.463239639047373 -34.606745354681593,-58.463051742287192 -34.606665352388077,-58.46192045128273 -34.606183290173647,-58.461770629880917 -34.606119483925163,-58.460635691234955 -34.605636001224191,-58.460513034071866 -34.605885867587773,-58.461540481849731 -34.606583583775418,-58.462150502498091 -34.606997828823296,-58.462510027418588 -34.607241993920148,-58.462704653845897 -34.607372984849533,-58.463759650447663 -34.608083006575413,-58.463884435260454 -34.608166740921604,-58.463946018573566 -34.608208009440993,-58.464064074723673 -34.608287236461294,-58.464251722069008 -34.608447380985474,-58.464402062573718 -34.608607314467562,-58.465186853312922 -34.607574727558976)));;604;11_21_11;COMUNA 11;21;11;941;416;525;79,24%;427;427;100,00%;0;0,00%;374;15;4,01%;359;95,99%
MULTIPOLYGON (((-58.466731336880905 -34.605540737257733,-58.467917415670087 -34.606047401393958,-58.468058298065536 -34.606107256678982,-58.468829819170651 -34.605088731534678,-58.468925715055292 -34.604962102210003,-58.469604132231915 -34.6040714688382,-58.468428206938775 -34.603567496614247,-58.468277448301798 -34.603502712419392,-58.467505594361469 -34.604520107545731,-58.466247397362032 -34.603979989431309,-58.466085226378873 -34.603910061824514,-58.465525171268901 -34.605025118018304,-58.466579894607463 -34.605476021434249,-58.466731336880905 -34.605540737257733)));;605;11_21_2;COMUNA 11;21;2;765;364;401;90,77%;306;306;100,00%;0;0,00%;271;7;2,58%;264;97,42%
MULTIPOLYGON (((-58.466082701622533 -34.602559588290077,-58.465796955896977 -34.602630373209024,-58.465278524191064 -34.602758911264544,-58.464945762974217 -34.602843075960919,-58.464710361233152 -34.603316689537913,-58.466085226378873 -34.603910061824514,-58.466247397362032 -34.603979989431309,-58.467505594361469 -34.604520107545731,-58.468277448301798 -34.603502712419392,-58.466852151948238 -34.602890281291806,-58.466082701622533 -34.602559588290077)));;606;11_21_3;COMUNA 11;21;3;997;432;565;76,46%;469;469;100,00%;0;0,00%;423;26;6,15%;397;93,85%
MULTIPOLYGON (((-58.466085226378873 -34.603910061824514,-58.464710361233152 -34.603316689537913,-58.464945762974217 -34.602843075960919,-58.464359362319819 -34.602991471245474,-58.463073021085428 -34.603316916804687,-58.462911195019778 -34.603358115932487,-58.462108535370866 -34.603562559025178,-58.462875935056125 -34.603891305131697,-58.464152932200889 -34.604438359466002,-58.464342102613607 -34.604519346028425,-58.465525171268901 -34.605025118018304,-58.466085226378873 -34.603910061824514)));;607;11_21_4;COMUNA 11;21;4;756;333;423;78,72%;373;373;100,00%;0;0,00%;318;17;5,35%;301;94,65%
MULTIPOLYGON (((-58.460124014023251 -34.604068749544716,-58.460020954527643 -34.60409515677113,-58.458934822710226 -34.604373659703114,-58.458473946988917 -34.604491818070478,-58.458782432641563 -34.604714864918293,-58.459513028578058 -34.605208989240523,-58.459653561548635 -34.60530399639142,-58.460310578719273 -34.605748393861894,-58.460513034071866 -34.605885867587773,-58.460635691234955 -34.605636001224191,-58.461183380577154 -34.604520051904331,-58.46232316208836 -34.605005642369626,-58.462875935056125 -34.603891305131697,-58.462108535370866 -34.603562559025178,-58.461588303522248 -34.603695095609218,-58.46146940288746 -34.603725377300925,-58.460539147232417 -34.603962345141632,-58.460124014023251 -34.604068749544716)));;608;11_21_5;COMUNA 11;21;5;922;410;512;80,08%;475;475;100,00%;0;0,00%;391;10;2,56%;381;97,44%
MULTIPOLYGON (((-58.463600428160753 -34.60555009665579,-58.464152932200889 -34.604438359466002,-58.462875935056125 -34.603891305131697,-58.46232316208836 -34.605005642369626,-58.461183380577154 -34.604520051904331,-58.460635691234955 -34.605636001224191,-58.461770629880917 -34.606119483925163,-58.46192045128273 -34.606183290173647,-58.463051742287192 -34.606665352388077,-58.463126184490946 -34.60650436023559,-58.463600428160753 -34.60555009665579)));;609;11_21_6;COMUNA 11;21;6;969;450;519;86,71%;426;426;100,00%;0;0,00%;385;23;5,97%;362;94,03%
MULTIPOLYGON (((-58.463600428160753 -34.60555009665579,-58.463126184490946 -34.60650436023559,-58.463051742287192 -34.606665352388077,-58.463239639047373 -34.606745354681593,-58.464303400391486 -34.607195784632637,-58.464419751330084 -34.607245714481181,-58.464909570306673 -34.606250669539016,-58.464967826621297 -34.606134607799426,-58.465525171268901 -34.605025118018304,-58.464342102613607 -34.604519346028425,-58.464152932200889 -34.604438359466002,-58.463600428160753 -34.60555009665579)));;610;11_21_7;COMUNA 11;21;7;711;323;388;83,25%;325;325;100,00%;0;0,00%;270;1;0,37%;269;99,63%
MULTIPOLYGON (((-58.464967826621297 -34.606134607799426,-58.464909570306673 -34.606250669539016,-58.464419751330084 -34.607245714481181,-58.465186853312922 -34.607574727558976,-58.465959530393782 -34.606557910988059,-58.467287694989189 -34.607124649938442,-58.468058298065536 -34.606107256678982,-58.467917415670087 -34.606047401393958,-58.466731336880905 -34.605540737257733,-58.466579894607463 -34.605476021434249,-58.465525171268901 -34.605025118018304,-58.464967826621297 -34.606134607799426)));;611;11_21_8;COMUNA 11;21;8;712;344;368;93,48%;313;313;100,00%;0;0,00%;256;6;2,34%;250;97,66%
MULTIPOLYGON (((-58.467287694989189 -34.607124649938442,-58.465959530393782 -34.606557910988059,-58.465186853312922 -34.607574727558976,-58.465351074912078 -34.607645219674261,-58.465499538946304 -34.607708176439544,-58.465780283944113 -34.607827329021902,-58.466516221397271 -34.608143094566195,-58.467287694989189 -34.607124649938442)));;612;11_21_9;COMUNA 11;21;9;537;246;291;84,54%;268;268;100,00%;0;0,00%;218;1;0,46%;217;99,54%
MULTIPOLYGON (((-58.463426363095046 -34.609050861670227,-58.462192911293833 -34.608406965769625,-58.46164061032156 -34.609522918869359,-58.461826041762755 -34.609625670596209,-58.462692899353591 -34.610080901714618,-58.462849883616521 -34.61016358071231,-58.462783699926149 -34.610291402364183,-58.462257374902116 -34.611286015434828,-58.462408994686754 -34.61136348350616,-58.463701522402779 -34.612041039635422,-58.464413951100234 -34.610987542594806,-58.465068017027583 -34.610020313131578,-58.46513172824762 -34.609941154042971,-58.463426363095046 -34.609050861670227)));;613;11_22_1;COMUNA 11;22;1;904;402;502;80,08%;379;378;99,74%;1;0,26%;345;16;4,64%;329;95,36%
MULTIPOLYGON (((-58.461707441490134 -34.612343304216026,-58.460708282779294 -34.611795525596513,-58.460552660241291 -34.611721013200949,-58.460485364234053 -34.611856932440126,-58.460036264498939 -34.612756181481409,-58.459543879233685 -34.613741909619613,-58.459448384254372 -34.613885644692253,-58.460393473713609 -34.614245397495068,-58.460667419190344 -34.614348011694609,-58.461864916380264 -34.614796703873267,-58.462046614975449 -34.614487891064549,-58.462453365945279 -34.613886532876094,-58.463013011617228 -34.613059038032191,-58.461707441490134 -34.612343304216026)));;614;11_22_10;COMUNA 11;22;10;777;369;408;90,44%;394;394;100,00%;0;0,00%;307;2;0,65%;305;99,35%
MULTIPOLYGON (((-58.464983658457662 -34.615078737735985,-58.463635534404112 -34.614443239733731,-58.464198240311283 -34.613708771032996,-58.463013011617228 -34.613059038032191,-58.462453365945279 -34.613886532876094,-58.462046614975449 -34.614487891064549,-58.461864916380264 -34.614796703873267,-58.463030141729767 -34.615233200820988,-58.463204087520914 -34.615298343406238,-58.464134812804005 -34.615643630064994,-58.464373160063033 -34.615728700494856,-58.464465926514876 -34.615761798962644,-58.464983658457662 -34.615078737735985)));;615;11_22_11;COMUNA 11;22;11;701;334;367;91,01%;284;283;99,65%;1;0,35%;248;4;1,61%;244;98,39%
MULTIPOLYGON (((-58.464413951100234 -34.610987542594806,-58.463701522402779 -34.612041039635422,-58.464798066437098 -34.612615905743162,-58.464966812764587 -34.612705694713654,-58.465650701488755 -34.611813112447116,-58.465744736102302 -34.611690218337124,-58.467035251961512 -34.612373936569554,-58.467716900819475 -34.611475920019771,-58.467813998215654 -34.611348657825722,-58.467848237754026 -34.611303795593948,-58.466560968438088 -34.610616634907366,-58.46594212927171 -34.610286288707115,-58.465880883444925 -34.610226499394685,-58.465823135258077 -34.610306292544344,-58.46513172824762 -34.609941154042971,-58.465068017027583 -34.610020313131578,-58.464413951100234 -34.610987542594806)));;616;11_22_2;COMUNA 11;22;2;977;488;489;99,80%;402;401;99,75%;1;0,25%;358;36;10,06%;322;89,94%
MULTIPOLYGON (((-58.466260489904577 -34.613394350724072,-58.466155381106503 -34.61353287987906,-58.465487582885267 -34.614413914645041,-58.46558520441733 -34.614466308626696,-58.466633919121776 -34.615019961182036,-58.467678729153086 -34.61557149207939,-58.468464483258856 -34.614559097221523,-58.467406902923663 -34.614000390097331,-58.468180208518454 -34.612980320955245,-58.46828318390066 -34.612844466294369,-58.468958691005469 -34.611957570322588,-58.468399545928108 -34.611660122105931,-58.467813998215654 -34.611348657825722,-58.467716900819475 -34.611475920019771,-58.467035251961512 -34.612373936569554,-58.466260489904577 -34.613394350724072)));;617;11_22_3;COMUNA 11;22;3;996;485;511;94,91%;419;419;100,00%;0;0,00%;360;10;2,78%;350;97,22%
MULTIPOLYGON (((-58.472219278287668 -34.613874189482871,-58.472093620134252 -34.613749546838555,-58.471959354427277 -34.613584128595498,-58.471821433622488 -34.613484487498241,-58.471645692785053 -34.613388792826953,-58.471359380269654 -34.613235005106361,-58.471170522005863 -34.613134380921089,-58.470944011950621 -34.61301368784256,-58.470038063541132 -34.612531756394212,-58.469507532752282 -34.612249593805025,-58.468958691005469 -34.611957570322588,-58.46828318390066 -34.612844466294369,-58.468180208518454 -34.612980320955245,-58.469250133120958 -34.613546908416531,-58.470384217957594 -34.614147427301738,-58.471521726654366 -34.614749766388563,-58.472219278287668 -34.613874189482871)));;618;11_22_4;COMUNA 11;22;4;694;324;370;87,57%;328;327;99,70%;1;0,31%;265;9;3,40%;256;96,60%
MULTIPOLYGON (((-58.469250133120958 -34.613546908416531,-58.468180208518454 -34.612980320955245,-58.467406902923663 -34.614000390097331,-58.468464483258856 -34.614559097221523,-58.468649082101351 -34.614656627077153,-58.469599513139997 -34.615158566880446,-58.468813937517133 -34.616170687239567,-58.4699233498458 -34.616756351698569,-58.470723314433208 -34.615752110953871,-58.471122608126798 -34.61525093933875,-58.471521726654366 -34.614749766388563,-58.470384217957594 -34.614147427301738,-58.469250133120958 -34.613546908416531)));;619;11_22_5;COMUNA 11;22;5;893;421;472;89,19%;378;377;99,74%;1;0,27%;310;6;1,94%;304;98,06%
MULTIPOLYGON (((-58.468813937517133 -34.616170687239567,-58.469599513139997 -34.615158566880446,-58.468649082101351 -34.614656627077153,-58.468464483258856 -34.614559097221523,-58.467678729153086 -34.61557149207939,-58.466762971479334 -34.616751216010556,-58.467960795944634 -34.617269709800688,-58.468635233643191 -34.617561661045286,-58.468796837982602 -34.617644895464046,-58.469093638786269 -34.617797843436996,-58.4699233498458 -34.616756351698569,-58.468813937517133 -34.616170687239567)));;620;11_22_6;COMUNA 11;22;6;1032;487;545;89,36%;488;488;100,00%;0;0,00%;409;29;7,09%;380;92,91%
MULTIPOLYGON (((-58.466633919121776 -34.615019961182036,-58.46558520441733 -34.614466308626696,-58.465487582885267 -34.614413914645041,-58.464983658457662 -34.615078737735985,-58.464465926514876 -34.615761798962644,-58.464538589360799 -34.615787714308901,-58.465542672776138 -34.616222992283888,-58.465677437292165 -34.616281371434042,-58.466651631893413 -34.616703048938774,-58.466762971479334 -34.616751216010556,-58.467678729153086 -34.61557149207939,-58.466633919121776 -34.615019961182036)));;621;11_22_7;COMUNA 11;22;7;856;371;485;76,49%;406;405;99,75%;1;0,25%;345;4;1,16%;341;98,84%
MULTIPOLYGON (((-58.467035251961512 -34.612373936569554,-58.465744736102302 -34.611690218337124,-58.465650701488755 -34.611813112447116,-58.464966812764587 -34.612705694713654,-58.464798066437098 -34.612615905743162,-58.463701522402779 -34.612041039635422,-58.463013011617228 -34.613059038032191,-58.464198240311283 -34.613708771032996,-58.463635534404112 -34.614443239733731,-58.464983658457662 -34.615078737735985,-58.465487582885267 -34.614413914645041,-58.466155381106503 -34.61353287987906,-58.466260489904577 -34.613394350724072,-58.467035251961512 -34.612373936569554)));;622;11_22_8;COMUNA 11;22;8;865;414;451;91,80%;346;344;99,42%;2;0,58%;269;7;2,60%;262;97,40%
MULTIPOLYGON (((-58.463701522402779 -34.612041039635422,-58.462408994686754 -34.61136348350616,-58.462257374902116 -34.611286015434828,-58.462783699926149 -34.610291402364183,-58.462849883616521 -34.61016358071231,-58.462692899353591 -34.610080901714618,-58.461826041762755 -34.609625670596209,-58.46164061032156 -34.609522918869359,-58.461074835734365 -34.61066605317923,-58.460552660241291 -34.611721013200949,-58.460708282779294 -34.611795525596513,-58.461707441490134 -34.612343304216026,-58.463013011617228 -34.613059038032191,-58.463701522402779 -34.612041039635422)));;623;11_22_9;COMUNA 11;22;9;763;358;405;88,40%;318;318;100,00%;0;0,00%;269;9;3,35%;260;96,65%
MULTIPOLYGON (((-58.51268955670772 -34.59741018459377,-58.512051606178282 -34.597020781314541,-58.5118171461244 -34.59687579987321,-58.511385288487659 -34.596608709057946,-58.510734277248787 -34.59732857238199,-58.510126747479653 -34.59800045566562,-58.510032867929787 -34.598103350503131,-58.509441839113705 -34.598757861763502,-58.508266905017443 -34.598032855707572,-58.508138771759192 -34.597953534230115,-58.507631993177355 -34.598512264533326,-58.507517171414065 -34.598639213049786,-58.508674642523886 -34.599353950748188,-58.508821095644322 -34.59944439190761,-58.509295132227706 -34.599737110355683,-58.5101241078603 -34.60024899366757,-58.510745272255129 -34.599562175120894,-58.511339498468693 -34.59890642753119,-58.51142983499345 -34.598805254923867,-58.512037019239955 -34.598133013256728,-58.512231241874204 -34.597919053092511,-58.51268955670772 -34.59741018459377)));;624;11_3_1;COMUNA 11;3;1;693;328;365;89,86%;337;337;100,00%;0;0,00%;264;2;0,76%;262;99,24%
MULTIPOLYGON (((-58.502912111701669 -34.599167105340378,-58.502214528280341 -34.599934897867264,-58.503093472005666 -34.600478785803013,-58.503909766393207 -34.600381185189597,-58.504715413435051 -34.600284850435223,-58.506280543543141 -34.600097674630312,-58.506373275270285 -34.599903197419792,-58.506896072159066 -34.59932545185044,-58.506757034360426 -34.599241555247815,-58.50559199862483 -34.598521449679801,-58.504923557279618 -34.59925903508978,-58.503582358879797 -34.59843009372841,-58.503017578041423 -34.599051009743683,-58.502912111701669 -34.599167105340378)));;625;11_3_10;COMUNA 11;3;10;773;356;417;85,37%;368;368;100,00%;0;0,00%;317;2;0,63%;315;99,37%
MULTIPOLYGON (((-58.503909766393207 -34.600381185189597,-58.503093472005666 -34.600478785803013,-58.503404431913118 -34.600671295452194,-58.503559997487649 -34.600767373885397,-58.503648174201267 -34.600821853447037,-58.504862383514606 -34.601572031880217,-58.505543788392913 -34.60199300769645,-58.506459912932719 -34.602055361016284,-58.507721332440006 -34.60214117298456,-58.508376485567268 -34.602181283134463,-58.508833827062944 -34.601675669377116,-58.50753123063334 -34.600870701752363,-58.506280543543141 -34.600097674630312,-58.504715413435051 -34.600284850435223,-58.503909766393207 -34.600381185189597)));;626;11_3_11;COMUNA 11;3;11;740;325;415;78,31%;319;316;99,06%;3;0,95%;254;0;0,00%;254;100,00%
MULTIPOLYGON (((-58.508076569315499 -34.60250016368564,-58.508400059781202 -34.602182853870453,-58.508376485567268 -34.602181283134463,-58.507721332440006 -34.60214117298456,-58.506459912932719 -34.602055361016284,-58.505543788392913 -34.60199300769645,-58.505816079672762 -34.602161298448948,-58.506167691415101 -34.602378505872416,-58.505978210120581 -34.602588017770564,-58.505373842238043 -34.603263678680797,-58.504619815712807 -34.604106577418491,-58.503734083241902 -34.605096704358346,-58.503607245510722 -34.605240977696269,-58.503784969588558 -34.605346344458439,-58.504331861331792 -34.60567004441701,-58.50444534682255 -34.605737261672928,-58.504737581244832 -34.605910195960597,-58.504919312227749 -34.606017249881099,-58.505785632672932 -34.605050009525229,-58.505907530015364 -34.604912919036956,-58.506012742749725 -34.604794567443918,-58.506671768334179 -34.604064022635136,-58.507312906913761 -34.603353270203471,-58.50746893499042 -34.603182502393821,-58.508091517192348 -34.602501094056265,-58.508076569315499 -34.60250016368564)));;627;11_3_12;COMUNA 11;3;12;775;371;404;91,83%;327;326;99,69%;1;0,31%;282;3;1,06%;279;98,94%
MULTIPOLYGON (((-58.5100846205221 -34.595804260205696,-58.509651836815813 -34.59553652973603,-58.509627444007954 -34.595533023920815,-58.508453063038075 -34.595364231874086,-58.508130316807787 -34.595720422668499,-58.507522181219684 -34.596391589138904,-58.507430950661359 -34.596493007743732,-58.508736278083617 -34.597295077802364,-58.510032867929787 -34.598103350503131,-58.510126747479653 -34.59800045566562,-58.510734277248787 -34.59732857238199,-58.511385288487659 -34.596608709057946,-58.5100846205221 -34.595804260205696)));;628;11_3_2;COMUNA 11;3;2;800;367;433;84,76%;374;372;99,47%;2;0,54%;292;2;0,68%;290;99,32%
MULTIPOLYGON (((-58.508453063038075 -34.595364231874086,-58.507255309765441 -34.595179949558045,-58.506623857554175 -34.595082850735622,-58.505092106688281 -34.594877340154149,-58.504779011883691 -34.594820492944834,-58.503181207085568 -34.594582220964853,-58.502876875202681 -34.594697918069137,-58.502876659364262 -34.594698000123508,-58.504163099233772 -34.595493938935142,-58.505499741441177 -34.596320904019095,-58.506836665705279 -34.597147995088037,-58.507430950661359 -34.596493007743732,-58.507522181219684 -34.596391589138904,-58.508130316807787 -34.595720422668499,-58.508453063038075 -34.595364231874086)));;629;11_3_3;COMUNA 11;3;3;687;307;380;80,79%;305;303;99,34%;2;0,66%;240;1;0,42%;239;99,58%
MULTIPOLYGON (((-58.506214379868645 -34.597834723990509,-58.506416629484761 -34.597959515673743,-58.507517171414065 -34.598639213049786,-58.507631993177355 -34.598512264533326,-58.508138771759192 -34.597953534230115,-58.508266905017443 -34.598032855707572,-58.509441839113705 -34.598757861763502,-58.510032867929787 -34.598103350503131,-58.508736278083617 -34.597295077802364,-58.507430950661359 -34.596493007743732,-58.506836665705279 -34.597147995088037,-58.505499741441177 -34.596320904019095,-58.504987677522038 -34.596884907241638,-58.5048754071817 -34.597008401584773,-58.506214379868645 -34.597834723990509)));;630;11_3_4;COMUNA 11;3;4;619;280;339;82,60%;271;269;99,26%;2;0,74%;210;1;0,48%;209;99,52%
MULTIPOLYGON (((-58.506280543543141 -34.600097674630312,-58.50753123063334 -34.600870701752363,-58.508833827062944 -34.601675669377116,-58.509501911843103 -34.600936936178343,-58.5101241078603 -34.60024899366757,-58.509295132227706 -34.599737110355683,-58.508821095644322 -34.59944439190761,-58.508674642523886 -34.599353950748188,-58.507517171414065 -34.598639213049786,-58.506416629484761 -34.597959515673743,-58.506214379868645 -34.597834723990509,-58.50559199862483 -34.598521449679801,-58.506757034360426 -34.599241555247815,-58.506896072159066 -34.59932545185044,-58.506373275270285 -34.599903197419792,-58.506280543543141 -34.600097674630312)));;631;11_3_5;COMUNA 11;3;5;565;247;318;77,67%;312;311;99,68%;1;0,32%;233;1;0,43%;232;99,57%
MULTIPOLYGON (((-58.5048754071817 -34.597008401584773,-58.504987677522038 -34.596884907241638,-58.505499741441177 -34.596320904019095,-58.504163099233772 -34.595493938935142,-58.502876659364262 -34.594698000123508,-58.502757452638221 -34.594742336820033,-58.502202820482566 -34.595353597837409,-58.502330264506647 -34.595436517498626,-58.503538249906853 -34.596182979285629,-58.503011873749969 -34.5967633176855,-58.502918924668769 -34.596869267956585,-58.504252338897913 -34.597693430567517,-58.50559199862483 -34.598521449679801,-58.506214379868645 -34.597834723990509,-58.5048754071817 -34.597008401584773)));;632;11_3_6;COMUNA 11;3;6;755;358;397;90,18%;349;349;100,00%;0;0,00%;287;0;0,00%;287;100,00%
MULTIPOLYGON (((-58.502202820482566 -34.595353597837409,-58.501578806994679 -34.596041219399844,-58.500910434712551 -34.596777797156584,-58.50212114992901 -34.597519553458035,-58.502251067424844 -34.597603387900605,-58.50238967481701 -34.597692923823267,-58.503582358879797 -34.59843009372841,-58.504923557279618 -34.59925903508978,-58.50559199862483 -34.598521449679801,-58.504252338897913 -34.597693430567517,-58.502918924668769 -34.596869267956585,-58.503011873749969 -34.5967633176855,-58.503538249906853 -34.596182979285629,-58.502330264506647 -34.595436517498626,-58.502202820482566 -34.595353597837409)));;633;11_3_7;COMUNA 11;3;7;789;376;413;91,04%;319;319;100,00%;0;0,00%;283;8;2,83%;275;97,17%
MULTIPOLYGON (((-58.498384861946384 -34.596367630400898,-58.4971751147229 -34.596817361824876,-58.498004753544379 -34.597329327566271,-58.498222579274021 -34.597464199150529,-58.499543434245709 -34.598281726406285,-58.500136924644451 -34.597634055982688,-58.500241880460266 -34.59751472334986,-58.500337983263897 -34.597405393742463,-58.500804968341527 -34.596893961400653,-58.500910434712551 -34.596777797156584,-58.501578806994679 -34.596041219399844,-58.502202820482566 -34.595353597837409,-58.502757452638221 -34.594742336820033,-58.501792895150956 -34.59510083264923,-58.500709716484167 -34.595503373643496,-58.500126357310904 -34.595720182118733,-58.499633935481931 -34.595903297026013,-58.499550828958974 -34.595934168422879,-58.498384861946384 -34.596367630400898)));;634;11_3_8;COMUNA 11;3;8;757;320;437;73,23%;380;379;99,74%;1;0,26%;299;0;0,00%;299;100,00%
MULTIPOLYGON (((-58.502251067424844 -34.597603387900605,-58.50212114992901 -34.597519553458035,-58.500910434712551 -34.596777797156584,-58.500804968341527 -34.596893961400653,-58.500337983263897 -34.597405393742463,-58.500241880460266 -34.59751472334986,-58.500136924644451 -34.597634055982688,-58.499543434245709 -34.598281726406285,-58.500642988044369 -34.598962331165339,-58.500880927464316 -34.599109586551585,-58.502214528280341 -34.599934897867264,-58.502912111701669 -34.599167105340378,-58.503017578041423 -34.599051009743683,-58.503582358879797 -34.59843009372841,-58.50238967481701 -34.597692923823267,-58.502251067424844 -34.597603387900605)));;635;11_3_9;COMUNA 11;3;9;734;340;394;86,29%;359;359;100,00%;0;0,00%;298;3;1,01%;295;98,99%
MULTIPOLYGON (((-58.521371215611076 -34.603893678750097,-58.522033244157477 -34.603153682935961,-58.520131058936855 -34.60308043536304,-58.51822546870865 -34.603004976502035,-58.518146995204127 -34.60309210322994,-58.519400818248279 -34.603889885412869,-58.519330879665659 -34.603967744119849,-58.518813416888939 -34.604539976459336,-58.518734009538463 -34.604627762714983,-58.518193729867612 -34.605226764407185,-58.517573692411901 -34.605914253544697,-58.518841186336239 -34.606695959496847,-58.519461218562725 -34.606007618909345,-58.520079964020532 -34.605320825057277,-58.520595463956276 -34.604748588353033,-58.520671605758579 -34.604666676462287,-58.520761342532182 -34.604570685979617,-58.520866112004875 -34.60445823750716,-58.521371215611076 -34.603893678750097)));;636;11_4_1;COMUNA 11;4;1;829;394;435;90,57%;331;331;100,00%;0;0,00%;284;0;0,00%;284;100,00%
MULTIPOLYGON (((-58.510462838180857 -34.605035803006921,-58.510230062729754 -34.604892437834856,-58.509194423991936 -34.604250700124986,-58.508397946968422 -34.605132583349267,-58.507632523213061 -34.605980011919314,-58.507780435610968 -34.606071932616047,-58.508129938822705 -34.606287726512782,-58.508270694478583 -34.606373874411986,-58.509032366334964 -34.605523978438477,-58.50914142597145 -34.605590488755603,-58.509471079252343 -34.605795863457153,-58.509672074045753 -34.605918185171909,-58.50984665628264 -34.606024459825839,-58.510274297799825 -34.606289374119143,-58.510472997498709 -34.606415639207036,-58.51064511346479 -34.60652494195606,-58.511965995442203 -34.607371771117862,-58.512784501347646 -34.606464854963711,-58.511730506856125 -34.605816103980111,-58.511244754658321 -34.605517061701114,-58.510462838180857 -34.605035803006921)));;637;11_4_10;COMUNA 11;4;10;691;309;382;80,89%;342;342;100,00%;0;0,00%;281;6;2,14%;275;97,86%
MULTIPOLYGON (((-58.511197438241531 -34.608223237231705,-58.511965995442203 -34.607371771117862,-58.51064511346479 -34.60652494195606,-58.510472997498709 -34.606415639207036,-58.510274297799825 -34.606289374119143,-58.50984665628264 -34.606024459825839,-58.509672074045753 -34.605918185171909,-58.509471079252343 -34.605795863457153,-58.50914142597145 -34.605590488755603,-58.509032366334964 -34.605523978438477,-58.508270694478583 -34.606373874411986,-58.508409490747518 -34.606458825653938,-58.508749455771706 -34.606671311351889,-58.508906657409867 -34.6067680865009,-58.508073380912073 -34.607693433495378,-58.507956930494039 -34.607823411125949,-58.508132109085665 -34.607926589271976,-58.508652789984609 -34.60823175765983,-58.508823541764379 -34.608336133699943,-58.51028790046756 -34.609230885955903,-58.511197438241531 -34.608223237231705)));;638;11_4_11;COMUNA 11;4;11;931;414;517;80,08%;407;406;99,75%;1;0,25%;313;3;0,96%;310;99,04%
MULTIPOLYGON (((-58.507632523213061 -34.605980011919314,-58.508397946968422 -34.605132583349267,-58.509194423991936 -34.604250700124986,-58.50833380367483 -34.603717343005243,-58.507539622567243 -34.604599712822981,-58.506774196569594 -34.605450164367106,-58.505793556763699 -34.606539569322599,-58.50602019165548 -34.606673437706036,-58.506495615089499 -34.606952362848901,-58.50666363378469 -34.60705265825834,-58.507780218670383 -34.607719317766154,-58.507956930494039 -34.607823411125949,-58.508073380912073 -34.607693433495378,-58.508906657409867 -34.6067680865009,-58.508749455771706 -34.606671311351889,-58.508409490747518 -34.606458825653938,-58.508270694478583 -34.606373874411986,-58.508129938822705 -34.606287726512782,-58.507780435610968 -34.606071932616047,-58.507632523213061 -34.605980011919314)));;639;11_4_12;COMUNA 11;4;12;883;414;469;88,27%;437;437;100,00%;0;0,00%;352;0;0,00%;352;100,00%
MULTIPOLYGON (((-58.506671768334179 -34.604064022635136,-58.506012742749725 -34.604794567443918,-58.505907530015364 -34.604912919036956,-58.505785632672932 -34.605050009525229,-58.504919312227749 -34.606017249881099,-58.505081788476467 -34.606112971768134,-58.505589245167727 -34.606418862173889,-58.505793556763699 -34.606539569322599,-58.506774196569594 -34.605450164367106,-58.507539622567243 -34.604599712822981,-58.50833380367483 -34.603717343005243,-58.508112877981318 -34.603580448444767,-58.50746893499042 -34.603182502393821,-58.507312906913761 -34.603353270203471,-58.506671768334179 -34.604064022635136)));;640;11_4_13;COMUNA 11;4;13;795;366;429;85,31%;398;398;100,00%;0;0,00%;327;0;0,00%;327;100,00%
MULTIPOLYGON (((-58.516281215955132 -34.602932321869524,-58.516174661466685 -34.603057021200762,-58.515184610048827 -34.603026534420884,-58.515182802709667 -34.602996745342715,-58.51485991133157 -34.602985756619326,-58.514855159526597 -34.603014210427588,-58.514786936680473 -34.603013253617078,-58.514718590875731 -34.603088285601046,-58.515527691728678 -34.603582604491315,-58.515656778350824 -34.603663185368951,-58.515776577837478 -34.603738065709344,-58.516802118546487 -34.604369469987461,-58.516926009283928 -34.604445755878942,-58.518193729867612 -34.605226764407185,-58.518734009538463 -34.604627762714983,-58.518813416888939 -34.604539976459336,-58.519330879665659 -34.603967744119849,-58.519400818248279 -34.603889885412869,-58.518146995204127 -34.60309210322994,-58.51822546870865 -34.603004976502035,-58.516281215955132 -34.602932321869524)));;641;11_4_2;COMUNA 11;4;2;786;364;422;86,26%;374;374;100,00%;0;0,00%;297;1;0,34%;296;99,66%
MULTIPOLYGON (((-58.51821958967291 -34.600825953006968,-58.518102263813752 -34.600753679638274,-58.516952360702653 -34.600043535427233,-58.51639431089594 -34.600663242507302,-58.516301030548853 -34.600764132428935,-58.516207579818641 -34.600865304053286,-58.515693113940181 -34.601436754764038,-58.515613804597699 -34.60152428954062,-58.515093406928685 -34.602101749947785,-58.51501033825236 -34.602193690474863,-58.515590405953652 -34.602551552546444,-58.516202856518774 -34.602929398396164,-58.516281215955132 -34.602932321869524,-58.51822546870865 -34.603004976502035,-58.520131058936855 -34.60308043536304,-58.522033244157477 -34.603153682935961,-58.522047460943099 -34.603154229086883,-58.521396859548624 -34.602774843447975,-58.521381841260897 -34.602774265339505,-58.520755650398378 -34.602388493977983,-58.519489312281962 -34.601608285727878,-58.51821958967291 -34.600825953006968)));;642;11_4_3;COMUNA 11;4;3;739;308;431;71,46%;278;276;99,28%;2;0,72%;221;1;0,45%;220;99,55%
MULTIPOLYGON (((-58.515286501489733 -34.599014859119791,-58.514414480765446 -34.598476337867467,-58.513722239768697 -34.598048795909726,-58.513630565412271 -34.597990733376776,-58.513501488755963 -34.597908882616871,-58.513363977708657 -34.59782175332758,-58.51268955670772 -34.59741018459377,-58.512231241874204 -34.597919053092511,-58.512037019239955 -34.598133013256728,-58.51142983499345 -34.598805254923867,-58.511339498468693 -34.59890642753119,-58.510745272255129 -34.599562175120894,-58.511609527229595 -34.600095373300221,-58.512473026517064 -34.600628213488839,-58.513742607697083 -34.601411521647449,-58.51501033825236 -34.602193690474863,-58.515093406928685 -34.602101749947785,-58.515613804597699 -34.60152428954062,-58.515693113940181 -34.601436754764038,-58.516207579818641 -34.600865304053286,-58.516301030548853 -34.600764132428935,-58.51639431089594 -34.600663242507302,-58.516952360702653 -34.600043535427233,-58.515684218202345 -34.599260400719182,-58.515286501489733 -34.599014859119791)));;643;11_4_4;COMUNA 11;4;4;948;407;541;75,23%;379;377;99,47%;2;0,53%;296;0;0,00%;296;100,00%
MULTIPOLYGON (((-58.514717128224632 -34.602518264712195,-58.515209257131332 -34.602536998299541,-58.515590405953652 -34.602551552546444,-58.51501033825236 -34.602193690474863,-58.513742607697083 -34.601411521647449,-58.512473026517064 -34.600628213488839,-58.511609527229595 -34.600095373300221,-58.510745272255129 -34.599562175120894,-58.5101241078603 -34.60024899366757,-58.509501911843103 -34.600936936178343,-58.508833827062944 -34.601675669377116,-58.508376485567268 -34.602181283134463,-58.508400059781202 -34.602182853870453,-58.508076569315499 -34.60250016368564,-58.508091517192348 -34.602501094056265,-58.508361321677171 -34.602534687465536,-58.50859777867857 -34.602682345815396,-58.508663743283869 -34.60260443071649,-58.509102556872634 -34.6026277162185,-58.509117483181249 -34.60266616269876,-58.509234964283976 -34.602720486202138,-58.509412095575719 -34.602524636471422,-58.509574926273288 -34.602344637642318,-58.509646169798316 -34.602265874878,-58.51091636936254 -34.602353481487278,-58.511089528288061 -34.602365455648581,-58.51155210407363 -34.602389004617422,-58.511881979828587 -34.602405281171407,-58.512180256412442 -34.602419949871937,-58.512257625391733 -34.60233371802962,-58.51258809721574 -34.602349922007512,-58.51277777770354 -34.602358929158441,-58.512872319886519 -34.60236346795849,-58.513075713338552 -34.602373173258876,-58.513605145705689 -34.60239175706004,-58.513751694197012 -34.602481417534833,-58.514717128224632 -34.602518264712195)));;644;11_4_5;COMUNA 11;4;5;777;360;417;86,33%;375;375;100,00%;0;0,00%;308;2;0,65%;306;99,35%
MULTIPOLYGON (((-58.514718590875731 -34.603088285601046,-58.514786936680473 -34.603013253617078,-58.514855159526597 -34.603014210427588,-58.51485991133157 -34.602985756619326,-58.515182802709667 -34.602996745342715,-58.515184610048827 -34.603026534420884,-58.516174661466685 -34.603057021200762,-58.516281215955132 -34.602932321869524,-58.516202856518774 -34.602929398396164,-58.515590405953652 -34.602551552546444,-58.515209257131332 -34.602536998299541,-58.514717128224632 -34.602518264712195,-58.513751694197012 -34.602481417534833,-58.513605145705689 -34.60239175706004,-58.513075713338552 -34.602373173258876,-58.512872319886519 -34.60236346795849,-58.51277777770354 -34.602358929158441,-58.51258809721574 -34.602349922007512,-58.512257625391733 -34.60233371802962,-58.512180256412442 -34.602419949871937,-58.511881979828587 -34.602405281171407,-58.51155210407363 -34.602389004617422,-58.511089528288061 -34.602365455648581,-58.51091636936254 -34.602353481487278,-58.509646169798316 -34.602265874878,-58.509574926273288 -34.602344637642318,-58.509412095575719 -34.602524636471422,-58.509234964283976 -34.602720486202138,-58.509346062118404 -34.602782699654185,-58.50970047372261 -34.602808620973768,-58.510335449516496 -34.602852320053827,-58.510427353393169 -34.602859608360255,-58.510756383746831 -34.602883987183269,-58.510839258896979 -34.602890151931895,-58.510986696648132 -34.602901150429908,-58.511598838049132 -34.60292802034725,-58.512225117811035 -34.602954106778434,-58.512302652430378 -34.603002457390446,-58.512903214357813 -34.603033762256771,-58.513102177290463 -34.604306826702562,-58.51437173491901 -34.605089634847467,-58.514454722049614 -34.604997765256861,-58.515037753381058 -34.604350238810028,-58.516306648284065 -34.605132815816461,-58.517573692411901 -34.605914253544697,-58.518193729867612 -34.605226764407185,-58.516926009283928 -34.604445755878942,-58.516802118546487 -34.604369469987461,-58.515776577837478 -34.603738065709344,-58.515656778350824 -34.603663185368951,-58.515527691728678 -34.603582604491315,-58.514718590875731 -34.603088285601046)));;645;11_4_6;COMUNA 11;4;6;644;294;350;84,00%;296;296;100,00%;0;0,00%;241;0;0,00%;241;100,00%
MULTIPOLYGON (((-58.516241833866637 -34.607392716992273,-58.517508231166268 -34.608175423030154,-58.518175438115883 -34.60743488290499,-58.518841186336239 -34.606695959496847,-58.517573692411901 -34.605914253544697,-58.516306648284065 -34.605132815816461,-58.515037753381058 -34.604350238810028,-58.514454722049614 -34.604997765256861,-58.51437173491901 -34.605089634847467,-58.515640549486527 -34.605871937017149,-58.515552966816479 -34.605969232128672,-58.514972649904671 -34.606610562292921,-58.515087253398633 -34.606679177659977,-58.516241833866637 -34.607392716992273)));;646;11_4_7;COMUNA 11;4;7;727;359;368;97,55%;337;337;100,00%;0;0,00%;279;0;0,00%;279;100,00%
MULTIPOLYGON (((-58.514275118238665 -34.60738300042555,-58.515543455176008 -34.608164387969644,-58.516813349702325 -34.608946747478072,-58.516952854691105 -34.608791820681155,-58.517508231166268 -34.608175423030154,-58.516241833866637 -34.607392716992273,-58.515087253398633 -34.606679177659977,-58.514972649904671 -34.606610562292921,-58.515552966816479 -34.605969232128672,-58.515640549486527 -34.605871937017149,-58.51437173491901 -34.605089634847467,-58.513102177290463 -34.604306826702562,-58.513347585191617 -34.605611280906793,-58.513438008797863 -34.606120135531334,-58.513587150163538 -34.606959118661543,-58.514275118238665 -34.60738300042555)));;647;11_4_8;COMUNA 11;4;8;700;339;361;93,91%;346;346;100,00%;0;0,00%;282;1;0,35%;281;99,65%
MULTIPOLYGON (((-58.513102177290463 -34.604306826702562,-58.512903214357813 -34.603033762256771,-58.512302652430378 -34.603002457390446,-58.512225117811035 -34.602954106778434,-58.511598838049132 -34.60292802034725,-58.510986696648132 -34.602901150429908,-58.510839258896979 -34.602890151931895,-58.510756383746831 -34.602883987183269,-58.510427353393169 -34.602859608360255,-58.510335449516496 -34.602852320053827,-58.50970047372261 -34.602808620973768,-58.509346062118404 -34.602782699654185,-58.509234964283976 -34.602720486202138,-58.509117483181249 -34.60266616269876,-58.509102556872634 -34.6026277162185,-58.508663743283869 -34.60260443071649,-58.50859777867857 -34.602682345815396,-58.508361321677171 -34.602534687465536,-58.508091517192348 -34.602501094056265,-58.50746893499042 -34.603182502393821,-58.508112877981318 -34.603580448444767,-58.50833380367483 -34.603717343005243,-58.509194423991936 -34.604250700124986,-58.510230062729754 -34.604892437834856,-58.510462838180857 -34.605035803006921,-58.511244754658321 -34.605517061701114,-58.511730506856125 -34.605816103980111,-58.512784501347646 -34.606464854963711,-58.512999306940245 -34.606597095457289,-58.513168527523142 -34.606701254799482,-58.513587150163538 -34.606959118661543,-58.513438008797863 -34.606120135531334,-58.513347585191617 -34.605611280906793,-58.513102177290463 -34.604306826702562)));;648;11_4_9;COMUNA 11;4;9;828;379;449;84,41%;428;428;100,00%;0;0,00%;309;2;0,65%;307;99,35%
MULTIPOLYGON (((-58.529091261467563 -34.611104682695093,-58.5293631166574 -34.610902756054003,-58.526163304343022 -34.604087037453667,-58.525885835332673 -34.604272878971337,-58.525324791991061 -34.604648646720115,-58.525326417262058 -34.604652093364862,-58.524910999007545 -34.604955204515981,-58.524073341703421 -34.605564383822681,-58.523933390491003 -34.605666218489915,-58.523470543879483 -34.606002096181136,-58.523295862985165 -34.606135568296253,-58.523195884583309 -34.606211883681617,-58.52307044538081 -34.606307658255062,-58.522435630038693 -34.606771861145049,-58.523336812166399 -34.607397214398617,-58.524307794864832 -34.608059851016939,-58.525760803586316 -34.609051187366134,-58.526835455786909 -34.609784456847535,-58.527243760401021 -34.610063054520914,-58.527840583768672 -34.610470287387656,-58.528177306139597 -34.61069997465826,-58.528552630576336 -34.611504758378629,-58.529091261467563 -34.611104682695093)));;649;11_5_1;COMUNA 11;5;1;704;347;357;97,20%;298;297;99,66%;1;0,34%;242;1;0,41%;241;99,59%
MULTIPOLYGON (((-58.5254270920124 -34.612240700791645,-58.524922822941726 -34.611899608647576,-58.524511621309358 -34.61162149773488,-58.523719222975757 -34.612247905189406,-58.523339557453063 -34.611993226116972,-58.522754595696824 -34.611600613907598,-58.522635371672834 -34.611521233036029,-58.521945205593717 -34.61206799837705,-58.523514240558278 -34.613014161936967,-58.523889887052533 -34.613240672408786,-58.523985332953188 -34.613298232205949,-58.524464694715014 -34.613587014933906,-58.524922584214046 -34.613862918929918,-58.525060483891302 -34.613962570405278,-58.52511417785049 -34.614001276730264,-58.52542561450035 -34.613787024820923,-58.525614369794816 -34.613662486542751,-58.525716021015114 -34.613587924362996,-58.525848490776006 -34.613490669278896,-58.526537397774383 -34.612986348968548,-58.525881423431315 -34.612547942240333,-58.5254270920124 -34.612240700791645)));;650;11_5_10;COMUNA 11;5;10;811;355;456;77,85%;412;412;100,00%;0;0,00%;334;0;0,00%;334;100,00%
MULTIPOLYGON (((-58.520671605758579 -34.604666676462287,-58.520595463956276 -34.604748588353033,-58.520079964020532 -34.605320825057277,-58.521348579488397 -34.606102293227728,-58.522435630038693 -34.606771861145049,-58.52307044538081 -34.606307658255062,-58.523195884583309 -34.606211883681617,-58.523295862985165 -34.606135568296253,-58.523470543879483 -34.606002096181136,-58.523933390491003 -34.605666218489915,-58.524073341703421 -34.605564383822681,-58.524910999007545 -34.604955204515981,-58.523279110306852 -34.603943945527213,-58.523118658867574 -34.603844514308818,-58.522033244157477 -34.603153682935961,-58.521371215611076 -34.603893678750097,-58.520866112004875 -34.60445823750716,-58.520761342532182 -34.604570685979617,-58.520671605758579 -34.604666676462287)));;651;11_5_2;COMUNA 11;5;2;867;426;441;96,60%;372;372;100,00%;0;0,00%;316;1;0,32%;315;99,68%
MULTIPOLYGON (((-58.518841186336239 -34.606695959496847,-58.518175438115883 -34.60743488290499,-58.519443642307174 -34.608216722916318,-58.52000308237087 -34.607596509014748,-58.520108279535471 -34.607479694686958,-58.520844516878022 -34.607935207941622,-58.521642888363466 -34.607351493472969,-58.522435630038693 -34.606771861145049,-58.521348579488397 -34.606102293227728,-58.520079964020532 -34.605320825057277,-58.519461218562725 -34.606007618909345,-58.518841186336239 -34.606695959496847)));;652;11_5_3;COMUNA 11;5;3;977;472;505;93,47%;380;380;100,00%;0;0,00%;353;1;0,28%;352;99,72%
MULTIPOLYGON (((-58.517508231166268 -34.608175423030154,-58.516952854691105 -34.608791820681155,-58.516813349702325 -34.608946747478072,-58.517940621471169 -34.609641126925055,-58.518082672451861 -34.609730079868037,-58.518324250782385 -34.609780525656149,-58.519141150766664 -34.609180490182581,-58.519994713131361 -34.608556477890765,-58.520844516878022 -34.607935207941622,-58.520108279535471 -34.607479694686958,-58.52000308237087 -34.607596509014748,-58.519443642307174 -34.608216722916318,-58.518175438115883 -34.60743488290499,-58.517508231166268 -34.608175423030154)));;653;11_5_4;COMUNA 11;5;4;624;268;356;75,28%;306;306;100,00%;0;0,00%;252;3;1,19%;249;98,81%
MULTIPOLYGON (((-58.519141150766664 -34.609180490182581,-58.518324250782385 -34.609780525656149,-58.518082672451861 -34.609730079868037,-58.518443126997205 -34.609955628191685,-58.519414217886975 -34.61054013156992,-58.520207648120142 -34.609904455290831,-58.52101596403422 -34.609256864833391,-58.521824863235373 -34.608608705274911,-58.522582673472812 -34.608001552802314,-58.523336812166399 -34.607397214398617,-58.522435630038693 -34.606771861145049,-58.521642888363466 -34.607351493472969,-58.520844516878022 -34.607935207941622,-58.519994713131361 -34.608556477890765,-58.519141150766664 -34.609180490182581)));;654;11_5_5;COMUNA 11;5;5;854;393;461;85,25%;424;424;100,00%;0;0,00%;339;0;0,00%;339;100,00%
MULTIPOLYGON (((-58.523431260590115 -34.610890675727504,-58.524109403972922 -34.610353415325832,-58.524233694102037 -34.610257222438641,-58.524364368747165 -34.610156166864627,-58.525001469733617 -34.609652937511129,-58.525115285587674 -34.60956301689891,-58.525760803586316 -34.609051187366134,-58.524307794864832 -34.608059851016939,-58.523336812166399 -34.607397214398617,-58.522582673472812 -34.608001552802314,-58.521824863235373 -34.608608705274911,-58.522784428970205 -34.609264035204014,-58.522657586248258 -34.609364312541629,-58.521974162928601 -34.609905018357111,-58.523431260590115 -34.610890675727504)));;655;11_5_6;COMUNA 11;5;6;876;424;452;93,81%;381;381;100,00%;0;0,00%;319;2;0,63%;317;99,37%
MULTIPOLYGON (((-58.52040654136168 -34.611137997882736,-58.521368884770631 -34.611720447384819,-58.521945205593717 -34.61206799837705,-58.522635371672834 -34.611521233036029,-58.523431260590115 -34.610890675727504,-58.521974162928601 -34.609905018357111,-58.522657586248258 -34.609364312541629,-58.522784428970205 -34.609264035204014,-58.521824863235373 -34.608608705274911,-58.52101596403422 -34.609256864833391,-58.520207648120142 -34.609904455290831,-58.519414217886975 -34.61054013156992,-58.520241223819639 -34.611037931478904,-58.52040654136168 -34.611137997882736)));;656;11_5_7;COMUNA 11;5;7;754;360;394;91,37%;340;340;100,00%;0;0,00%;280;3;1,07%;277;98,93%
MULTIPOLYGON (((-58.523339557453063 -34.611993226116972,-58.523719222975757 -34.612247905189406,-58.524511621309358 -34.61162149773488,-58.524922822941726 -34.611899608647576,-58.525714953058802 -34.611272770934946,-58.526483490983914 -34.610664673433597,-58.527243760401021 -34.610063054520914,-58.526835455786909 -34.609784456847535,-58.525760803586316 -34.609051187366134,-58.525115285587674 -34.60956301689891,-58.525001469733617 -34.609652937511129,-58.524364368747165 -34.610156166864627,-58.524233694102037 -34.610257222438641,-58.524109403972922 -34.610353415325832,-58.523431260590115 -34.610890675727504,-58.522635371672834 -34.611521233036029,-58.522754595696824 -34.611600613907598,-58.523339557453063 -34.611993226116972)));;657;11_5_8;COMUNA 11;5;8;862;413;449;91,98%;348;348;100,00%;0;0,00%;307;1;0,33%;306;99,67%
MULTIPOLYGON (((-58.528177306139597 -34.61069997465826,-58.527840583768672 -34.610470287387656,-58.527243760401021 -34.610063054520914,-58.526483490983914 -34.610664673433597,-58.525714953058802 -34.611272770934946,-58.524922822941726 -34.611899608647576,-58.5254270920124 -34.612240700791645,-58.525881423431315 -34.612547942240333,-58.526537397774383 -34.612986348968548,-58.52694374007325 -34.61268894187004,-58.527348461964721 -34.612392731490317,-58.527756926728564 -34.61209370075629,-58.528159429371023 -34.611799038196004,-58.528553668768915 -34.61150698448396,-58.528552630576336 -34.611504758378629,-58.528177306139597 -34.61069997465826)));;658;11_5_9;COMUNA 11;5;9;842;381;461;82,65%;326;324;99,39%;2;0,62%;292;5;1,71%;287;98,29%
MULTIPOLYGON (((-58.512999306940245 -34.606597095457289,-58.512784501347646 -34.606464854963711,-58.511965995442203 -34.607371771117862,-58.512617584746366 -34.607789479473489,-58.513436703199531 -34.608314583515835,-58.514184894111381 -34.607483816905955,-58.514275118238665 -34.60738300042555,-58.513587150163538 -34.606959118661543,-58.513168527523142 -34.606701254799482,-58.512999306940245 -34.606597095457289)));;659;11_6_1;COMUNA 11;6;1;698;292;406;71,92%;337;337;100,00%;0;0,00%;317;0;0,00%;317;100,00%
MULTIPOLYGON (((-58.51438665894937 -34.61570290319122,-58.514269840121166 -34.615790279682301,-58.514104232449853 -34.615913522974068,-58.513986733546389 -34.616004139029727,-58.513046734697554 -34.616731669086143,-58.513650772768294 -34.617270803608001,-58.514333318709127 -34.617879904354112,-58.514973108560113 -34.617398628990486,-58.515229991908917 -34.617203511753345,-58.515632045517037 -34.616898045472702,-58.516028646984338 -34.616596735313543,-58.516818946506191 -34.615996365976024,-58.516993914332048 -34.615863466606648,-58.517589820815182 -34.615408324589886,-58.51743076771443 -34.615256348371567,-58.516715211845693 -34.614581009335751,-58.516648131759212 -34.614517726891343,-58.516376790415656 -34.614201497213024,-58.5155768873759 -34.614815107929267,-58.514784111039283 -34.615401526234024,-58.514519825370193 -34.615603406536628,-58.51438665894937 -34.61570290319122)));;660;11_6_10;COMUNA 11;6;10;799;372;427;87,12%;317;317;100,00%;0;0,00%;271;6;2,21%;265;97,79%
MULTIPOLYGON (((-58.514943936440972 -34.618424804429694,-58.515013743796182 -34.618487171075046,-58.515695798258371 -34.619095841727876,-58.516412383842201 -34.619735339451232,-58.516527113539915 -34.619837686826095,-58.516950149852178 -34.620215188669739,-58.517741498648121 -34.619613897706948,-58.518208264824636 -34.619259307614612,-58.516993831341004 -34.618090799014851,-58.51732086776169 -34.617837615941411,-58.516618409711505 -34.617163045444592,-58.516323740151535 -34.61687964416182,-58.516028646984338 -34.616596735313543,-58.515632045517037 -34.616898045472702,-58.515229991908917 -34.617203511753345,-58.514973108560113 -34.617398628990486,-58.514333318709127 -34.617879904354112,-58.514943936440972 -34.618424804429694)));;661;11_6_11;COMUNA 11;6;11;859;415;444;93,47%;357;357;100,00%;0;0,00%;314;3;0,96%;311;99,04%
MULTIPOLYGON (((-58.512667387353673 -34.609168735224657,-58.513436703199531 -34.608314583515835,-58.512617584746366 -34.607789479473489,-58.511965995442203 -34.607371771117862,-58.511197438241531 -34.608223237231705,-58.51028790046756 -34.609230885955903,-58.510953288369855 -34.609637540943666,-58.511786544766451 -34.610146663809793,-58.513058560688883 -34.610923920261719,-58.513694321912809 -34.611312402726149,-58.514331282016528 -34.611701585593686,-58.514445855686702 -34.611574419763421,-58.51503012519516 -34.610926400529038,-58.515167593965771 -34.610773800722221,-58.514542639832584 -34.610372644791234,-58.51391675440108 -34.60997092261983,-58.512830395194143 -34.609273601785119,-58.512667387353673 -34.609168735224657)));;662;11_6_2;COMUNA 11;6;2;967;461;506;91,11%;443;443;100,00%;0;0,00%;351;6;1,71%;345;98,29%
MULTIPOLYGON (((-58.515938346057595 -34.609918153924241,-58.516813349702325 -34.608946747478072,-58.515543455176008 -34.608164387969644,-58.514275118238665 -34.60738300042555,-58.514184894111381 -34.607483816905955,-58.513436703199531 -34.608314583515835,-58.512667387353673 -34.609168735224657,-58.512830395194143 -34.609273601785119,-58.51391675440108 -34.60997092261983,-58.514542639832584 -34.610372644791234,-58.515167593965771 -34.610773800722221,-58.515938346057595 -34.609918153924241)));;663;11_6_3;COMUNA 11;6;3;819;366;453;80,79%;457;457;100,00%;0;0,00%;347;27;7,78%;320;92,22%
MULTIPOLYGON (((-58.515605816498535 -34.612480222703311,-58.516745393427364 -34.613176508912829,-58.517289922404068 -34.613509165782737,-58.517415248075892 -34.613414176647808,-58.518061625787269 -34.612926473123245,-58.518271576409795 -34.612766090199543,-58.519233882289335 -34.612030903212514,-58.520283604827085 -34.611229045189617,-58.52040654136168 -34.611137997882736,-58.520241223819639 -34.611037931478904,-58.519414217886975 -34.61054013156992,-58.518443126997205 -34.609955628191685,-58.518082672451861 -34.609730079868037,-58.517940621471169 -34.609641126925055,-58.516813349702325 -34.608946747478072,-58.515938346057595 -34.609918153924241,-58.515167593965771 -34.610773800722221,-58.51503012519516 -34.610926400529038,-58.514445855686702 -34.611574419763421,-58.514331282016528 -34.611701585593686,-58.514969867068267 -34.612091679938047,-58.515243146523822 -34.612258681275904,-58.515605816498535 -34.612480222703311)));;664;11_6_4;COMUNA 11;6;4;916;457;459;99,56%;392;392;100,00%;0;0,00%;333;3;0,90%;330;99,10%
MULTIPOLYGON (((-58.52427037536858 -34.614599755071694,-58.525060483891302 -34.613962570405278,-58.524922584214046 -34.613862918929918,-58.524464694715014 -34.613587014933906,-58.523985332953188 -34.613298232205949,-58.523889887052533 -34.613240672408786,-58.523514240558278 -34.613014161936967,-58.521945205593717 -34.61206799837705,-58.521368884770631 -34.611720447384819,-58.52040654136168 -34.611137997882736,-58.520283604827085 -34.611229045189617,-58.519233882289335 -34.612030903212514,-58.519902720508192 -34.612652585763989,-58.520513760712745 -34.613195345479653,-58.52096806100473 -34.613598383289393,-58.521325026632546 -34.613915265914898,-58.521816328093216 -34.614352086755353,-58.522318714628049 -34.614797421597814,-58.522940526825721 -34.615350375317973,-58.52311986843555 -34.615508531702723,-58.524121137868718 -34.614720045861397,-58.52427037536858 -34.614599755071694)));;665;11_6_5;COMUNA 11;6;5;732;331;401;82,54%;417;417;100,00%;0;0,00%;304;1;0,33%;303;99,67%
MULTIPOLYGON (((-58.52096806100473 -34.613598383289393,-58.520513760712745 -34.613195345479653,-58.519902720508192 -34.612652585763989,-58.519233882289335 -34.612030903212514,-58.518271576409795 -34.612766090199543,-58.518915633880724 -34.613400325035535,-58.519493810463963 -34.613969162205166,-58.519594478607218 -34.614068203361576,-58.519924188780379 -34.614394258028113,-58.520023579621665 -34.61449245432145,-58.520262765599988 -34.614727561382011,-58.520310841616819 -34.614774793899059,-58.52040213509369 -34.614864542694768,-58.520609357864643 -34.615068747577645,-58.520734238092352 -34.615192565895754,-58.520841132518221 -34.615298645544648,-58.521203241499386 -34.615651865304862,-58.521958156667452 -34.61638842854174,-58.52311986843555 -34.615508531702723,-58.522940526825721 -34.615350375317973,-58.522318714628049 -34.614797421597814,-58.521816328093216 -34.614352086755353,-58.521325026632546 -34.613915265914898,-58.52096806100473 -34.613598383289393)));;666;11_6_6;COMUNA 11;6;6;855;378;477;79,25%;348;348;100,00%;0;0,00%;306;1;0,33%;305;99,67%
MULTIPOLYGON (((-58.519924188780379 -34.614394258028113,-58.519594478607218 -34.614068203361576,-58.519493810463963 -34.613969162205166,-58.518915633880724 -34.613400325035535,-58.518271576409795 -34.612766090199543,-58.518061625787269 -34.612926473123245,-58.517415248075892 -34.613414176647808,-58.517289922404068 -34.613509165782737,-58.516682531666312 -34.613969663857453,-58.516376790415656 -34.614201497213024,-58.516648131759212 -34.614517726891343,-58.516715211845693 -34.614581009335751,-58.51743076771443 -34.615256348371567,-58.517589820815182 -34.615408324589886,-58.51773975398293 -34.615551501581088,-58.517895994611465 -34.615699675708854,-58.517991034898095 -34.615789847151028,-58.518190321549874 -34.615978495776538,-58.518323293367047 -34.616104214340517,-58.518443309536572 -34.616218036846071,-58.51922438273035 -34.615609627659587,-58.519350815306971 -34.615512523304368,-58.520310841616819 -34.614774793899059,-58.520262765599988 -34.614727561382011,-58.520023579621665 -34.61449245432145,-58.519924188780379 -34.614394258028113)));;667;11_6_7;COMUNA 11;6;7;895;411;484;84,92%;333;333;100,00%;0;0,00%;308;5;1,62%;303;98,38%
MULTIPOLYGON (((-58.520734238092352 -34.615192565895754,-58.520609357864643 -34.615068747577645,-58.52040213509369 -34.614864542694768,-58.520310841616819 -34.614774793899059,-58.519350815306971 -34.615512523304368,-58.51922438273035 -34.615609627659587,-58.518443309536572 -34.616218036846071,-58.518537498591193 -34.616307363142795,-58.518876583307403 -34.6166325711269,-58.518251220526828 -34.617117240841218,-58.518113035193288 -34.617224279300686,-58.518239019506538 -34.617343803701509,-58.518397224511546 -34.617493243897712,-58.518506162211551 -34.617597563994117,-58.51934127497239 -34.61839713686458,-58.519480313305387 -34.618291223437438,-58.52012245212957 -34.617795905442094,-58.520890420315638 -34.617203407968255,-58.521013277878659 -34.617109613596632,-58.521958156667452 -34.61638842854174,-58.521203241499386 -34.615651865304862,-58.520841132518221 -34.615298645544648,-58.520734238092352 -34.615192565895754)));;668;11_6_8;COMUNA 11;6;8;740;336;404;83,17%;349;349;100,00%;0;0,00%;284;4;1,41%;280;98,59%
MULTIPOLYGON (((-58.518506162211551 -34.617597563994117,-58.518397224511546 -34.617493243897712,-58.518239019506538 -34.617343803701509,-58.518113035193288 -34.617224279300686,-58.518251220526828 -34.617117240841218,-58.518876583307403 -34.6166325711269,-58.518537498591193 -34.616307363142795,-58.518443309536572 -34.616218036846071,-58.518323293367047 -34.616104214340517,-58.518190321549874 -34.615978495776538,-58.517991034898095 -34.615789847151028,-58.517895994611465 -34.615699675708854,-58.51773975398293 -34.615551501581088,-58.517589820815182 -34.615408324589886,-58.516993914332048 -34.615863466606648,-58.516818946506191 -34.615996365976024,-58.516028646984338 -34.616596735313543,-58.516323740151535 -34.61687964416182,-58.516618409711505 -34.617163045444592,-58.51732086776169 -34.617837615941411,-58.516993831341004 -34.618090799014851,-58.518208264824636 -34.619259307614612,-58.5185393921764 -34.619007668811207,-58.518673749831812 -34.618905631830621,-58.518899551288072 -34.618733550151418,-58.51934127497239 -34.61839713686458,-58.518506162211551 -34.617597563994117)));;669;11_6_9;COMUNA 11;6;9;865;392;473;82,88%;322;322;100,00%;0;0,00%;302;8;2,65%;294;97,35%
MULTIPOLYGON (((-58.513010087531477 -34.613173035834691,-58.512666609469825 -34.613557204909341,-58.512568034514594 -34.613667460474979,-58.512422810756071 -34.613830342505281,-58.512321339621806 -34.613941725848328,-58.511683648522798 -34.614641515687467,-58.512156751775279 -34.614921405260773,-58.512469911766608 -34.61510670707122,-58.512931431161718 -34.615379767112074,-58.513368496887914 -34.615638327992777,-58.513986733546389 -34.616004139029727,-58.514104232449853 -34.615913522974068,-58.514269840121166 -34.615790279682301,-58.51438665894937 -34.61570290319122,-58.514519825370193 -34.615603406536628,-58.514784111039283 -34.615401526234024,-58.5155768873759 -34.614815107929267,-58.516376790415656 -34.614201497213024,-58.516682531666312 -34.613969663857453,-58.517289922404068 -34.613509165782737,-58.516745393427364 -34.613176508912829,-58.515605816498535 -34.612480222703311,-58.515243146523822 -34.612258681275904,-58.514969867068267 -34.612091679938047,-58.514331282016528 -34.611701585593686,-58.514014798280826 -34.61205314030925,-58.51360578298705 -34.612507553448602,-58.513494271217127 -34.612631336793079,-58.513306148578927 -34.612841845106594,-58.513010087531477 -34.613173035834691)));;670;11_7_1;COMUNA 11;7;1;2218;1944;274;709,49%;189;187;98,94%;2;1,07%;171;14;8,19%;157;91,81%
MULTIPOLYGON (((-58.506801918019512 -34.61068062913855,-58.506646417731119 -34.610588991761752,-58.506068882723348 -34.610221368082769,-58.505912529537042 -34.610124377757742,-58.505740754463638 -34.610017814856725,-58.504756121414623 -34.609402501866782,-58.504616643139855 -34.609318743971691,-58.503949980843416 -34.610056674292309,-58.503253225987585 -34.610944123387085,-58.503408127267392 -34.611036399110276,-58.503721680286823 -34.611224047405507,-58.50386064949538 -34.611307243067643,-58.504139525198894 -34.611472577218549,-58.504278835677532 -34.611555208883971,-58.504527040103738 -34.611704495669294,-58.504665073826281 -34.611787479453419,-58.505249676171594 -34.612140740498738,-58.505412245191494 -34.612227236125989,-58.50552308737921 -34.612104235066518,-58.505696841532213 -34.611911209208337,-58.505795168582679 -34.6118021564739,-58.505894942636928 -34.611691553794032,-58.506051327429006 -34.61151599899064,-58.506169574195148 -34.611384966237878,-58.506287480091686 -34.611254356040227,-58.506401980833118 -34.611128324577237,-58.506489579818016 -34.611031458654693,-58.506601525789776 -34.610907751945362,-58.506693125212088 -34.610806095526769,-58.506801918019512 -34.61068062913855)));;671;11_7_10;COMUNA 11;7;10;817;372;445;83,60%;356;356;100,00%;0;0,00%;292;2;0,68%;290;99,32%
MULTIPOLYGON (((-58.507835541683896 -34.612364467273153,-58.507960513144013 -34.612227937158679,-58.508153500812824 -34.612013068893518,-58.506489579818016 -34.611031458654693,-58.506401980833118 -34.611128324577237,-58.506287480091686 -34.611254356040227,-58.506169574195148 -34.611384966237878,-58.506051327429006 -34.61151599899064,-58.505894942636928 -34.611691553794032,-58.505795168582679 -34.6118021564739,-58.505696841532213 -34.611911209208337,-58.50552308737921 -34.612104235066518,-58.505412245191494 -34.612227236125989,-58.505564419699724 -34.612308312456058,-58.50705470024679 -34.613187529868974,-58.507521814679123 -34.613463143740788,-58.507625002903566 -34.613524023474206,-58.507868103436657 -34.61366443172998,-58.508015600146905 -34.613749591367302,-58.508308464793537 -34.613919699623665,-58.508467721655904 -34.614012248945365,-58.508724969479751 -34.614160115229943,-58.50953325007363 -34.613369074956388,-58.509117510552159 -34.613123098205556,-58.508650733135298 -34.612846856476658,-58.508306062867177 -34.612642893923173,-58.507835541683896 -34.612364467273153)));;672;11_7_11;COMUNA 11;7;11;807;367;440;83,41%;415;415;100,00%;0;0,00%;323;4;1,24%;319;98,76%
MULTIPOLYGON (((-58.513368496887914 -34.615638327992777,-58.512931431161718 -34.615379767112074,-58.512469911766608 -34.61510670707122,-58.512156751775279 -34.614921405260773,-58.511683648522798 -34.614641515687467,-58.511252898911671 -34.614386608313353,-58.51083680839556 -34.614140426331311,-58.510386720983284 -34.613874044218285,-58.509861225032623 -34.613563110536106,-58.50953325007363 -34.613369074956388,-58.508724969479751 -34.614160115229943,-58.508847756861314 -34.614230705184724,-58.509056181293481 -34.614351757274939,-58.509205896210972 -34.614438745671265,-58.509580739749559 -34.614658328390306,-58.509744090060437 -34.614754114012975,-58.510018388919669 -34.614919225112502,-58.510138112786422 -34.614991364298206,-58.510344415302747 -34.615119246226016,-58.51042860629741 -34.615170764455563,-58.510575855564042 -34.61526085082459,-58.510703590772017 -34.61533833861052,-58.510841296078731 -34.615421597181715,-58.511003628509776 -34.615519775957928,-58.511250662670697 -34.61566644369411,-58.511677840314434 -34.615919943952896,-58.512137487433392 -34.616192796436522,-58.512573873780568 -34.616451853379296,-58.513046734697554 -34.616731669086143,-58.513986733546389 -34.616004139029727,-58.513368496887914 -34.615638327992777)));;673;11_7_12;COMUNA 11;7;12;854;410;444;92,34%;323;323;100,00%;0;0,00%;306;9;2,94%;297;97,06%
MULTIPOLYGON (((-58.51102935940699 -34.613177287386293,-58.510514167633204 -34.613749412391634,-58.510386720983284 -34.613874044218285,-58.51083680839556 -34.614140426331311,-58.511252898911671 -34.614386608313353,-58.511683648522798 -34.614641515687467,-58.512321339621806 -34.613941725848328,-58.512422810756071 -34.613830342505281,-58.512568034514594 -34.613667460474979,-58.512666609469825 -34.613557204909341,-58.513010087531477 -34.613173035834691,-58.513306148578927 -34.612841845106594,-58.513494271217127 -34.612631336793079,-58.51360578298705 -34.612507553448602,-58.514014798280826 -34.61205314030925,-58.514331282016528 -34.611701585593686,-58.513694321912809 -34.611312402726149,-58.513058560688883 -34.610923920261719,-58.512752714858131 -34.611263565516722,-58.512343355953981 -34.611718185900273,-58.512031460437058 -34.612064522150348,-58.511720073084739 -34.612410293979707,-58.511374973192517 -34.612793474167802,-58.51102935940699 -34.613177287386293)));;674;11_7_2;COMUNA 11;7;2;884;424;460;92,17%;377;377;100,00%;0;0,00%;328;1;0,30%;327;99,70%
MULTIPOLYGON (((-58.510095801085917 -34.612037049013189,-58.510012462472048 -34.612130746726727,-58.509752144138069 -34.612421632578048,-58.509439129841333 -34.612771483852264,-58.509207580977098 -34.613030243652645,-58.509117510552159 -34.613123098205556,-58.50953325007363 -34.613369074956388,-58.509861225032623 -34.613563110536106,-58.510386720983284 -34.613874044218285,-58.510514167633204 -34.613749412391634,-58.51102935940699 -34.613177287386293,-58.511374973192517 -34.612793474167802,-58.511720073084739 -34.612410293979707,-58.512031460437058 -34.612064522150348,-58.512343355953981 -34.611718185900273,-58.512752714858131 -34.611263565516722,-58.513058560688883 -34.610923920261719,-58.511786544766451 -34.610146663809793,-58.511491251867035 -34.610474470282909,-58.511414129762066 -34.610560138028411,-58.511082231728984 -34.610930917412361,-58.510760971320245 -34.611289719415751,-58.510686061253644 -34.611373413916155,-58.510438091861836 -34.611652253716713,-58.510095801085917 -34.612037049013189)));;675;11_7_3;COMUNA 11;7;3;786;373;413;90,31%;371;371;100,00%;0;0,00%;297;1;0,34%;296;99,66%
MULTIPOLYGON (((-58.509713001261559 -34.61007557639946,-58.509434697344716 -34.610485980004896,-58.509157752893664 -34.610895185204654,-58.508813329036052 -34.611278569262339,-58.508468391279585 -34.611662586343506,-58.508153500812824 -34.612013068893518,-58.507960513144013 -34.612227937158679,-58.507835541683896 -34.612364467273153,-58.508306062867177 -34.612642893923173,-58.508650733135298 -34.612846856476658,-58.509117510552159 -34.613123098205556,-58.509207580977098 -34.613030243652645,-58.509439129841333 -34.612771483852264,-58.509752144138069 -34.612421632578048,-58.510012462472048 -34.612130746726727,-58.510095801085917 -34.612037049013189,-58.510438091861836 -34.611652253716713,-58.510686061253644 -34.611373413916155,-58.510760971320245 -34.611289719415751,-58.511082231728984 -34.610930917412361,-58.511414129762066 -34.610560138028411,-58.511491251867035 -34.610474470282909,-58.511786544766451 -34.610146663809793,-58.510953288369855 -34.609637540943666,-58.51028790046756 -34.609230885955903,-58.510052493970953 -34.609574370425243,-58.509713001261559 -34.61007557639946)));;676;11_7_4;COMUNA 11;7;4;936;433;503;86,08%;372;371;99,73%;1;0,27%;325;1;0,31%;324;99,69%
MULTIPOLYGON (((-58.508159669317273 -34.609109087355222,-58.507590018017957 -34.60977242119646,-58.507477822525189 -34.60990176293528,-58.507155207668717 -34.610298022164855,-58.506801918019512 -34.61068062913855,-58.506693125212088 -34.610806095526769,-58.506601525789776 -34.610907751945362,-58.506489579818016 -34.611031458654693,-58.508153500812824 -34.612013068893518,-58.508468391279585 -34.611662586343506,-58.508813329036052 -34.611278569262339,-58.509157752893664 -34.610895185204654,-58.509434697344716 -34.610485980004896,-58.509713001261559 -34.61007557639946,-58.510052493970953 -34.609574370425243,-58.51028790046756 -34.609230885955903,-58.508823541764379 -34.608336133699943,-58.508159669317273 -34.609109087355222)));;677;11_7_5;COMUNA 11;7;5;965;433;532;81,39%;414;413;99,76%;1;0,24%;349;10;2,87%;339;97,13%
MULTIPOLYGON (((-58.505979641767048 -34.607809902660662,-58.505297339830172 -34.608565100220432,-58.504616643139855 -34.609318743971691,-58.504756121414623 -34.609402501866782,-58.505740754463638 -34.610017814856725,-58.505912529537042 -34.610124377757742,-58.506068882723348 -34.610221368082769,-58.506646417731119 -34.610588991761752,-58.506801918019512 -34.61068062913855,-58.507155207668717 -34.610298022164855,-58.507477822525189 -34.60990176293528,-58.507590018017957 -34.60977242119646,-58.508159669317273 -34.609109087355222,-58.508823541764379 -34.608336133699943,-58.508652789984609 -34.60823175765983,-58.508132109085665 -34.607926589271976,-58.507956930494039 -34.607823411125949,-58.507780218670383 -34.607719317766154,-58.50666363378469 -34.60705265825834,-58.505979641767048 -34.607809902660662)));;678;11_7_6;COMUNA 11;7;6;791;369;422;87,44%;332;332;100,00%;0;0,00%;291;2;0,69%;289;99,31%
MULTIPOLYGON (((-58.50666363378469 -34.60705265825834,-58.506495615089499 -34.606952362848901,-58.50602019165548 -34.606673437706036,-58.505793556763699 -34.606539569322599,-58.505589245167727 -34.606418862173889,-58.505081788476467 -34.606112971768134,-58.504919312227749 -34.606017249881099,-58.504737581244832 -34.605910195960597,-58.50444534682255 -34.605737261672928,-58.504331861331792 -34.60567004441701,-58.503784969588558 -34.605346344458439,-58.503607245510722 -34.605240977696269,-58.503469851611889 -34.605397156280041,-58.50307826832745 -34.605843641189558,-58.502955259066518 -34.605983546205906,-58.502821182769786 -34.606136060838232,-58.50226563465565 -34.606770491201992,-58.502446938468843 -34.606877548928871,-58.502847120463009 -34.607113623856343,-58.503000650685387 -34.607204492105872,-58.503562717244648 -34.607537063964536,-58.50371471540651 -34.607627016294899,-58.50447428436766 -34.608075014600537,-58.504598572937311 -34.607937361265641,-58.505034345176092 -34.60745339012928,-58.505154545611418 -34.607319963141762,-58.505333384223647 -34.607427017425749,-58.505818182057482 -34.607711787183575,-58.505979641767048 -34.607809902660662,-58.50666363378469 -34.60705265825834)));;679;11_7_7;COMUNA 11;7;7;796;370;426;86,85%;331;331;100,00%;0;0,00%;273;4;1,47%;269;98,53%
MULTIPOLYGON (((-58.500959983631724 -34.608254765382028,-58.500192507163966 -34.609125739943693,-58.501327384255134 -34.609798438800524,-58.501459958393689 -34.609877484161025,-58.502112002106017 -34.609163587107432,-58.502235103178322 -34.609024809784309,-58.502353181023409 -34.608891597551676,-58.502885167436432 -34.608296190292045,-58.503617984219545 -34.608727511931647,-58.503789068655387 -34.608826260889401,-58.503912168943671 -34.608692552477237,-58.504365488953255 -34.608195478783216,-58.50447428436766 -34.608075014600537,-58.50371471540651 -34.607627016294899,-58.503562717244648 -34.607537063964536,-58.503000650685387 -34.607204492105872,-58.502847120463009 -34.607113623856343,-58.502446938468843 -34.606877548928871,-58.50226563465565 -34.606770491201992,-58.502134365421043 -34.606920468845139,-58.501735361238907 -34.607374839352815,-58.501597108891218 -34.607531720301701,-58.500959983631724 -34.608254765382028)));;680;11_7_8;COMUNA 11;7;8;691;342;349;97,99%;303;303;100,00%;0;0,00%;249;7;2,81%;242;97,19%
MULTIPOLYGON (((-58.503789068655387 -34.608826260889401,-58.503617984219545 -34.608727511931647,-58.502885167436432 -34.608296190292045,-58.502353181023409 -34.608891597551676,-58.502235103178322 -34.609024809784309,-58.502112002106017 -34.609163587107432,-58.501459958393689 -34.609877484161025,-58.502207098525552 -34.610323105906872,-58.502369409968473 -34.61041939479059,-58.503102074033222 -34.610854099827499,-58.503253225987585 -34.610944123387085,-58.503949980843416 -34.610056674292309,-58.504616643139855 -34.609318743971691,-58.505297339830172 -34.608565100220432,-58.505979641767048 -34.607809902660662,-58.505818182057482 -34.607711787183575,-58.505333384223647 -34.607427017425749,-58.505154545611418 -34.607319963141762,-58.505034345176092 -34.60745339012928,-58.504598572937311 -34.607937361265641,-58.50447428436766 -34.608075014600537,-58.504365488953255 -34.608195478783216,-58.503912168943671 -34.608692552477237,-58.503789068655387 -34.608826260889401)));;681;11_7_9;COMUNA 11;7;9;808;382;426;89,67%;349;349;100,00%;0;0,00%;296;5;1,69%;291;98,31%
MULTIPOLYGON (((-58.500552077469912 -34.604512006817238,-58.499853686921419 -34.605337745361886,-58.500867189371846 -34.605940553650015,-58.501033495067283 -34.606039308014822,-58.502082201332627 -34.606662166238273,-58.50226563465565 -34.606770491201992,-58.502821182769786 -34.606136060838232,-58.502955259066518 -34.605983546205906,-58.50307826832745 -34.605843641189558,-58.503469851611889 -34.605397156280041,-58.503607245510722 -34.605240977696269,-58.503424921171614 -34.605132865627112,-58.502476331159947 -34.604570622266046,-58.502293754432984 -34.60446293112701,-58.502108707436797 -34.604353691156625,-58.5013064170315 -34.603880690417938,-58.501162607578806 -34.603796718588569,-58.501055516203614 -34.603916756815813,-58.500552077469912 -34.604512006817238)));;682;11_8_1;COMUNA 11;8;1;886;391;495;78,99%;434;434;100,00%;0;0,00%;347;9;2,59%;338;97,41%
MULTIPOLYGON (((-58.499853686921419 -34.605337745361886,-58.500552077469912 -34.604512006817238,-58.501055516203614 -34.603916756815813,-58.501162607578806 -34.603796718588569,-58.501002270607273 -34.603703103527067,-58.499952842131343 -34.603078123168167,-58.499796340732019 -34.602984787039723,-58.499622545375175 -34.602881173864596,-58.499264136369391 -34.602667400464718,-58.499117433899443 -34.602580328364816,-58.498607935357761 -34.60315965619175,-58.498496073475337 -34.603284271227487,-58.498391106885997 -34.603401207795606,-58.497777313533852 -34.604102679812087,-58.497200883174514 -34.604761319597401,-58.497878605341391 -34.605164098926153,-58.498063989715263 -34.605274331153254,-58.499118372791735 -34.605901579654606,-58.499288172043677 -34.606008434250441,-58.499738762697007 -34.605473560026809,-58.499853686921419 -34.605337745361886)));;683;11_8_2;COMUNA 11;8;2;896;434;462;93,94%;405;405;100,00%;0;0,00%;338;0;0,00%;338;100,00%
MULTIPOLYGON (((-58.496846236933536 -34.603548768130238,-58.496268099336547 -34.604206770220927,-58.49642613276324 -34.604301518936794,-58.497012774906935 -34.604649537461064,-58.497200883174514 -34.604761319597401,-58.497777313533852 -34.604102679812087,-58.498391106885997 -34.603401207795606,-58.498496073475337 -34.603284271227487,-58.498607935357761 -34.60315965619175,-58.499117433899443 -34.602580328364816,-58.498988281456349 -34.602503673798957,-58.498185683118528 -34.602024243782743,-58.497563894670208 -34.60273191462386,-58.496846236933536 -34.603548768130238)));;684;11_8_3;COMUNA 11;8;3;519;238;281;84,70%;259;259;100,00%;0;0,00%;210;0;0,00%;210;100,00%
MULTIPOLYGON (((-58.497861783889213 -34.601830668225467,-58.497087056104995 -34.601781802644631,-58.496945584776469 -34.601772546303771,-58.496641010930077 -34.602177435503357,-58.496531625853798 -34.602322964355572,-58.495992697065724 -34.60304109751219,-58.495473763961094 -34.603732531691008,-58.496072070249056 -34.604089284362324,-58.496268099336547 -34.604206770220927,-58.496846236933536 -34.603548768130238,-58.497563894670208 -34.60273191462386,-58.498185683118528 -34.602024243782743,-58.497861783889213 -34.601830668225467)));;685;11_8_4;COMUNA 11;8;4;724;285;439;64,92%;404;402;99,50%;2;0,50%;329;1;0,30%;328;99,70%
MULTIPOLYGON (((-58.496268099336547 -34.604206770220927,-58.496072070249056 -34.604089284362324,-58.495473763961094 -34.603732531691008,-58.495383103016373 -34.603853335206253,-58.494797757160718 -34.604628519729928,-58.495350911851212 -34.604951413244628,-58.495524790481902 -34.605052708416139,-58.495694069077786 -34.605151258000348,-58.49629919934948 -34.60550540189481,-58.496465668039114 -34.605601486293537,-58.496637589571527 -34.605700808504565,-58.497153100403359 -34.605997083541439,-58.497406300749802 -34.606146172272709,-58.497543866645394 -34.605963802322286,-58.49794872902045 -34.605426834996926,-58.498063989715263 -34.605274331153254,-58.497878605341391 -34.605164098926153,-58.497200883174514 -34.604761319597401,-58.497012774906935 -34.604649537461064,-58.49642613276324 -34.604301518936794,-58.496268099336547 -34.604206770220927)));;686;11_8_5;COMUNA 11;8;5;658;296;362;81,77%;331;331;100,00%;0;0,00%;265;1;0,38%;264;99,62%
MULTIPOLYGON (((-58.501033495067283 -34.606039308014822,-58.500867189371846 -34.605940553650015,-58.499853686921419 -34.605337745361886,-58.499738762697007 -34.605473560026809,-58.499288172043677 -34.606008434250441,-58.499118372791735 -34.605901579654606,-58.498063989715263 -34.605274331153254,-58.49794872902045 -34.605426834996926,-58.497543866645394 -34.605963802322286,-58.497406300749802 -34.606146172272709,-58.497601228189943 -34.606261050530257,-58.498263878823515 -34.606641155026026,-58.498407178433226 -34.606723299327307,-58.498591374579227 -34.606833671921606,-58.49898234571382 -34.607067931185973,-58.499118321357798 -34.607149372572039,-58.499817799644717 -34.607569177351088,-58.500959983631724 -34.608254765382028,-58.501597108891218 -34.607531720301701,-58.501735361238907 -34.607374839352815,-58.502134365421043 -34.606920468845139,-58.50226563465565 -34.606770491201992,-58.502082201332627 -34.606662166238273,-58.501033495067283 -34.606039308014822)));;687;11_8_6;COMUNA 11;8;6;992;470;522;90,04%;433;433;100,00%;0;0,00%;379;0;0,00%;379;100,00%
MULTIPOLYGON (((-58.498263878823515 -34.606641155026026,-58.497601228189943 -34.606261050530257,-58.497406300749802 -34.606146172272709,-58.497280481913037 -34.606312974774013,-58.496837898300839 -34.606898825422071,-58.496715226531748 -34.60706034455378,-58.496901038193677 -34.607167479687078,-58.497443908849512 -34.607483816914758,-58.497620608114211 -34.607589897161532,-58.496941995781881 -34.608590901134569,-58.498131380221075 -34.609327349216734,-58.498310385603702 -34.609437019442424,-58.498515207199404 -34.609562527479845,-58.49920831983691 -34.609994943545274,-58.499351372059856 -34.610080396744593,-58.500192507163966 -34.609125739943693,-58.500959983631724 -34.608254765382028,-58.499817799644717 -34.607569177351088,-58.499118321357798 -34.607149372572039,-58.49898234571382 -34.607067931185973,-58.498591374579227 -34.606833671921606,-58.498407178433226 -34.606723299327307,-58.498263878823515 -34.606641155026026)));;688;11_8_7;COMUNA 11;8;7;992;478;514;93,00%;398;398;100,00%;0;0,00%;345;4;1,16%;341;98,84%
MULTIPOLYGON (((-58.494890303111809 -34.607401626966642,-58.495055836512051 -34.607496375427367,-58.495752223958306 -34.607898598030395,-58.495978589876891 -34.608029879383359,-58.496240057479788 -34.608181573958746,-58.49677287655107 -34.608486155883696,-58.496941995781881 -34.608590901134569,-58.497620608114211 -34.607589897161532,-58.497443908849512 -34.607483816914758,-58.496901038193677 -34.607167479687078,-58.496715226531748 -34.60706034455378,-58.496837898300839 -34.606898825422071,-58.497280481913037 -34.606312974774013,-58.497406300749802 -34.606146172272709,-58.497153100403359 -34.605997083541439,-58.496637589571527 -34.605700808504565,-58.496465668039114 -34.605601486293537,-58.49629919934948 -34.60550540189481,-58.495694069077786 -34.605151258000348,-58.495524790481902 -34.605052708416139,-58.494757372758727 -34.605926043695533,-58.49394302744939 -34.606852838744572,-58.494097739690858 -34.606943013649918,-58.494740871871301 -34.607316170171721,-58.494890303111809 -34.607401626966642)));;689;11_8_8;COMUNA 11;8;8;973;455;518;87,84%;407;407;100,00%;0;0,00%;355;0;0,00%;355;100,00%
MULTIPOLYGON (((-58.495524790481902 -34.605052708416139,-58.495350911851212 -34.604951413244628,-58.494797757160718 -34.604628519729928,-58.494008272195323 -34.60549256004056,-58.493161548021234 -34.606396540493741,-58.49334641646098 -34.606502977037735,-58.493788230314678 -34.606762522812957,-58.49394302744939 -34.606852838744572,-58.494757372758727 -34.605926043695533,-58.495524790481902 -34.605052708416139)));;690;11_8_9;COMUNA 11;8;9;823;349;474;73,63%;456;456;100,00%;0;0,00%;365;0;0,00%;365;100,00%
MULTIPOLYGON (((-58.502833578273354 -34.601804062858193,-58.5024914397912 -34.60178283607366,-58.500836959714754 -34.601671317886506,-58.500594278608808 -34.601976264225492,-58.500632265674852 -34.601978717304554,-58.502012236644468 -34.602790494365287,-58.503221199523395 -34.603407023563285,-58.502446808486077 -34.604280973127118,-58.502293754432984 -34.60446293112701,-58.502476331159947 -34.604570622266046,-58.503424921171614 -34.605132865627112,-58.503607245510722 -34.605240977696269,-58.503734083241902 -34.605096704358346,-58.504619815712807 -34.604106577418491,-58.505373842238043 -34.603263678680797,-58.505978210120581 -34.602588017770564,-58.506167691415101 -34.602378505872416,-58.505816079672762 -34.602161298448948,-58.505543788392913 -34.60199300769645,-58.505398588253954 -34.602022778030118,-58.504503844709468 -34.601964634930113,-58.504283672939358 -34.601951399798573,-58.504169935331127 -34.601880379473045,-58.502833578273354 -34.601804062858193)));;691;11_9_1;COMUNA 11;9;1;873;401;472;84,96%;364;364;100,00%;0;0,00%;315;2;0,63%;313;99,37%
MULTIPOLYGON (((-58.491958478157407 -34.600637603579209,-58.491707686600101 -34.600971549440423,-58.492617740955204 -34.601029289658172,-58.493571234798559 -34.601092012295751,-58.49371918595218 -34.600894995432178,-58.493880364263468 -34.600997211773304,-58.494000465984598 -34.601031900657752,-58.494195338021044 -34.601044104502186,-58.494278973108571 -34.601040913751142,-58.49436813315581 -34.601008635893066,-58.494516464422453 -34.600920354504659,-58.494377350482601 -34.600834471928231,-58.493954050566096 -34.600582177082913,-58.492716792571343 -34.599844783433838,-58.492604261490349 -34.599777836665886,-58.491958478157407 -34.600637603579209)));;692;11_9_10;COMUNA 11;9;10;671;303;368;82,34%;400;400;100,00%;0;0,00%;352;3;0,85%;349;99,15%
MULTIPOLYGON (((-58.49451324085387 -34.599837285770661,-58.493954050566096 -34.600582177082913,-58.494377350482601 -34.600834471928231,-58.494516464422453 -34.600920354504659,-58.49500969859541 -34.601189953489779,-58.495382167615766 -34.601248236800714,-58.495845755454532 -34.600630200864735,-58.496625139589518 -34.599591144094646,-58.49529357089169 -34.598797884994859,-58.49451324085387 -34.599837285770661)));;693;11_9_11;COMUNA 11;9;11;586;256;330;77,58%;332;332;100,00%;0;0,00%;258;1;0,39%;257;99,61%
MULTIPOLYGON (((-58.495845755454532 -34.600630200864735,-58.495382167615766 -34.601248236800714,-58.495341137277634 -34.601302897751864,-58.497204955217924 -34.601427248840992,-58.497876907665805 -34.600532093282496,-58.49797803112601 -34.600397058930618,-58.496625139589518 -34.599591144094646,-58.495845755454532 -34.600630200864735)));;694;11_9_12;COMUNA 11;9;12;658;286;372;76,88%;387;387;100,00%;0;0,00%;297;0;0,00%;297;100,00%
MULTIPOLYGON (((-58.500632265674852 -34.601978717304554,-58.500594278608808 -34.601976264225492,-58.500836959714754 -34.601671317886506,-58.500708434252253 -34.601662625263081,-58.500024668946288 -34.601616214846658,-58.499073717833987 -34.601549950202724,-58.497204955217924 -34.601427248840992,-58.497142730341302 -34.601510086473162,-58.497006448106511 -34.601691610639087,-58.496945584776469 -34.601772546303771,-58.497087056104995 -34.601781802644631,-58.497861783889213 -34.601830668225467,-58.498185683118528 -34.602024243782743,-58.498988281456349 -34.602503673798957,-58.499117433899443 -34.602580328364816,-58.499264136369391 -34.602667400464718,-58.499622545375175 -34.602881173864596,-58.499796340732019 -34.602984787039723,-58.499952842131343 -34.603078123168167,-58.501002270607273 -34.603703103527067,-58.501162607578806 -34.603796718588569,-58.5013064170315 -34.603880690417938,-58.502108707436797 -34.604353691156625,-58.502293754432984 -34.60446293112701,-58.502446808486077 -34.604280973127118,-58.503221199523395 -34.603407023563285,-58.502012236644468 -34.602790494365287,-58.500632265674852 -34.601978717304554)));;695;11_9_2;COMUNA 11;9;2;807;378;429;88,11%;355;355;100,00%;0;0,00%;312;0;0,00%;312;100,00%
MULTIPOLYGON (((-58.499073717833987 -34.601549950202724,-58.500024668946288 -34.601616214846658,-58.500708434252253 -34.601662625263081,-58.500836959714754 -34.601671317886506,-58.5024914397912 -34.60178283607366,-58.502833578273354 -34.601804062858193,-58.501415776239327 -34.600940051448916,-58.500110976099791 -34.600163668249827,-58.498754319815447 -34.599356440069883,-58.498660944796292 -34.599481401995227,-58.498073621469366 -34.60026949117033,-58.49797803112601 -34.600397058930618,-58.497876907665805 -34.600532093282496,-58.497204955217924 -34.601427248840992,-58.499073717833987 -34.601549950202724)));;696;11_9_3;COMUNA 11;9;3;1008;471;537;87,71%;481;481;100,00%;0;0,00%;379;2;0,53%;377;99,47%
MULTIPOLYGON (((-58.504862383514606 -34.601572031880217,-58.503648174201267 -34.600821853447037,-58.503559997487649 -34.600767373885397,-58.503404431913118 -34.600671295452194,-58.503093472005666 -34.600478785803013,-58.502214528280341 -34.599934897867264,-58.500880927464316 -34.599109586551585,-58.500217202427251 -34.600021587947829,-58.500110976099791 -34.600163668249827,-58.501415776239327 -34.600940051448916,-58.502833578273354 -34.601804062858193,-58.504169935331127 -34.601880379473045,-58.504283672939358 -34.601951399798573,-58.504503844709468 -34.601964634930113,-58.505398588253954 -34.602022778030118,-58.505543788392913 -34.60199300769645,-58.504862383514606 -34.601572031880217)));;697;11_9_4;COMUNA 11;9;4;659;312;347;89,91%;305;305;100,00%;0;0,00%;255;1;0,39%;254;99,61%
MULTIPOLYGON (((-58.500880927464316 -34.599109586551585,-58.500642988044369 -34.598962331165339,-58.499543434245709 -34.598281726406285,-58.4988561212527 -34.599220207535765,-58.498754319815447 -34.599356440069883,-58.500110976099791 -34.600163668249827,-58.500217202427251 -34.600021587947829,-58.500880927464316 -34.599109586551585)));;698;11_9_5;COMUNA 11;9;5;737;334;403;82,88%;368;368;100,00%;0;0,00%;308;0;0,00%;308;100,00%
MULTIPOLYGON (((-58.499543434245709 -34.598281726406285,-58.498222579274021 -34.597464199150529,-58.497402034365301 -34.598551801182339,-58.497306957100975 -34.598682114891247,-58.496625139589518 -34.599591144094646,-58.49797803112601 -34.600397058930618,-58.498073621469366 -34.60026949117033,-58.498660944796292 -34.599481401995227,-58.498754319815447 -34.599356440069883,-58.4988561212527 -34.599220207535765,-58.499543434245709 -34.598281726406285)));;699;11_9_6;COMUNA 11;9;6;579;264;315;83,81%;337;337;100,00%;0;0,00%;248;1;0,40%;247;99,60%
MULTIPOLYGON (((-58.496784886019391 -34.59681113317415,-58.494715769031906 -34.596947684774236,-58.496072264129701 -34.597760451412327,-58.49529357089169 -34.598797884994859,-58.496625139589518 -34.599591144094646,-58.497306957100975 -34.598682114891247,-58.497402034365301 -34.598551801182339,-58.498222579274021 -34.597464199150529,-58.498004753544379 -34.597329327566271,-58.4971751147229 -34.596817361824876,-58.497128262049465 -34.596788500692718,-58.496784886019391 -34.59681113317415)));;700;11_9_7;COMUNA 11;9;7;788;318;470;67,66%;384;383;99,74%;1;0,26%;312;3;0,96%;309;99,04%
MULTIPOLYGON (((-58.496072264129701 -34.597760451412327,-58.494715769031906 -34.596947684774236,-58.493940220100065 -34.597991658585279,-58.493161669909767 -34.599032881458719,-58.49451324085387 -34.599837285770661,-58.49529357089169 -34.598797884994859,-58.496072264129701 -34.597760451412327)));;701;11_9_8;COMUNA 11;9;8;866;370;496;74,60%;356;354;99,44%;2;0,56%;331;1;0,30%;330;99,70%
MULTIPOLYGON (((-58.493161669909767 -34.599032881458719,-58.492691261613054 -34.59966203622627,-58.492604261490349 -34.599777836665886,-58.492716792571343 -34.599844783433838,-58.493954050566096 -34.600582177082913,-58.49451324085387 -34.599837285770661,-58.493161669909767 -34.599032881458719)));;702;11_9_9;COMUNA 11;9;9;529;228;301;75,75%;300;300;100,00%;0;0,00%;246;1;0,41%;245;99,59%
MULTIPOLYGON (((-58.509627693196244 -34.569600000008691,-58.509859361197989 -34.569340360677103,-58.506601736822496 -34.562394048848667,-58.506043769350114 -34.562426534409965,-58.505592405166595 -34.562452811510632,-58.505589363582409 -34.562445716757836,-58.505432326000737 -34.562448461243733,-58.505437139893068 -34.562539590365262,-58.505421815870577 -34.562704884753998,-58.505365576544889 -34.562933787810962,-58.505258092541396 -34.563171159786954,-58.505073811247236 -34.5633916561831,-58.504947791502182 -34.563508676865503,-58.504726428257996 -34.563633195393898,-58.504380062096352 -34.563869240059837,-58.50417325936759 -34.564003471345487,-58.504022787929749 -34.564086695057419,-58.503871891401126 -34.564171679367313,-58.503823378454101 -34.564196344693912,-58.503769927247241 -34.564219814426657,-58.503714686790573 -34.564240326860066,-58.503661317238446 -34.564256824379108,-58.503522565126687 -34.564282928343289,-58.503444842751335 -34.56428908133924,-58.503273385037886 -34.564284631202895,-58.50312779821752 -34.564261157337668,-58.503022647208326 -34.564233796539199,-58.502912821540619 -34.564752658452761,-58.502801295607476 -34.565279338027437,-58.502699551298583 -34.565257328184515,-58.502614153921208 -34.565238200363922,-58.502511130068505 -34.565210627157242,-58.502418065476355 -34.565180233598348,-58.502318186794263 -34.565142377062877,-58.502268118453877 -34.565120631780907,-58.5021941218344 -34.565086147182228,-58.502111948557804 -34.565043214102488,-58.501793394971642 -34.565434178783754,-58.501437997127923 -34.565871494367833,-58.50187738529263 -34.566083616975909,-58.50199847306699 -34.566142453875209,-58.502560571362409 -34.566415875162889,-58.502712145212584 -34.566489561197685,-58.50333215437464 -34.566793454210938,-58.503957362514456 -34.567099877623363,-58.504101362469648 -34.567174832144524,-58.504241275194438 -34.567247745543114,-58.504657517079487 -34.56745211914928,-58.505072143037218 -34.567655717207806,-58.505208649025789 -34.567722785348799,-58.506263065249314 -34.568241098157586,-58.507316898408618 -34.568759049894695,-58.508600498345118 -34.569389434197696,-58.508817518507577 -34.569509186412311,-58.509040630948547 -34.569997300875663,-58.509168094227221 -34.569943714833755,-58.509221635170938 -34.569915827208412,-58.509365830973032 -34.569806446872192,-58.509522103735272 -34.569668479954224,-58.509627693196244 -34.569600000008691)));;703;12_1_1;COMUNA 12;1;1;581;263;318;82,70%;216;216;100,00%;0;0,00%;191;1;0,52%;190;99,48%
MULTIPOLYGON (((-58.497443121914557 -34.553413193585094,-58.498058739122911 -34.552664531737598,-58.497038694905747 -34.552125783945378,-58.496114953645304 -34.551637848683264,-58.496031584499853 -34.551756820628675,-58.495565137907242 -34.552421555204504,-58.49501344013597 -34.553207654126652,-58.494948273629404 -34.553300562948642,-58.49455352965046 -34.553867030596471,-58.494464966254462 -34.553992834084092,-58.494034056230895 -34.554605508690173,-58.493955019916982 -34.554717858028525,-58.494415366203867 -34.554957820710769,-58.494591009282438 -34.555051300357398,-58.494878696972876 -34.555204400881017,-58.49504581069278 -34.555251048994286,-58.495275234680427 -34.555298384527141,-58.495539037360608 -34.555317328810311,-58.495768590010293 -34.555288860849529,-58.495768431796819 -34.555288814893551,-58.495925679953487 -34.555226184954904,-58.496066962244292 -34.55509771336903,-58.496208791457718 -34.554914100266068,-58.496824600957495 -34.554165303914125,-58.497443121914557 -34.553413193585094)));;704;12_1_10;COMUNA 12;1;10;888;425;463;91,79%;439;439;100,00%;0;0,00%;361;4;1,11%;357;98,89%
MULTIPOLYGON (((-58.494090379658132 -34.552719633028182,-58.493168692126112 -34.552232308824479,-58.492246759906713 -34.551744766403161,-58.491444366691454 -34.551320501685844,-58.491308833375271 -34.551249121760854,-58.491162573417768 -34.551172039695942,-58.491033425609906 -34.551104038412987,-58.490487397462751 -34.551891876392602,-58.490408019142777 -34.55200626591116,-58.489984482331373 -34.552609867602278,-58.489904117527239 -34.552729613872167,-58.490028620018215 -34.55279797859432,-58.490180355960035 -34.552875992477539,-58.491111058601511 -34.553372434887279,-58.49185200142383 -34.553765376868945,-58.492028149462982 -34.553857733289384,-58.492957253822119 -34.554344923280517,-58.493877769984998 -34.554827601104677,-58.493955019916982 -34.554717858028525,-58.494034056230895 -34.554605508690173,-58.494464966254462 -34.553992834084092,-58.49455352965046 -34.553867030596471,-58.494948273629404 -34.553300562948642,-58.49501344013597 -34.553207654126652,-58.494090379658132 -34.552719633028182)));;705;12_1_11;COMUNA 12;1;11;1038;510;528;96,59%;439;439;100,00%;0;0,00%;374;5;1,34%;369;98,66%
MULTIPOLYGON (((-58.504723772226242 -34.561737689668895,-58.504673450657336 -34.561717424386998,-58.504591116050449 -34.56168822601299,-58.504501888012328 -34.561662973781438,-58.504415046984214 -34.561644411107807,-58.504323866444146 -34.561629934540925,-58.50335930056066 -34.561521663206271,-58.503302346132251 -34.56151527342498,-58.502996631236421 -34.561480936561281,-58.503083882208543 -34.561291885217791,-58.503103008601144 -34.561234834091209,-58.503113025382497 -34.561176095760672,-58.50312295269417 -34.5611084133972,-58.503130161908516 -34.56105319727758,-58.503132581903031 -34.560952487753823,-58.503126676658447 -34.560887627657273,-58.503115494626179 -34.560825163779924,-58.503102701507991 -34.560775799611037,-58.503072610126068 -34.560690735340586,-58.503030418583826 -34.560580744366916,-58.502984834801531 -34.560497234554006,-58.502952206461337 -34.560446750099118,-58.502922647340753 -34.560405772091663,-58.502883209389246 -34.56035641667188,-58.502819530047006 -34.560294119938391,-58.502737568573849 -34.560211312695614,-58.502631361780473 -34.560186246221889,-58.5022234529606 -34.560683336797211,-58.501710435079048 -34.56133669998664,-58.501160569629754 -34.562036835211167,-58.500783154012133 -34.562517538271671,-58.500391014827677 -34.563016766623555,-58.499862142852628 -34.563690268435813,-58.499483776316595 -34.564172024028217,-58.499228267977799 -34.564497396791246,-58.499052822852448 -34.564720768864397,-58.499139761191138 -34.564762646199391,-58.499712825144677 -34.565041007188448,-58.500235311162243 -34.565290858654478,-58.500862538262979 -34.565593705672725,-58.501437997127923 -34.565871494367833,-58.501793394971642 -34.565434178783754,-58.502111948557804 -34.565043214102488,-58.5021941218344 -34.565086147182228,-58.502268118453877 -34.565120631780907,-58.502318186794263 -34.565142377062877,-58.502418065476355 -34.565180233598348,-58.502511130068505 -34.565210627157242,-58.502614153921208 -34.565238200363922,-58.502699551298583 -34.565257328184515,-58.502801295607476 -34.565279338027437,-58.502912821540619 -34.564752658452761,-58.503022647208326 -34.564233796539199,-58.50312779821752 -34.564261157337668,-58.503273385037886 -34.564284631202895,-58.503444842751335 -34.56428908133924,-58.503522565126687 -34.564282928343289,-58.503661317238446 -34.564256824379108,-58.503714686790573 -34.564240326860066,-58.503769927247241 -34.564219814426657,-58.503823378454101 -34.564196344693912,-58.503871891401126 -34.564171679367313,-58.504022787929749 -34.564086695057419,-58.50417325936759 -34.564003471345487,-58.504380062096352 -34.563869240059837,-58.504726428257996 -34.563633195393898,-58.504947791502182 -34.563508676865503,-58.505073811247236 -34.5633916561831,-58.505258092541396 -34.563171159786954,-58.505365576544889 -34.562933787810962,-58.505421815870577 -34.562704884753998,-58.505437139893068 -34.562539590365262,-58.505432326000737 -34.562448461243733,-58.505406303946451 -34.562336141416644,-58.505293509920243 -34.56217511732617,-58.505129461920916 -34.562001434330725,-58.504955214078748 -34.56185740384732,-58.504723772226242 -34.561737689668895)));;706;12_1_2;COMUNA 12;1;2;582;270;312;86,54%;223;223;100,00%;0;0,00%;196;0;0,00%;196;100,00%
MULTIPOLYGON (((-58.493877769984998 -34.554827601104677,-58.493707870478595 -34.555068993425188,-58.493606544014781 -34.555216068083155,-58.493443195840939 -34.555453232817044,-58.493171201946602 -34.555847826022678,-58.492926600984894 -34.556202832554185,-58.492783242614593 -34.55641097601422,-58.492387110241779 -34.556985746955363,-58.492317684441971 -34.5570865430346,-58.491857392010431 -34.557749219042613,-58.491327833944979 -34.558511491463904,-58.490778441298765 -34.559302358894229,-58.490022871183072 -34.560390043935726,-58.490186512726851 -34.560468320570237,-58.490845679534381 -34.560783325336963,-58.49098437595697 -34.56084963427849,-58.491454446915156 -34.561074323250466,-58.491930139813213 -34.561301614807789,-58.492883747164164 -34.561757389021643,-58.494129582691933 -34.562352734965948,-58.494288804500897 -34.562429246570602,-58.495417329209467 -34.562971156525066,-58.496593125486939 -34.563535719940262,-58.496676485108821 -34.563575768964938,-58.496822854208403 -34.563646012941312,-58.497860558571922 -34.564146022285165,-58.497991092062065 -34.564208945146497,-58.498787069629351 -34.564592673048502,-58.499052822852448 -34.564720768864397,-58.499228267977799 -34.564497396791246,-58.499483776316595 -34.564172024028217,-58.499862142852628 -34.563690268435813,-58.500391014827677 -34.563016766623555,-58.500783154012133 -34.562517538271671,-58.501160569629754 -34.562036835211167,-58.501710435079048 -34.56133669998664,-58.5022234529606 -34.560683336797211,-58.502631361780473 -34.560186246221889,-58.502737568573849 -34.560211312695614,-58.502819530047006 -34.560294119938391,-58.502883209389246 -34.56035641667188,-58.502922647340753 -34.560405772091663,-58.502952206461337 -34.560446750099118,-58.502984834801531 -34.560497234554006,-58.503030418583826 -34.560580744366916,-58.503072610126068 -34.560690735340586,-58.503102701507991 -34.560775799611037,-58.503115494626179 -34.560825163779924,-58.503126676658447 -34.560887627657273,-58.503132581903031 -34.560952487753823,-58.503130161908516 -34.56105319727758,-58.50312295269417 -34.5611084133972,-58.503113025382497 -34.561176095760672,-58.503103008601144 -34.561234834091209,-58.503083882208543 -34.561291885217791,-58.502996631236421 -34.561480936561281,-58.503302346132251 -34.56151527342498,-58.50335930056066 -34.561521663206271,-58.504323866444146 -34.561629934540925,-58.504415046984214 -34.561644411107807,-58.504501888012328 -34.561662973781438,-58.504591116050449 -34.56168822601299,-58.504673450657336 -34.561717424386998,-58.504723772226242 -34.561737689668895,-58.504955214078748 -34.56185740384732,-58.505129461920916 -34.562001434330725,-58.505293509920243 -34.56217511732617,-58.505406303946451 -34.562336141416644,-58.505432326000737 -34.562448461243733,-58.505589363582409 -34.562445716757836,-58.505592405166595 -34.562452811510632,-58.506043769350114 -34.562426534409965,-58.506601736822496 -34.562394048848667,-58.50160405609288 -34.55173493942641,-58.501085256300279 -34.551909316653926,-58.500655289550203 -34.552053833395306,-58.500650532285306 -34.552044640628715,-58.50043766975994 -34.551902728221869,-58.500224650935131 -34.551790253467551,-58.499939819894124 -34.551739845382194,-58.499695369489075 -34.551765977235135,-58.499517920980892 -34.551822301075973,-58.499340580939176 -34.551932429926502,-58.499017796246818 -34.552099717177107,-58.498675791211568 -34.551913260520998,-58.498058739122911 -34.552664531737598,-58.497443121914557 -34.553413193585094,-58.496824600957495 -34.554165303914125,-58.496208791457718 -34.554914100266068,-58.496066962244292 -34.55509771336903,-58.495925679953487 -34.555226184954904,-58.495768431796819 -34.555288814893551,-58.495768460802246 -34.555288876873398,-58.495539037360608 -34.555317328810311,-58.495275234680427 -34.555298384527141,-58.49504581069278 -34.555251048994286,-58.494878696972876 -34.555204400881017,-58.494591009282438 -34.555051300357398,-58.494415366203867 -34.554957820710769,-58.493955019916982 -34.554717858028525,-58.493877769984998 -34.554827601104677)));;707;12_1_3;COMUNA 12;1;3;687;335;352;95,17%;202;200;99,01%;2;1,00%;187;0;0,00%;187;100,00%
MULTIPOLYGON (((-58.496293727341687 -34.54957932386332,-58.495743672092019 -34.550364651307746,-58.496665949758452 -34.550851744783159,-58.497589855806829 -34.551339746320053,-58.498675791211568 -34.551913260520998,-58.499017796246818 -34.552099717177107,-58.499340580939176 -34.551932429926502,-58.499517920980892 -34.551822301075973,-58.499695369489075 -34.551765977235135,-58.499939819894124 -34.551739845382194,-58.500224650935131 -34.551790253467551,-58.50043766975994 -34.551902728221869,-58.500650532285306 -34.552044640628715,-58.500655289550203 -34.552053833395306,-58.501085256300279 -34.551909316653926,-58.50160405609288 -34.55173493942641,-58.500679389348733 -34.549762476899275,-58.50055131757798 -34.54948927131236,-58.497335420296395 -34.548070098476444,-58.497061086723619 -34.548473793750148,-58.496838762753576 -34.548800951019274,-58.496848287928294 -34.548805049437313,-58.496293727341687 -34.54957932386332)));;708;12_1_4;COMUNA 12;1;4;885;429;456;94,08%;315;315;100,00%;0;0,00%;313;6;1,92%;307;98,08%
MULTIPOLYGON (((-58.497061086723619 -34.548473793750148,-58.497335420296395 -34.548070098476444,-58.49443622026476 -34.546790569656636,-58.494162908512052 -34.547184595290403,-58.493248709896271 -34.548502537342962,-58.493242320602491 -34.548505215953348,-58.492966006577106 -34.548897486173665,-58.493898723306408 -34.549390161728972,-58.494821149765222 -34.549877410036615,-58.495743672092019 -34.550364651307746,-58.496293727341687 -34.54957932386332,-58.496848287928294 -34.548805049437313,-58.496838762753576 -34.548800951019274,-58.497061086723619 -34.548473793750148)));;709;12_1_5;COMUNA 12;1;5;588;284;304;93,42%;249;249;100,00%;0;0,00%;217;5;2,30%;212;97,70%
MULTIPOLYGON (((-58.492727249363647 -34.546036284131432,-58.492466004985857 -34.546425169229963,-58.491940106630004 -34.547209417671915,-58.491916781134876 -34.547197591713768,-58.491880200878178 -34.547251898785149,-58.491880641839451 -34.547295985256525,-58.491367151557107 -34.548057480612059,-58.491410141129137 -34.548075922079761,-58.490872393982876 -34.548867985768155,-58.491512839432019 -34.549206443670933,-58.49213813644262 -34.549536873304525,-58.491666565761797 -34.550206101721336,-58.491583531692704 -34.550323662063356,-58.49170867706119 -34.55038835371144,-58.49186021386933 -34.550466631110922,-58.491948182075106 -34.550342097246968,-58.492412945314548 -34.549682447325232,-58.493348391825258 -34.550176534871305,-58.494269802159117 -34.55066329455417,-58.495192925918836 -34.551150891895453,-58.496114953645304 -34.551637848683264,-58.497038694905747 -34.552125783945378,-58.498058739122911 -34.552664531737598,-58.498675791211568 -34.551913260520998,-58.497589855806829 -34.551339746320053,-58.496665949758452 -34.550851744783159,-58.495743672092019 -34.550364651307746,-58.494821149765222 -34.549877410036615,-58.493898723306408 -34.549390161728972,-58.492966006577106 -34.548897486173665,-58.493242320602491 -34.548505215953348,-58.493248709896271 -34.548502537342962,-58.494162908512052 -34.547184595290403,-58.49443622026476 -34.546790569656636,-58.492727249363647 -34.546036284131432)));;710;12_1_6;COMUNA 12;1;6;760;346;414;83,57%;330;330;100,00%;0;0,00%;286;5;1,75%;281;98,25%
MULTIPOLYGON (((-58.492307838774749 -34.546354500128267,-58.492579469414764 -34.545971035613391,-58.491741312130607 -34.545601082492226,-58.491470790564904 -34.545980732709282,-58.49092432003291 -34.546747637551704,-58.490925046024984 -34.546748015107504,-58.490916926474178 -34.546900277665024,-58.490856808559592 -34.547071848900949,-58.490756514516335 -34.547237936124681,-58.490500788114964 -34.547622097146423,-58.490050287297677 -34.547399371528854,-58.489460261838595 -34.548163693009215,-58.488872607942625 -34.548925123578329,-58.488492109354411 -34.549382408970658,-58.48824876507647 -34.549674938544889,-58.487661346624712 -34.550442208393626,-58.487399398984955 -34.550305776449491,-58.486940108605523 -34.550907516136967,-58.486835452785208 -34.55104465590108,-58.487655269645344 -34.551470003758929,-58.488462268919477 -34.551707030223518,-58.488462347354435 -34.551706937191696,-58.488560375171254 -34.551590666076443,-58.488615511922113 -34.551525158399002,-58.488914569725019 -34.551094792947673,-58.489460352913483 -34.550309356427434,-58.490009103947585 -34.549520888395129,-58.490561165377855 -34.548736079184941,-58.491105219540607 -34.547962819080126,-58.491668827564141 -34.54715377549033,-58.491765192609179 -34.547198473000641,-58.491804835956351 -34.547141066496089,-58.491769676859008 -34.547121355635262,-58.492307838774749 -34.546354500128267)));;711;12_1_7;COMUNA 12;1;7;1089;533;556;95,86%;370;370;100,00%;0;0,00%;360;18;5,00%;342;95,00%
MULTIPOLYGON (((-58.489300220691774 -34.552367444428278,-58.489904117527239 -34.552729613872167,-58.489984482331373 -34.552609867602278,-58.490408019142777 -34.55200626591116,-58.490487397462751 -34.551891876392602,-58.491033425609906 -34.551104038412987,-58.491090682295045 -34.551021556503805,-58.491583531692704 -34.550323662063356,-58.491666565761797 -34.550206101721336,-58.49213813644262 -34.549536873304525,-58.491512839432019 -34.549206443670933,-58.490872393982876 -34.548867985768155,-58.491410141129137 -34.548075922079761,-58.491367151557107 -34.548057480612059,-58.491880641839451 -34.547295985256525,-58.491880200878178 -34.547251898785149,-58.491916781134876 -34.547197591713768,-58.491940106630004 -34.547209417671915,-58.492466004985857 -34.546425169229963,-58.492727249363647 -34.546036284131432,-58.492579469414764 -34.545971035613391,-58.492307838774749 -34.546354500128267,-58.491769676859008 -34.547121355635262,-58.491804835956351 -34.547141066496089,-58.491765192609179 -34.547198473000641,-58.491668827564141 -34.54715377549033,-58.491105219540607 -34.547962819080126,-58.490561165377855 -34.548736079184941,-58.490009103947585 -34.549520888395129,-58.489460352913483 -34.550309356427434,-58.488914569725019 -34.551094792947673,-58.488615511922113 -34.551525158399002,-58.488560375171254 -34.551590666076443,-58.488462347354435 -34.551706937191696,-58.488462268919477 -34.551707030223518,-58.488461981361851 -34.551707426881713,-58.488552654615972 -34.55169732386986,-58.488651963755267 -34.551722549862284,-58.488778695348913 -34.551783286969915,-58.488800452123826 -34.551804697051708,-58.488826200261144 -34.551830034874435,-58.488826106154093 -34.551830057195481,-58.488873191648693 -34.551876668983837,-58.488873280856119 -34.551877122393513,-58.488900473262696 -34.552015331509651,-58.489151743750334 -34.552278458494243,-58.489300220691774 -34.552367444428278)));;712;12_1_8;COMUNA 12;1;8;505;241;264;91,29%;214;214;100,00%;0;0,00%;182;5;2,75%;177;97,25%
MULTIPOLYGON (((-58.492246759906713 -34.551744766403161,-58.493168692126112 -34.552232308824479,-58.494090379658132 -34.552719633028182,-58.49501344013597 -34.553207654126652,-58.495565137907242 -34.552421555204504,-58.496031584499853 -34.551756820628675,-58.496114953645304 -34.551637848683264,-58.495192925918836 -34.551150891895453,-58.494269802159117 -34.55066329455417,-58.493348391825258 -34.550176534871305,-58.492412945314548 -34.549682447325232,-58.491948182075106 -34.550342097246968,-58.49186021386933 -34.550466631110922,-58.49170867706119 -34.55038835371144,-58.491583531692704 -34.550323662063356,-58.491090682295045 -34.551021556503805,-58.491033425609906 -34.551104038412987,-58.491162573417768 -34.551172039695942,-58.491308833375271 -34.551249121760854,-58.491444366691454 -34.551320501685844,-58.492246759906713 -34.551744766403161)));;713;12_1_9;COMUNA 12;1;9;974;468;506;92,49%;423;423;100,00%;0;0,00%;356;4;1,12%;352;98,88%
MULTIPOLYGON (((-58.486462338340786 -34.566468100428487,-58.487274299803026 -34.566885845297904,-58.4874055120195 -34.566953286553527,-58.487512063662223 -34.566829245433588,-58.488256990994209 -34.565997435591427,-58.488368222386363 -34.565873040597424,-58.489164108926445 -34.564983817473816,-58.489290060217279 -34.564842727551493,-58.488310140755473 -34.564417284476491,-58.487529805409849 -34.564078557472975,-58.487327930455564 -34.56398415757014,-58.486355429100442 -34.563529188894314,-58.485413984065225 -34.564540750435711,-58.486376197301979 -34.565017842180332,-58.485498399850442 -34.565971290626671,-58.485649363238657 -34.566049786913659,-58.486462338340786 -34.566468100428487)));;714;12_10_1;COMUNA 12;10;1;994;462;532;86,84%;381;381;100,00%;0;0,00%;366;2;0,55%;364;99,45%
MULTIPOLYGON (((-58.480143496031502 -34.568815325585547,-58.480030879658536 -34.568942593447836,-58.480117591330618 -34.568982371879777,-58.480379983478151 -34.569115163739063,-58.480472963071144 -34.569163250915878,-58.480768083467723 -34.569330397941393,-58.480906362923839 -34.569408268096744,-58.4809822295516 -34.569451638919993,-58.481062098912339 -34.569500502289536,-58.481347944712255 -34.569681100584994,-58.481460682763078 -34.569753199108987,-58.481795412479038 -34.569991537802949,-58.481866429236199 -34.570043571177351,-58.481937190587438 -34.570095252422298,-58.482102217512697 -34.570224034688067,-58.482221858505895 -34.570319160568808,-58.482347374979582 -34.570417172833871,-58.482442664057565 -34.570499837085407,-58.482586833673913 -34.570628622058699,-58.482679399441444 -34.570713962737884,-58.482862316784946 -34.57087985530891,-58.48332353032518 -34.571297049749496,-58.483405352409278 -34.571372126969017,-58.483419244226852 -34.57138470145793,-58.483421118519765 -34.571382716128987,-58.483578458874398 -34.571262252068109,-58.483578698879199 -34.571262023069963,-58.483482624708195 -34.571174834408936,-58.482902872215369 -34.57064969783444,-58.482850500312281 -34.57060069029172,-58.482814222752154 -34.570564779232043,-58.482464744258571 -34.57026433038471,-58.482066141118096 -34.56995205682729,-58.481989422211221 -34.569909179795161,-58.482452871245577 -34.569380068687614,-58.482577989633597 -34.569241098690881,-58.482699192326038 -34.569106354739858,-58.483414480854428 -34.568296341106972,-58.482498201297282 -34.567740764711914,-58.48158729813612 -34.567188349707372,-58.480749349918355 -34.568132602180299,-58.479837517497344 -34.567579892588327,-58.479125604697501 -34.56838403958298,-58.47924353045746 -34.568446420739697,-58.479262092401996 -34.568457897595387,-58.479331823093283 -34.568479086220137,-58.479982575383239 -34.568753866929569,-58.480053415062727 -34.568783646906653,-58.480143496031502 -34.568815325585547)));;715;12_10_10;COMUNA 12;10;10;815;349;466;74,89%;308;307;99,68%;1;0,33%;299;32;10,70%;267;89,30%
MULTIPOLYGON (((-58.479125604697501 -34.56838403958298,-58.479837517497344 -34.567579892588327,-58.480749349918355 -34.568132602180299,-58.48158729813612 -34.567188349707372,-58.480674278407051 -34.566634730929813,-58.479759908466534 -34.566080260352607,-58.478847594088656 -34.565526979838211,-58.478009887096285 -34.566471988416403,-58.477164926100805 -34.567425231758556,-58.477091213460596 -34.567508342691475,-58.477027632598762 -34.567596311757065,-58.476887267787113 -34.567732812980097,-58.476974281018798 -34.567761395633212,-58.477858556724982 -34.568089049798516,-58.477952382806528 -34.568124673466826,-58.478547523740772 -34.56834559319492,-58.478868268970558 -34.568541616002889,-58.478910065619743 -34.568514707881299,-58.478961230205748 -34.56850315127825,-58.479010013220829 -34.568503144770155,-58.479091323524983 -34.568530036457908,-58.47917272092036 -34.568566576386523,-58.47940737670136 -34.568668379909703,-58.479941910926023 -34.568902822812809,-58.480030879658536 -34.568942593447836,-58.480143496031502 -34.568815325585547,-58.480053415062727 -34.568783646906653,-58.479982575383239 -34.568753866929569,-58.479331823093283 -34.568479086220137,-58.479262092401996 -34.568457897595387,-58.47924353045746 -34.568446420739697,-58.479125604697501 -34.56838403958298)));;716;12_10_11;COMUNA 12;10;11;883;420;463;90,71%;395;395;100,00%;0;0,00%;345;30;8,70%;315;91,30%
MULTIPOLYGON (((-58.4874055120195 -34.566953286553527,-58.487274299803026 -34.566885845297904,-58.486462338340786 -34.566468100428487,-58.485649363238657 -34.566049786913659,-58.485498399850442 -34.565971290626671,-58.486376197301979 -34.565017842180332,-58.485413984065225 -34.564540750435711,-58.484453484667988 -34.56406449586985,-58.483592607293602 -34.564980461308338,-58.48276524509803 -34.565860850095596,-58.483105482361765 -34.566040801602114,-58.48372456837636 -34.566355851220173,-58.483888302114977 -34.566439136422417,-58.484525787563726 -34.566771433036983,-58.484689693777476 -34.566856970747288,-58.485655342358513 -34.567360969952304,-58.486613254069319 -34.567860807879789,-58.487311044995806 -34.567063099168251,-58.4874055120195 -34.566953286553527)));;717;12_10_2;COMUNA 12;10;2;994;465;529;87,90%;491;490;99,80%;1;0,20%;390;1;0,26%;389;99,74%
MULTIPOLYGON (((-58.484453484667988 -34.56406449586985,-58.485413984065225 -34.564540750435711,-58.486355429100442 -34.563529188894314,-58.485383704624255 -34.563074634844888,-58.48460934662674 -34.562712365811265,-58.483625891894143 -34.562252447459208,-58.482966685952405 -34.563115554774249,-58.482850519766117 -34.563269665346468,-58.48212951389737 -34.564226162594437,-58.483097499109533 -34.56472518166624,-58.4823913779381 -34.565665127723136,-58.482575629028688 -34.565760595018666,-58.48276524509803 -34.565860850095596,-58.483592607293602 -34.564980461308338,-58.484453484667988 -34.56406449586985)));;718;12_10_3;COMUNA 12;10;3;730;337;393;85,75%;338;338;100,00%;0;0,00%;287;5;1,74%;282;98,26%
MULTIPOLYGON (((-58.481290087841593 -34.565094685157675,-58.481290818542575 -34.565095063923685,-58.481422959799652 -34.565163497448303,-58.481802696845449 -34.56536020784398,-58.4823913779381 -34.565665127723136,-58.483097499109533 -34.56472518166624,-58.48212951389737 -34.564226162594437,-58.482850519766117 -34.563269665346468,-58.482966685952405 -34.563115554774249,-58.483625891894143 -34.562252447459208,-58.48347383958334 -34.562210147599501,-58.482781433085783 -34.562017437967491,-58.481998834184431 -34.561614231187221,-58.481843365102677 -34.561534008660772,-58.481783229068689 -34.56162066910597,-58.481597435337946 -34.561879721643059,-58.481409967340504 -34.562144314755393,-58.481254300556053 -34.562361807537741,-58.481153870771529 -34.562505878670109,-58.480986463582909 -34.562638878543822,-58.480661690854433 -34.562891024588353,-58.48039885750314 -34.563093295292944,-58.480141718260093 -34.563292580821162,-58.480221560788195 -34.563231945851349,-58.480372632958968 -34.563320772728353,-58.480068153412823 -34.563507216081568,-58.479910170199382 -34.563604496285684,-58.479721623305252 -34.563695935219862,-58.479541500565993 -34.56377032969165,-58.479054921530924 -34.563932022719669,-58.479311960115744 -34.564065796750072,-58.47990036787958 -34.56437206683345,-58.480840671319484 -34.564861388948813,-58.481047822225193 -34.564969179645288,-58.481245182174504 -34.565071407850624,-58.481290087841593 -34.565094685157675)));;719;12_10_4;COMUNA 12;10;4;758;381;377;101,06%;307;307;100,00%;0;0,00%;270;5;1,85%;265;98,15%
MULTIPOLYGON (((-58.479311960115744 -34.564065796750072,-58.47911831955215 -34.564238295360063,-58.478148147065767 -34.565102826324107,-58.477177528893456 -34.565967701639352,-58.476356024456855 -34.56669965938471,-58.476190206944445 -34.566849120984607,-58.475123633688391 -34.566218643171759,-58.47466568760936 -34.566734627028012,-58.474596272623195 -34.5668128520933,-58.474523876397861 -34.566894436574408,-58.474596924589122 -34.566913937373364,-58.47516743964708 -34.567105156414186,-58.475593903384222 -34.56725983718934,-58.475685087959562 -34.567292716285444,-58.475775165786132 -34.5673251728781,-58.476399072703281 -34.567556734293561,-58.476793017707209 -34.567701836629823,-58.476887267787113 -34.567732812980097,-58.477027632598762 -34.567596311757065,-58.477091213460596 -34.567508342691475,-58.477164926100805 -34.567425231758556,-58.478009887096285 -34.566471988416403,-58.478847594088656 -34.565526979838211,-58.47968502677756 -34.564582176683096,-58.47990036787958 -34.56437206683345,-58.479311960115744 -34.564065796750072)));;720;12_10_5;COMUNA 12;10;5;738;347;391;88,75%;368;368;100,00%;0;0,00%;298;11;3,69%;287;96,31%
MULTIPOLYGON (((-58.480840671319484 -34.564861388948813,-58.47990036787958 -34.56437206683345,-58.47968502677756 -34.564582176683096,-58.478847594088656 -34.565526979838211,-58.479759908466534 -34.566080260352607,-58.480674278407051 -34.566634730929813,-58.48158729813612 -34.567188349707372,-58.482424972061111 -34.566244302660827,-58.481510935298886 -34.565689774685346,-58.481802696845449 -34.56536020784398,-58.481422959799652 -34.565163497448303,-58.481290818542575 -34.565095063923685,-58.481290087841593 -34.565094685157675,-58.481245182174504 -34.565071407850624,-58.481047822225193 -34.564969179645288,-58.480840671319484 -34.564861388948813)));;721;12_10_6;COMUNA 12;10;6;874;404;470;85,96%;423;423;100,00%;0;0,00%;353;5;1,42%;348;98,58%
MULTIPOLYGON (((-58.483334678440372 -34.566796148298522,-58.483473127866382 -34.566880072153324,-58.484253251946171 -34.567352140650705,-58.48516868711345 -34.567906084272934,-58.486083708660757 -34.568459739354303,-58.486727534827288 -34.568849279148942,-58.487448393578205 -34.568301435269966,-58.487353111577256 -34.568251029820168,-58.486780315040484 -34.567947961937747,-58.486613254069319 -34.567860807879789,-58.485655342358513 -34.567360969952304,-58.484689693777476 -34.566856970747288,-58.484525787563726 -34.566771433036983,-58.483888302114977 -34.566439136422417,-58.48372456837636 -34.566355851220173,-58.483105482361765 -34.566040801602114,-58.48276524509803 -34.565860850095596,-58.482575629028688 -34.565760595018666,-58.4823913779381 -34.565665127723136,-58.481802696845449 -34.56536020784398,-58.481510935298886 -34.565689774685346,-58.482424972061111 -34.566244302660827,-58.483334678440372 -34.566796148298522)));;722;12_10_7;COMUNA 12;10;7;768;353;415;85,06%;314;313;99,68%;1;0,32%;295;2;0,68%;293;99,32%
MULTIPOLYGON (((-58.484329835969099 -34.568851417756164,-58.48349232767174 -34.569795266166274,-58.483377168809604 -34.569925080075208,-58.482814222752154 -34.570564779232043,-58.482850500312281 -34.57060069029172,-58.482902872215369 -34.57064969783444,-58.483482624708195 -34.571174834408936,-58.483578698879199 -34.571262023069963,-58.483919598259732 -34.571000455949452,-58.484143809356205 -34.570828155823953,-58.484965738569876 -34.570196572967625,-58.485663806859193 -34.569660223268194,-58.485785612507293 -34.569566604691353,-58.485958148752189 -34.569433960561518,-58.48661151899703 -34.568937404346023,-58.486727534827288 -34.568849279148942,-58.486083708660757 -34.568459739354303,-58.48516868711345 -34.567906084272934,-58.484329835969099 -34.568851417756164)));;723;12_10_8;COMUNA 12;10;8;1166;543;623;87,16%;580;579;99,83%;1;0,17%;477;1;0,21%;476;99,79%
MULTIPOLYGON (((-58.484253251946171 -34.567352140650705,-58.483473127866382 -34.566880072153324,-58.483334678440372 -34.566796148298522,-58.482424972061111 -34.566244302660827,-58.48158729813612 -34.567188349707372,-58.482498201297282 -34.567740764711914,-58.483414480854428 -34.568296341106972,-58.482699192326038 -34.569106354739858,-58.482577989633597 -34.569241098690881,-58.482452871245577 -34.569380068687614,-58.481989422211221 -34.569909179795161,-58.482066141118096 -34.56995205682729,-58.482464744258571 -34.57026433038471,-58.482814222752154 -34.570564779232043,-58.483377168809604 -34.569925080075208,-58.48349232767174 -34.569795266166274,-58.484329835969099 -34.568851417756164,-58.48516868711345 -34.567906084272934,-58.484253251946171 -34.567352140650705)));;724;12_10_9;COMUNA 12;10;9;842;415;427;97,19%;386;386;100,00%;0;0,00%;318;18;5,66%;300;94,34%
MULTIPOLYGON (((-58.480820934986959 -34.569637304815636,-58.479909254891389 -34.569079525233384,-58.479055011311175 -34.570043557673515,-58.478408868014405 -34.570772899380493,-58.477579700895397 -34.571708606928325,-58.477753744566705 -34.571812322440394,-58.47850722653115 -34.572247105013439,-58.479320300885853 -34.571329281534517,-58.479974696986268 -34.570590496875624,-58.480710964874817 -34.569763875866172,-58.480820934986959 -34.569637304815636)));;725;12_11_1;COMUNA 12;11;1;760;343;417;82,25%;388;388;100,00%;0;0,00%;328;3;0,91%;325;99,09%
MULTIPOLYGON (((-58.469035309908634 -34.572119155758045,-58.469837450437474 -34.572564834829457,-58.469981259357979 -34.572644688912,-58.470698350852075 -34.573054450301875,-58.471649431769748 -34.573597999048289,-58.471799886069405 -34.573685526870868,-58.472568510679508 -34.574132810159995,-58.47332479760162 -34.573239398706804,-58.474100647398132 -34.572322810605399,-58.473175021455361 -34.571776813767798,-58.472252217375697 -34.57123235900292,-58.472135484121473 -34.57116356230172,-58.471326360264257 -34.570687122746691,-58.470608007700712 -34.570264195384205,-58.470416011098052 -34.570150259083256,-58.46958565754322 -34.571131337001965,-58.468840587191586 -34.572011696306838,-58.469035309908634 -34.572119155758045)));;726;12_11_10;COMUNA 12;11;10;860;411;449;91,54%;346;346;100,00%;0;0,00%;283;2;0,71%;281;99,29%
MULTIPOLYGON (((-58.470865027192218 -34.574496120465113,-58.471805907701011 -34.57503255556643,-58.471958408116556 -34.575119519615953,-58.472742458323978 -34.575571800744079,-58.472886701329585 -34.575655031752653,-58.473547122953228 -34.576032737309397,-58.473684725238414 -34.576107657748111,-58.473829054651894 -34.576186380395164,-58.474618999610584 -34.576636113532544,-58.475378953837428 -34.575778324671241,-58.475234197137446 -34.5756941811308,-58.474593183100176 -34.575315848962532,-58.474453367160393 -34.575237901453917,-58.474311593047091 -34.575158897587585,-58.47362665100362 -34.574759648098834,-58.47350131112298 -34.574681768621197,-58.473347361358201 -34.574586003428479,-58.472568510679508 -34.574132810159995,-58.471799886069405 -34.573685526870868,-58.471649431769748 -34.573597999048289,-58.470698350852075 -34.573054450301875,-58.469981259357979 -34.572644688912,-58.469837450437474 -34.572564834829457,-58.469035309908634 -34.572119155758045,-58.468840587191586 -34.572011696306838,-58.46808128372858 -34.572908812846634,-58.468287587386541 -34.57302648466802,-58.469133838630654 -34.573508998827798,-58.469925606246086 -34.573960452657751,-58.470865027192218 -34.574496120465113)));;727;12_11_11;COMUNA 12;11;11;774;360;414;86,96%;344;343;99,71%;1;0,29%;278;9;3,24%;269;96,76%
MULTIPOLYGON (((-58.480030879658536 -34.568942593447836,-58.479941910926023 -34.568902822812809,-58.47940737670136 -34.568668379909703,-58.47917272092036 -34.568566576386523,-58.479091323524983 -34.568530036457908,-58.479010013220829 -34.568503144770155,-58.478961230205748 -34.56850315127825,-58.478910065619743 -34.568514707881299,-58.478868268970558 -34.568541616002889,-58.478547523740772 -34.56834559319492,-58.477952382806528 -34.568124673466826,-58.477215080255718 -34.568950362652437,-58.478011024173398 -34.569424370492662,-58.478137807203467 -34.569499569052432,-58.479055011311175 -34.570043557673515,-58.479909254891389 -34.569079525233384,-58.480820934986959 -34.569637304815636,-58.4809822295516 -34.569451638919993,-58.480906362923839 -34.569408268096744,-58.480768083467723 -34.569330397941393,-58.480472963071144 -34.569163250915878,-58.480379983478151 -34.569115163739063,-58.480117591330618 -34.568982371879777,-58.480030879658536 -34.568942593447836)));;728;12_11_2;COMUNA 12;11;2;645;309;336;91,96%;320;320;100,00%;0;0,00%;267;8;3,00%;259;97,00%
MULTIPOLYGON (((-58.478137807203467 -34.569499569052432,-58.478011024173398 -34.569424370492662,-58.477215080255718 -34.568950362652437,-58.476531630424155 -34.569626809370114,-58.475613820497991 -34.570535188630316,-58.476365409196006 -34.570984914939245,-58.47655358428063 -34.571097011235089,-58.477579700895397 -34.571708606928325,-58.478408868014405 -34.570772899380493,-58.479055011311175 -34.570043557673515,-58.478137807203467 -34.569499569052432)));;729;12_11_3;COMUNA 12;11;3;568;248;320;77,50%;301;301;100,00%;0;0,00%;254;5;1,97%;249;98,03%
MULTIPOLYGON (((-58.475042463572258 -34.572878376612501,-58.474948228498668 -34.572984658256345,-58.474267979492694 -34.573782505166385,-58.475086429815057 -34.574253642115373,-58.475241827784217 -34.57434546114127,-58.476024272430607 -34.574808003537228,-58.476164430617878 -34.574891724107182,-58.476950827101085 -34.574004061871271,-58.477732354816347 -34.573121817808662,-58.47850722653115 -34.572247105013439,-58.477753744566705 -34.571812322440394,-58.477579700895397 -34.571708606928325,-58.47655358428063 -34.571097011235089,-58.475804416797978 -34.571983470106574,-58.475159597377527 -34.572746457658724,-58.475042463572258 -34.572878376612501)));;730;12_11_4;COMUNA 12;11;4;888;405;483;83,85%;422;420;99,53%;2;0,48%;343;2;0,58%;341;99,42%
MULTIPOLYGON (((-58.47350131112298 -34.574681768621197,-58.47362665100362 -34.574759648098834,-58.474311593047091 -34.575158897587585,-58.474453367160393 -34.575237901453917,-58.474593183100176 -34.575315848962532,-58.475234197137446 -34.5756941811308,-58.475378953837428 -34.575778324671241,-58.476164430617878 -34.574891724107182,-58.476024272430607 -34.574808003537228,-58.475241827784217 -34.57434546114127,-58.475086429815057 -34.574253642115373,-58.474267979492694 -34.573782505166385,-58.474948228498668 -34.572984658256345,-58.475042463572258 -34.572878376612501,-58.475159597377527 -34.572746457658724,-58.475804416797978 -34.571983470106574,-58.47655358428063 -34.571097011235089,-58.476365409196006 -34.570984914939245,-58.475613820497991 -34.570535188630316,-58.474859795782187 -34.571426008685457,-58.474100647398132 -34.572322810605399,-58.47332479760162 -34.573239398706804,-58.472568510679508 -34.574132810159995,-58.473347361358201 -34.574586003428479,-58.47350131112298 -34.574681768621197)));;731;12_11_5;COMUNA 12;11;5;920;450;470;95,74%;346;346;100,00%;0;0,00%;307;48;15,64%;259;84,36%
MULTIPOLYGON (((-58.474696121849334 -34.569986174026958,-58.473936133119693 -34.570880862449734,-58.473175021455361 -34.571776813767798,-58.474100647398132 -34.572322810605399,-58.474859795782187 -34.571426008685457,-58.475613820497991 -34.570535188630316,-58.476531630424155 -34.569626809370114,-58.477215080255718 -34.568950362652437,-58.477952382806528 -34.568124673466826,-58.477858556724982 -34.568089049798516,-58.476974281018798 -34.567761395633212,-58.476887267787113 -34.567732812980097,-58.47629049222968 -34.568399811347419,-58.475617935792513 -34.569068997961686,-58.474696121849334 -34.569986174026958)));;732;12_11_6;COMUNA 12;11;6;858;403;455;88,57%;373;373;100,00%;0;0,00%;319;15;4,70%;304;95,30%
MULTIPOLYGON (((-58.473014440826979 -34.570336835817713,-58.472922930786659 -34.570445791883962,-58.472252217375697 -34.57123235900292,-58.473175021455361 -34.571776813767798,-58.473936133119693 -34.570880862449734,-58.474696121849334 -34.569986174026958,-58.475617935792513 -34.569068997961686,-58.47629049222968 -34.568399811347419,-58.475191117744458 -34.567745674930116,-58.474598335461167 -34.568451398696531,-58.473776986868074 -34.569429124087037,-58.473014440826979 -34.570336835817713)));;733;12_11_7;COMUNA 12;11;7;778;353;425;83,06%;391;391;100,00%;0;0,00%;330;0;0,00%;330;100,00%
MULTIPOLYGON (((-58.476887267787113 -34.567732812980097,-58.476793017707209 -34.567701836629823,-58.476399072703281 -34.567556734293561,-58.475775165786132 -34.5673251728781,-58.475685087959562 -34.567292716285444,-58.475593903384222 -34.56725983718934,-58.47516743964708 -34.567105156414186,-58.474596924589122 -34.566913937373364,-58.474523876397861 -34.566894436574408,-58.474268770148562 -34.567196939037252,-58.473690116362299 -34.567901882435912,-58.473027265718116 -34.568709299407452,-58.472878213037362 -34.568882418040843,-58.472093867406109 -34.569793506346507,-58.471397782499047 -34.570601973158851,-58.471326360264257 -34.570687122746691,-58.472135484121473 -34.57116356230172,-58.472252217375697 -34.57123235900292,-58.472922930786659 -34.570445791883962,-58.473014440826979 -34.570336835817713,-58.473776986868074 -34.569429124087037,-58.474598335461167 -34.568451398696531,-58.475191117744458 -34.567745674930116,-58.47629049222968 -34.568399811347419,-58.476887267787113 -34.567732812980097)));;734;12_11_8;COMUNA 12;11;8;922;442;480;92,08%;412;411;99,76%;1;0,24%;344;26;7,56%;318;92,44%
MULTIPOLYGON (((-58.473002120703384 -34.56644752734686,-58.47319590645202 -34.566561937772896,-58.473368486143315 -34.566661504640933,-58.47278310119502 -34.567353133949787,-58.471961400861716 -34.568324156898427,-58.471176371054035 -34.569251789458477,-58.470416011098052 -34.570150259083256,-58.470608007700712 -34.570264195384205,-58.471326360264257 -34.570687122746691,-58.471397782499047 -34.570601973158851,-58.472093867406109 -34.569793506346507,-58.472878213037362 -34.568882418040843,-58.473027265718116 -34.568709299407452,-58.473690116362299 -34.567901882435912,-58.474268770148562 -34.567196939037252,-58.474523876397861 -34.566894436574408,-58.474596272623195 -34.5668128520933,-58.473991632188707 -34.56666180766527,-58.473631538431896 -34.566570924148664,-58.473540430532637 -34.566548203199609,-58.473262770923505 -34.566496788057812,-58.473002120703384 -34.56644752734686)));;735;12_11_9;COMUNA 12;11;9;869;398;471;84,50%;469;468;99,79%;1;0,21%;373;1;0,27%;372;99,73%
MULTIPOLYGON (((-58.484292157272016 -34.575580234075758,-58.484026812259856 -34.575430344800061,-58.483031349462635 -34.574860983478821,-58.482891270116973 -34.574779453972688,-58.481757562269962 -34.575746367358015,-58.482737433463505 -34.576620120582433,-58.484292157272016 -34.575580234075758)));;736;12_12_1;COMUNA 12;12;1;661;285;376;75,80%;352;351;99,72%;1;0,28%;272;4;1,47%;268;98,53%
MULTIPOLYGON (((-58.481761194302607 -34.574126579740259,-58.480787730346876 -34.573563675706723,-58.480668773133601 -34.573494887523097,-58.480471449188968 -34.573652106216052,-58.479736958132086 -34.574186247780546,-58.480168998410662 -34.574329854799473,-58.481757562269962 -34.575746367358015,-58.482891270116973 -34.574779453972688,-58.481761194302607 -34.574126579740259)));;737;12_12_2;COMUNA 12;12;2;1098;493;605;81,49%;619;619;100,00%;0;0,00%;501;7;1,40%;494;98,60%
MULTIPOLYGON (((-58.479441575466147 -34.572786088044658,-58.47850722653115 -34.572247105013439,-58.477732354816347 -34.573121817808662,-58.476950827101085 -34.574004061871271,-58.477849935169566 -34.574534398698283,-58.478853107536722 -34.573787196009448,-58.479518974996473 -34.57408817524265,-58.479736958132086 -34.574186247780546,-58.480471449188968 -34.573652106216052,-58.480668773133601 -34.573494887523097,-58.480049977393314 -34.573137074436673,-58.479867413700674 -34.57303174363296,-58.479441575466147 -34.572786088044658)));;738;12_12_3;COMUNA 12;12;3;1209;571;638;89,50%;628;627;99,84%;1;0,16%;509;1;0,20%;508;99,80%
MULTIPOLYGON (((-58.477849935169566 -34.574534398698283,-58.476950827101085 -34.574004061871271,-58.476164430617878 -34.574891724107182,-58.475378953837428 -34.575778324671241,-58.474618999610584 -34.576636113532544,-58.474850867146678 -34.576768138491417,-58.475006865103332 -34.576856929421709,-58.475594329657426 -34.577190263095595,-58.476583851915315 -34.57647934995267,-58.477428291083193 -34.575872676060676,-58.47802668620561 -34.575438358656989,-58.478552630135745 -34.575064824947212,-58.478711057266302 -34.574941207475042,-58.478879273838324 -34.57480991211532,-58.479736958132086 -34.574186247780546,-58.479518974996473 -34.57408817524265,-58.478853107536722 -34.573787196009448,-58.477849935169566 -34.574534398698283)));;739;12_12_4;COMUNA 12;12;4;911;417;494;84,41%;437;437;100,00%;0;0,00%;356;0;0,00%;356;100,00%
MULTIPOLYGON (((-58.480168998410662 -34.574329854799473,-58.479736958132086 -34.574186247780546,-58.478879273838324 -34.57480991211532,-58.478711057266302 -34.574941207475042,-58.478552630135745 -34.575064824947212,-58.47802668620561 -34.575438358656989,-58.478778211502373 -34.576146531376949,-58.4783154828324 -34.576755208682734,-58.478600257628351 -34.577024972015735,-58.479019588470862 -34.57742225732963,-58.479122803537834 -34.577519008115992,-58.480578749505376 -34.576539466534442,-58.481757562269962 -34.575746367358015,-58.480168998410662 -34.574329854799473)));;740;12_12_5;COMUNA 12;12;5;803;360;443;81,26%;397;396;99,75%;1;0,25%;328;3;0,91%;325;99,09%
MULTIPOLYGON (((-58.481757562269962 -34.575746367358015,-58.480578749505376 -34.576539466534442,-58.481401632627716 -34.577514877252462,-58.481553849212425 -34.577411750910727,-58.482737433463505 -34.576620120582433,-58.481757562269962 -34.575746367358015)));;741;12_12_6;COMUNA 12;12;6;553;234;319;73,35%;358;358;100,00%;0;0,00%;260;1;0,38%;259;99,62%
MULTIPOLYGON (((-58.481401632627716 -34.577514877252462,-58.480578749505376 -34.576539466534442,-58.479122803537834 -34.577519008115992,-58.477773158274999 -34.578426966805758,-58.478198679084123 -34.578668825048261,-58.478655284303969 -34.578928354532991,-58.478988076277027 -34.579124938508393,-58.480106414239422 -34.578391936599921,-58.481401632627716 -34.577514877252462)));;742;12_12_7;COMUNA 12;12;7;858;400;458;87,34%;521;521;100,00%;0;0,00%;386;7;1,81%;379;98,19%
MULTIPOLYGON (((-58.478600257628351 -34.577024972015735,-58.4783154828324 -34.576755208682734,-58.478778211502373 -34.576146531376949,-58.47802668620561 -34.575438358656989,-58.477428291083193 -34.575872676060676,-58.476583851915315 -34.57647934995267,-58.475594329657426 -34.577190263095595,-58.477150337217346 -34.578073154062281,-58.477333248821083 -34.578176939439217,-58.477773158274999 -34.578426966805758,-58.479122803537834 -34.577519008115992,-58.479019588470862 -34.57742225732963,-58.478600257628351 -34.577024972015735)));;743;12_12_8;COMUNA 12;12;8;716;331;385;85,97%;326;325;99,69%;1;0,31%;267;3;1,12%;264;98,88%
MULTIPOLYGON (((-58.485778857685723 -34.573467266614379,-58.485889497689094 -34.573310337539787,-58.485820772758707 -34.573252179078565,-58.485456116452561 -34.572949136060942,-58.4851852232173 -34.572723613232597,-58.484995912960407 -34.572562443874048,-58.484862817705398 -34.572483380217768,-58.484782254643939 -34.572406137987706,-58.484832640970858 -34.572343379694473,-58.484394167928905 -34.572009077872146,-58.484370404822393 -34.572030279252246,-58.484282345776734 -34.571938802082116,-58.483803685892788 -34.571507562690108,-58.483652412805377 -34.571373150379074,-58.483672723819353 -34.571354474894996,-58.483578458874398 -34.571262252068109,-58.483421118519765 -34.571382716128987,-58.483419244226852 -34.57138470145793,-58.483405352409278 -34.571372126969017,-58.483419071774328 -34.57138458325521,-58.48323308408122 -34.571526934039206,-58.482507574014363 -34.572082007334288,-58.484232256112008 -34.573092674069585,-58.484392941310588 -34.573186804571748,-58.48547610797376 -34.573825085214274,-58.485778857685723 -34.573467266614379)));;744;12_13_1;COMUNA 12;13;1;898;403;495;81,41%;536;536;100,00%;0;0,00%;407;3;0,74%;404;99,26%
MULTIPOLYGON (((-58.481866429236199 -34.570043571177351,-58.481795412479038 -34.569991537802949,-58.481460682763078 -34.569753199108987,-58.481347944712255 -34.569681100584994,-58.481062098912339 -34.569500502289536,-58.4809822295516 -34.569451638919993,-58.480820934986959 -34.569637304815636,-58.480710964874817 -34.569763875866172,-58.479974696986268 -34.570590496875624,-58.480148656131867 -34.570694068152797,-58.480903164342244 -34.571138977151023,-58.481821510416118 -34.571679212108208,-58.482507574014363 -34.572082007334288,-58.48323308408122 -34.571526934039206,-58.483419071774328 -34.57138458325521,-58.483405352409278 -34.571372126969017,-58.48332353032518 -34.571297049749496,-58.482862316784946 -34.57087985530891,-58.482679399441444 -34.570713962737884,-58.482586833673913 -34.570628622058699,-58.482442664057565 -34.570499837085407,-58.482347374979582 -34.570417172833871,-58.482221858505895 -34.570319160568808,-58.482102217512697 -34.570224034688067,-58.481937190587438 -34.570095252422298,-58.481866429236199 -34.570043571177351)));;745;12_13_2;COMUNA 12;13;2;872;390;482;80,91%;483;483;100,00%;0;0,00%;389;16;4,11%;373;95,89%
MULTIPOLYGON (((-58.480903164342244 -34.571138977151023,-58.480148656131867 -34.570694068152797,-58.479974696986268 -34.570590496875624,-58.479320300885853 -34.571329281534517,-58.47850722653115 -34.572247105013439,-58.479441575466147 -34.572786088044658,-58.479867413700674 -34.57303174363296,-58.480049977393314 -34.573137074436673,-58.480668773133601 -34.573494887523097,-58.480859796982692 -34.573342669658217,-58.481638021798737 -34.572747314686559,-58.48023728075659 -34.571889388588502,-58.480903164342244 -34.571138977151023)));;746;12_13_3;COMUNA 12;13;3;1564;706;858;82,28%;962;962;100,00%;0;0,00%;721;8;1,11%;713;98,89%
MULTIPOLYGON (((-58.481821510416118 -34.571679212108208,-58.480903164342244 -34.571138977151023,-58.48023728075659 -34.571889388588502,-58.481638021798737 -34.572747314686559,-58.482497719130258 -34.573249523701833,-58.483588962436841 -34.57389521445748,-58.484111990942033 -34.573244110144621,-58.484232256112008 -34.573092674069585,-58.482507574014363 -34.572082007334288,-58.481821510416118 -34.571679212108208)));;747;12_13_4;COMUNA 12;13;4;1257;582;675;86,22%;625;623;99,68%;2;0,32%;526;1;0,19%;525;99,81%
MULTIPOLYGON (((-58.482497719130258 -34.573249523701833,-58.481638021798737 -34.572747314686559,-58.480859796982692 -34.573342669658217,-58.480668773133601 -34.573494887523097,-58.480787730346876 -34.573563675706723,-58.481761194302607 -34.574126579740259,-58.482891270116973 -34.574779453972688,-58.483588962436841 -34.57389521445748,-58.482497719130258 -34.573249523701833)));;748;12_13_5;COMUNA 12;13;5;1077;467;610;76,56%;577;576;99,83%;1;0,17%;475;6;1,26%;469;98,74%
MULTIPOLYGON (((-58.484832479786583 -34.574626646163061,-58.483588962436841 -34.57389521445748,-58.482891270116973 -34.574779453972688,-58.483031349462635 -34.574860983478821,-58.484026812259856 -34.575430344800061,-58.484292157272016 -34.575580234075758,-58.485174537247318 -34.575093364036746,-58.485396980109684 -34.574962894809758,-58.484832479786583 -34.574626646163061)));;749;12_13_6;COMUNA 12;13;6;911;428;483;88,61%;497;497;100,00%;0;0,00%;395;0;0,00%;395;100,00%
MULTIPOLYGON (((-58.486618703079756 -34.574105371571669,-58.486798651776425 -34.573962583621153,-58.486679772207097 -34.573886899583314,-58.486535175720789 -34.573795867686215,-58.486436819563949 -34.573733701103436,-58.486337950352905 -34.573663224326623,-58.486261050415926 -34.573602109826965,-58.486153832699948 -34.573513957700179,-58.485889497689094 -34.573310337539787,-58.485778857685723 -34.573467266614379,-58.48547610797376 -34.573825085214274,-58.484392941310588 -34.573186804571748,-58.484232256112008 -34.573092674069585,-58.484111990942033 -34.573244110144621,-58.483588962436841 -34.57389521445748,-58.484832479786583 -34.574626646163061,-58.485396980109684 -34.574962894809758,-58.486444146306852 -34.574348725862571,-58.486361036736234 -34.574310360087047,-58.486618703079756 -34.574105371571669)));;750;12_13_7;COMUNA 12;13;7;493;198;295;67,12%;299;299;100,00%;0;0,00%;249;2;0,80%;247;99,20%
MULTIPOLYGON (((-58.486622051116107 -34.575687550728709,-58.485919931492312 -34.576510819672563,-58.486927100721104 -34.577087831330289,-58.487619256893566 -34.576276249340715,-58.488335912026749 -34.575435854141915,-58.487801970063018 -34.575123205385275,-58.487547263281897 -34.57497409624488,-58.487335902468544 -34.574850331017011,-58.486622051116107 -34.575687550728709)));;751;12_14_1;COMUNA 12;14;1;1000;393;607;64,74%;490;483;98,57%;7;1,45%;373;30;8,04%;343;91,96%
MULTIPOLYGON (((-58.481932444430655 -34.579431635565939,-58.481283369590898 -34.579062495354599,-58.480106414239422 -34.578391936599921,-58.478988076277027 -34.579124938508393,-58.479232647018669 -34.579269418700775,-58.480183429969721 -34.579819802118507,-58.4804836125763 -34.579993498376773,-58.480993713004558 -34.580288787383687,-58.481129201162872 -34.580367713943829,-58.48214558336155 -34.580959552643478,-58.483013543429173 -34.581464925162038,-58.483134132097369 -34.581535048778576,-58.483949790638192 -34.580578743119901,-58.482947114360265 -34.580008608179504,-58.481932444430655 -34.579431635565939)));;752;12_14_10;COMUNA 12;14;10;1023;474;549;86,34%;534;534;100,00%;0;0,00%;441;2;0,45%;439;99,55%
MULTIPOLYGON (((-58.485396980109684 -34.574962894809758,-58.485174537247318 -34.575093364036746,-58.484292157272016 -34.575580234075758,-58.484538513433002 -34.575719421491421,-58.484911413673991 -34.575933025211469,-58.485919931492312 -34.576510819672563,-58.486622051116107 -34.575687550728709,-58.487335902468544 -34.574850331017011,-58.486610450859622 -34.574425598077376,-58.486444146306852 -34.574348725862571,-58.485396980109684 -34.574962894809758)));;753;12_14_2;COMUNA 12;14;2;914;402;512;78,52%;510;510;100,00%;0;0,00%;400;5;1,25%;395;98,75%
MULTIPOLYGON (((-58.485919931492312 -34.576510819672563,-58.484911413673991 -34.575933025211469,-58.483811768625038 -34.57722552837091,-58.484820974631013 -34.577799599118059,-58.485919931492312 -34.576510819672563)));;754;12_14_3;COMUNA 12;14;3;778;360;418;86,12%;403;403;100,00%;0;0,00%;308;1;0,32%;307;99,68%
MULTIPOLYGON (((-58.486927100721104 -34.577087831330289,-58.485919931492312 -34.576510819672563,-58.484820974631013 -34.577799599118059,-58.485830364822768 -34.578373731854541,-58.486927100721104 -34.577087831330289)));;755;12_14_4;COMUNA 12;14;4;866;375;491;76,37%;602;602;100,00%;0;0,00%;407;2;0,49%;405;99,51%
MULTIPOLYGON (((-58.487932752162457 -34.577667863229586,-58.487095801015357 -34.577184491937167,-58.486927100721104 -34.577087831330289,-58.485830364822768 -34.578373731854541,-58.486835936676094 -34.578945744177354,-58.487932752162457 -34.577667863229586)));;756;12_14_5;COMUNA 12;14;5;986;468;518;90,35%;513;513;100,00%;0;0,00%;421;0;0,00%;421;100,00%
MULTIPOLYGON (((-58.485830364822768 -34.578373731854541,-58.484820974631013 -34.577799599118059,-58.484692784900481 -34.577949910277724,-58.483868394365899 -34.578921786852618,-58.484872682946616 -34.579496702966757,-58.485899710071436 -34.580036393708433,-58.486835936676094 -34.578945744177354,-58.485830364822768 -34.578373731854541)));;757;12_14_6;COMUNA 12;14;6;778;371;407;91,15%;393;393;100,00%;0;0,00%;318;0;0,00%;318;100,00%
MULTIPOLYGON (((-58.482859776544956 -34.578344327815856,-58.483868394365899 -34.578921786852618,-58.484692784900481 -34.577949910277724,-58.484820974631013 -34.577799599118059,-58.483811768625038 -34.57722552837091,-58.484911413673991 -34.575933025211469,-58.484538513433002 -34.575719421491421,-58.484292157272016 -34.575580234075758,-58.482737433463505 -34.576620120582433,-58.481553849212425 -34.577411750910727,-58.481401632627716 -34.577514877252462,-58.482859776544956 -34.578344327815856)));;758;12_14_7;COMUNA 12;14;7;1057;480;577;83,19%;569;569;100,00%;0;0,00%;432;9;2,08%;423;97,92%
MULTIPOLYGON (((-58.482859776544956 -34.578344327815856,-58.481401632627716 -34.577514877252462,-58.480106414239422 -34.578391936599921,-58.481283369590898 -34.579062495354599,-58.481932444430655 -34.579431635565939,-58.482947114360265 -34.580008608179504,-58.483032407909072 -34.579907463031859,-58.483868394365899 -34.578921786852618,-58.482859776544956 -34.578344327815856)));;759;12_14_8;COMUNA 12;14;8;971;448;523;85,66%;633;633;100,00%;0;0,00%;469;4;0,85%;465;99,15%
MULTIPOLYGON (((-58.483949790638192 -34.580578743119901,-58.483134132097369 -34.581535048778576,-58.484120905802641 -34.582108565249364,-58.484947285727543 -34.581145912842835,-58.485899710071436 -34.580036393708433,-58.484872682946616 -34.579496702966757,-58.483868394365899 -34.578921786852618,-58.483032407909072 -34.579907463031859,-58.482947114360265 -34.580008608179504,-58.483949790638192 -34.580578743119901)));;760;12_14_9;COMUNA 12;14;9;800;375;425;88,24%;420;420;100,00%;0;0,00%;324;2;0,62%;322;99,38%
MULTIPOLYGON (((-58.493381685969879 -34.57779816997283,-58.493303313417222 -34.577925237228435,-58.493065091984306 -34.578204463350012,-58.492335523471866 -34.579059185435533,-58.491663646816093 -34.579846421772203,-58.493138887537199 -34.580702225099429,-58.493453493655679 -34.580884759436522,-58.493618982016443 -34.580774431366116,-58.494329087218688 -34.580233452327818,-58.494460517793378 -34.580133273192736,-58.495285867459671 -34.579504437932876,-58.495416529689379 -34.579404962216863,-58.495545913901772 -34.579304219044914,-58.495728584477881 -34.579164586465822,-58.495774209494797 -34.57912978392762,-58.495908190108082 -34.57902734891038,-58.495804125806544 -34.578989981252455,-58.495390756605211 -34.578820296845777,-58.494989568952313 -34.578660749080818,-58.494935149574268 -34.578632874975639,-58.49489674069612 -34.578612602575518,-58.494852711060545 -34.578589444199366,-58.494798294156986 -34.578567767474368,-58.494669866364106 -34.578497234849777,-58.494368048393 -34.578340757685886,-58.494138446745978 -34.578214473724408,-58.493482260469776 -34.577845681854605,-58.493381685969879 -34.57779816997283)));;761;12_15_1;COMUNA 12;15;1;884;394;490;80,41%;508;508;100,00%;0;0,00%;378;24;6,35%;354;93,65%
MULTIPOLYGON (((-58.489825222386095 -34.582204970027185,-58.489362110268289 -34.582798969768383,-58.488993045829531 -34.583272449568184,-58.488898310859817 -34.583394587628362,-58.488211750861637 -34.584280332727261,-58.488103649614509 -34.584418670789297,-58.488793593920711 -34.58481818943666,-58.489505700086561 -34.584204981899298,-58.48983242266516 -34.583923701012402,-58.490264360493917 -34.583551828427971,-58.490437594215457 -34.583402628133157,-58.49051965654234 -34.583331902328865,-58.491042502567915 -34.582880988868254,-58.491751595999744 -34.582269388525077,-58.491939635969082 -34.582107224262288,-58.492405518894003 -34.581704912065788,-58.492543506375711 -34.581592901947111,-58.49106787248688 -34.580610748374554,-58.490665378209037 -34.581127130261329,-58.489593325039898 -34.580514669733404,-58.488743798798396 -34.58160440613004,-58.489391560972514 -34.581964140205734,-58.489825222386095 -34.582204970027185)));;762;12_15_10;COMUNA 12;15;10;848;426;422;100,95%;368;368;100,00%;0;0,00%;297;1;0,34%;296;99,66%
MULTIPOLYGON (((-58.486748057154912 -34.582169838999221,-58.485959677627953 -34.583176934643767,-58.487033103476314 -34.583798652275703,-58.488103649614509 -34.584418670789297,-58.488211750861637 -34.584280332727261,-58.488898310859817 -34.583394587628362,-58.488993045829531 -34.583272449568184,-58.489362110268289 -34.582798969768383,-58.489825222386095 -34.582204970027185,-58.489391560972514 -34.581964140205734,-58.488743798798396 -34.58160440613004,-58.487663157210299 -34.581004184555546,-58.486827898461087 -34.582067847204385,-58.486748057154912 -34.582169838999221)));;763;12_15_11;COMUNA 12;15;11;844;377;467;80,73%;323;322;99,69%;1;0,31%;272;2;0,74%;270;99,26%
MULTIPOLYGON (((-58.486779341573509 -34.580517440518818,-58.486015613383131 -34.580097289649181,-58.485899710071436 -34.580036393708433,-58.484947285727543 -34.581145912842835,-58.484120905802641 -34.582108565249364,-58.484746854545975 -34.582472342026094,-58.485095429448613 -34.5826748925397,-58.485824350784434 -34.583098506431426,-58.485959677627953 -34.583176934643767,-58.486748057154912 -34.582169838999221,-58.486827898461087 -34.582067847204385,-58.487663157210299 -34.581004184555546,-58.487542310962489 -34.580937093755175,-58.486779341573509 -34.580517440518818)));;764;12_15_12;COMUNA 12;15;12;798;377;421;89,55%;312;311;99,68%;1;0,32%;284;5;1,76%;279;98,24%
MULTIPOLYGON (((-58.4885193295232 -34.57990325651663,-58.487649737794499 -34.579408628030684,-58.486835936676094 -34.578945744177354,-58.485899710071436 -34.580036393708433,-58.486015613383131 -34.580097289649181,-58.486779341573509 -34.580517440518818,-58.487542310962489 -34.580937093755175,-58.487663157210299 -34.581004184555546,-58.487761807084965 -34.580878595755337,-58.4885193295232 -34.57990325651663)));;765;12_15_13;COMUNA 12;15;13;690;301;389;77,38%;282;281;99,65%;1;0,36%;262;1;0,38%;261;99,62%
MULTIPOLYGON (((-58.492111103833089 -34.577445439759771,-58.491997311591582 -34.577579345986869,-58.491272249871884 -34.578432652214509,-58.490596794588512 -34.579227489549432,-58.491663646816086 -34.579846421772203,-58.492335523471866 -34.579059185435533,-58.493065091984306 -34.578204463350012,-58.493303313417194 -34.577925237228435,-58.493194492947744 -34.577876944418932,-58.493087052846739 -34.577993225800263,-58.492177399172206 -34.577466883965826,-58.492111103833089 -34.577445439759771)));;766;12_15_2;COMUNA 12;15;2;844;366;478;76,57%;547;547;100,00%;0;0,00%;422;5;1,18%;417;98,82%
MULTIPOLYGON (((-58.490208566055806 -34.577804771670586,-58.489531317846549 -34.578600237425732,-58.490408327833002 -34.579118232144779,-58.490596794588512 -34.579227489549432,-58.491272249871884 -34.578432652214509,-58.491997311591582 -34.577579345986869,-58.492111246842342 -34.577439545901335,-58.489986004502022 -34.576188592829439,-58.489855411756622 -34.576325422316565,-58.489497600751321 -34.576745800804858,-58.489135530545134 -34.577171390625431,-58.490208566055806 -34.577804771670586)));;767;12_15_3;COMUNA 12;15;3;997;438;559;78,35%;569;568;99,82%;1;0,18%;420;1;0,24%;419;99,76%
MULTIPOLYGON (((-58.486798651776425 -34.573962583621153,-58.486618703079756 -34.574105371571655,-58.48636103673622 -34.574310360087047,-58.486444146306852 -34.574348725862556,-58.486610450859601 -34.574425598077362,-58.487335902468544 -34.574850331017004,-58.487547263281897 -34.574974096244866,-58.487801970063003 -34.575123205385275,-58.488335912026734 -34.575435854141915,-58.487619256893566 -34.576276249340715,-58.489135530545134 -34.577171390625431,-58.489497600751321 -34.576745800804858,-58.489855411756622 -34.576325422316565,-58.489977732323922 -34.576174917664169,-58.490953516351645 -34.576749130266485,-58.492119512267266 -34.577432705403758,-58.493087047869565 -34.577979548791475,-58.493196433537392 -34.577865120613076,-58.493303313417194 -34.577925237228435,-58.493381685969858 -34.57779816997283,-58.493398478932427 -34.577781864446877,-58.49232568540009 -34.577165694519159,-58.49124879960403 -34.576547027627626,-58.49017322509615 -34.57592889662164,-58.489081124634723 -34.575301537012074,-58.489429735131282 -34.574866863010975,-58.488322013178241 -34.574258976131318,-58.487205536378667 -34.573646291956138,-58.486798651776425 -34.573962583621153)));;768;12_15_4;COMUNA 12;15;4;974;454;520;87,31%;537;536;99,81%;1;0,19%;418;2;0,48%;416;99,52%
MULTIPOLYGON (((-58.487619256893566 -34.576276249340715,-58.486927100721104 -34.577087831330289,-58.487095801015357 -34.577184491937167,-58.487932752162457 -34.577667863229586,-58.488455979283927 -34.577970020143546,-58.488678505283183 -34.578098640349033,-58.488831455008416 -34.578186921258641,-58.489531317846563 -34.578600237425761,-58.49020856605582 -34.577804771670593,-58.489135530545134 -34.577171390625445,-58.487619256893566 -34.576276249340715)));;769;12_15_5;COMUNA 12;15;5;913;397;516;76,94%;497;496;99,80%;1;0,20%;393;3;0,76%;390;99,24%
MULTIPOLYGON (((-58.488455979283927 -34.577970020143546,-58.487932752162457 -34.577667863229586,-58.486835936676094 -34.578945744177354,-58.487649737794499 -34.579408628030684,-58.488678505283183 -34.578098640349033,-58.488455979283927 -34.577970020143546)));;770;12_15_6;COMUNA 12;15;6;829;377;452;83,41%;423;423;100,00%;0;0,00%;343;3;0,87%;340;99,13%
MULTIPOLYGON (((-58.489531317846563 -34.578600237425761,-58.488831455008416 -34.578186921258641,-58.488678505283183 -34.578098640349033,-58.487649737794499 -34.579408628030684,-58.4885193295232 -34.57990325651663,-58.489531317846563 -34.578600237425761)));;771;12_15_7;COMUNA 12;15;7;921;397;524;75,76%;483;482;99,79%;1;0,21%;383;0;0,00%;383;100,00%
MULTIPOLYGON (((-58.490596794588512 -34.579227489549446,-58.490408327833023 -34.579118232144779,-58.489531317846563 -34.578600237425761,-58.4885193295232 -34.57990325651663,-58.487761807084965 -34.580878595755337,-58.487663157210299 -34.581004184555546,-58.488743798798396 -34.58160440613004,-58.489593325039898 -34.580514669733404,-58.490596794588512 -34.579227489549446)));;772;12_15_8;COMUNA 12;15;8;938;409;529;77,32%;456;456;100,00%;0;0,00%;364;6;1,65%;358;98,35%
MULTIPOLYGON (((-58.49106787248688 -34.580610748374554,-58.492543506375711 -34.581592901947111,-58.49324552589858 -34.581023338525291,-58.493453493655679 -34.580884759436522,-58.493138887537199 -34.580702225099429,-58.491663646816093 -34.579846421772203,-58.490596794588512 -34.579227489549446,-58.489593325039898 -34.580514669733404,-58.490665378209037 -34.581127130261329,-58.49106787248688 -34.580610748374554)));;773;12_15_9;COMUNA 12;15;9;995;455;540;84,26%;553;552;99,82%;1;0,18%;426;1;0,23%;425;99,77%
MULTIPOLYGON (((-58.491774068951607 -34.57393572419614,-58.492864268691811 -34.57453330197982,-58.493954994992563 -34.575131151530826,-58.49455624325212 -34.574380400865792,-58.49515714035833 -34.573630210647558,-58.495256452016392 -34.573506235254811,-58.495857081377231 -34.57275667538844,-58.494753523702848 -34.572177931291037,-58.494098243037563 -34.57183435446651,-58.49365032197916 -34.571599458769384,-58.492979641893719 -34.572434662789959,-58.491870393443037 -34.571825540585898,-58.491267351723899 -34.572577053438266,-58.490665235305777 -34.573327365775484,-58.491614908912638 -34.573848434339865,-58.491774068951607 -34.57393572419614)));;774;12_16_1;COMUNA 12;16;1;1110;537;573;93,72%;447;447;100,00%;0;0,00%;395;9;2,28%;386;97,72%
MULTIPOLYGON (((-58.490665235305777 -34.573327365775484,-58.489558717009714 -34.572720264367852,-58.488877391099642 -34.572346452708679,-58.488062197113955 -34.572980243471818,-58.48895522212176 -34.573471131964133,-58.488322013178269 -34.574258976131333,-58.489429735131282 -34.574866863010975,-58.490062427213687 -34.574078520314501,-58.490665235305777 -34.573327365775484)));;775;12_16_10;COMUNA 12;16;10;663;306;357;85,71%;459;459;100,00%;0;0,00%;330;1;0,30%;329;99,70%
MULTIPOLYGON (((-58.490062427213672 -34.574078520314501,-58.491171181162947 -34.57468646160013,-58.492247848865382 -34.575276857077881,-58.492261727119377 -34.575284467162703,-58.493352969942897 -34.575882744446091,-58.493954994992549 -34.575131151530805,-58.492864268691825 -34.574533301979827,-58.491774068951621 -34.57393572419614,-58.491614908912616 -34.573848434339865,-58.490665235305762 -34.573327365775484,-58.490062427213672 -34.574078520314501)));;776;12_16_11;COMUNA 12;16;11;796;374;422;88,63%;384;384;100,00%;0;0,00%;334;2;0,60%;332;99,40%
MULTIPOLYGON (((-58.491633319726041 -34.576076127182382,-58.492247848865382 -34.575276857077881,-58.491171181162947 -34.57468646160013,-58.490062427213672 -34.574078520314501,-58.489429735131282 -34.574866863010975,-58.490537898993502 -34.5754749509492,-58.491628706371259 -34.576073595858553,-58.491633319726041 -34.576076127182382)));;777;12_16_12;COMUNA 12;16;12;714;311;403;77,17%;383;383;100,00%;0;0,00%;316;2;0,63%;314;99,37%
MULTIPOLYGON (((-58.49017322509615 -34.57592889662164,-58.49124879960403 -34.576547027627626,-58.49232568540009 -34.577165694519159,-58.492720380955689 -34.576672582871083,-58.493352969942897 -34.575882744446091,-58.492261727119377 -34.575284467162703,-58.492247848865382 -34.575276857077881,-58.491633319726041 -34.576076127182382,-58.491628706371259 -34.576073595858553,-58.490537898993502 -34.5754749509492,-58.489429735131282 -34.574866863010975,-58.489081124634723 -34.575301537012074,-58.49017322509615 -34.57592889662164)));;778;12_16_13;COMUNA 12;16;13;498;230;268;85,82%;252;252;100,00%;0;0,00%;202;1;0,50%;201;99,50%
MULTIPOLYGON (((-58.491191610910043 -34.57068022909629,-58.491113615280504 -34.570654119388927,-58.491028818380265 -34.57065674484349,-58.490943783896505 -34.570712119047073,-58.490581443447887 -34.570992918665972,-58.490497778350097 -34.571071743957035,-58.490411729907727 -34.571152682497846,-58.48969495734481 -34.571714909531835,-58.490161264929277 -34.57197066157115,-58.491267351723899 -34.572577053438266,-58.491870393443037 -34.571825540585898,-58.492979641893719 -34.572434662789959,-58.49365032197916 -34.571599458769384,-58.493093745240557 -34.571307543815117,-58.492525250759584 -34.571009431770591,-58.492095050617451 -34.570783822176459,-58.491392190998006 -34.570415170684377,-58.491191610910043 -34.57068022909629)));;779;12_16_2;COMUNA 12;16;2;873;399;474;84,18%;431;431;100,00%;0;0,00%;363;1;0,28%;362;99,72%
MULTIPOLYGON (((-58.489635169849286 -34.570598043684683,-58.489031606342074 -34.571350531719141,-58.488429819247116 -34.572100903537944,-58.488877391099642 -34.572346452708679,-58.489558717009714 -34.572720264367852,-58.490665235305777 -34.573327365775484,-58.491267351723899 -34.572577053438266,-58.490161264929277 -34.57197066157115,-58.48969495734481 -34.571714909531835,-58.490411729907727 -34.571152682497846,-58.490497778350097 -34.571071743957035,-58.490581443447887 -34.570992918665972,-58.490943783896505 -34.570712119047073,-58.491028818380265 -34.57065674484349,-58.491113615280504 -34.570654119388927,-58.491191610910043 -34.57068022909629,-58.491392190998006 -34.570415170684377,-58.491170792369601 -34.570299090749479,-58.490266296509738 -34.569813643566114,-58.490163576833282 -34.569939165104422,-58.489635169849286 -34.570598043684683)));;780;12_16_3;COMUNA 12;16;3;908;428;480;89,17%;399;399;100,00%;0;0,00%;359;0;0,00%;359;100,00%
MULTIPOLYGON (((-58.489166901133082 -34.569228931973115,-58.489014565108263 -34.569146003562828,-58.488066835327409 -34.568628646501722,-58.487888957255151 -34.568534524313186,-58.487784024951139 -34.568669763064676,-58.487275862068074 -34.569302288240465,-58.488547258201876 -34.570000577023301,-58.487943433639508 -34.570752566828666,-58.489031606342074 -34.571350531719141,-58.489635169849286 -34.570598043684683,-58.490163576833282 -34.569939165104422,-58.490266296509738 -34.569813643566114,-58.490119067842912 -34.569734588796223,-58.489365389701959 -34.569336921628356,-58.489166901133082 -34.569228931973115)));;781;12_16_4;COMUNA 12;16;4;1143;532;611;87,07%;616;616;100,00%;0;0,00%;521;20;3,84%;501;96,16%
MULTIPOLYGON (((-58.489031606342074 -34.571350531719141,-58.487943433639508 -34.570752566828666,-58.488547258201876 -34.570000577023301,-58.487275862068074 -34.569302288240465,-58.486672030937839 -34.570053708441051,-58.486572880749236 -34.57017711348589,-58.486069295391232 -34.570803857694486,-58.486197193240159 -34.570874329138405,-58.487341045053874 -34.571502792628017,-58.48828165105644 -34.572019593162345,-58.488429819247116 -34.572100903537944,-58.489031606342074 -34.571350531719141)));;782;12_16_5;COMUNA 12;16;5;1339;651;688;94,62%;687;687;100,00%;0;0,00%;618;31;5,02%;587;94,98%
MULTIPOLYGON (((-58.484965738569876 -34.570196572967625,-58.484143809356205 -34.570828155823953,-58.485466463957749 -34.571554285602019,-58.485960781429661 -34.570938954664165,-58.486069295391232 -34.570803857694486,-58.486572880749236 -34.57017711348589,-58.486672030937839 -34.570053708441051,-58.487275862068074 -34.569302288240465,-58.487784024951139 -34.568669763064676,-58.487888957255151 -34.568534524313186,-58.487448393578205 -34.568301435269966,-58.486727534827288 -34.568849279148942,-58.48661151899703 -34.568937404346023,-58.485958148752189 -34.569433960561518,-58.485785612507293 -34.569566604691353,-58.485663806859193 -34.569660223268194,-58.484965738569876 -34.570196572967625)));;783;12_16_6;COMUNA 12;16;6;1406;648;758;85,49%;863;863;100,00%;0;0,00%;647;1;0,15%;646;99,85%
MULTIPOLYGON (((-58.484832640970858 -34.572343379694473,-58.485466463957749 -34.571554285602019,-58.484143809356205 -34.570828155823953,-58.483919598259732 -34.571000455949452,-58.483578698879199 -34.571262023069963,-58.483578458874398 -34.571262252068109,-58.483672723819353 -34.571354474894996,-58.483652412805377 -34.571373150379074,-58.483803685892788 -34.571507562690108,-58.484282345776734 -34.571938802082116,-58.484370404822393 -34.572030279252246,-58.484394167928905 -34.572009077872146,-58.484832640970858 -34.572343379694473)),((-58.484832640970858 -34.572343379694473,-58.484782254643939 -34.572406137987706,-58.484862817705398 -34.572483380217768,-58.484995912960407 -34.572562443874048,-58.4851852232173 -34.572723613232597,-58.485456116452561 -34.572949136060942,-58.485820772758707 -34.573252179078565,-58.485889497689094 -34.573310337539787,-58.486153832699948 -34.573513957700179,-58.486261050415926 -34.573602109826965,-58.486337950352905 -34.573663224326623,-58.486436819563949 -34.573733701103436,-58.486535175720789 -34.573795867686215,-58.486679772207097 -34.573886899583314,-58.486798651776425 -34.573962583621153,-58.487205536378667 -34.573646291956138,-58.488062197113955 -34.572980243471818,-58.486903758235592 -34.572343338724778,-58.486738730727964 -34.5722528040735,-58.486104914507713 -34.57304204553013,-58.484832640970858 -34.572343379694473)));;784;12_16_7;COMUNA 12;16;7;754;335;419;79,95%;386;386;100,00%;0;0,00%;338;6;1,78%;332;98,22%
MULTIPOLYGON (((-58.487341045053874 -34.571502792628017,-58.486197193240159 -34.570874329138405,-58.486069295391232 -34.570803857694486,-58.485960781429661 -34.570938954664165,-58.485466463957749 -34.571554285602019,-58.484832640970858 -34.572343379694473,-58.486104914507713 -34.57304204553013,-58.486738730727964 -34.5722528040735,-58.487341045053874 -34.571502792628017)));;785;12_16_8;COMUNA 12;16;8;1063;488;575;84,87%;690;690;100,00%;0;0,00%;528;2;0,38%;526;99,62%
MULTIPOLYGON (((-58.488429819247116 -34.572100903537944,-58.48828165105644 -34.572019593162345,-58.487341045053874 -34.571502792628017,-58.486738730727964 -34.5722528040735,-58.486903758235592 -34.572343338724778,-58.488062197113955 -34.572980243471818,-58.488877391099642 -34.572346452708679,-58.488429819247116 -34.572100903537944)));;786;12_16_9;COMUNA 12;16;9;838;382;456;83,77%;427;427;100,00%;0;0,00%;362;23;6,35%;339;93,65%
MULTIPOLYGON (((-58.498679438706482 -34.566316301682335,-58.498065434942873 -34.5670783454134,-58.497487073321743 -34.567796148534356,-58.498028746366366 -34.568095442630018,-58.498586517843172 -34.568403673625355,-58.498724556282937 -34.568479974312666,-58.499140461531148 -34.568710142558132,-58.49923235922995 -34.568596800311923,-58.499715413048222 -34.56799958658479,-58.500308308073279 -34.567266415677103,-58.500408541070044 -34.567142576535666,-58.50133819236067 -34.565994277859403,-58.501437997127923 -34.565871494367833,-58.500862538262979 -34.565593705672725,-58.500235311162243 -34.565290858654478,-58.499712825144677 -34.565041007188448,-58.498679438706482 -34.566316301682335)));;787;12_17_1;COMUNA 12;17;1;1010;470;540;87,04%;421;421;100,00%;0;0,00%;355;1;0,28%;354;99,72%
MULTIPOLYGON (((-58.495837297825375 -34.56688438460737,-58.494644992540515 -34.566225377797892,-58.493820864236717 -34.567279862147572,-58.495011806162594 -34.567913664885111,-58.496129107655719 -34.568508249064585,-58.496677928999745 -34.568800363751237,-58.497221985446693 -34.569089871556116,-58.498347323138383 -34.5696887289958,-58.499140461531148 -34.568710142558132,-58.498724556282937 -34.568479974312666,-58.498586517843172 -34.568403673625355,-58.498028746366366 -34.568095442630018,-58.497487073321743 -34.567796148534356,-58.496943190095976 -34.567495514552697,-58.495837297825375 -34.56688438460737)));;788;12_17_2;COMUNA 12;17;2;1052;491;561;87,52%;426;425;99,77%;1;0,24%;380;10;2,63%;370;97,37%
MULTIPOLYGON (((-58.493820864236717 -34.567279862147572,-58.493684627919926 -34.567454200185097,-58.493420833354229 -34.567791887211733,-58.493020031754689 -34.568305037924375,-58.493767759152483 -34.568704656024678,-58.494196335898557 -34.568931316605237,-58.494346802597306 -34.569011422011783,-58.494752647343446 -34.569228719914889,-58.4948962177684 -34.569305586873618,-58.495308962473665 -34.569525416416809,-58.495757730083128 -34.569764460989504,-58.49586928371572 -34.569823869918842,-58.4964064461955 -34.570109228072717,-58.49752514908387 -34.570703517159082,-58.498235256005714 -34.569826866233313,-58.498347323138383 -34.5696887289958,-58.497221985446693 -34.569089871556116,-58.496677928999745 -34.568800363751237,-58.496129107655719 -34.568508249064585,-58.495011806162594 -34.567913664885111,-58.493820864236717 -34.567279862147572)));;789;12_17_3;COMUNA 12;17;3;917;444;473;93,87%;389;389;100,00%;0;0,00%;333;2;0,60%;331;99,40%
MULTIPOLYGON (((-58.492685799113922 -34.566675753618568,-58.491617061045858 -34.566047110660648,-58.490356326767369 -34.565305609634734,-58.489290060217279 -34.564842727551493,-58.489164108926445 -34.564983817473816,-58.488368222386363 -34.565873040597424,-58.489576072664391 -34.566329490831848,-58.49082753629871 -34.567072480863409,-58.491893473540721 -34.567705286406373,-58.493020031754689 -34.568305037924375,-58.493420833354229 -34.567791887211733,-58.493684627919926 -34.567454200185097,-58.493820864236717 -34.567279862147572,-58.492685799113922 -34.566675753618568)));;790;12_17_4;COMUNA 12;17;4;796;356;440;80,91%;368;368;100,00%;0;0,00%;306;6;1,96%;300;98,04%
MULTIPOLYGON (((-58.491893473540721 -34.567705286406373,-58.49082753629871 -34.567072480863409,-58.489576072664391 -34.566329490831848,-58.488368222386363 -34.565873040597424,-58.488256990994209 -34.565997435591427,-58.487512063662223 -34.566829245433588,-58.4874055120195 -34.566953286553527,-58.488085673268309 -34.56730302145364,-58.48862662177671 -34.56758108892052,-58.48877307785267 -34.567656413127473,-58.489920980021694 -34.568249709540105,-58.491035519110731 -34.568825678149814,-58.49116205420345 -34.568891074088135,-58.492151696483518 -34.569416707205349,-58.493020031754689 -34.568305037924375,-58.491893473540721 -34.567705286406373)));;791;12_17_5;COMUNA 12;17;5;1133;537;596;90,10%;514;512;99,61%;2;0,39%;437;8;1,83%;429;98,17%
MULTIPOLYGON (((-58.4964064461955 -34.570109228072717,-58.49586928371572 -34.569823869918842,-58.495757730083128 -34.569764460989504,-58.495308962473665 -34.569525416416809,-58.4948962177684 -34.569305586873618,-58.494752647343446 -34.569228719914889,-58.494346802597306 -34.569011422011783,-58.494196335898557 -34.568931316605237,-58.493767759152483 -34.568704656024678,-58.493020031754689 -34.568305037924375,-58.492151696483518 -34.569416707205349,-58.492882653479946 -34.569804925753601,-58.492995908155379 -34.569865111569733,-58.493313192286763 -34.570033349547259,-58.493873509340681 -34.57033054452711,-58.494431616329912 -34.570626540259227,-58.494877150999677 -34.570862771842663,-58.495039628723234 -34.570948929800771,-58.495532428651643 -34.571209936246525,-58.495624079107223 -34.571097934913006,-58.496323480662525 -34.570218058468349,-58.4964064461955 -34.570109228072717)));;792;12_17_6;COMUNA 12;17;6;1006;479;527;90,89%;477;477;100,00%;0;0,00%;414;1;0,24%;413;99,76%
MULTIPOLYGON (((-58.493313192286763 -34.570033349547259,-58.492995908155379 -34.569865111569733,-58.492882653479946 -34.569804925753601,-58.492095050617451 -34.570783822176459,-58.492525250759584 -34.571009431770591,-58.493093745240557 -34.571307543815117,-58.49365032197916 -34.571599458769384,-58.494098243037563 -34.57183435446651,-58.494753523702848 -34.572177931291037,-58.495857081377231 -34.57275667538844,-58.49597920102336 -34.572613748720656,-58.496640409437674 -34.571796700680018,-58.497407803451701 -34.570848415975163,-58.49752514908387 -34.570703517159082,-58.4964064461955 -34.570109228072717,-58.496323480662525 -34.570218058468349,-58.495624079107223 -34.571097934913006,-58.495532428651643 -34.571209936246525,-58.495039628723234 -34.570948929800771,-58.494877150999677 -34.570862771842663,-58.494431616329912 -34.570626540259227,-58.493873509340681 -34.57033054452711,-58.493313192286763 -34.570033349547259)));;793;12_17_7;COMUNA 12;17;7;992;469;523;89,67%;431;431;100,00%;0;0,00%;373;4;1,07%;369;98,93%
MULTIPOLYGON (((-58.492882653479946 -34.569804925753601,-58.492151696483518 -34.569416707205349,-58.49116205420345 -34.568891074088135,-58.491035519110731 -34.568825678149814,-58.489920980021694 -34.568249709540105,-58.48877307785267 -34.567656413127473,-58.48862662177671 -34.56758108892052,-58.488085673268309 -34.56730302145364,-58.4874055120195 -34.566953286553527,-58.487311044995806 -34.567063099168251,-58.486613254069319 -34.567860807879789,-58.486780315040484 -34.567947961937747,-58.487353111577256 -34.568251029820168,-58.487448393578205 -34.568301435269966,-58.487888957255151 -34.568534524313186,-58.488066835327409 -34.568628646501722,-58.489014565108263 -34.569146003562828,-58.489166901133082 -34.569228931973115,-58.489365389701959 -34.569336921628356,-58.490119067842912 -34.569734588796223,-58.490266296509738 -34.569813643566114,-58.491170792369601 -34.570299090749479,-58.491392190998006 -34.570415170684377,-58.492095050617451 -34.570783822176459,-58.492882653479946 -34.569804925753601)));;794;12_17_8;COMUNA 12;17;8;1252;590;662;89,12%;701;701;100,00%;0;0,00%;557;5;0,90%;552;99,10%
MULTIPOLYGON (((-58.506263065249314 -34.568241098157586,-58.505208649025789 -34.567722785348799,-58.504212243454042 -34.568959379143372,-58.505274240152112 -34.569465584606405,-58.506338378671217 -34.569972765975649,-58.507880278367246 -34.570707659264208,-58.507980455539588 -34.570650999989937,-58.509040630948547 -34.569997300875663,-58.508817518507577 -34.569509186412311,-58.508600498345118 -34.569389434197696,-58.507316898408618 -34.568759049894695,-58.506263065249314 -34.568241098157586)));;795;12_18_1;COMUNA 12;18;1;631;289;342;84,50%;294;294;100,00%;0;0,00%;231;2;0,87%;229;99,13%
MULTIPOLYGON (((-58.500150849675563 -34.575712742316142,-58.500692426368367 -34.575292064208256,-58.499582670049897 -34.574710196812909,-58.498493538171665 -34.574139158752722,-58.497727433209178 -34.573737462486712,-58.496961676235891 -34.573335902137025,-58.496345222465159 -34.574100894919731,-58.496244464869882 -34.574226280093896,-58.495642466173166 -34.574975912483005,-58.497045168678319 -34.575744995045355,-58.497155027648702 -34.575802713003242,-58.497281748857041 -34.57586922927424,-58.498845869263647 -34.57672860109836,-58.499656931912064 -34.576096782309889,-58.499826735180115 -34.57596454210212,-58.500150849675563 -34.575712742316142)));;796;12_18_10;COMUNA 12;18;10;747;361;386;93,52%;360;360;100,00%;0;0,00%;284;3;1,06%;281;98,94%
MULTIPOLYGON (((-58.496961676235891 -34.573335902137025,-58.495857081377231 -34.57275667538844,-58.495256452016392 -34.573506235254811,-58.49515714035833 -34.573630210647558,-58.49455624325212 -34.574380400865792,-58.493954994992563 -34.575131151530826,-58.493352969942897 -34.575882744446098,-58.493508303427149 -34.575967920206018,-58.494437329945221 -34.576476365617133,-58.495040286439476 -34.575725682713227,-58.495642466173166 -34.574975912483005,-58.496244464869882 -34.574226280093896,-58.496345222465159 -34.574100894919731,-58.496961676235891 -34.573335902137025)));;797;12_18_11;COMUNA 12;18;11;708;316;392;80,61%;285;284;99,65%;1;0,35%;238;10;4,20%;228;95,80%
MULTIPOLYGON (((-58.498034964542342 -34.577360203113855,-58.498845869263647 -34.57672860109836,-58.497281748857041 -34.57586922927424,-58.497155027648702 -34.575802713003242,-58.497045168678319 -34.575744995045355,-58.495642466173166 -34.574975912483005,-58.495040286439476 -34.575725682713227,-58.494437329945221 -34.576476365617133,-58.494343119697312 -34.576593718964816,-58.493806535664895 -34.57726860359287,-58.495312649246145 -34.578094935290643,-58.496361794004663 -34.578670590044347,-58.497023594268612 -34.578150243132683,-58.497218089995812 -34.577998210088168,-58.497860048570615 -34.577496456526468,-58.498034964542342 -34.577360203113855)));;798;12_18_12;COMUNA 12;18;12;1163;534;629;84,90%;541;540;99,82%;1;0,19%;436;5;1,15%;431;98,85%
MULTIPOLYGON (((-58.493806535664895 -34.57726860359287,-58.494343119697312 -34.576593718964816,-58.494437329945221 -34.576476365617133,-58.493508303427149 -34.575967920206018,-58.493352969942897 -34.575882744446098,-58.492720380955703 -34.576672582871076,-58.49232568540009 -34.577165694519159,-58.493398478932427 -34.577781864446877,-58.493381685969879 -34.57779816997283,-58.493482260469776 -34.577845681854605,-58.494138446745978 -34.578214473724408,-58.494368048393 -34.578340757685886,-58.494669866364106 -34.578497234849777,-58.494798294156986 -34.578567767474368,-58.494852711060545 -34.578589444199366,-58.49489674069612 -34.578612602575518,-58.494935149574268 -34.578632874975639,-58.494989568952313 -34.578660749080818,-58.495390756605211 -34.578820296845777,-58.495804125806544 -34.578989981252455,-58.495908190108082 -34.57902734891038,-58.496361794004663 -34.578670590044347,-58.495312649246145 -34.578094935290643,-58.493806535664895 -34.57726860359287)));;799;12_18_13;COMUNA 12;18;13;756;327;429;76,22%;347;347;100,00%;0;0,00%;306;3;0,98%;303;99,02%
MULTIPOLYGON (((-58.50199847306699 -34.566142453875209,-58.50187738529263 -34.566083616975909,-58.501437997127923 -34.565871494367833,-58.50133819236067 -34.565994277859403,-58.500408541070044 -34.567142576535666,-58.500549980523402 -34.567210141348596,-58.500999421061493 -34.567425855657206,-58.501518520073056 -34.567674927907838,-58.501672479179796 -34.567748825736125,-58.502317780948651 -34.568056377890279,-58.502944438409436 -34.56835505913903,-58.503095334178269 -34.568426984256902,-58.503656512038631 -34.568694484943819,-58.504212243454042 -34.568959379143372,-58.505208649025789 -34.567722785348799,-58.505072143037218 -34.567655717207806,-58.504657517079487 -34.56745211914928,-58.504241275194438 -34.567247745543114,-58.504101362469648 -34.567174832144524,-58.503957362514456 -34.567099877623363,-58.50333215437464 -34.566793454210938,-58.502712145212584 -34.566489561197685,-58.502560571362409 -34.566415875162889,-58.50199847306699 -34.566142453875209)));;800;12_18_2;COMUNA 12;18;2;924;440;484;90,91%;355;355;100,00%;0;0,00%;323;5;1,55%;318;98,45%
MULTIPOLYGON (((-58.507880278367246 -34.570707659264208,-58.506338378671217 -34.569972765975649,-58.505274240152112 -34.569465584606405,-58.504212243454042 -34.568959379143372,-58.503656512038631 -34.568694484943819,-58.503095334178269 -34.568426984256902,-58.502944438409436 -34.56835505913903,-58.502317780948651 -34.568056377890279,-58.501672479179796 -34.567748825736125,-58.501518520073056 -34.567674927907838,-58.500786776499055 -34.568596184377476,-58.500842724445199 -34.568625604806613,-58.501575825085951 -34.568974684469367,-58.50235798188109 -34.569347195499503,-58.503331238211643 -34.56981069830816,-58.503472854201917 -34.569876991983335,-58.503603144563819 -34.569938077796252,-58.504534943201328 -34.570383133342844,-58.505598067596871 -34.570890955264211,-58.506675086106007 -34.571405453302745,-58.506789649340213 -34.571341043016581,-58.506874164901348 -34.57128903839822,-58.507121838247961 -34.571136547605249,-58.507635920502956 -34.570846065272278,-58.507880278367246 -34.570707659264208)));;801;12_18_3;COMUNA 12;18;3;864;379;485;78,14%;363;363;100,00%;0;0,00%;318;7;2,20%;311;97,80%
MULTIPOLYGON (((-58.504534943201328 -34.570383133342844,-58.503603144563819 -34.569938077796252,-58.503472854201917 -34.569876991983335,-58.503331238211643 -34.56981069830816,-58.50235798188109 -34.569347195499503,-58.501575825085951 -34.568974684469367,-58.500842724445199 -34.568625604806613,-58.500786776499055 -34.568596184377476,-58.50068118286152 -34.568729110369695,-58.500220940222427 -34.569308010184763,-58.50097118712727 -34.569723147361252,-58.501561256028765 -34.57004966519446,-58.501721356448058 -34.570138491197383,-58.502784244403813 -34.570727960961953,-58.503802352007938 -34.571292576272711,-58.504819451448768 -34.571856690403521,-58.50533988668861 -34.572145324907126,-58.505546034876041 -34.57202728992398,-58.506485962689382 -34.571511652604158,-58.506675086106007 -34.571405453302745,-58.505598067596871 -34.570890955264211,-58.504534943201328 -34.570383133342844)));;802;12_18_4;COMUNA 12;18;4;817;383;434;88,25%;347;347;100,00%;0;0,00%;308;2;0,65%;306;99,35%
MULTIPOLYGON (((-58.50097118712727 -34.569723147361252,-58.500220940222427 -34.569308010184763,-58.500122832589831 -34.569431425924137,-58.499441594326647 -34.570271035341975,-58.500201632122561 -34.570675469547126,-58.500962869509202 -34.571080532444782,-58.502036142425389 -34.571651553878176,-58.50307008528992 -34.572201732866809,-58.503246285291596 -34.572295481299207,-58.504195934819649 -34.572805183970694,-58.505127098932924 -34.572267164827636,-58.50533988668861 -34.572145324907126,-58.504819451448768 -34.571856690403521,-58.503802352007938 -34.571292576272711,-58.502784244403813 -34.570727960961953,-58.501721356448058 -34.570138491197383,-58.501561256028765 -34.57004966519446,-58.50097118712727 -34.569723147361252)));;803;12_18_5;COMUNA 12;18;5;913;405;508;79,72%;345;342;99,13%;3;0,88%;301;10;3,32%;291;96,68%
MULTIPOLYGON (((-58.49752514908387 -34.570703517159082,-58.497407803451701 -34.570848415975163,-58.496640409437674 -34.571796700680018,-58.496789350641016 -34.571875606225611,-58.497736057961504 -34.572377472363847,-58.498621724934658 -34.57128195669199,-58.498714221650239 -34.571167487897171,-58.499441594326647 -34.570271035341975,-58.500122832589831 -34.569431425924137,-58.500220940222427 -34.569308010184763,-58.50068118286152 -34.568729110369695,-58.500786776499055 -34.568596184377476,-58.501518520073056 -34.567674927907838,-58.500999421061493 -34.567425855657206,-58.500549980523402 -34.567210141348596,-58.500408541070044 -34.567142576535666,-58.500308308073279 -34.567266415677103,-58.499715413048222 -34.56799958658479,-58.49923235922995 -34.568596800311923,-58.499140461531148 -34.568710142558132,-58.498347323138383 -34.5696887289958,-58.498235256005714 -34.569826866233313,-58.49752514908387 -34.570703517159082)));;804;12_18_6;COMUNA 12;18;6;889;420;469;89,55%;358;358;100,00%;0;0,00%;312;11;3,53%;301;96,47%
MULTIPOLYGON (((-58.502036142425389 -34.571651553878176,-58.500962869509202 -34.571080532444782,-58.500201632122561 -34.570675469547126,-58.499441594326647 -34.570271035341975,-58.498714221650239 -34.571167487897171,-58.498621724934658 -34.57128195669199,-58.499247385326683 -34.571611714722842,-58.499386619923925 -34.57168414085556,-58.500155608134115 -34.572084417451336,-58.500307022192224 -34.572163247515483,-58.501232972420915 -34.572649458423086,-58.502270580852127 -34.573194220167501,-58.502946770911556 -34.573549225499612,-58.502994605223215 -34.573517940780789,-58.503948161412936 -34.572948302226095,-58.504195934819649 -34.572805183970694,-58.503246285291596 -34.572295481299207,-58.50307008528992 -34.572201732866809,-58.502036142425389 -34.571651553878176)));;805;12_18_7;COMUNA 12;18;7;894;429;465;92,26%;373;373;100,00%;0;0,00%;336;3;0,89%;333;99,11%
MULTIPOLYGON (((-58.501232972420915 -34.572649458423086,-58.500307022192224 -34.572163247515483,-58.500155608134115 -34.572084417451336,-58.499386619923925 -34.57168414085556,-58.499247385326683 -34.571611714722842,-58.498621724934658 -34.57128195669199,-58.497736057961504 -34.572377472363847,-58.498365215452758 -34.572711036831208,-58.498499257035697 -34.572782268245611,-58.49926978762835 -34.573191634790149,-58.499431422845781 -34.573277434991482,-58.500345712592072 -34.573756190939989,-58.501735562055629 -34.574483883928757,-58.502283507429546 -34.574061083879513,-58.502946770911556 -34.573549225499612,-58.502270580852127 -34.573194220167501,-58.501232972420915 -34.572649458423086)));;806;12_18_8;COMUNA 12;18;8;980;444;536;82,84%;382;380;99,48%;2;0,53%;328;9;2,74%;319;97,26%
MULTIPOLYGON (((-58.497736057961504 -34.572377472363847,-58.496789350641016 -34.571875606225611,-58.496640409437674 -34.571796700680018,-58.49597920102336 -34.572613748720656,-58.495857081377231 -34.57275667538844,-58.496961676235891 -34.573335902137025,-58.497727433209178 -34.573737462486712,-58.498493538171665 -34.574139158752722,-58.499582670049897 -34.574710196812909,-58.500692426368367 -34.575292064208256,-58.501328727340223 -34.574797829486307,-58.501475715914999 -34.574684468216226,-58.501735562055629 -34.574483883928757,-58.500345712592072 -34.573756190939989,-58.499431422845781 -34.573277434991482,-58.49926978762835 -34.573191634790149,-58.498499257035697 -34.572782268245611,-58.498365215452758 -34.572711036831208,-58.497736057961504 -34.572377472363847)));;807;12_18_9;COMUNA 12;18;9;794;372;422;88,15%;291;291;100,00%;0;0,00%;290;2;0,69%;288;99,31%
MULTIPOLYGON (((-58.509533830275018 -34.573430039942778,-58.509556418599324 -34.573476230424319,-58.509588382528271 -34.573540305385634,-58.509681889777305 -34.573730981771405,-58.509704732857173 -34.573775693188949,-58.509733543524533 -34.57383399442984,-58.509755193804835 -34.573877156935104,-58.509847763225167 -34.574064241842599,-58.509967950553595 -34.574306952146536,-58.509990122857239 -34.574369410997953,-58.509996456875975 -34.574428565983091,-58.510000153967724 -34.574492088371564,-58.510096443604759 -34.574331058275774,-58.510205138122174 -34.57442461154217,-58.510833920672937 -34.573846805474012,-58.510841950164497 -34.57386410921773,-58.511397373690734 -34.573410744127102,-58.511665767264461 -34.573191664884661,-58.509859361197989 -34.569340360677103,-58.509627693196244 -34.569600000008691,-58.509522103735272 -34.569668479954224,-58.509365830973032 -34.569806446872192,-58.509221635170938 -34.569915827208412,-58.509168094227221 -34.569943714833755,-58.509040630948547 -34.569997300875663,-58.507980455539588 -34.570650999989937,-58.507880278367246 -34.570707659264208,-58.507635920502956 -34.570846065272278,-58.507121838247961 -34.571136547605249,-58.506874164901348 -34.57128903839822,-58.50920373682105 -34.572663443305473,-58.509360843707817 -34.573009172758368,-58.509489246729714 -34.573332376823586,-58.509511155255687 -34.573381032468568,-58.509533830275018 -34.573430039942778)));;808;12_19_1;COMUNA 12;19;1;913;403;510;79,02%;404;404;100,00%;0;0,00%;352;2;0,57%;350;99,43%
MULTIPOLYGON (((-58.504555313655025 -34.579771340750227,-58.50569120303895 -34.580471538401781,-58.506075171815169 -34.580046948324458,-58.506883348799235 -34.579153522707735,-58.505867135934785 -34.578526888353203,-58.505749340917141 -34.578453969161998,-58.50630936591746 -34.577835998037678,-58.50640450364272 -34.577730677909095,-58.505403728396018 -34.57711473868823,-58.505265579877843 -34.577029501670083,-58.504136724580817 -34.576333029806833,-58.503484616750399 -34.57705299803731,-58.504487425120224 -34.57767796677156,-58.504611945183321 -34.577752363816906,-58.503803672452044 -34.578646126762926,-58.50314516165507 -34.579374334850392,-58.50411221955828 -34.579971641055337,-58.504279927250437 -34.580075250314984,-58.504555313655025 -34.579771340750227)));;809;12_19_10;COMUNA 12;19;10;1080;507;573;88,48%;392;391;99,74%;1;0,26%;360;3;0,83%;357;99,17%
MULTIPOLYGON (((-58.508663590826878 -34.579132582753495,-58.50753569844759 -34.57843226882477,-58.506883348799235 -34.579153522707735,-58.506075171815169 -34.580046948324458,-58.50569120303895 -34.580471538401781,-58.506741550774507 -34.580552787016209,-58.506909209979575 -34.580556458952138,-58.507207411748297 -34.580738611644648,-58.507067422380594 -34.580889373075124,-58.506965704786893 -34.581004715077761,-58.506898587717473 -34.58107923091373,-58.50787145806985 -34.581159441443361,-58.508766075799812 -34.581235236973384,-58.509460839281019 -34.581291946955986,-58.510465223638533 -34.581378885570665,-58.510734645963026 -34.581396315769517,-58.512478825998613 -34.581508931403036,-58.51249494375174 -34.581121725747572,-58.511820377221639 -34.581094392318775,-58.511028217678557 -34.581062312850236,-58.51129473262575 -34.580767546958242,-58.511954289526393 -34.580038167863592,-58.511810422640664 -34.579949630609789,-58.510605153934556 -34.579205149070759,-58.509948229041015 -34.579930364855919,-58.509811689232819 -34.579845484530949,-58.508663590826878 -34.579132582753495)));;810;12_19_11;COMUNA 12;19;11;1082;509;573;88,83%;370;370;100,00%;0;0,00%;372;4;1,08%;368;98,92%
MULTIPOLYGON (((-58.50046317774423 -34.580394622058719,-58.500462997776133 -34.580394826664389,-58.500463284533645 -34.580394893571246,-58.500564162343593 -34.580413201735631,-58.500408480550767 -34.580585402150007,-58.501162095793042 -34.580696791337438,-58.501719002206471 -34.580953244916401,-58.501825807882682 -34.580833487458904,-58.502212495259037 -34.581070555803244,-58.502428318786585 -34.580830475810153,-58.503568799943288 -34.580936947881241,-58.503624778329566 -34.580916904433387,-58.503661095606098 -34.580918143793845,-58.503708006473325 -34.580921882671007,-58.503786695043608 -34.58092686238011,-58.503827552526744 -34.580929351705755,-58.503854799898086 -34.580949367212135,-58.504184672187947 -34.580983418959015,-58.504312067370918 -34.580837594911159,-58.50518087474854 -34.580906312553125,-58.505199598015651 -34.580887713716315,-58.505302376627355 -34.580895635960644,-58.505259039564976 -34.580945165572608,-58.505738821641323 -34.580986899780093,-58.505636343487431 -34.580921576349219,-58.505826658676995 -34.580936298595049,-58.506522099918598 -34.580994996983655,-58.506830439112107 -34.581023549044453,-58.506965704786893 -34.581004715077761,-58.507067422380594 -34.580889373075124,-58.507207411748297 -34.580738611644648,-58.506909209979575 -34.580556458952138,-58.506741550774507 -34.580552787016209,-58.50569120303895 -34.580471538401781,-58.504555313655025 -34.579771340750227,-58.504279927250437 -34.580075250314984,-58.50411221955828 -34.579971641055337,-58.50314516165507 -34.579374334850392,-58.502014588478694 -34.578675942714916,-58.501885383750484 -34.578596121773039,-58.500880881690172 -34.577972892918758,-58.500223968000917 -34.578700028451848,-58.4995613407728 -34.579433429958939,-58.499088575635518 -34.579956762602656,-58.499087505608074 -34.579956505738444,-58.498948225355278 -34.580121916769727,-58.498972763957127 -34.580128283073392,-58.499037483540256 -34.580144602529252,-58.499699135759364 -34.580262225544395,-58.500359937308723 -34.580377521192197,-58.50046317774423 -34.580394622058719)));;811;12_19_12;COMUNA 12;19;12;833;388;445;87,19%;392;392;100,00%;0;0,00%;333;35;10,51%;298;89,49%
MULTIPOLYGON (((-58.500223968000917 -34.578700028451848,-58.499085082388639 -34.577997738245699,-58.498034964542342 -34.577360203113855,-58.497860048570615 -34.577496456526468,-58.497218089995812 -34.577998210088168,-58.497023594268612 -34.578150243132683,-58.496361794004663 -34.578670590044347,-58.495908190108082 -34.57902734891038,-58.495774209494797 -34.57912978392762,-58.495870272096418 -34.579172083568032,-58.496473879671733 -34.57938333530025,-58.496787944124634 -34.57948480151763,-58.497194660955287 -34.579613354579863,-58.497433701826566 -34.579690050547185,-58.497409363154155 -34.579722594036035,-58.497504652628947 -34.579744962198809,-58.49759117200837 -34.579767473645383,-58.498253865091549 -34.579941726278911,-58.498518874593486 -34.580010524897183,-58.498948225355278 -34.580121916769727,-58.499087505608074 -34.579956505738444,-58.499088575635518 -34.579956762602656,-58.4995613407728 -34.579433429958939,-58.500223968000917 -34.578700028451848)));;812;12_19_13;COMUNA 12;19;13;713;306;407;75,18%;322;321;99,69%;1;0,31%;286;3;1,05%;283;98,95%
MULTIPOLYGON (((-58.508083542228761 -34.573912227987314,-58.507475479695394 -34.574583255682228,-58.507378390397847 -34.574691887411753,-58.508534998001998 -34.575371628216168,-58.508893907900834 -34.575582558171469,-58.509027371356545 -34.575661525010737,-58.509669955970622 -34.57491716346339,-58.509750108026502 -34.574824241336664,-58.509826854443517 -34.574731743023996,-58.509899856774226 -34.574643401215255,-58.509935760769949 -34.574597258610588,-58.509968766181018 -34.574544567544045,-58.510000153967724 -34.574492088371564,-58.509996456875975 -34.574428565983091,-58.509990122857239 -34.574369410997953,-58.509967950553595 -34.574306952146536,-58.509847763225167 -34.574064241842599,-58.509755193804835 -34.573877156935104,-58.509733543524533 -34.57383399442984,-58.509704732857173 -34.573775693188949,-58.509681889777305 -34.573730981771405,-58.509588382528271 -34.573540305385634,-58.509556418599324 -34.573476230424319,-58.509533830275018 -34.573430039942778,-58.509511155255687 -34.573381032468568,-58.509489246729714 -34.573332376823586,-58.509360843707817 -34.573009172758368,-58.50920373682105 -34.572663443305473,-58.508083542228761 -34.573912227987314)));;813;12_19_2;COMUNA 12;19;2;593;267;326;81,90%;233;233;100,00%;0;0,00%;225;0;0,00%;225;100,00%
MULTIPOLYGON (((-58.510833920672937 -34.573846805474012,-58.510205138122174 -34.57442461154217,-58.510096443604759 -34.574331058275774,-58.510000153967724 -34.574492088371564,-58.509968766181018 -34.574544567544045,-58.509935760769949 -34.574597258610588,-58.509899856774226 -34.574643401215255,-58.509826854443517 -34.574731743023996,-58.509750108026502 -34.574824241336664,-58.509669955970622 -34.57491716346339,-58.509027371356545 -34.575661525010737,-58.509088609665113 -34.575697841315211,-58.509685153260342 -34.576050937908256,-58.510239796849355 -34.576379258113647,-58.510705694038059 -34.57665507329488,-58.510833029134652 -34.576731646087723,-58.512015766198452 -34.577442964394848,-58.512135863927014 -34.577515454063324,-58.51271565766119 -34.577865162088422,-58.512783287819865 -34.577905981136169,-58.512784651530282 -34.577908916837302,-58.513415663384272 -34.577703178754099,-58.513733457814389 -34.577599561937085,-58.511665767264461 -34.573191664884661,-58.511397373690734 -34.573410744127102,-58.510841950164497 -34.57386410921773,-58.510833920672937 -34.573846805474012)));;814;12_19_3;COMUNA 12;19;3;764;349;415;84,10%;278;278;100,00%;0;0,00%;283;0;0,00%;283;100,00%
MULTIPOLYGON (((-58.512479490908433 -34.581509297044065,-58.51247824908107 -34.581507245390711,-58.512478825998613 -34.581508931403036,-58.512479490908433 -34.581509297044065)),((-58.511954289526393 -34.580038167863592,-58.51129473262575 -34.580767546958242,-58.511028217678557 -34.581062312850236,-58.511820377221639 -34.581094392318775,-58.51249494375174 -34.581121725747572,-58.512478879393093 -34.58150764868374,-58.512479490908433 -34.581509297044065,-58.512561429589532 -34.581607767268089,-58.512738984811229 -34.581643481125617,-58.51371051350371 -34.581632629240389,-58.51375177427709 -34.581590451229182,-58.514696763671182 -34.581558978997769,-58.514969678324327 -34.581314504385219,-58.515028924732583 -34.58130994913757,-58.515104145709721 -34.58130253802193,-58.51510512303409 -34.581304644615471,-58.515456641906539 -34.581272669581701,-58.51462103739653 -34.579491546972157,-58.514597855962222 -34.579442134075755,-58.513733457814389 -34.577599561937085,-58.513415663384272 -34.577703178754099,-58.512784651530282 -34.577908916837302,-58.512783287819865 -34.577905981136169,-58.51271565766119 -34.577865162088422,-58.512135863927014 -34.577515454063324,-58.51130529406722 -34.578432375271113,-58.510605153934556 -34.579205149070759,-58.511810422640664 -34.579949630609789,-58.511954289526393 -34.580038167863592)));;815;12_19_4;COMUNA 12;19;4;1082;488;594;82,15%;418;417;99,76%;1;0,24%;367;5;1,36%;362;98,64%
MULTIPOLYGON (((-58.508663590826878 -34.579132582753495,-58.509811689232819 -34.579845484530949,-58.509948229041015 -34.579930364855919,-58.510605153934556 -34.579205149070759,-58.51130529406722 -34.578432375271113,-58.512135863927014 -34.577515454063324,-58.512015766198452 -34.577442964394848,-58.510833029134652 -34.576731646087723,-58.510705694038059 -34.57665507329488,-58.510239796849355 -34.576379258113647,-58.509685153260342 -34.576050937908256,-58.509088609665113 -34.575697841315211,-58.508278472023086 -34.576638538257804,-58.508850744952923 -34.576977703685849,-58.508295086514984 -34.57759491023608,-58.508188122588869 -34.577712138154538,-58.508060905828586 -34.57785169838386,-58.50753569844759 -34.57843226882477,-58.508663590826878 -34.579132582753495)));;816;12_19_5;COMUNA 12;19;5;1089;502;587;85,52%;459;459;100,00%;0;0,00%;406;9;2,22%;397;97,78%
MULTIPOLYGON (((-58.509027371356545 -34.575661525010737,-58.508893907900834 -34.575582558171469,-58.508534998001998 -34.575371628216168,-58.507378390397847 -34.574691887411753,-58.507288618707605 -34.574792276603581,-58.506545670387965 -34.575613848090697,-58.505916990824865 -34.576309172047132,-58.505265579877843 -34.577029501670083,-58.505403728396018 -34.57711473868823,-58.50640450364272 -34.577730677909095,-58.50630936591746 -34.577835998037678,-58.505749340917141 -34.578453969161998,-58.505867135934785 -34.578526888353203,-58.506883348799235 -34.579153522707735,-58.50753569844759 -34.57843226882477,-58.508060905828586 -34.57785169838386,-58.508188122588869 -34.577712138154538,-58.508295086514984 -34.57759491023608,-58.508850744952923 -34.576977703685849,-58.508278472023086 -34.576638538257804,-58.509088609665113 -34.575697841315211,-58.509027371356545 -34.575661525010737)));;817;12_19_6;COMUNA 12;19;6;1078;497;581;85,54%;399;398;99,75%;1;0,25%;356;2;0,56%;354;99,44%
MULTIPOLYGON (((-58.505916990824865 -34.576309172047132,-58.506545670387965 -34.575613848090697,-58.507288618707605 -34.574792276603581,-58.507378390397847 -34.574691887411753,-58.507475479695394 -34.574583255682228,-58.508083542228761 -34.573912227987314,-58.50920373682105 -34.572663443305473,-58.506874164901348 -34.57128903839822,-58.506789649340213 -34.571341043016581,-58.506675086106007 -34.571405453302745,-58.506485962689382 -34.571511652604158,-58.505546034876041 -34.57202728992398,-58.50533988668861 -34.572145324907126,-58.505127098932924 -34.572267164827636,-58.504195934819649 -34.572805183970694,-58.503948161412936 -34.572948302226095,-58.502994605223215 -34.573517940780789,-58.502946770911556 -34.573549225499612,-58.502283507429546 -34.574061083879513,-58.501735562055629 -34.574483883928757,-58.501475715914999 -34.574684468216226,-58.501869699776947 -34.574929423236256,-58.502868807598865 -34.575550674135442,-58.503000393245998 -34.575631901801664,-58.504136724580817 -34.576333029806833,-58.505265579877843 -34.577029501670083,-58.505916990824865 -34.576309172047132)));;818;12_19_7;COMUNA 12;19;7;998;465;533;87,24%;386;386;100,00%;0;0,00%;346;2;0,58%;344;99,42%
MULTIPOLYGON (((-58.498845869263647 -34.57672860109836,-58.498034964542342 -34.577360203113855,-58.499085082388639 -34.577997738245699,-58.500223968000917 -34.578700028451848,-58.500880881690172 -34.577972892918758,-58.501539741294835 -34.577243640383436,-58.50224530910355 -34.576462606341288,-58.502347428870884 -34.576350244537345,-58.503000393245998 -34.575631901801664,-58.502868807598865 -34.575550674135442,-58.501869699776947 -34.574929423236256,-58.501475715914999 -34.574684468216226,-58.501328727340223 -34.574797829486307,-58.500692426368367 -34.575292064208256,-58.500150849675563 -34.575712742316142,-58.499826735180115 -34.57596454210212,-58.499656931912064 -34.576096782309889,-58.498845869263647 -34.57672860109836)));;819;12_19_8;COMUNA 12;19;8;963;476;487;97,74%;360;360;100,00%;0;0,00%;351;42;11,97%;309;88,03%
MULTIPOLYGON (((-58.502014588478694 -34.578675942714916,-58.50314516165507 -34.579374334850392,-58.503803672452044 -34.578646126762926,-58.504611945183321 -34.577752363816906,-58.504487425120224 -34.57767796677156,-58.503484616750399 -34.57705299803731,-58.504136724580817 -34.576333029806833,-58.503000393245998 -34.575631901801664,-58.502347428870884 -34.576350244537345,-58.50224530910355 -34.576462606341288,-58.501539741294835 -34.577243640383436,-58.500880881690172 -34.577972892918758,-58.501885383750484 -34.578596121773039,-58.502014588478694 -34.578675942714916)));;820;12_19_9;COMUNA 12;19;9;789;339;450;75,33%;373;372;99,73%;1;0,27%;316;2;0,63%;314;99,37%
MULTIPOLYGON (((-58.492957253822119 -34.554344923280517,-58.492028149462982 -34.553857733289384,-58.49185200142383 -34.553765376868945,-58.491111058601511 -34.553372434887279,-58.490180355960035 -34.552875992477539,-58.490028620018215 -34.55279797859432,-58.489904117527239 -34.552729613872167,-58.489300220691774 -34.552367444428278,-58.489151743750334 -34.552278458494243,-58.488900473262696 -34.552015331509651,-58.488873280856119 -34.551877122393513,-58.488873191648693 -34.551876668983837,-58.488826106154093 -34.551830057195481,-58.488826200261144 -34.551830034874435,-58.488800452123826 -34.551804697051708,-58.488778695348913 -34.551783286969915,-58.488651963755267 -34.551722549862284,-58.488552654615972 -34.55169732386986,-58.488461981361851 -34.551707426881713,-58.487809676303215 -34.55260720771691,-58.487261058776113 -34.553410173157296,-58.486713280793523 -34.554209192021425,-58.486279441208666 -34.554901773060259,-58.486409338063218 -34.554902593013971,-58.486559749432772 -34.554903549673782,-58.486663854197616 -34.554904233542793,-58.486769491145097 -34.554904846595242,-58.487193146860719 -34.554911804917026,-58.48753346751009 -34.554917440657817,-58.487854465334209 -34.554922727303733,-58.488359844296625 -34.554948045834536,-58.488525494930357 -34.554956321147358,-58.488723577739414 -34.554966279545098,-58.489966980341997 -34.555028475834078,-58.490523775400511 -34.555056379666482,-58.491178718720093 -34.555089187908294,-58.492135256939257 -34.555137061835026,-58.492395566602632 -34.555151013524792,-58.492909035791293 -34.555178635305516,-58.492909243311495 -34.555178646442975,-58.493606544014781 -34.555216068083155,-58.493707870478595 -34.555068993425188,-58.493877769984998 -34.554827601104677,-58.492957253822119 -34.554344923280517)));;821;12_2_1;COMUNA 12;2;1;1066;458;608;75,33%;388;386;99,48%;2;0,52%;371;16;4,31%;355;95,69%
MULTIPOLYGON (((-58.488462268919477 -34.551707030223518,-58.487655269645344 -34.551470003758929,-58.486835452785208 -34.55104465590108,-58.486244523797112 -34.551818821187695,-58.485665411240689 -34.552577346773063,-58.486508904881354 -34.553017557602267,-58.485932858186892 -34.553802704650536,-58.486713280793523 -34.554209192021425,-58.487261058776113 -34.553410173157296,-58.487809676303215 -34.55260720771691,-58.488461981361851 -34.551707426881713,-58.488462268919477 -34.551707030223518)));;822;12_2_2;COMUNA 12;2;2;738;325;413;78,69%;389;389;100,00%;0;0,00%;316;3;0,95%;313;99,05%
MULTIPOLYGON (((-58.485072248218472 -34.553354394073104,-58.484486051746181 -34.554122281802627,-58.485359949096605 -34.554583834031774,-58.485956741822001 -34.554899017924697,-58.486279441208666 -34.554901773060259,-58.486713280793523 -34.554209192021425,-58.485932858186892 -34.553802704650536,-58.486508904881354 -34.553017557602267,-58.485665411240689 -34.552577346773063,-58.485072248218472 -34.553354394073104)));;823;12_2_3;COMUNA 12;2;3;850;393;457;86,00%;480;480;100,00%;0;0,00%;394;4;1,02%;390;98,98%
MULTIPOLYGON (((-58.49049006648039 -34.55607903960184,-58.491440285974718 -34.556533206477646,-58.492387110241779 -34.556985746955363,-58.492783242614593 -34.55641097601422,-58.492926600984894 -34.556202832554185,-58.493171201946602 -34.555847826022678,-58.493443195840939 -34.555453232817044,-58.493606544014781 -34.555216068083155,-58.492909243311495 -34.555178646442975,-58.492909035791293 -34.555178635305516,-58.492395566602632 -34.555151013524792,-58.492135256939257 -34.555137061835026,-58.491178718720093 -34.555089187908294,-58.490523775400511 -34.555056379666482,-58.489966980341997 -34.555028475834078,-58.488723577739414 -34.554966279545098,-58.488525494930357 -34.554956321147358,-58.488359844296625 -34.554948045834536,-58.487854465334209 -34.554922727303733,-58.48753346751009 -34.554917440657817,-58.487193146860719 -34.554911804917026,-58.486769491145097 -34.554904846595242,-58.486663854197616 -34.554904233542793,-58.486474959901251 -34.555175620897501,-58.485943836993854 -34.555938574857954,-58.486603633674648 -34.556255715426147,-58.48718034262783 -34.556532867281469,-58.487384754066262 -34.556630436193011,-58.487519779948343 -34.556694848365176,-58.488501405637933 -34.557163116827219,-58.488942064806757 -34.556522641730055,-58.489028510902457 -34.556396208922813,-58.48955203178123 -34.555630707951927,-58.49049006648039 -34.55607903960184)));;824;12_2_4;COMUNA 12;2;4;1032;491;541;90,76%;457;457;100,00%;0;0,00%;379;0;0,00%;379;100,00%
MULTIPOLYGON (((-58.491440285974718 -34.556533206477646,-58.49049006648039 -34.55607903960184,-58.48955203178123 -34.555630707951927,-58.489028510902457 -34.556396208922813,-58.488942064806757 -34.556522641730055,-58.488501405637933 -34.557163116827219,-58.489426936368247 -34.557604698302143,-58.490378529359063 -34.55805859132137,-58.491327833944979 -34.558511491463904,-58.491857392010431 -34.557749219042613,-58.492317684441971 -34.5570865430346,-58.492387110241779 -34.556985746955363,-58.491440285974718 -34.556533206477646)));;825;12_2_5;COMUNA 12;2;5;1020;460;560;82,14%;442;442;100,00%;0;0,00%;401;2;0,50%;399;99,50%
MULTIPOLYGON (((-58.488119900994647 -34.559480062017187,-58.489072019465155 -34.55993537348121,-58.490022871183072 -34.560390043935726,-58.490778441298765 -34.559302358894229,-58.491327833944979 -34.558511491463904,-58.490378529359063 -34.55805859132137,-58.489426936368247 -34.557604698302143,-58.488501405637933 -34.557163116827219,-58.488030363367756 -34.557847683076716,-58.487957102613514 -34.557953970665253,-58.487582372144601 -34.558497382010323,-58.487503068893076 -34.558612403334926,-58.487210958079899 -34.559045369163051,-58.488119900994647 -34.559480062017187)));;826;12_2_6;COMUNA 12;2;6;968;433;535;80,93%;399;399;100,00%;0;0,00%;344;1;0,29%;343;99,71%
MULTIPOLYGON (((-58.487210958079899 -34.559045369163051,-58.486220633135915 -34.558571739795582,-58.48599981988955 -34.558890247198391,-58.485389799288185 -34.55981188242145,-58.485301045962366 -34.5599392285447,-58.486255026934771 -34.560393857343932,-58.486388695782985 -34.560457566731039,-58.487174535033475 -34.560827076159789,-58.487319954362874 -34.560895430261468,-58.488131091780033 -34.561286901212668,-58.488292179293076 -34.561364687927046,-58.489086464484288 -34.56173798620582,-58.489276841964539 -34.561827455942606,-58.490043381979099 -34.562195612928093,-58.490400643199926 -34.56236723016805,-58.490518226363548 -34.562423614391136,-58.490991285271036 -34.562650628452538,-58.491834078209521 -34.561441644018927,-58.491930139813213 -34.561301614807789,-58.491454446915156 -34.561074323250466,-58.49098437595697 -34.56084963427849,-58.490845679534381 -34.560783325336963,-58.490186512726851 -34.560468320570237,-58.490022871183072 -34.560390043935726,-58.489072019465155 -34.55993537348121,-58.488119900994647 -34.559480062017187,-58.487210958079899 -34.559045369163051)));;827;12_2_7;COMUNA 12;2;7;850;389;461;84,38%;387;387;100,00%;0;0,00%;319;2;0,63%;317;99,37%
MULTIPOLYGON (((-58.487582372144601 -34.558497382010323,-58.487957102613514 -34.557953970665253,-58.488030363367756 -34.557847683076716,-58.488501405637933 -34.557163116827219,-58.487519779948343 -34.556694848365176,-58.487384754066262 -34.556630436193011,-58.48718034262783 -34.556532867281469,-58.486603633674648 -34.556255715426147,-58.485943836993854 -34.555938574857954,-58.486474959901251 -34.555175620897501,-58.486663854197616 -34.554904233542793,-58.486559749432772 -34.554903549673782,-58.486409338063218 -34.554902593013971,-58.486279441208666 -34.554901773060259,-58.485628754718427 -34.555790036117237,-58.485084859169483 -34.556581299810333,-58.484347799333278 -34.557678806433067,-58.483407757258355 -34.55903135450135,-58.483505068471381 -34.559078030201093,-58.483556313885103 -34.55910266057527,-58.483620343690625 -34.559133435533553,-58.483700712902476 -34.559172015022277,-58.484350139719631 -34.559483746601416,-58.485017961242747 -34.559804344985821,-58.485165931436676 -34.559874884395718,-58.485301045962366 -34.5599392285447,-58.485389799288185 -34.55981188242145,-58.48599981988955 -34.558890247198391,-58.486220633135915 -34.558571739795582,-58.487210958079899 -34.559045369163051,-58.487503068893076 -34.558612403334926,-58.487582372144601 -34.558497382010323)));;828;12_2_8;COMUNA 12;2;8;1003;468;535;87,48%;381;380;99,74%;1;0,26%;345;3;0,87%;342;99,13%
MULTIPOLYGON (((-58.506503951872702 -34.583732369621217,-58.506622499178413 -34.583601265315011,-58.50716417032956 -34.583003439054153,-58.506030701264031 -34.582298958609464,-58.505879937118088 -34.582205627915982,-58.505322604342766 -34.582823313998013,-58.505219969948129 -34.582936030479807,-58.504512840424788 -34.583712715057771,-58.503854633941145 -34.584435714796129,-58.503744166401333 -34.584558292206793,-58.504397232940271 -34.58496308733951,-58.505034121535857 -34.58535774330381,-58.505158314223067 -34.585434675121299,-58.505713776636739 -34.585778226970724,-58.506228015745371 -34.586096296989666,-58.506382875743014 -34.586191597635576,-58.50714830244123 -34.585346427833549,-58.507004516831671 -34.585258237090976,-58.506478694783063 -34.584931864257157,-58.505800149347607 -34.58451068014444,-58.506503951872702 -34.583732369621217)));;829;12_20_1;COMUNA 12;20;1;851;405;446;90,81%;401;401;100,00%;0;0,00%;317;3;0,95%;314;99,05%
MULTIPOLYGON (((-58.505713776636739 -34.585778226970724,-58.505158314223067 -34.585434675121299,-58.505034121535857 -34.58535774330381,-58.504397232940271 -34.58496308733951,-58.503744166401333 -34.584558292206793,-58.502979054848446 -34.585407173221157,-58.502188054409764 -34.586284720838805,-58.502846827818829 -34.586680226153682,-58.503489252911542 -34.587065944222076,-58.504176914993714 -34.587478827710797,-58.504848143773486 -34.587881782993755,-58.504977937095319 -34.587744690329941,-58.505608923368101 -34.587047118054556,-58.506282877287646 -34.586302130819533,-58.506382875743014 -34.586191597635576,-58.506228015745371 -34.586096296989666,-58.505713776636739 -34.585778226970724)));;830;12_20_2;COMUNA 12;20;2;1286;587;699;83,98%;697;696;99,86%;1;0,14%;559;6;1,07%;553;98,93%
MULTIPOLYGON (((-58.501853510142048 -34.584708074400012,-58.501735461791114 -34.584832976458401,-58.501054585491829 -34.58558625114442,-58.502015738603689 -34.586181321574585,-58.502188054409764 -34.586284720838805,-58.502979054848446 -34.585407173221157,-58.503744166401333 -34.584558292206793,-58.503854633941145 -34.584435714796129,-58.504512840424788 -34.583712715057771,-58.503386540110846 -34.583015109369391,-58.502254637065342 -34.58231404417004,-58.501587912148317 -34.583048232256132,-58.501486889582743 -34.583159395723598,-58.501391654059155 -34.583264148557504,-58.500717168734582 -34.584006221884351,-58.501722165140798 -34.584623394701104,-58.501853510142048 -34.584708074400012)));;831;12_20_3;COMUNA 12;20;3;1026;485;541;89,65%;486;484;99,59%;2;0,41%;411;2;0,49%;409;99,51%
MULTIPOLYGON (((-58.506898587717473 -34.58107923091373,-58.506965704786893 -34.581004715077761,-58.506830439112107 -34.581023549044453,-58.506522099918598 -34.580994996983655,-58.505826658676995 -34.580936298595049,-58.505636343487431 -34.580921576349219,-58.505738821641323 -34.580986899780093,-58.505259039564976 -34.580945165572608,-58.505302376627355 -34.580895635960644,-58.505199598015651 -34.580887713716315,-58.50518087474854 -34.580906312553125,-58.504312067370918 -34.580837594911159,-58.504184672187947 -34.580983418959015,-58.503854799898086 -34.580949367212135,-58.503827552526744 -34.580929351705755,-58.503786695043608 -34.58092686238011,-58.503708006473325 -34.580921882671007,-58.503661095606098 -34.580918143793845,-58.503624778329566 -34.580916904433387,-58.503568799943288 -34.580936947881241,-58.502428318786585 -34.580830475810153,-58.502212495259037 -34.581070555803244,-58.502239665744419 -34.581087378686362,-58.502961859941585 -34.581535330125341,-58.502254637065342 -34.58231404417004,-58.503386540110846 -34.583015109369391,-58.504512840424788 -34.583712715057771,-58.505219969948129 -34.582936030479807,-58.505322604342766 -34.582823313998013,-58.505879937118088 -34.582205627915982,-58.506205958929925 -34.581844300076099,-58.506431304690267 -34.58159463178405,-58.506535297155892 -34.581479941859989,-58.506898587717473 -34.58107923091373)));;832;12_20_4;COMUNA 12;20;4;1034;495;539;91,84%;459;459;100,00%;0;0,00%;391;2;0,51%;389;99,49%
MULTIPOLYGON (((-58.500463284533645 -34.580394893571246,-58.500463485344092 -34.580394673009778,-58.50046317774423 -34.580394622058719,-58.500359937308723 -34.580377521192197,-58.499699135759364 -34.580262225544395,-58.499037483540256 -34.580144602529252,-58.498972763957127 -34.580128283073392,-58.498948225355278 -34.580121916769727,-58.498518874593486 -34.580010524897183,-58.498847637206225 -34.580222549460416,-58.498090853738894 -34.581056326925449,-58.498219973443611 -34.58113601102572,-58.499221172471863 -34.581758276481885,-58.500221449514662 -34.582379970536607,-58.500351253771434 -34.582458032368095,-58.500488212884484 -34.582540458222226,-58.501486889582743 -34.583159395723598,-58.501587912148317 -34.583048232256132,-58.502254637065342 -34.58231404417004,-58.502961859941585 -34.581535330125341,-58.502239665744419 -34.581087378686362,-58.502212495259037 -34.581070555803244,-58.501825807882682 -34.580833487458904,-58.501719002206471 -34.580953244916401,-58.501162095793042 -34.580696791337438,-58.500408480550767 -34.580585402150007,-58.500564162343593 -34.580413201735631,-58.500463284533645 -34.580394893571246)));;833;12_20_5;COMUNA 12;20;5;993;474;519;91,33%;418;417;99,76%;1;0,24%;382;1;0,26%;381;99,74%
MULTIPOLYGON (((-58.501486889582743 -34.583159395723598,-58.500488212884484 -34.582540458222226,-58.500351253771434 -34.582458032368095,-58.500221449514662 -34.582379970536607,-58.499221172471863 -34.581758276481885,-58.49912874389095 -34.581859012484507,-58.498454847584092 -34.582605157982265,-58.498345055285135 -34.58272667396556,-58.49765701399879 -34.583482749071273,-58.498785146510599 -34.584181252157819,-58.499918578785213 -34.584882912257527,-58.501054585491829 -34.58558625114442,-58.501735461791114 -34.584832976458401,-58.501853510142048 -34.584708074400012,-58.501722165140798 -34.584623394701104,-58.500717168734582 -34.584006221884351,-58.501391654059155 -34.583264148557504,-58.501486889582743 -34.583159395723598)));;834;12_20_6;COMUNA 12;20;6;1014;447;567;78,84%;524;524;100,00%;0;0,00%;407;1;0,25%;406;99,75%
MULTIPOLYGON (((-58.498090853738894 -34.581056326925449,-58.498847637206225 -34.580222549460416,-58.498518874593486 -34.580010524897183,-58.498253865091549 -34.579941726278911,-58.49759117200837 -34.579767473645383,-58.497504652628947 -34.579744962198809,-58.496954593776628 -34.580354720609122,-58.496863526471429 -34.58045566581422,-58.49618553356126 -34.58120053244528,-58.497320947407431 -34.581902920742195,-58.496522342130426 -34.582780223033829,-58.49765701399879 -34.583482749071273,-58.498345055285135 -34.58272667396556,-58.498454847584092 -34.582605157982265,-58.49912874389095 -34.581859012484507,-58.499221172471863 -34.581758276481885,-58.498219973443611 -34.58113601102572,-58.498090853738894 -34.581056326925449)));;835;12_20_7;COMUNA 12;20;7;887;393;494;79,55%;417;417;100,00%;0;0,00%;346;7;2,02%;339;97,98%
MULTIPOLYGON (((-58.494460517793378 -34.580133273192736,-58.494329087218688 -34.580233452327818,-58.493618982016443 -34.580774431366116,-58.493453493655679 -34.580884759436522,-58.494257399293552 -34.581377814081449,-58.495385985940928 -34.58207663043023,-58.496522342130426 -34.582780223033829,-58.497320947407431 -34.581902920742195,-58.49618553356126 -34.58120053244528,-58.496863526471429 -34.58045566581422,-58.496954593776628 -34.580354720609122,-58.497504652628947 -34.579744962198809,-58.497409363154155 -34.579722594036035,-58.497433701826566 -34.579690050547185,-58.497194660955287 -34.579613354579863,-58.496787944124634 -34.57948480151763,-58.496473879671733 -34.57938333530025,-58.495870272096418 -34.579172083568032,-58.495774209494797 -34.57912978392762,-58.495728584477881 -34.579164586465822,-58.495545913901772 -34.579304219044914,-58.495416529689379 -34.579404962216863,-58.495285867459671 -34.579504437932876,-58.494460517793378 -34.580133273192736)));;836;12_20_8;COMUNA 12;20;8;937;451;486;92,80%;436;436;100,00%;0;0,00%;365;35;9,59%;330;90,41%
MULTIPOLYGON (((-58.501054585491829 -34.58558625114442,-58.499918578785213 -34.584882912257527,-58.499797294450907 -34.58501450383887,-58.499179212413331 -34.585698591204796,-58.498528266228028 -34.586418954094228,-58.499666581523776 -34.587122727595073,-58.500800657028229 -34.587823885975915,-58.501450402168565 -34.58710308896417,-58.502188054409764 -34.586284720838805,-58.502015738603689 -34.586181321574585,-58.501054585491829 -34.58558625114442)));;837;12_21_1;COMUNA 12;21;1;1052;479;573;83,60%;588;588;100,00%;0;0,00%;467;2;0,43%;465;99,57%
MULTIPOLYGON (((-58.490176921028421 -34.584620483418426,-58.489505700086561 -34.584204981899298,-58.488793593920711 -34.58481818943666,-58.488968873558733 -34.584930057809075,-58.489559528778308 -34.58530255006675,-58.49028569696226 -34.585760434894887,-58.490850301212831 -34.586116447195579,-58.491413377158914 -34.586471471266414,-58.491970155028916 -34.586822479981151,-58.492540139654842 -34.587181933951598,-58.492672844276058 -34.587036191318532,-58.49317513989859 -34.586476537239022,-58.493292434881241 -34.586345868796371,-58.493826217720461 -34.585755709882676,-58.492693591456813 -34.585054908624315,-58.492042509187641 -34.58577537789651,-58.491474667913458 -34.585423949506321,-58.490907597915729 -34.585072870401383,-58.490176921028421 -34.584620483418426)));;838;12_21_10;COMUNA 12;21;10;664;299;365;81,92%;340;340;100,00%;0;0,00%;258;4;1,55%;254;98,45%
MULTIPOLYGON (((-58.499918578785213 -34.584882912257527,-58.498785146510599 -34.584181252157819,-58.49765701399879 -34.583482749071273,-58.496915423658933 -34.584297710877699,-58.496821287561175 -34.58440119216246,-58.496263617566314 -34.585018695926308,-58.497393803003952 -34.58571749283179,-58.498528266228028 -34.586418954094228,-58.499179212413331 -34.585698591204796,-58.499797294450907 -34.58501450383887,-58.499918578785213 -34.584882912257527)));;839;12_21_2;COMUNA 12;21;2;1074;482;592;81,42%;530;529;99,81%;1;0,19%;476;44;9,24%;432;90,76%
MULTIPOLYGON (((-58.494646004411479 -34.582893268417621,-58.494110458669311 -34.58348660078466,-58.493994190113817 -34.583615438749135,-58.495128085167238 -34.584316579895464,-58.496263617566314 -34.585018695926308,-58.496821287561175 -34.58440119216246,-58.496915423658933 -34.584297710877699,-58.49765701399879 -34.583482749071273,-58.496522342130426 -34.582780223033829,-58.495385985940928 -34.58207663043023,-58.495254399678807 -34.582219277110788,-58.494646004411479 -34.582893268417621)));;840;12_21_3;COMUNA 12;21;3;920;441;479;92,07%;437;437;100,00%;0;0,00%;360;16;4,44%;344;95,56%
MULTIPOLYGON (((-58.495385985940928 -34.58207663043023,-58.494257399293552 -34.581377814081449,-58.493453493655679 -34.580884759436522,-58.49324552589858 -34.581023338525291,-58.492543506375711 -34.581592901947111,-58.492405518894003 -34.581704912065788,-58.491939635969082 -34.582107224262288,-58.491751595999744 -34.582269388525077,-58.491042502567915 -34.582880988868254,-58.492211122242765 -34.583631799062424,-58.492741916298058 -34.583044955348768,-58.492859717894163 -34.582913864572312,-58.493994190113817 -34.583615438749135,-58.494110458669311 -34.58348660078466,-58.494646004411479 -34.582893268417621,-58.495254399678807 -34.582219277110788,-58.495385985940928 -34.58207663043023)));;841;12_21_4;COMUNA 12;21;4;1015;471;544;86,58%;529;529;100,00%;0;0,00%;421;2;0,48%;419;99,52%
MULTIPOLYGON (((-58.492211122242765 -34.583631799062424,-58.491042502567915 -34.582880988868254,-58.49051965654234 -34.583331902328865,-58.490437594215457 -34.583402628133157,-58.490264360493917 -34.583551828427971,-58.48983242266516 -34.583923701012402,-58.489505700086561 -34.584204981899298,-58.490176921028421 -34.584620483418426,-58.490907597915729 -34.585072870401383,-58.491474667913458 -34.585423949506321,-58.492042509187641 -34.58577537789651,-58.492693591456813 -34.585054908624315,-58.493345002969768 -34.584334083586967,-58.493899030105261 -34.583720960392114,-58.493994190113817 -34.583615438749135,-58.492859717894163 -34.582913864572312,-58.492741916298058 -34.583044955348768,-58.492211122242765 -34.583631799062424)));;842;12_21_5;COMUNA 12;21;5;813;383;430;89,07%;220;220;100,00%;0;0,00%;297;2;0,67%;295;99,33%
MULTIPOLYGON (((-58.495612055011932 -34.585737987136859,-58.496171097361241 -34.585121190297784,-58.496263617566314 -34.585018695926308,-58.495128085167238 -34.584316579895464,-58.493994190113817 -34.583615438749135,-58.493899030105261 -34.583720960392114,-58.493345002969768 -34.584334083586967,-58.492693591456813 -34.585054908624315,-58.493826217720461 -34.585755709882676,-58.494958011235205 -34.586455937360874,-58.496092379036895 -34.587157773336585,-58.496742671061803 -34.586438127954573,-58.495612055011932 -34.585737987136859)));;843;12_21_6;COMUNA 12;21;6;869;420;449;93,54%;377;377;100,00%;0;0,00%;326;1;0,31%;325;99,69%
MULTIPOLYGON (((-58.499666581523776 -34.587122727595073,-58.498528266228028 -34.586418954094228,-58.497393803003952 -34.58571749283179,-58.496263617566314 -34.585018695926308,-58.496171097361241 -34.585121190297784,-58.495612055011932 -34.585737987136859,-58.496742671061803 -34.586438127954573,-58.496092379036895 -34.587157773336585,-58.497226595539956 -34.587859457873989,-58.498224374309636 -34.588476731564121,-58.4983646641478 -34.588563454694899,-58.499355389592907 -34.589175932198202,-58.499499685167891 -34.589264906421626,-58.500148772355061 -34.588546018185582,-58.50069154234459 -34.587944981203506,-58.500800657028229 -34.587823885975915,-58.499666581523776 -34.587122727595073)));;844;12_21_7;COMUNA 12;21;7;957;459;498;92,17%;437;437;100,00%;0;0,00%;340;3;0,88%;337;99,12%
MULTIPOLYGON (((-58.497226595539956 -34.587859457873989,-58.496092379036895 -34.587157773336585,-58.495440713887298 -34.587878894473249,-58.496007055374271 -34.588229389138874,-58.495472762460437 -34.588822726629871,-58.49536116995769 -34.588945789650168,-58.495592342581055 -34.589089254443849,-58.49592794422454 -34.589296495779728,-58.497066361691346 -34.589999448063971,-58.49820249841391 -34.590700911372963,-58.498333155556779 -34.590556642198131,-58.498538886132806 -34.590328755975221,-58.498848033219929 -34.589986468047258,-58.499499685167891 -34.589264906421626,-58.499355389592907 -34.589175932198202,-58.4983646641478 -34.588563454694899,-58.498224374309636 -34.588476731564121,-58.497226595539956 -34.587859457873989)));;845;12_21_8;COMUNA 12;21;8;803;367;436;84,17%;398;397;99,75%;1;0,25%;319;2;0,63%;317;99,37%
MULTIPOLYGON (((-58.49317513989859 -34.586476537239022,-58.492672844276058 -34.587036191318532,-58.492540139654842 -34.587181933951598,-58.493663514281408 -34.587890203818986,-58.4938905082861 -34.588033320796093,-58.494225335240046 -34.588241060027983,-58.494794400100673 -34.588594165335927,-58.49536116995769 -34.588945789650168,-58.495472762460437 -34.588822726629871,-58.496007055374271 -34.588229389138874,-58.495440713887298 -34.587878894473249,-58.496092379036895 -34.587157773336585,-58.494958011235205 -34.586455937360874,-58.493826217720461 -34.585755709882676,-58.493292434881241 -34.586345868796371,-58.49317513989859 -34.586476537239022)));;846;12_21_9;COMUNA 12;21;9;801;372;429;86,71%;322;322;100,00%;0;0,00%;286;0;0,00%;286;100,00%
MULTIPOLYGON (((-58.512478184542324 -34.581508889991071,-58.512478825998613 -34.581508931403036,-58.51247824908107 -34.581507245390711,-58.512478184542324 -34.581508889991071)),((-58.51392103617416 -34.58239830088857,-58.514571566576834 -34.581684123532369,-58.514696763671182 -34.581558978997769,-58.51375177427709 -34.581590451229182,-58.51371051350371 -34.581632629240389,-58.512738984811229 -34.581643481125617,-58.512561429589532 -34.581607767268089,-58.512479490908433 -34.581509297044065,-58.512478879393093 -34.58150764868374,-58.51247824908107 -34.581507245390711,-58.512479395070812 -34.581510296487139,-58.512478184542324 -34.581508889991071,-58.510734645963026 -34.581396315769517,-58.510465223638533 -34.581378885570665,-58.510646145157828 -34.58149114321175,-58.509834832963037 -34.582380439504476,-58.510969187802964 -34.583086785733244,-58.511155821157054 -34.583203054575328,-58.51187211685393 -34.583644194610287,-58.512468056118358 -34.584011221586472,-58.513272541255958 -34.583117403635086,-58.513813818901596 -34.582516097153842,-58.51392103617416 -34.58239830088857)));;847;12_22_1;COMUNA 12;22;1;788;364;424;85,85%;330;330;100,00%;0;0,00%;294;2;0,68%;292;99,32%
MULTIPOLYGON (((-58.499499685167891 -34.589264906421626,-58.498848033219929 -34.589986468047258,-58.498538886132806 -34.590328755975221,-58.498333155556779 -34.590556642198131,-58.49820249841391 -34.590700911372963,-58.499487298018579 -34.591494153924103,-58.500817099464669 -34.59231525721588,-58.5009302207879 -34.592191061991706,-58.501155186159721 -34.591945136510375,-58.501466798875001 -34.59160446104638,-58.50158179105712 -34.591478715252869,-58.502119038364917 -34.590885984157026,-58.502773819515099 -34.590163629472613,-58.502236569341854 -34.589831819629907,-58.502104452257456 -34.589753056395985,-58.501976253738128 -34.589676545368036,-58.501438157805076 -34.589343675873614,-58.500148772355061 -34.588546018185582,-58.499499685167891 -34.589264906421626)));;848;12_22_10;COMUNA 12;22;10;964;457;507;90,14%;404;404;100,00%;0;0,00%;370;7;1,89%;363;98,11%
MULTIPOLYGON (((-58.502781941557025 -34.591294235161371,-58.502237783518176 -34.59095679363012,-58.502119038364917 -34.590885984157026,-58.50158179105712 -34.591478715252869,-58.501466798875001 -34.59160446104638,-58.501155186159721 -34.591945136510375,-58.5009302207879 -34.592191061991706,-58.500817099464669 -34.59231525721588,-58.501928169404664 -34.593001199810445,-58.502141986320559 -34.593133389622757,-58.503311346736744 -34.593856133102356,-58.503471839545547 -34.593953548200965,-58.50411684460164 -34.593241542455445,-58.504768647671447 -34.592521924944414,-58.503439911621037 -34.59170177992884,-58.503299611305422 -34.591615203534786,-58.502781941557025 -34.591294235161371)));;849;12_22_11;COMUNA 12;22;11;955;422;533;79,17%;464;464;100,00%;0;0,00%;371;5;1,35%;366;98,65%
MULTIPOLYGON (((-58.508766075799812 -34.581235236973384,-58.50787145806985 -34.581159441443361,-58.506898587717473 -34.58107923091373,-58.506535297155892 -34.581479941859989,-58.506431304690267 -34.58159463178405,-58.506205958929925 -34.581844300076099,-58.505879937118088 -34.582205627915982,-58.506030701264031 -34.582298958609464,-58.50716417032956 -34.583003439054153,-58.507841177388208 -34.583424123280693,-58.508358136706114 -34.583745423012807,-58.508512738733408 -34.583839664709032,-58.509173110591931 -34.583110371109669,-58.509726588654587 -34.582499148109356,-58.509834832963037 -34.582380439504476,-58.510646145157828 -34.58149114321175,-58.510465223638533 -34.581378885570665,-58.509460839281019 -34.581291946955986,-58.508766075799812 -34.581235236973384)));;850;12_22_2;COMUNA 12;22;2;954;444;510;87,06%;416;416;100,00%;0;0,00%;362;3;0,83%;359;99,17%
MULTIPOLYGON (((-58.511155821157054 -34.583203054575328,-58.510969187802964 -34.583086785733244,-58.509834832963037 -34.582380439504476,-58.509726588654587 -34.582499148109356,-58.509173110591931 -34.583110371109669,-58.508512738733408 -34.583839664709032,-58.50917263342437 -34.584241755600765,-58.50968738468076 -34.584555444552137,-58.509841138579574 -34.584650389132406,-58.510568003185497 -34.585099279425222,-58.509893659163225 -34.585822529155777,-58.510492757902263 -34.586192874414373,-58.511040629589793 -34.585586859433704,-58.511154407074812 -34.585461386688053,-58.511810258914039 -34.584737785270114,-58.512357261522858 -34.584134370332727,-58.512468056118358 -34.584011221586472,-58.51187211685393 -34.583644194610287,-58.511155821157054 -34.583203054575328)));;851;12_22_3;COMUNA 12;22;3;786;347;439;79,04%;343;343;100,00%;0;0,00%;299;0;0,00%;299;100,00%
MULTIPOLYGON (((-58.508512738733408 -34.583839664709032,-58.508358136706114 -34.583745423012807,-58.507841177388208 -34.583424123280693,-58.50716417032956 -34.583003439054153,-58.506622499178413 -34.583601265315011,-58.506503951872702 -34.583732369621217,-58.505800149347607 -34.58451068014444,-58.506478694783063 -34.584931864257157,-58.507004516831671 -34.585258237090976,-58.50714830244123 -34.585346427833549,-58.507806926247582 -34.585750498381813,-58.508308479581146 -34.586058282214097,-58.508471093724687 -34.586158718365255,-58.509178206108459 -34.58538025054316,-58.509841138579574 -34.584650389132406,-58.50968738468076 -34.584555444552137,-58.50917263342437 -34.584241755600765,-58.508512738733408 -34.583839664709032)));;852;12_22_4;COMUNA 12;22;4;885;419;466;89,91%;338;338;100,00%;0;0,00%;299;0;0,00%;299;100,00%
MULTIPOLYGON (((-58.509788291073207 -34.586971982554495,-58.510492757902263 -34.586192874414373,-58.509893659163225 -34.585822529155777,-58.510568003185497 -34.585099279425222,-58.509841138579574 -34.584650389132406,-58.509178206108459 -34.58538025054316,-58.508471093724687 -34.586158718365255,-58.507828647444626 -34.586866028468556,-58.507702777795977 -34.587004038264624,-58.507596567014424 -34.587120560957565,-58.506921595014035 -34.587863020400739,-58.507636801688278 -34.588304819171476,-58.506893564215737 -34.589122306438838,-58.507504172463875 -34.589497943896262,-58.508244000678545 -34.58867982040578,-58.509021855735092 -34.587819633954389,-58.509788291073207 -34.586971982554495)));;853;12_22_5;COMUNA 12;22;5;1207;575;632;90,98%;422;422;100,00%;0;0,00%;435;1;0,23%;434;99,77%
MULTIPOLYGON (((-58.508471093724687 -34.586158718365255,-58.508308479581146 -34.586058282214097,-58.507806926247582 -34.585750498381813,-58.50714830244123 -34.585346427833549,-58.506382875743014 -34.586191597635576,-58.506282877287646 -34.586302130819533,-58.505608923368101 -34.587047118054556,-58.504977937095319 -34.587744690329941,-58.504848143773486 -34.587881782993755,-58.505015015005966 -34.587982010973711,-58.505515205000528 -34.588282059854137,-58.506018039248964 -34.588583655087724,-58.506177673904432 -34.588681841698275,-58.506893564215737 -34.589122306438838,-58.507636801688278 -34.588304819171476,-58.506921595014035 -34.587863020400739,-58.507596567014424 -34.587120560957565,-58.507702777795977 -34.587004038264624,-58.507828647444626 -34.586866028468556,-58.508471093724687 -34.586158718365255)));;854;12_22_6;COMUNA 12;22;6;1119;517;602;85,88%;555;555;100,00%;0;0,00%;448;0;0,00%;448;100,00%
MULTIPOLYGON (((-58.504076624070628 -34.588726235848767,-58.503423908180949 -34.58944641381018,-58.504609838658183 -34.590178717615622,-58.504744516188445 -34.590262759149141,-58.504896060624027 -34.590357217652368,-58.50533510536151 -34.590627709633715,-58.506071964145583 -34.591081763810038,-58.506723817988949 -34.590360867940269,-58.507504172463875 -34.589497943896262,-58.506893564215737 -34.589122306438838,-58.506177673904432 -34.588681841698275,-58.506018039248964 -34.588583655087724,-58.505515205000528 -34.588282059854137,-58.505015015005966 -34.587982010973711,-58.504848143773486 -34.587881782993755,-58.504701923699614 -34.58803634666225,-58.504076624070628 -34.588726235848767)));;855;12_22_7;COMUNA 12;22;7;1121;503;618;81,39%;549;549;100,00%;0;0,00%;459;3;0,65%;456;99,35%
MULTIPOLYGON (((-58.503439911621037 -34.59170177992884,-58.504768647671447 -34.592521924944414,-58.505284856192397 -34.591952075499179,-58.50542231186769 -34.591800049609482,-58.506071964145583 -34.591081763810038,-58.50533510536151 -34.590627709633715,-58.504896060624027 -34.590357217652368,-58.504744516188445 -34.590262759149141,-58.504609838658183 -34.590178717615622,-58.503423908180949 -34.58944641381018,-58.502773819515099 -34.590163629472613,-58.502119038364917 -34.590885984157026,-58.502237783518176 -34.59095679363012,-58.502781941557025 -34.591294235161371,-58.503299611305422 -34.591615203534786,-58.503439911621037 -34.59170177992884)));;856;12_22_8;COMUNA 12;22;8;982;465;517;89,94%;386;386;100,00%;0;0,00%;365;5;1,37%;360;98,63%
MULTIPOLYGON (((-58.502846827818829 -34.586680226153682,-58.502188054409764 -34.586284720838805,-58.501450402168565 -34.58710308896417,-58.500800657028229 -34.587823885975915,-58.50069154234459 -34.587944981203506,-58.500148772355061 -34.588546018185582,-58.501438157805076 -34.589343675873614,-58.501976253738128 -34.589676545368036,-58.502104452257456 -34.589753056395985,-58.502236569341854 -34.589831819629907,-58.502773819515099 -34.590163629472613,-58.503423908180949 -34.58944641381018,-58.504076624070628 -34.588726235848767,-58.504701923699614 -34.58803634666225,-58.504848143773486 -34.587881782993755,-58.504176914993714 -34.587478827710797,-58.503489252911542 -34.587065944222076,-58.502846827818829 -34.586680226153682)));;857;12_22_9;COMUNA 12;22;9;920;420;500;84,00%;448;447;99,78%;1;0,22%;365;5;1,37%;360;98,63%
MULTIPOLYGON (((-58.487516641279605 -34.544977192910522,-58.486934356539955 -34.545746782856739,-58.48634755174713 -34.546522357004406,-58.485763969217253 -34.547293561225047,-58.486028033558448 -34.547433376783665,-58.487610988646928 -34.548263736838145,-58.488872607942625 -34.548925123578329,-58.489460261838595 -34.548163693009215,-58.490050287297677 -34.547399371528854,-58.490500788114964 -34.547622097146423,-58.490756514516335 -34.547237936124681,-58.490856808559592 -34.547071848900949,-58.490916926474178 -34.546900277665024,-58.490925046024984 -34.546748015107504,-58.49092432003291 -34.546747637551704,-58.491470790564904 -34.545980732709282,-58.491741312130607 -34.545601082492226,-58.490165610255943 -34.544905561046875,-58.488204131584723 -34.544039711397751,-58.487928424026677 -34.544402513102199,-58.487498739946304 -34.54496792390966,-58.487516641279605 -34.544977192910522)));;858;12_3_1;COMUNA 12;3;1;232;111;121;91,74%;126;126;100,00%;0;0,00%;104;1;0,96%;103;99,04%
MULTIPOLYGON (((-58.48380410358137 -34.551604820850351,-58.484375992590287 -34.550851446336161,-58.484963612477934 -34.550077290571046,-58.4847345321337 -34.549965495937485,-58.48419907732319 -34.549704241197503,-58.484014433448991 -34.549605818278614,-58.483093263632874 -34.549114685090089,-58.482640131403755 -34.54887312892938,-58.482175765213377 -34.548626079654838,-58.481598086564176 -34.549392332960643,-58.481492403151869 -34.549532496649739,-58.481600938775884 -34.549584102021115,-58.4817755373249 -34.549688516354614,-58.482007688281143 -34.549848416891003,-58.482226562253011 -34.550010150176696,-58.482340986378873 -34.55012274269631,-58.482434722462216 -34.55021505581896,-58.482581512218857 -34.550413280655839,-58.4827040450919 -34.550615805260193,-58.482776135207843 -34.550855894784739,-58.482797776013022 -34.550938180551192,-58.482798103710302 -34.550983553354946,-58.4827978236139 -34.55113615196219,-58.482721454227736 -34.551241113210097,-58.482581913240708 -34.551435075928339,-58.482374030184786 -34.551627216763237,-58.482268922732374 -34.55167884453224,-58.482215791600211 -34.551705614231977,-58.482059802247925 -34.551782089896889,-58.482280457969004 -34.551897200878535,-58.483212973417807 -34.552383478685535,-58.48380410358137 -34.551604820850351)));;859;12_3_10;COMUNA 12;3;10;878;433;445;97,30%;363;363;100,00%;0;0,00%;305;5;1,64%;300;98,36%
MULTIPOLYGON (((-58.48380410358137 -34.551604820850351,-58.483212973417807 -34.552383478685535,-58.48414166879919 -34.55286777807887,-58.485072248218472 -34.553354394073104,-58.485665411240689 -34.552577346773063,-58.486244523797112 -34.551818821187695,-58.486835452785208 -34.55104465590108,-58.485902846413303 -34.550559532484684,-58.485138296230602 -34.550162544250924,-58.484963612477934 -34.550077290571046,-58.484375992590287 -34.550851446336161,-58.48380410358137 -34.551604820850351)));;860;12_3_11;COMUNA 12;3;11;785;363;422;86,02%;346;345;99,71%;1;0,29%;290;6;2,07%;284;97,93%
MULTIPOLYGON (((-58.487928424026677 -34.544402513102199,-58.488204131584723 -34.544039711397751,-58.486246293234451 -34.543175419246417,-58.485985719926276 -34.543539127463767,-58.485653465771101 -34.544002882380596,-58.48566969679397 -34.544011452147799,-58.485082806570048 -34.544784203419432,-58.484499138646463 -34.545552584795978,-58.483917246809142 -34.546318709352114,-58.484449278966636 -34.546597149994724,-58.484837112013032 -34.546802582928834,-58.485763969217253 -34.547293561225047,-58.48634755174713 -34.546522357004406,-58.486934356539955 -34.545746782856739,-58.487516641279605 -34.544977192910522,-58.487498739946304 -34.54496792390966,-58.487928424026677 -34.544402513102199)));;861;12_3_2;COMUNA 12;3;2;698;329;369;89,16%;268;268;100,00%;0;0,00%;249;0;0,00%;249;100,00%
MULTIPOLYGON (((-58.483577502728863 -34.545072441444823,-58.482995094489205 -34.545836026425221,-58.483917246809142 -34.546318709352114,-58.484499138646463 -34.545552584795978,-58.485082806570048 -34.544784203419432,-58.48566969679397 -34.544011452147799,-58.485653465771101 -34.544002882380596,-58.485985719926276 -34.543539127463767,-58.486246293234451 -34.543175419246417,-58.483350361981834 -34.541896913307781,-58.483089199333413 -34.542265584278695,-58.482842941000932 -34.54261321202241,-58.482844774492968 -34.542613996953499,-58.482296666439979 -34.543335810693428,-58.481711706787337 -34.54410615106395,-58.482653324394079 -34.544593770456572,-58.483577502728863 -34.545072441444823)));;862;12_3_3;COMUNA 12;3;3;824;371;453;81,90%;313;312;99,68%;1;0,32%;270;2;0,74%;268;99,26%
MULTIPOLYGON (((-58.480551540362605 -34.545633863328099,-58.479962294024077 -34.546409759302499,-58.480902821499697 -34.546900138769018,-58.481186028324437 -34.547045103041214,-58.481829142832062 -34.54737727311791,-58.482412846488096 -34.546602355116512,-58.482590678249302 -34.546366258821138,-58.482995094489205 -34.545836026425221,-58.483577502728863 -34.545072441444823,-58.482653324394079 -34.544593770456572,-58.481711706787337 -34.54410615106395,-58.481129203878211 -34.544873178150205,-58.480551540362605 -34.545633863328099)));;863;12_3_4;COMUNA 12;3;4;805;373;432;86,34%;304;303;99,67%;1;0,33%;268;10;3,73%;258;96,27%
MULTIPOLYGON (((-58.485183864457724 -34.548060325093502,-58.485763969217253 -34.547293561225047,-58.484837112013032 -34.546802582928834,-58.484449278966636 -34.546597149994724,-58.483917246809142 -34.546318709352114,-58.482995094489205 -34.545836026425221,-58.482590678249302 -34.546366258821138,-58.482412846488096 -34.546602355116512,-58.481829142832062 -34.54737727311791,-58.482279368591726 -34.547609818307969,-58.482755730622294 -34.547856653983423,-58.483677306739438 -34.548334127141658,-58.484463966173152 -34.548741684582339,-58.484608173527377 -34.548821099124822,-58.48485398785725 -34.548496250859365,-58.485183864457724 -34.548060325093502)));;864;12_3_5;COMUNA 12;3;5;819;368;451;81,60%;341;341;100,00%;0;0,00%;292;8;2,74%;284;97,26%
MULTIPOLYGON (((-58.48485398785725 -34.548496250859365,-58.484608173527377 -34.548821099124822,-58.485409661594588 -34.549262663448047,-58.485532247313181 -34.549328136599271,-58.486464500908511 -34.549825869236848,-58.487251356812635 -34.550228690046794,-58.487399398984955 -34.550305776449491,-58.487661346624712 -34.550442208393626,-58.48824876507647 -34.549674938544889,-58.488492109354411 -34.549382408970658,-58.488872607942625 -34.548925123578329,-58.487610988646928 -34.548263736838145,-58.486028033558448 -34.547433376783665,-58.485763969217253 -34.547293561225047,-58.485183864457724 -34.548060325093502,-58.48485398785725 -34.548496250859365)));;865;12_3_6;COMUNA 12;3;6;1820;890;930;95,70%;347;346;99,71%;1;0,29%;451;30;6,65%;421;93,35%
MULTIPOLYGON (((-58.485532247313181 -34.549328136599271,-58.485409661594588 -34.549262663448047,-58.484608173527377 -34.548821099124822,-58.484014433448991 -34.549605818278614,-58.48419907732319 -34.549704241197503,-58.4847345321337 -34.549965495937485,-58.484963612477934 -34.550077290571046,-58.485138296230602 -34.550162544250924,-58.485902846413303 -34.550559532484684,-58.486835452785208 -34.55104465590108,-58.486940108605523 -34.550907516136967,-58.487399398984955 -34.550305776449491,-58.487251356812635 -34.550228690046794,-58.486464500908511 -34.549825869236848,-58.485532247313181 -34.549328136599271)));;866;12_3_7;COMUNA 12;3;7;1009;448;561;79,86%;422;422;100,00%;0;0,00%;378;4;1,06%;374;98,94%
MULTIPOLYGON (((-58.482755730622294 -34.547856653983423,-58.482279368591726 -34.547609818307969,-58.481829142832062 -34.54737727311791,-58.481186028324437 -34.547045103041214,-58.480902821499697 -34.546900138769018,-58.479962294024077 -34.546409759302499,-58.479394054488637 -34.547157972109268,-58.480333906772231 -34.547651384300252,-58.481082493733815 -34.548044390920218,-58.481256745346343 -34.548137044960626,-58.482175765213377 -34.548626079654838,-58.482640131403755 -34.54887312892938,-58.483093263632874 -34.549114685090089,-58.484014433448991 -34.549605818278614,-58.484608173527377 -34.548821099124822,-58.484463966173152 -34.548741684582339,-58.483677306739438 -34.548334127141658,-58.482755730622294 -34.547856653983423)));;867;12_3_8;COMUNA 12;3;8;724;330;394;83,76%;303;302;99,67%;1;0,33%;253;3;1,19%;250;98,81%
MULTIPOLYGON (((-58.478203764739099 -34.548725033468237,-58.477629707124166 -34.549480703660322,-58.477253491475864 -34.549972462125787,-58.477041426773525 -34.550249612784931,-58.477099996181792 -34.550299115235617,-58.477143163099193 -34.550370240203861,-58.47720685752423 -34.550522352396818,-58.47730622386721 -34.550715941089564,-58.477448324209078 -34.550933258036181,-58.477580366779073 -34.551068952533967,-58.477664562346305 -34.551144227423897,-58.477742202885324 -34.551213657721284,-58.478018024094027 -34.551416308874302,-58.478220460726575 -34.551546923160132,-58.478452090892453 -34.551662039670212,-58.478542921136089 -34.551705691910016,-58.478685764043128 -34.551774479291062,-58.478936287994856 -34.551869239349514,-58.479217624713634 -34.551958994496864,-58.479374931805701 -34.551992214087612,-58.479589781022291 -34.552031904701906,-58.479684948056757 -34.552049497947706,-58.480106129688899 -34.552101764992287,-58.480471210433443 -34.552117980758524,-58.480585648499741 -34.55212615647504,-58.480786760373022 -34.552171382863456,-58.480936702009252 -34.552108969326113,-58.481263139724838 -34.552025577918776,-58.481667945052884 -34.551919692968852,-58.482059802247925 -34.551782089896889,-58.482215791600211 -34.551705614231977,-58.482268922732374 -34.55167884453224,-58.482374030184786 -34.551627216763237,-58.482581913240708 -34.551435075928339,-58.482721454227736 -34.551241113210097,-58.4827978236139 -34.55113615196219,-58.482798103710302 -34.550983553354946,-58.482797776013022 -34.550938180551192,-58.482776135207843 -34.550855894784739,-58.4827040450919 -34.550615805260193,-58.482581512218857 -34.550413280655839,-58.482434722462216 -34.55021505581896,-58.482340986378873 -34.55012274269631,-58.482226562253011 -34.550010150176696,-58.482007688281143 -34.549848416891003,-58.4817755373249 -34.549688516354614,-58.481600938775884 -34.549584102021115,-58.481492403151869 -34.549532496649739,-58.481598086564176 -34.549392332960643,-58.482175765213377 -34.548626079654838,-58.481256745346343 -34.548137044960626,-58.481082493733815 -34.548044390920218,-58.480333906772231 -34.547651384300252,-58.479394054488637 -34.547157972109268,-58.478971910079366 -34.547713759411927,-58.478796958049934 -34.547944145514762,-58.478203764739099 -34.548725033468237)));;868;12_3_9;COMUNA 12;3;9;669;325;344;94,48%;235;234;99,57%;1;0,43%;223;2;0,90%;221;99,10%
MULTIPOLYGON (((-58.480510362374964 -34.543714271305305,-58.480311884179159 -34.544120375729925,-58.480105236335575 -34.544540918274357,-58.4797009526404 -34.545363760674576,-58.479296746075541 -34.546186460764339,-58.479962294024077 -34.546409759302499,-58.480551540362605 -34.545633863328099,-58.481129203878211 -34.544873178150205,-58.481711706787337 -34.54410615106395,-58.482296666439979 -34.543335810693428,-58.482844774492968 -34.542613996953499,-58.482842941000932 -34.54261321202241,-58.483089199333413 -34.542265584278695,-58.483350361981834 -34.541896913307781,-58.481744852307855 -34.541188060673569,-58.481537596139489 -34.541596611001339,-58.481308575020478 -34.542048060050028,-58.481322120577261 -34.542052803368428,-58.480915224631424 -34.54288558056988,-58.480510362374964 -34.543714271305305)));;869;12_4_1;COMUNA 12;4;1;769;377;392;96,17%;284;284;100,00%;0;0,00%;277;0;0,00%;277;100,00%
MULTIPOLYGON (((-58.479394054488637 -34.547157972109268,-58.477900295260604 -34.546682581442631,-58.47735315141265 -34.546502710275234,-58.47688934041954 -34.54634832115493,-58.475888862778142 -34.546015248586414,-58.475484106069125 -34.546845823727729,-58.475084701933078 -34.547665410441475,-58.476078387623716 -34.548002997504526,-58.477097447270168 -34.548349165423623,-58.478203764739099 -34.548725033468237,-58.478796958049934 -34.547944145514762,-58.478971910079366 -34.547713759411927,-58.479394054488637 -34.547157972109268)));;870;12_4_10;COMUNA 12;4;10;630;312;318;98,11%;293;292;99,66%;1;0,34%;243;0;0,00%;243;100,00%
MULTIPOLYGON (((-58.478703793795042 -34.545024583602981,-58.478363814803878 -34.545715857560154,-58.478297963023181 -34.545853266844517,-58.477900295260604 -34.546682581442631,-58.479394054488637 -34.547157972109268,-58.479962294024077 -34.546409759302499,-58.479296746075541 -34.546186460764339,-58.4797009526404 -34.545363760674576,-58.480105236335575 -34.544540918274357,-58.480311884179159 -34.544120375729925,-58.480510362374964 -34.543714271305305,-58.480915224631424 -34.54288558056988,-58.481322120577261 -34.542052803368428,-58.481308575020478 -34.542048060050028,-58.481537596139489 -34.541596611001339,-58.481744852307855 -34.541188060673569,-58.480740784654479 -34.540744735344404,-58.480558915049293 -34.541174637241461,-58.480318960653669 -34.541741832274596,-58.480306361136044 -34.541738924929803,-58.479911112877545 -34.542553456842271,-58.479507434445182 -34.543385242871217,-58.479314227457103 -34.543783386846286,-58.479104172255838 -34.544210477790848,-58.478703793795042 -34.545024583602981)));;871;12_4_2;COMUNA 12;4;2;788;386;402;96,02%;327;327;100,00%;0;0,00%;287;12;4,18%;275;95,82%
MULTIPOLYGON (((-58.47688934041954 -34.54634832115493,-58.47735315141265 -34.546502710275234,-58.477900295260604 -34.546682581442631,-58.478297963023181 -34.545853266844517,-58.478363814803878 -34.545715857560154,-58.478703793795042 -34.545024583602981,-58.479104172255838 -34.544210477790848,-58.479314227457103 -34.543783386846286,-58.479507434445182 -34.543385242871217,-58.478502982315398 -34.543055642971126,-58.47776630968815 -34.542813963989211,-58.477507049515822 -34.54272842823768,-58.477417206324162 -34.542915138147166,-58.477102663650676 -34.543549853777172,-58.476704735195504 -34.544352614269975,-58.476366698466244 -34.545034586307224,-58.476294292105884 -34.545183192973234,-58.476090429810881 -34.545601615567371,-58.475888862778142 -34.546015248586414,-58.47688934041954 -34.54634832115493)));;872;12_4_3;COMUNA 12;4;3;1088;512;576;88,89%;471;469;99,58%;2;0,43%;418;0;0,00%;418;100,00%
MULTIPOLYGON (((-58.479454295937465 -34.541114226121572,-58.479310351134785 -34.541408062695353,-58.478303880044919 -34.541073672359452,-58.477302949333875 -34.540741104120357,-58.47690206059653 -34.541562951399357,-58.476698635509223 -34.541980177964447,-58.476496314409992 -34.54239493913115,-58.477507049515822 -34.54272842823768,-58.47776630968815 -34.542813963989211,-58.478502982315398 -34.543055642971126,-58.479507434445182 -34.543385242871217,-58.479911112877545 -34.542553456842271,-58.480306361136044 -34.541738924929803,-58.480318960653669 -34.541741832274596,-58.480558915049293 -34.541174637241461,-58.480740784654479 -34.540744735344404,-58.479730323955195 -34.540298574182685,-58.47959738556213 -34.54073432060796,-58.47951081846066 -34.541018068344428,-58.479502446364776 -34.541010482132521,-58.479454295937465 -34.541114226121572)));;873;12_4_4;COMUNA 12;4;4;952;467;485;96,29%;331;329;99,40%;2;0,61%;295;2;0,68%;293;99,32%
MULTIPOLYGON (((-58.477302949333875 -34.540741104120357,-58.478303880044919 -34.541073672359452,-58.479310351134785 -34.541408062695353,-58.479454295937465 -34.541114226121572,-58.479502446364776 -34.541010482132521,-58.47951081846066 -34.541018068344428,-58.47959738556213 -34.54073432060796,-58.479734991038377 -34.540299220350327,-58.477877113563352 -34.539480269173708,-58.475912447832307 -34.538612685910401,-58.475761150095153 -34.538830328132789,-58.475411310059592 -34.539333568928015,-58.475411468099416 -34.539333642214359,-58.475408016355324 -34.539338306849309,-58.474927393179172 -34.539987807699617,-58.475414906154988 -34.540121128939163,-58.475383172019257 -34.540183048840781,-58.475346905310431 -34.540259979288017,-58.475012726438763 -34.540945662101336,-58.474818230042011 -34.541364434046642,-58.474718683866044 -34.541578609080503,-58.474623304837365 -34.541773979901613,-58.475622449881868 -34.542106006829712,-58.475894898936389 -34.542196545406341,-58.476496314409992 -34.54239493913115,-58.476698635509223 -34.541980177964447,-58.47690206059653 -34.541562951399357,-58.477302949333875 -34.540741104120357)));;874;12_4_5;COMUNA 12;4;5;606;283;323;87,62%;298;298;100,00%;0;0,00%;249;2;0,80%;247;99,20%
MULTIPOLYGON (((-58.477507049515822 -34.54272842823768,-58.476496314409992 -34.54239493913115,-58.475894898936389 -34.542196545406341,-58.475622449881868 -34.542106006829712,-58.474623304837365 -34.541773979901613,-58.474221108552079 -34.542598635407636,-58.473834390207976 -34.543391314714448,-58.474806485231753 -34.543716801085125,-58.475709729247455 -34.544019257790559,-58.476554504936566 -34.544302136052565,-58.476704735195504 -34.544352614269975,-58.477102663650676 -34.543549853777172,-58.477417206324162 -34.542915138147166,-58.477507049515822 -34.54272842823768)));;875;12_4_6;COMUNA 12;4;6;760;344;416;82,69%;368;367;99,73%;1;0,27%;297;2;0,67%;295;99,33%
MULTIPOLYGON (((-58.474356006540582 -34.540759872552037,-58.473786311236012 -34.541529751277579,-58.473236007098613 -34.542273427142277,-58.472691905207533 -34.543008648822763,-58.472093926708496 -34.543816692512557,-58.471537039808531 -34.544569305037278,-58.472724933567363 -34.544965582710752,-58.472724992362728 -34.544965429251597,-58.472871391246869 -34.545014222273288,-58.472965444115339 -34.545045624340929,-58.473404687630875 -34.544217941744087,-58.473732455300841 -34.54360020715,-58.473834390207976 -34.543391314714448,-58.474221108552079 -34.542598635407636,-58.474623304837365 -34.541773979901613,-58.474718683866044 -34.541578609080503,-58.474818230042011 -34.541364434046642,-58.475012726438763 -34.540945662101336,-58.475346905310431 -34.540259979288017,-58.475383172019257 -34.540183048840781,-58.475414906154988 -34.540121128939163,-58.474927393179172 -34.539987807699617,-58.474677311779253 -34.540325736078266,-58.474356006540582 -34.540759872552037)));;876;12_4_7;COMUNA 12;4;7;1071;476;595;80,00%;653;653;100,00%;0;0,00%;499;3;0,60%;496;99,40%
MULTIPOLYGON (((-58.473404687630875 -34.544217941744087,-58.472965444115339 -34.545045624340929,-58.473635987745709 -34.545269168262713,-58.47390546583005 -34.545358302978876,-58.474901075731239 -34.545687659751437,-58.4754951088319 -34.545884157530246,-58.475888862778142 -34.546015248586414,-58.476090429810881 -34.545601615567371,-58.476294292105884 -34.545183192973234,-58.476366698466244 -34.545034586307224,-58.476704735195504 -34.544352614269975,-58.476554504936566 -34.544302136052565,-58.475709729247455 -34.544019257790559,-58.474806485231753 -34.543716801085125,-58.473834390207976 -34.543391314714448,-58.473732455300841 -34.54360020715,-58.473404687630875 -34.544217941744087)));;877;12_4_8;COMUNA 12;4;8;786;376;410;91,71%;355;355;100,00%;0;0,00%;289;11;3,81%;278;96,19%
MULTIPOLYGON (((-58.473509200119985 -34.546159362451633,-58.473100928763358 -34.546984929752227,-58.474100557262481 -34.547329011621258,-58.474576285934631 -34.547492706362121,-58.475084701933078 -34.547665410441475,-58.475484106069125 -34.546845823727729,-58.475888862778142 -34.546015248586414,-58.4754951088319 -34.545884157530246,-58.474901075731239 -34.545687659751437,-58.47390546583005 -34.545358302978876,-58.473509200119985 -34.546159362451633)));;878;12_4_9;COMUNA 12;4;9;594;264;330;80,00%;279;279;100,00%;0;0,00%;224;1;0,45%;223;99,55%
MULTIPOLYGON (((-58.477097447270168 -34.548349165423623,-58.476078387623716 -34.548002997504526,-58.475084701933078 -34.547665410441475,-58.47468129070775 -34.54849323595495,-58.474295825970842 -34.549284084765191,-58.474247577432806 -34.54937500907198,-58.474102405700435 -34.54964848616784,-58.475168356746067 -34.549859800271165,-58.476223162437421 -34.550068852669767,-58.476889398794896 -34.550202374828167,-58.477041426773525 -34.550249612784931,-58.477253491475864 -34.549972462125787,-58.477629707124166 -34.549480703660322,-58.478203764739099 -34.548725033468237,-58.477097447270168 -34.548349165423623)));;879;12_5_1;COMUNA 12;5;1;622;298;324;91,98%;256;256;100,00%;0;0,00%;212;0;0,00%;212;100,00%
MULTIPOLYGON (((-58.475202125622161 -34.551415714135473,-58.474509557663353 -34.55232448706834,-58.474435942685624 -34.552420907066463,-58.475101804180284 -34.552789238518166,-58.475173886805472 -34.552694508499791,-58.475878534655209 -34.551767560696739,-58.476269488306635 -34.551253127866438,-58.476460708838182 -34.551004573819114,-58.477041426773525 -34.550249612784931,-58.476889398794896 -34.550202374828167,-58.476223162437421 -34.550068852669767,-58.475168356746067 -34.549859800271165,-58.474102405700435 -34.54964848616784,-58.474015339558918 -34.549711243669833,-58.474909562871858 -34.550184418992956,-58.474321934137102 -34.550957962967907,-58.475202125622161 -34.551415714135473)));;880;12_5_10;COMUNA 12;5;10;695;327;368;88,86%;326;326;100,00%;0;0,00%;284;26;9,15%;258;90,85%
MULTIPOLYGON (((-58.472585329041024 -34.550052721737508,-58.471712912138635 -34.549597415931174,-58.471069172674419 -34.550443698317643,-58.471007640578918 -34.550524621772453,-58.471863552352936 -34.550998033219024,-58.472703555560251 -34.551462707133929,-58.473572851241194 -34.551943570560532,-58.474435942685624 -34.552420907066463,-58.474509557663353 -34.55232448706834,-58.475202125622161 -34.551415714135473,-58.474321934137102 -34.550957962967907,-58.473700613273614 -34.550634766087519,-58.473429324186725 -34.55049316393108,-58.472585329041024 -34.550052721737508)));;881;12_5_11;COMUNA 12;5;11;793;365;428;85,28%;377;377;100,00%;0;0,00%;332;31;9,34%;301;90,66%
MULTIPOLYGON (((-58.472686863564192 -34.547827609529463,-58.472129146284651 -34.548953903768492,-58.47199231008387 -34.549230194763979,-58.473052632621837 -34.549440400968066,-58.474102405700435 -34.54964848616784,-58.474247577432806 -34.54937500907198,-58.474295825970842 -34.549284084765191,-58.47468129070775 -34.54849323595495,-58.475084701933078 -34.547665410441475,-58.474576285934631 -34.547492706362121,-58.474100557262481 -34.547329011621258,-58.473100928763358 -34.546984929752227,-58.472895939130041 -34.547399473566387,-58.472686863564192 -34.547827609529463)));;882;12_5_2;COMUNA 12;5;2;658;302;356;84,83%;356;356;100,00%;0;0,00%;283;9;3,18%;274;96,82%
MULTIPOLYGON (((-58.471688512896471 -34.547495206711041,-58.470679360292941 -34.547159204699518,-58.470049374177798 -34.54847733423145,-58.470022908243216 -34.548535155428233,-58.469894918100138 -34.54881447187244,-58.470418732156553 -34.548918317977133,-58.470952336077232 -34.549024062668884,-58.47199231008387 -34.549230194763979,-58.472129146284651 -34.548953903768492,-58.472686863564192 -34.547827609529463,-58.472895939130041 -34.547399473566387,-58.473100928763358 -34.546984929752227,-58.472097988930919 -34.546639783546702,-58.471894613743594 -34.547067072657718,-58.471688512896471 -34.547495206711041)));;883;12_5_3;COMUNA 12;5;3;1358;656;702;93,45%;665;665;100,00%;0;0,00%;543;2;0,37%;541;99,63%
MULTIPOLYGON (((-58.472496479105004 -34.545802247940657,-58.472097988930919 -34.546639783546702,-58.473100928763358 -34.546984929752227,-58.473509200119985 -34.546159362451633,-58.47390546583005 -34.545358302978876,-58.473635987745709 -34.545269168262713,-58.472965444115339 -34.545045624340929,-58.472871391246869 -34.545014222273288,-58.472496479105004 -34.545802247940657)));;884;12_5_4;COMUNA 12;5;4;657;298;359;83,01%;313;313;100,00%;0;0,00%;277;2;0,72%;275;99,28%
MULTIPOLYGON (((-58.471053350305112 -34.546280194642463,-58.472097988930919 -34.546639783546702,-58.472496479105004 -34.545802247940657,-58.472871391246869 -34.545014222273288,-58.472724992362728 -34.544965429251597,-58.472724933567363 -34.544965582710752,-58.471537039808531 -34.544569305037278,-58.471012566490423 -34.545278952949005,-58.470430895342488 -34.54606600017982,-58.470820750233244 -34.546200418625133,-58.471053350305112 -34.546280194642463)));;885;12_5_5;COMUNA 12;5;5;694;300;394;76,14%;436;436;100,00%;0;0,00%;348;2;0,57%;346;99,43%
MULTIPOLYGON (((-58.471053350305112 -34.546280194642463,-58.470820750233244 -34.546200418625133,-58.470430895342488 -34.54606600017982,-58.469939507387338 -34.54671542710841,-58.469400706611808 -34.547410490548373,-58.469128962436905 -34.547761084994733,-58.46884785344615 -34.548113792063226,-58.468718659964829 -34.54827591876947,-58.468663322020241 -34.548345361747231,-58.468553741556313 -34.548482872648975,-58.468553039656761 -34.548483753450547,-58.468508527994246 -34.548539603259528,-58.469894918100138 -34.54881447187244,-58.470022908243216 -34.548535155428233,-58.470049374177798 -34.54847733423145,-58.470679360292941 -34.547159204699518,-58.471688512896471 -34.547495206711041,-58.471894613743594 -34.547067072657718,-58.472097988930919 -34.546639783546702,-58.471053350305112 -34.546280194642463)));;886;12_5_6;COMUNA 12;5;6;635;279;356;78,37%;424;424;100,00%;0;0,00%;301;2;0,66%;299;99,34%
MULTIPOLYGON (((-58.470418732156553 -34.548918317977133,-58.469894918100138 -34.54881447187244,-58.468508527994246 -34.548539603259528,-58.468225881807179 -34.548894280847655,-58.468189284851512 -34.548939988859246,-58.468372974881333 -34.549075761453061,-58.469302655753367 -34.549581442540521,-58.470157356515053 -34.550054232254965,-58.47023939997586 -34.549946968703331,-58.470847910246256 -34.549145976782441,-58.471712912138635 -34.549597415931174,-58.47199231008387 -34.549230194763979,-58.470952336077232 -34.549024062668884,-58.470418732156553 -34.548918317977133)));;887;12_5_7;COMUNA 12;5;7;759;348;411;84,67%;401;400;99,75%;1;0,25%;327;10;3,06%;317;96,94%
MULTIPOLYGON (((-58.471712912138635 -34.549597415931174,-58.470847910246256 -34.549145976782441,-58.47023939997586 -34.549946968703331,-58.470157356515053 -34.550054232254965,-58.471007640578918 -34.550524621772453,-58.471069172674419 -34.550443698317643,-58.471712912138635 -34.549597415931174)));;888;12_5_8;COMUNA 12;5;8;997;433;564;76,77%;499;498;99,80%;1;0,20%;421;1;0,24%;420;99,76%
MULTIPOLYGON (((-58.474909562871858 -34.550184418992956,-58.474015339558918 -34.549711243669833,-58.474102405700435 -34.54964848616784,-58.473052632621837 -34.549440400968066,-58.47199231008387 -34.549230194763979,-58.471712912138635 -34.549597415931174,-58.472585329041024 -34.550052721737508,-58.473429324186725 -34.55049316393108,-58.473700613273614 -34.550634766087519,-58.474321934137102 -34.550957962967907,-58.474909562871858 -34.550184418992956)));;889;12_5_9;COMUNA 12;5;9;769;363;406;89,41%;352;352;100,00%;0;0,00%;311;9;2,89%;302;97,11%
MULTIPOLYGON (((-58.483849872058663 -34.554867779901606,-58.483306985348342 -34.555651781769875,-58.484214349433977 -34.556127703279067,-58.485084859169483 -34.556581299810333,-58.485628754718427 -34.555790036117237,-58.486279441208666 -34.554901773060259,-58.485956741822001 -34.554899017924697,-58.485359949096605 -34.554583834031774,-58.484486051746181 -34.554122281802627,-58.484139978891498 -34.554575603263096,-58.483952005586445 -34.554815928810633,-58.483849872058663 -34.554867779901606)));;890;12_6_1;COMUNA 12;6;1;789;337;452;74,56%;386;386;100,00%;0;0,00%;320;0;0,00%;320;100,00%
MULTIPOLYGON (((-58.482446467030947 -34.558494376869653,-58.483407757258355 -34.55903135450135,-58.484347799333278 -34.557678806433067,-58.485084859169483 -34.556581299810333,-58.484214349433977 -34.556127703279067,-58.483306985348342 -34.555651781769875,-58.482832744942947 -34.556276114676152,-58.482458232078457 -34.556768944736177,-58.482346328399387 -34.556916293427413,-58.481536355937969 -34.557985835725056,-58.482446467030947 -34.558494376869653)));;891;12_6_10;COMUNA 12;6;10;774;361;413;87,41%;353;353;100,00%;0;0,00%;316;2;0,63%;314;99,37%
MULTIPOLYGON (((-58.482716668904708 -34.555346373080688,-58.482998289805373 -34.555489854262383,-58.483306985348342 -34.555651781769875,-58.483849872058663 -34.554867779901606,-58.483952005586445 -34.554815928810633,-58.484139978891498 -34.554575603263096,-58.484486051746181 -34.554122281802627,-58.485072248218472 -34.553354394073104,-58.48414166879919 -34.55286777807887,-58.483212973417807 -34.552383478685535,-58.483077251064039 -34.55256238290108,-58.482634255572002 -34.553144243388672,-58.482039699312423 -34.553925219960675,-58.481456534953253 -34.554691261529229,-58.482385925882248 -34.555171700567868,-58.482716668904708 -34.555346373080688)));;892;12_6_2;COMUNA 12;6;2;870;401;469;85,50%;478;478;100,00%;0;0,00%;353;2;0,57%;351;99,43%
MULTIPOLYGON (((-58.480186832350711 -34.552960525457479,-58.479604423821904 -34.553726558194484,-58.480529878523328 -34.554210462848268,-58.480827156824247 -34.554365848732125,-58.481456534953253 -34.554691261529229,-58.482039699312423 -34.553925219960675,-58.482634255572002 -34.553144243388672,-58.483077251064039 -34.55256238290108,-58.483212973417807 -34.552383478685535,-58.482280457969004 -34.551897200878535,-58.482059802247925 -34.551782089896889,-58.481667945052884 -34.551919692968852,-58.481263139724838 -34.552025577918776,-58.480936702009252 -34.552108969326113,-58.480786760373022 -34.552171382863456,-58.480786759831474 -34.552171387595948,-58.480186832350711 -34.552960525457479)));;893;12_6_3;COMUNA 12;6;3;686;319;367;86,92%;305;305;100,00%;0;0,00%;257;1;0,39%;256;99,61%
MULTIPOLYGON (((-58.477748182170203 -34.552748587067825,-58.47867421199107 -34.553236942620714,-58.479401218527542 -34.553620313672774,-58.479604423821904 -34.553726558194484,-58.480186832350711 -34.552960525457479,-58.480786759831474 -34.552171387595948,-58.480786760373022 -34.552171382863456,-58.480585648499741 -34.55212615647504,-58.480471210433443 -34.552117980758524,-58.480106129688899 -34.552101764992287,-58.479684948056757 -34.552049497947706,-58.479589781022291 -34.552031904701906,-58.479374931805701 -34.551992214087612,-58.479217624713634 -34.551958994496864,-58.478936287994856 -34.551869239349514,-58.478685764043128 -34.551774479291062,-58.478542921136089 -34.551705691910016,-58.478452090892453 -34.551662039670212,-58.478220460726575 -34.551546923160132,-58.478018024094027 -34.551416308874302,-58.477742202885324 -34.551213657721284,-58.477664562346305 -34.551144227423897,-58.477580366779073 -34.551068952533967,-58.477448324209078 -34.550933258036181,-58.47730622386721 -34.550715941089564,-58.47720685752423 -34.550522352396818,-58.477143163099193 -34.550370240203861,-58.477099996181792 -34.550299115235617,-58.477041426773525 -34.550249612784931,-58.476460708838182 -34.551004573819114,-58.476269488306635 -34.551253127866438,-58.475878534655209 -34.551767560696739,-58.476556737042642 -34.552120318821601,-58.476818077071229 -34.552258112148735,-58.477748182170203 -34.552748587067825)));;894;12_6_4;COMUNA 12;6;4;950;436;514;84,82%;354;354;100,00%;0;0,00%;349;2;0,57%;347;99,43%
MULTIPOLYGON (((-58.477748182170203 -34.552748587067825,-58.476818077071229 -34.552258112148735,-58.476118031114368 -34.553179430730971,-58.47602603516799 -34.553300854842753,-58.476941168674564 -34.553807605810384,-58.477855206580095 -34.554313716179522,-58.478772064885334 -34.554821368657805,-58.479684422321888 -34.555326549932083,-58.480590746313062 -34.555828344793639,-58.480675164736915 -34.555717552696805,-58.481456534953253 -34.554691261529229,-58.480827156824247 -34.554365848732125,-58.480529878523328 -34.554210462848268,-58.479604423821904 -34.553726558194484,-58.479401218527542 -34.553620313672774,-58.47867421199107 -34.553236942620714,-58.477748182170203 -34.552748587067825)));;895;12_6_5;COMUNA 12;6;5;1001;481;520;92,50%;475;475;100,00%;0;0,00%;387;3;0,78%;384;99,22%
MULTIPOLYGON (((-58.474252033844088 -34.553905711245903,-58.475176102651538 -34.554423460966341,-58.476080347621313 -34.554930078552488,-58.476295236763818 -34.554655112657393,-58.476941168674564 -34.553807605810384,-58.47602603516799 -34.553300854842753,-58.476118031114368 -34.553179430730971,-58.476818077071229 -34.552258112148735,-58.476556737042642 -34.552120318821601,-58.475878534655209 -34.551767560696739,-58.475173886805472 -34.552694508499791,-58.475101804180284 -34.552789238518166,-58.474435942685624 -34.552420907066463,-58.473586166729007 -34.553533783514055,-58.473929059385377 -34.553724747150966,-58.474252033844088 -34.553905711245903)));;896;12_6_6;COMUNA 12;6;6;983;442;541;81,70%;425;425;100,00%;0;0,00%;380;2;0,53%;378;99,47%
MULTIPOLYGON (((-58.477855206580095 -34.554313716179522,-58.476941168674564 -34.553807605810384,-58.476295236763818 -34.554655112657393,-58.476080347621313 -34.554930078552488,-58.476990562729533 -34.555440069135642,-58.477910068327503 -34.555955192811254,-58.478772064885334 -34.554821368657805,-58.477855206580095 -34.554313716179522)));;897;12_6_7;COMUNA 12;6;7;736;335;401;83,54%;401;401;100,00%;0;0,00%;332;2;0,60%;330;99,40%
MULTIPOLYGON (((-58.47935434752344 -34.556764266508331,-58.479721274671498 -34.556969859045012,-58.480137759390793 -34.556423014865693,-58.480590746313062 -34.555828344793639,-58.479684422321888 -34.555326549932083,-58.478772064885334 -34.554821368657805,-58.477910068327503 -34.555955192811254,-58.478816900427859 -34.556463198190933,-58.47935434752344 -34.556764266508331)));;898;12_6_8;COMUNA 12;6;8;733;343;390;87,95%;314;314;100,00%;0;0,00%;288;1;0,35%;287;99,65%
MULTIPOLYGON (((-58.482716668904708 -34.555346373080688,-58.482385925882248 -34.555171700567868,-58.481456534953253 -34.554691261529229,-58.480675164736915 -34.555717552696805,-58.480590746313062 -34.555828344793639,-58.480137759390793 -34.556423014865693,-58.479721274671498 -34.556969859045012,-58.480525796410333 -34.557420539323836,-58.480628384209481 -34.557478062120609,-58.480805550692359 -34.557577406674191,-58.481536355937969 -34.557985835725056,-58.482346328399387 -34.556916293427413,-58.482458232078457 -34.556768944736177,-58.482832744942947 -34.556276114676152,-58.483306985348342 -34.555651781769875,-58.482998289805373 -34.555489854262383,-58.482716668904708 -34.555346373080688)));;899;12_6_9;COMUNA 12;6;9;725;319;406;78,57%;369;369;100,00%;0;0,00%;302;2;0,66%;300;99,34%
MULTIPOLYGON (((-58.478816900427859 -34.556463198190933,-58.477910068327503 -34.555955192811254,-58.476990562729533 -34.555440069135642,-58.476080347621313 -34.554930078552488,-58.475612863100082 -34.555528184377479,-58.475491587464731 -34.555688556571596,-58.474980352390396 -34.556364837048321,-58.475902916605328 -34.556856875814177,-58.476843199235745 -34.557358342564086,-58.477039344713567 -34.557462901889203,-58.477357825574401 -34.557625899622956,-58.477614671375889 -34.557757353342595,-58.477766634630903 -34.557839239799144,-58.478114454353559 -34.557365794659873,-58.478237007530446 -34.557223026174583,-58.47935434752344 -34.556764266508331,-58.478816900427859 -34.556463198190933)));;900;12_7_1;COMUNA 12;7;1;836;377;459;82,14%;385;385;100,00%;0;0,00%;318;4;1,26%;314;98,74%
MULTIPOLYGON (((-58.46945173419202 -34.562705060168305,-58.46876359880202 -34.56349766668491,-58.468610375449849 -34.563675006001681,-58.469610891692355 -34.564327447123731,-58.470439189978535 -34.564867562117449,-58.471422873252038 -34.563839703897379,-58.47219509362958 -34.563032779516924,-58.471216291132073 -34.562481277907139,-58.470978424583045 -34.562347274219185,-58.470160200387312 -34.56188920795708,-58.46945173419202 -34.562705060168305)));;901;12_7_10;COMUNA 12;7;10;1092;498;594;83,84%;616;616;100,00%;0;0,00%;476;11;2,31%;465;97,69%
MULTIPOLYGON (((-58.475176102651538 -34.554423460966341,-58.474252033844088 -34.553905711245903,-58.473929059385377 -34.553724747150966,-58.473586166729007 -34.553533783514055,-58.472983692928523 -34.554322745192174,-58.472743006622416 -34.554637990934125,-58.472449464916309 -34.555016623597403,-58.472916987592576 -34.555265117854006,-58.473134490477804 -34.555381020246223,-58.474072526468269 -34.555880888859136,-58.474529417653414 -34.556124377667366,-58.474980352390396 -34.556364837048321,-58.475491587464731 -34.555688556571596,-58.475612863100082 -34.555528184377479,-58.476080347621313 -34.554930078552488,-58.475176102651538 -34.554423460966341)));;902;12_7_2;COMUNA 12;7;2;836;402;434;92,63%;338;338;100,00%;0;0,00%;310;1;0,32%;309;99,68%
MULTIPOLYGON (((-58.474072526468269 -34.555880888859136,-58.473134490477804 -34.555381020246223,-58.472916987592576 -34.555265117854006,-58.472449464916309 -34.555016623597403,-58.471849947313871 -34.555790085590999,-58.471555971285845 -34.556162941157005,-58.470872088108685 -34.557030140945152,-58.470068423522385 -34.557944388450288,-58.469649646190582 -34.558420772567139,-58.46918421726712 -34.558928497138304,-58.470100815358798 -34.55940445237151,-58.470224067221125 -34.559272678343362,-58.470851889329481 -34.558526477636988,-58.470954540335832 -34.558415761515477,-58.471061702235275 -34.558300044770895,-58.471910838432642 -34.557589036006057,-58.471789613291349 -34.557523830869407,-58.472781743677416 -34.556809002238964,-58.474072526468269 -34.555880888859136)));;903;12_7_3;COMUNA 12;7;3;879;400;479;83,51%;379;378;99,74%;1;0,26%;325;2;0,62%;323;99,38%
MULTIPOLYGON (((-58.470954540335832 -34.558415761515477,-58.470851889329481 -34.558526477636988,-58.470224067221125 -34.559272678343362,-58.470100815358798 -34.55940445237151,-58.471428441114526 -34.560093761855256,-58.472270315262861 -34.559764810752597,-58.472634009822769 -34.55930905697825,-58.473366153352735 -34.558391770754234,-58.473452542172119 -34.558283589275774,-58.474044499273496 -34.557602730260584,-58.474121438416738 -34.55750102833948,-58.474980352390396 -34.556364837048321,-58.474529417653414 -34.556124377667366,-58.474072526468269 -34.555880888859136,-58.472781743677416 -34.556809002238964,-58.471789613291349 -34.557523830869407,-58.471910838432642 -34.557589036006057,-58.471061702235275 -34.558300044770895,-58.470954540335832 -34.558415761515477)));;904;12_7_4;COMUNA 12;7;4;944;444;500;88,80%;404;404;100,00%;0;0,00%;359;8;2,23%;351;97,77%
MULTIPOLYGON (((-58.475902916605328 -34.556856875814177,-58.474980352390396 -34.556364837048321,-58.474121438416738 -34.55750102833948,-58.474044499273496 -34.557602730260584,-58.473452542172119 -34.558283589275774,-58.473366153352735 -34.558391770754234,-58.472634009822769 -34.55930905697825,-58.472270315262861 -34.559764810752597,-58.472953426374524 -34.559478967794952,-58.474324317348369 -34.558913185689462,-58.475659094512864 -34.558335137904116,-58.476310432123064 -34.558059068642187,-58.476663507735623 -34.557909374115347,-58.477357825574401 -34.557625899622956,-58.477039344713567 -34.557462901889203,-58.476843199235745 -34.557358342564086,-58.475902916605328 -34.556856875814177)));;905;12_7_5;COMUNA 12;7;5;745;350;395;88,61%;353;353;100,00%;0;0,00%;290;0;0,00%;290;100,00%
MULTIPOLYGON (((-58.47457479191776 -34.56034167651535,-58.475491693597725 -34.560830690309089,-58.476184150676616 -34.559919377752685,-58.476896252466787 -34.558982142190978,-58.477313020770268 -34.558433547148098,-58.477766634630903 -34.557839239799144,-58.477614671375889 -34.557757353342595,-58.477357825574401 -34.557625899622956,-58.476663507735623 -34.557909374115347,-58.476310432123064 -34.558059068642187,-58.475659094512864 -34.558335137904116,-58.474324317348369 -34.558913185689462,-58.472953426374524 -34.559478967794952,-58.472270315262861 -34.559764810752597,-58.471428441114526 -34.560093761855256,-58.471602285959705 -34.56022812152996,-58.472699307471814 -34.560776934449244,-58.473553016970492 -34.559797873968733,-58.47433777840272 -34.560215214791981,-58.47457479191776 -34.56034167651535)));;906;12_7_6;COMUNA 12;7;6;908;414;494;83,81%;440;440;100,00%;0;0,00%;347;10;2,88%;337;97,12%
MULTIPOLYGON (((-58.47457479191776 -34.56034167651535,-58.47433777840272 -34.560215214791981,-58.473553016970492 -34.559797873968733,-58.472699307471814 -34.560776934449244,-58.471602285959705 -34.56022812152996,-58.470927640143145 -34.561005175502537,-58.470160200387312 -34.56188920795708,-58.470978424583045 -34.562347274219185,-58.471216291132073 -34.562481277907139,-58.47219509362958 -34.563032779516924,-58.473121193638519 -34.562065055297289,-58.473818137838165 -34.561336721882519,-58.47457479191776 -34.56034167651535)));;907;12_7_7;COMUNA 12;7;7;822;379;443;85,55%;386;386;100,00%;0;0,00%;301;10;3,32%;291;96,68%
MULTIPOLYGON (((-58.468464868960076 -34.559724132419198,-58.467738612412965 -34.560533496653719,-58.468688764529027 -34.561065449393183,-58.468892060002013 -34.561179247157952,-58.4690274200563 -34.56125100398917,-58.470160200387312 -34.56188920795708,-58.470927640143145 -34.561005175502537,-58.471602285959705 -34.56022812152996,-58.471428441114526 -34.560093761855256,-58.470100815358798 -34.55940445237151,-58.46918421726712 -34.558928497138304,-58.468929965391283 -34.559205846817015,-58.468464868960076 -34.559724132419198)));;908;12_7_8;COMUNA 12;7;8;874;392;482;81,33%;445;445;100,00%;0;0,00%;365;8;2,19%;357;97,81%
MULTIPOLYGON (((-58.468892060002013 -34.561179247157952,-58.468688764529027 -34.561065449393183,-58.467738612412965 -34.560533496653719,-58.467037197982933 -34.561315107862242,-58.46768394391259 -34.56168735331935,-58.466913796287713 -34.562011270016434,-58.466490199815986 -34.562190235538701,-58.466575843256642 -34.562253615954667,-58.467540490244545 -34.562967768213412,-58.467648951279401 -34.563048119546295,-58.468610375449849 -34.563675006001681,-58.46876359880202 -34.56349766668491,-58.46945173419202 -34.562705060168305,-58.470160200387312 -34.56188920795708,-58.4690274200563 -34.56125100398917,-58.468892060002013 -34.561179247157952)));;909;12_7_9;COMUNA 12;7;9;1237;558;679;82,18%;750;749;99,87%;1;0,13%;557;7;1,26%;550;98,74%
MULTIPOLYGON (((-58.479721274671498 -34.556969859045012,-58.47935434752344 -34.556764266508331,-58.478237007530446 -34.557223026174583,-58.478114454353559 -34.557365794659873,-58.477766634630903 -34.557839239799144,-58.478685401483396 -34.558334497467804,-58.479604434632158 -34.558829888995149,-58.479713237981251 -34.558888538498017,-58.48052109536598 -34.55932640072001,-58.480065546224573 -34.559974241961648,-58.479734751305315 -34.560442830709889,-58.480675519800926 -34.560929759881596,-58.481731057520932 -34.561474271636229,-58.481843365102677 -34.561534008660772,-58.481925501238031 -34.561415644112252,-58.482116313352748 -34.561145509032343,-58.48228201739596 -34.560910006505544,-58.482430982803727 -34.560698054058669,-58.482563209829344 -34.560509651755389,-58.48260285541636 -34.560453322214769,-58.482663635116452 -34.560366964571529,-58.482834357684723 -34.560125919830789,-58.482998384987781 -34.559897065306608,-58.483223066170751 -34.559578331606133,-58.483315615953245 -34.55944640506182,-58.483409022157339 -34.559312350703244,-58.483556313885103 -34.55910266057527,-58.483505068471381 -34.559078030201093,-58.483407757258355 -34.55903135450135,-58.482446467030947 -34.558494376869653,-58.481536355937969 -34.557985835725056,-58.480805550692359 -34.557577406674191,-58.480628384209481 -34.557478062120609,-58.480525796410333 -34.557420539323836,-58.479721274671498 -34.556969859045012)));;910;12_8_1;COMUNA 12;8;1;1465;737;728;101,24%;586;586;100,00%;0;0,00%;548;7;1,28%;541;98,72%
MULTIPOLYGON (((-58.479054921530924 -34.563932022719669,-58.479005030558554 -34.56391195808262,-58.478842525203689 -34.56396698211239,-58.478777914994538 -34.563991005785589,-58.478021746124213 -34.564289496506305,-58.477397775432003 -34.564550077688317,-58.477303366875645 -34.564590854769669,-58.476878678942633 -34.56478113519119,-58.476977124927359 -34.564974089973198,-58.476662494667288 -34.565091807606585,-58.476554298276696 -34.565135483829003,-58.476254736468213 -34.565260241261171,-58.476107636242588 -34.565318429080975,-58.477177528893456 -34.565967701639352,-58.478148147065767 -34.565102826324107,-58.47911831955215 -34.564238295360063,-58.479311960115744 -34.564065796750072,-58.479054921530924 -34.563932022719669)));;911;12_8_10;COMUNA 12;8;10;731;328;403;81,39%;324;323;99,69%;1;0,31%;290;0;0,00%;290;100,00%
MULTIPOLYGON (((-58.476107636242588 -34.565318429080975,-58.475808753158418 -34.565436706182247,-58.475123633688391 -34.566218643171759,-58.476190206944445 -34.566849120984607,-58.476356024456855 -34.56669965938471,-58.477177528893456 -34.565967701639352,-58.476107636242588 -34.565318429080975)));;912;12_8_11;COMUNA 12;8;11;642;286;356;80,34%;300;300;100,00%;0;0,00%;262;1;0,38%;261;99,62%
MULTIPOLYGON (((-58.478790673476766 -34.559954204467694,-58.47870888766213 -34.56006724846268,-58.478077743006011 -34.560943777317277,-58.478587629753996 -34.561219639858862,-58.479019448711028 -34.561455297655371,-58.479734751305315 -34.560442830709889,-58.480065546224573 -34.559974241961648,-58.48052109536598 -34.55932640072001,-58.479713237981251 -34.558888538498017,-58.479604434632158 -34.558829888995149,-58.478685401483396 -34.558334497467804,-58.477766634630903 -34.557839239799144,-58.477313020770268 -34.558433547148098,-58.476896252466787 -34.558982142190978,-58.477851034463669 -34.559472049498204,-58.478790673476766 -34.559954204467694)));;913;12_8_2;COMUNA 12;8;2;745;337;408;82,60%;325;324;99,69%;1;0,31%;273;1;0,37%;272;99,63%
MULTIPOLYGON (((-58.476471947525127 -34.56135405777863,-58.475780255609052 -34.562314810492957,-58.476737706018994 -34.56279176762709,-58.476912408280569 -34.562878863960542,-58.477723945159255 -34.563288644135554,-58.478373150865835 -34.562369930150695,-58.479019448711028 -34.561455297655371,-58.478587629753996 -34.561219639858862,-58.478077743006011 -34.560943777317277,-58.47870888766213 -34.56006724846268,-58.478790673476766 -34.559954204467694,-58.477851034463669 -34.559472049498204,-58.476896252466787 -34.558982142190978,-58.476184150676616 -34.559919377752685,-58.475491693597725 -34.560830690309089,-58.476119909398633 -34.561165708282452,-58.476471947525127 -34.56135405777863)));;914;12_8_3;COMUNA 12;8;3;868;387;481;80,46%;384;384;100,00%;0;0,00%;325;3;0,92%;322;99,08%
MULTIPOLYGON (((-58.481731057520932 -34.561474271636229,-58.480675519800926 -34.560929759881596,-58.479734751305315 -34.560442830709889,-58.479019448711028 -34.561455297655371,-58.478373150865835 -34.562369930150695,-58.477723945159255 -34.563288644135554,-58.47682573054886 -34.56430090885862,-58.477106914725013 -34.564470122750507,-58.477303366875645 -34.564590854769669,-58.477397775432003 -34.564550077688317,-58.478021746124213 -34.564289496506305,-58.478777914994538 -34.563991005785589,-58.478842525203689 -34.56396698211239,-58.479005030558554 -34.56391195808262,-58.479054921530924 -34.563932022719669,-58.479541500565993 -34.56377032969165,-58.479721623305252 -34.563695935219862,-58.479910170199382 -34.563604496285684,-58.480068153412823 -34.563507216081568,-58.480372632958968 -34.563320772728353,-58.480221560788195 -34.563231945851349,-58.480141718260093 -34.563292580821162,-58.48039885750314 -34.563093295292944,-58.480661690854433 -34.562891024588353,-58.480986463582909 -34.562638878543822,-58.481153870771529 -34.562505878670109,-58.481254300556053 -34.562361807537741,-58.481409967340504 -34.562144314755393,-58.481597435337946 -34.561879721643059,-58.481783229068689 -34.56162066910597,-58.481843365102677 -34.561534008660772,-58.481731057520932 -34.561474271636229)));;915;12_8_4;COMUNA 12;8;4;769;376;393;95,67%;316;316;100,00%;0;0,00%;262;1;0,38%;261;99,62%
MULTIPOLYGON (((-58.477723945159255 -34.563288644135554,-58.476912408280569 -34.562878863960542,-58.476737706018994 -34.56279176762709,-58.476639743413592 -34.562926080593485,-58.475913540206179 -34.563747887938959,-58.47682573054886 -34.56430090885862,-58.477723945159255 -34.563288644135554)));;916;12_8_5;COMUNA 12;8;5;602;280;322;86,96%;441;441;100,00%;0;0,00%;344;1;0,29%;343;99,71%
MULTIPOLYGON (((-58.475491693597725 -34.560830690309089,-58.47457479191776 -34.56034167651535,-58.473818137838165 -34.561336721882519,-58.473121193638519 -34.562065055297289,-58.474016403842064 -34.562600492396406,-58.474418337027096 -34.562841451106273,-58.474999574047793 -34.563193874371471,-58.475780255609052 -34.562314810492957,-58.476471947525127 -34.56135405777863,-58.476119909398633 -34.561165708282452,-58.475491693597725 -34.560830690309089)));;917;12_8_6;COMUNA 12;8;6;836;376;460;81,74%;416;416;100,00%;0;0,00%;352;2;0,57%;350;99,43%
MULTIPOLYGON (((-58.474999574047793 -34.563193874371471,-58.474418337027096 -34.562841451106273,-58.474016403842064 -34.562600492396406,-58.473121193638519 -34.562065055297289,-58.47219509362958 -34.563032779516924,-58.473130489106325 -34.563559768816091,-58.474159633577379 -34.564139561374652,-58.475075648044601 -34.564695975408242,-58.475913540206179 -34.563747887938959,-58.476639743413592 -34.562926080593485,-58.476737706018994 -34.56279176762709,-58.475780255609052 -34.562314810492957,-58.474999574047793 -34.563193874371471)));;918;12_8_7;COMUNA 12;8;7;871;384;487;78,85%;440;439;99,77%;1;0,23%;364;19;5,22%;345;94,78%
MULTIPOLYGON (((-58.473130489106325 -34.563559768816091,-58.47219509362958 -34.563032779516924,-58.471422873252038 -34.563839703897379,-58.470439189978535 -34.564867562117449,-58.470649820726763 -34.56500487858191,-58.471371280699032 -34.565451961838548,-58.472420535485838 -34.566097685834237,-58.47332188724689 -34.565082918217215,-58.474159633577379 -34.564139561374652,-58.473130489106325 -34.563559768816091)));;919;12_8_8;COMUNA 12;8;8;927;440;487;90,35%;504;503;99,80%;1;0,20%;415;3;0,72%;412;99,28%
MULTIPOLYGON (((-58.472741853664516 -34.566293865619684,-58.473002120703384 -34.56644752734686,-58.473262770923505 -34.566496788057812,-58.473540430532637 -34.566548203199609,-58.473631538431896 -34.566570924148664,-58.473991632188707 -34.56666180766527,-58.474596272623195 -34.5668128520933,-58.47466568760936 -34.566734627028012,-58.475123633688391 -34.566218643171759,-58.475808753158418 -34.565436706182247,-58.476107636242588 -34.565318429080975,-58.476254736468213 -34.565260241261171,-58.476554298276696 -34.565135483829003,-58.476662494667288 -34.565091807606585,-58.476977124927359 -34.564974089973198,-58.476878678942633 -34.56478113519119,-58.477303366875645 -34.564590854769669,-58.477106914725013 -34.564470122750507,-58.47682573054886 -34.56430090885862,-58.475913540206179 -34.563747887938959,-58.475075648044601 -34.564695975408242,-58.474159633577379 -34.564139561374652,-58.47332188724689 -34.565082918217215,-58.472420535485838 -34.566097685834237,-58.472460466747016 -34.566128106518931,-58.472741853664516 -34.566293865619684)));;920;12_8_9;COMUNA 12;8;9;975;462;513;90,06%;473;473;100,00%;0;0,00%;396;2;0,51%;394;99,49%
MULTIPOLYGON (((-58.496593125486939 -34.563535719940262,-58.495417329209467 -34.562971156525066,-58.494455858688475 -34.564297877563668,-58.495633454242856 -34.564860688986322,-58.496957352830982 -34.565493380676031,-58.498109777381906 -34.566044061944552,-58.498679438706482 -34.566316301682335,-58.499712825144677 -34.565041007188448,-58.499139761191138 -34.564762646199391,-58.499052822852448 -34.564720768864397,-58.498787069629351 -34.564592673048502,-58.497991092062065 -34.564208945146497,-58.497860558571922 -34.564146022285165,-58.496822854208403 -34.563646012941312,-58.496676485108821 -34.563575768964938,-58.496593125486939 -34.563535719940262)));;921;12_9_1;COMUNA 12;9;1;937;414;523;79,16%;403;402;99,75%;1;0,25%;331;8;2,42%;323;97,58%
MULTIPOLYGON (((-58.495633454242856 -34.564860688986322,-58.494455858688475 -34.564297877563668,-58.493578766703358 -34.565508015018843,-58.493476912545852 -34.565644173482113,-58.494644992540515 -34.566225377797892,-58.495837297825375 -34.56688438460737,-58.496943190095976 -34.567495514552697,-58.497487073321743 -34.567796148534356,-58.498065434942873 -34.5670783454134,-58.498679438706482 -34.566316301682335,-58.498109777381906 -34.566044061944552,-58.496957352830982 -34.565493380676031,-58.495633454242856 -34.564860688986322)));;922;12_9_2;COMUNA 12;9;2;1127;541;586;92,32%;466;465;99,79%;1;0,22%;420;8;1,90%;412;98,10%
MULTIPOLYGON (((-58.492883747164164 -34.561757389021643,-58.491930139813213 -34.561301614807789,-58.491834078209521 -34.561441644018927,-58.490991285271036 -34.562650628452538,-58.491936389079932 -34.563104228737686,-58.492094843965376 -34.56318025039851,-58.493323576788043 -34.563756734467276,-58.492356191170344 -34.56508724327859,-58.493476912545852 -34.565644173482113,-58.493578766703358 -34.565508015018843,-58.494455858688475 -34.564297877563668,-58.495417329209467 -34.562971156525066,-58.494288804500897 -34.562429246570602,-58.494129582691933 -34.562352734965948,-58.492883747164164 -34.561757389021643)));;923;12_9_3;COMUNA 12;9;3;1005;483;522;92,53%;455;455;100,00%;0;0,00%;385;18;4,68%;367;95,32%
MULTIPOLYGON (((-58.490987897227619 -34.564461343219556,-58.490907318263638 -34.564582986949183,-58.490356326767369 -34.565305609634734,-58.491617061045858 -34.566047110660648,-58.492685799113922 -34.566675753618568,-58.493820864236717 -34.567279862147572,-58.494644992540515 -34.566225377797892,-58.493476912545852 -34.565644173482113,-58.492356191170344 -34.56508724327859,-58.493323576788043 -34.563756734467276,-58.492094843965376 -34.56318025039851,-58.491936389079932 -34.563104228737686,-58.49108745067965 -34.56431117263751,-58.490987897227619 -34.564461343219556)));;924;12_9_4;COMUNA 12;9;4;1061;498;563;88,45%;468;468;100,00%;0;0,00%;392;8;2,04%;384;97,96%
MULTIPOLYGON (((-58.485801232615309 -34.562630381895389,-58.485383704624255 -34.563074634844888,-58.486355429100442 -34.563529188894314,-58.487327930455564 -34.56398415757014,-58.487529805409849 -34.564078557472975,-58.488310140755473 -34.564417284476491,-58.489290060217279 -34.564842727551493,-58.490356326767369 -34.565305609634734,-58.490907318263638 -34.564582986949183,-58.490987897227619 -34.564461343219556,-58.49108745067965 -34.56431117263751,-58.491936389079932 -34.563104228737686,-58.490991285271036 -34.562650628452538,-58.490465091002804 -34.563405360204428,-58.490043294894178 -34.564010482183086,-58.489091891218322 -34.563556305266601,-58.488139220751989 -34.563101557757982,-58.487184942931997 -34.562645957993219,-58.486376948184542 -34.562260255140359,-58.486221139065101 -34.562183521278477,-58.485801232615309 -34.562630381895389)));;925;12_9_5;COMUNA 12;9;5;965;469;496;94,56%;456;456;100,00%;0;0,00%;358;4;1,12%;354;98,88%
MULTIPOLYGON (((-58.490043381979099 -34.562195612928093,-58.489276841964539 -34.561827455942606,-58.489086464484288 -34.56173798620582,-58.488292179293076 -34.561364687927046,-58.488131091780033 -34.561286901212668,-58.487319954362874 -34.560895430261468,-58.487174535033475 -34.560827076159789,-58.486221139065101 -34.562183521278477,-58.486376948184542 -34.562260255140359,-58.487184942931997 -34.562645957993219,-58.488139220751989 -34.563101557757982,-58.489091891218322 -34.563556305266601,-58.490043294894178 -34.564010482183086,-58.490465091002804 -34.563405360204428,-58.490991285271036 -34.562650628452538,-58.490518226363548 -34.562423614391136,-58.490400643199926 -34.56236723016805,-58.490043381979099 -34.562195612928093)));;926;12_9_6;COMUNA 12;9;6;960;452;508;88,98%;452;452;100,00%;0;0,00%;377;3;0,80%;374;99,20%
MULTIPOLYGON (((-58.485801232615309 -34.562630381895389,-58.486221139065101 -34.562183521278477,-58.487174535033475 -34.560827076159789,-58.486388695782985 -34.560457566731039,-58.486255026934771 -34.560393857343932,-58.485301045962366 -34.5599392285447,-58.485165931436676 -34.559874884395718,-58.485017961242747 -34.559804344985821,-58.484350139719631 -34.559483746601416,-58.483700712902476 -34.559172015022277,-58.483620343690625 -34.559133435533553,-58.483556313885103 -34.55910266057527,-58.483409022157339 -34.559312350703244,-58.483315615953245 -34.55944640506182,-58.483223066170751 -34.559578331606133,-58.482998384987781 -34.559897065306608,-58.482834357684723 -34.560125919830789,-58.482663635116452 -34.560366964571529,-58.48260285541636 -34.560453322214769,-58.482563209829344 -34.560509651755389,-58.482430982803727 -34.560698054058669,-58.48228201739596 -34.560910006505544,-58.482116313352748 -34.561145509032343,-58.481925501238031 -34.561415644112252,-58.481843365102677 -34.561534008660772,-58.481998834184431 -34.561614231187221,-58.482781433085783 -34.562017437967491,-58.48347383958334 -34.562210147599501,-58.483625891894143 -34.562252447459208,-58.48460934662674 -34.562712365811265,-58.485383704624255 -34.563074634844888,-58.485801232615309 -34.562630381895389)));;927;12_9_7;COMUNA 12;9;7;879;437;442;98,87%;369;369;100,00%;0;0,00%;307;2;0,65%;305;99,35%
MULTIPOLYGON (((-58.472193546157975 -34.539667542421363,-58.473134205756779 -34.540143544954617,-58.473263066401422 -34.540208748284094,-58.474356006540582 -34.540759872552037,-58.474677311779253 -34.540325736078266,-58.474927393179172 -34.539987807699617,-58.475408016355324 -34.539338306849309,-58.475411468099416 -34.539333642214359,-58.475411310059592 -34.539333568928015,-58.475761150095153 -34.538830328132789,-58.475912447832307 -34.538612685910401,-58.472708267592559 -34.537197634609917,-58.47268366576106 -34.537186769274321,-58.472463335342987 -34.537499724661586,-58.472167713199333 -34.53791961942494,-58.472199341563645 -34.537933650357608,-58.472199987543306 -34.537933936926116,-58.471849322698873 -34.538417930826036,-58.471269919400747 -34.539200052948708,-58.472193546157975 -34.539667542421363)));;928;13_1_1;COMUNA 13;1;1;733;316;417;75,78%;393;392;99,75%;1;0,26%;296;1;0,34%;295;99,66%
MULTIPOLYGON (((-58.470340770845731 -34.538729880613538,-58.469400398362914 -34.538253856434622,-58.468834589156941 -34.539020683849841,-58.469772328637369 -34.539495515237178,-58.470440276630967 -34.539833730480773,-58.470702248543098 -34.539966466472627,-58.47162656157478 -34.540435086944214,-58.472118578343554 -34.539767553049323,-58.472193546157975 -34.539667542421363,-58.471269919400747 -34.539200052948708,-58.470340770845731 -34.538729880613538)));;929;13_1_10;COMUNA 13;1;10;709;341;368;92,66%;368;368;100,00%;0;0,00%;314;0;0,00%;314;100,00%
MULTIPOLYGON (((-58.471056077767912 -34.54120889688474,-58.471993003422796 -34.541684697065087,-58.47256577975395 -34.54091116432685,-58.473786311236012 -34.541529751277579,-58.474356006540567 -34.540759872552037,-58.473263066401422 -34.540208748284087,-58.473134205756786 -34.540143544954617,-58.472193546157975 -34.539667542421356,-58.472118578343554 -34.539767553049344,-58.471626561574773 -34.540435086944207,-58.471153343296344 -34.541077123302927,-58.471056077767912 -34.54120889688474)));;930;13_1_11;COMUNA 13;1;11;660;285;375;76,00%;346;346;100,00%;0;0,00%;300;3;1,00%;297;99,00%
MULTIPOLYGON (((-58.47256577975395 -34.54091116432685,-58.471993003422796 -34.541684697065087,-58.471056077767912 -34.54120889688474,-58.47051409128683 -34.541943334161274,-58.471451362306219 -34.542417025640489,-58.472691905207533 -34.543008648822763,-58.473236007098613 -34.542273427142263,-58.473786311236012 -34.541529751277579,-58.47256577975395 -34.54091116432685)));;931;13_1_12;COMUNA 13;1;12;544;255;289;88,24%;310;309;99,68%;1;0,32%;246;1;0,41%;245;99,59%
MULTIPOLYGON (((-58.468437503834572 -34.54303138868606,-58.469365242611893 -34.543501575245564,-58.469937714953801 -34.542724533783542,-58.470875161797593 -34.543199356428083,-58.472093926708496 -34.543816692512557,-58.472691905207533 -34.543008648822763,-58.471451362306219 -34.542417025640489,-58.47051409128683 -34.541943334161274,-58.469587555019004 -34.541475057640902,-58.469011088066708 -34.542255196566444,-58.468437503834572 -34.54303138868606)));;932;13_1_13;COMUNA 13;1;13;622;283;339;83,48%;306;306;100,00%;0;0,00%;245;1;0,41%;244;99,59%
MULTIPOLYGON (((-58.470875161797593 -34.543199356428083,-58.469937714953801 -34.542724533783542,-58.469365242611893 -34.543501575245564,-58.470302609826604 -34.543976613506651,-58.471537039808531 -34.544569305037278,-58.472093926708496 -34.543816692512557,-58.470875161797593 -34.543199356428083)));;933;13_1_14;COMUNA 13;1;14;647;262;385;68,05%;355;353;99,44%;2;0,57%;283;28;9,89%;255;90,11%
MULTIPOLYGON (((-58.472463335342987 -34.537499724661586,-58.47268366576106 -34.537186769274321,-58.470528841894236 -34.536235066599225,-58.470449241531597 -34.5361999090401,-58.470240152179194 -34.536571183207776,-58.470023651726343 -34.536955613187033,-58.470024872846956 -34.536956151906388,-58.470033477610876 -34.53706171990865,-58.470049234067815 -34.537200458105929,-58.470012569797298 -34.537379694374593,-58.469971982619661 -34.537467658820063,-58.469953178045145 -34.537508366141815,-58.469935818732047 -34.537531748589373,-58.469400398362914 -34.538253856434622,-58.470340770845731 -34.538729880613538,-58.471269919400747 -34.539200052948708,-58.471849322698873 -34.538417930826036,-58.472199987543306 -34.537933936926116,-58.472199341563645 -34.537933650357608,-58.472167713199333 -34.53791961942494,-58.472463335342987 -34.537499724661586)));;934;13_1_2;COMUNA 13;1;2;770;373;397;93,95%;408;408;100,00%;0;0,00%;343;5;1,46%;338;98,54%
MULTIPOLYGON (((-58.467899158251974 -34.538547042367064,-58.468834589156941 -34.539020683849841,-58.469400398362914 -34.538253856434622,-58.469935818732047 -34.537531748589373,-58.469953178045145 -34.537508366141815,-58.469971982619661 -34.537467658820063,-58.470012569797298 -34.537379694374593,-58.470049234067815 -34.537200458105929,-58.470033477610876 -34.53706171990865,-58.470024872846956 -34.536956151906388,-58.470023651726343 -34.536955613187033,-58.470240152179194 -34.536571183207776,-58.470449241531597 -34.5361999090401,-58.468546759588747 -34.535359604383949,-58.468457995082289 -34.535320381329072,-58.468385925590241 -34.535499970958817,-58.468358436548506 -34.53548638002129,-58.468271476328503 -34.535705056685693,-58.468109296857371 -34.536112900803019,-58.468066411092991 -34.536097097702012,-58.467930793282676 -34.53643019705293,-58.467566217432903 -34.537325640516663,-58.467616877623747 -34.537351291813913,-58.46759900832982 -34.537396294719834,-58.467279041999738 -34.538140701393139,-58.467249981392577 -34.538218248185466,-58.467472748958471 -34.538331678583646,-58.467472936855721 -34.538331204242539,-58.467899158251974 -34.538547042367064)));;935;13_1_3;COMUNA 13;1;3;612;286;326;87,73%;314;314;100,00%;0;0,00%;258;4;1,55%;254;98,45%
MULTIPOLYGON (((-58.465308874957323 -34.538295774969505,-58.466390418314212 -34.538840773465495,-58.466541655082843 -34.538917040096344,-58.466899109828091 -34.539105206440382,-58.467032368584462 -34.538765960027945,-58.467217363505824 -34.538298747601715,-58.467249954495735 -34.538218319958297,-58.467249981392577 -34.538218248185466,-58.467279041999738 -34.538140701393139,-58.46759900832982 -34.537396294719834,-58.467616877623747 -34.537351291813913,-58.467566217432903 -34.537325640516663,-58.467930793282676 -34.53643019705293,-58.468066411092991 -34.536097097702012,-58.468109296857371 -34.536112900803019,-58.468271476328503 -34.535705056685693,-58.468358436548506 -34.53548638002129,-58.468385925590241 -34.535499970958817,-58.468457995082289 -34.535320381329072,-58.467387044116002 -34.534847341111117,-58.467152287131547 -34.535256831378028,-58.466807124127889 -34.535841499867836,-58.466806949734043 -34.535841600261655,-58.466759891854529 -34.535924422783125,-58.46659795416565 -34.536209301124373,-58.466303006802661 -34.536686586978959,-58.467565558140912 -34.537325306690313,-58.466959567682004 -34.538071281048346,-58.465807902950736 -34.537488048033687,-58.465308874957323 -34.538295774969505)));;936;13_1_4;COMUNA 13;1;4;763;379;384;98,70%;524;524;100,00%;0;0,00%;367;3;0,82%;364;99,18%
MULTIPOLYGON (((-58.467565558140912 -34.537325306690313,-58.466303006802661 -34.536686586978959,-58.465807902950736 -34.537488048033687,-58.466959567682004 -34.538071281048346,-58.467565558140912 -34.537325306690313)));;937;13_1_5;COMUNA 13;1;5;835;402;433;92,84%;674;674;100,00%;0;0,00%;421;7;1,66%;414;98,34%
MULTIPOLYGON (((-58.464835283024456 -34.539062088864995,-58.464329512994752 -34.539880234746164,-58.463824073494038 -34.540697955864474,-58.464692439186798 -34.541136346124397,-58.465633498125598 -34.54161142035241,-58.465849678501264 -34.541720575127641,-58.465993839185877 -34.541371470084158,-58.466170166142668 -34.540940176895127,-58.46621135412181 -34.540837001747249,-58.466348363018923 -34.540494446051021,-58.4665034966389 -34.54010780298831,-58.466569447139662 -34.539943426799553,-58.466681690042073 -34.539663691393692,-58.466856051529831 -34.539214790673462,-58.466899109828091 -34.539105206440382,-58.466541655082843 -34.538917040096344,-58.466390418314212 -34.538840773465495,-58.465308874957323 -34.538295774969505,-58.465133055498015 -34.538580299423863,-58.464835283024456 -34.539062088864995)));;938;13_1_6;COMUNA 13;1;6;882;430;452;95,13%;519;519;100,00%;0;0,00%;386;1;0,26%;385;99,74%
MULTIPOLYGON (((-58.467499732247376 -34.542556054345532,-58.468437503834572 -34.54303138868606,-58.469011088066708 -34.542255196566444,-58.469587555019004 -34.541475057640902,-58.46885244448135 -34.541103600194802,-58.46865336908386 -34.541002408020304,-58.467721661788978 -34.540529046854942,-58.468260174558957 -34.53979927007034,-58.468834589156941 -34.539020683849841,-58.467899158251974 -34.538547042367064,-58.467472936855721 -34.538331204242539,-58.467472748958471 -34.538331678583646,-58.467249981392577 -34.538218248185466,-58.467249954495735 -34.538218319958297,-58.467217363505824 -34.538298747601715,-58.467032368584462 -34.538765960027945,-58.466899109828091 -34.539105206440382,-58.466856051529831 -34.539214790673462,-58.466681690042073 -34.539663691393692,-58.466569447139662 -34.539943426799553,-58.4665034966389 -34.54010780298831,-58.466348363018923 -34.540494446051021,-58.46621135412181 -34.540837001747249,-58.466170166142668 -34.540940176895127,-58.465993839185877 -34.541371470084158,-58.465849678501264 -34.541720575127641,-58.465844481501684 -34.541733149813936,-58.466073792718731 -34.541842147185392,-58.466076668501749 -34.54183515201467,-58.466119394097504 -34.541856701153428,-58.46624476236051 -34.541920010468914,-58.466572695341014 -34.542086205646548,-58.467499732247376 -34.542556054345532)));;939;13_1_7;COMUNA 13;1;7;509;240;269;89,22%;254;254;100,00%;0;0,00%;185;0;0,00%;185;100,00%
MULTIPOLYGON (((-58.470129376488828 -34.540741751244617,-58.469393248893667 -34.540372691552406,-58.469195366162296 -34.540272486146854,-58.468260174558957 -34.53979927007034,-58.467721661788978 -34.540529046854942,-58.46865336908386 -34.541002408020304,-58.46885244448135 -34.541103600194802,-58.469587555019004 -34.541475057640902,-58.47051409128683 -34.541943334161274,-58.471056077767912 -34.54120889688474,-58.470770014497418 -34.541062923201508,-58.470129376488828 -34.540741751244617)));;940;13_1_8;COMUNA 13;1;8;538;260;278;93,53%;302;302;100,00%;0;0,00%;241;7;2,90%;234;97,10%
MULTIPOLYGON (((-58.469772328637369 -34.539495515237178,-58.468834589156941 -34.539020683849841,-58.468260174558957 -34.53979927007034,-58.469195366162296 -34.540272486146854,-58.469393248893667 -34.540372691552406,-58.470129376488828 -34.540741751244617,-58.470770014497418 -34.541062923201508,-58.471056077767912 -34.54120889688474,-58.471153343296358 -34.541077123302934,-58.47162656157478 -34.540435086944214,-58.470702248543098 -34.539966466472627,-58.470440276630967 -34.539833730480773,-58.469772328637369 -34.539495515237178)));;941;13_1_9;COMUNA 13;1;9;457;220;237;92,83%;223;223;100,00%;0;0,00%;217;2;0,92%;215;99,08%
MULTIPOLYGON (((-58.456821671324064 -34.55379646330988,-58.455778728859677 -34.55322588945937,-58.455040739515219 -34.554087363849852,-58.455530419307799 -34.554367265573568,-58.455863740513578 -34.554557715950928,-58.455983619364012 -34.55462464808447,-58.456203106675154 -34.554751194041899,-58.456389533326487 -34.554629930662706,-58.456639463568663 -34.554464583638513,-58.456896373103191 -34.55429487003277,-58.457193886334409 -34.554098114225475,-58.457269733241581 -34.554041636157883,-58.457366180391517 -34.553969876552806,-58.457581632563773 -34.553805934586215,-58.457768141420345 -34.553664456890274,-58.457819556759688 -34.553626217762556,-58.458228494650378 -34.553315655764209,-58.458261962456056 -34.553244582182195,-58.458117164830732 -34.553169166022649,-58.457592753828251 -34.552897512986661,-58.456821671324064 -34.55379646330988)));;942;13_10_1;COMUNA 13;10;1;798;376;422;89,10%;569;569;100,00%;0;0,00%;415;1;0,24%;414;99,76%
MULTIPOLYGON (((-58.451664370391626 -34.556219033765814,-58.450512491831098 -34.555535794491519,-58.449901199381358 -34.556252243467064,-58.449728026931012 -34.556451318755848,-58.448900550906416 -34.557402609255995,-58.450036047308863 -34.558082623235428,-58.450046539737428 -34.558088959198017,-58.450288092022618 -34.557934261140367,-58.450817530329914 -34.55762810277308,-58.451263876071593 -34.557372500011866,-58.451341345681591 -34.557328139035207,-58.451819187331139 -34.557049155814276,-58.452382326081107 -34.556722851854254,-58.452448983016772 -34.556684334591765,-58.451664370391626 -34.556219033765814)));;943;13_10_10;COMUNA 13;10;10;893;389;504;77,18%;549;549;100,00%;0;0,00%;424;7;1,65%;417;98,35%
MULTIPOLYGON (((-58.448515986450253 -34.555723686046186,-58.447693525301382 -34.556679758010901,-58.448900550906416 -34.557402609255995,-58.449728026931012 -34.556451318755848,-58.449901199381358 -34.556252243467064,-58.450512491831098 -34.555535794491519,-58.449297562519845 -34.554815141293822,-58.448515986450253 -34.555723686046186)));;944;13_10_11;COMUNA 13;10;11;616;267;349;76,50%;489;489;100,00%;0;0,00%;314;7;2,23%;307;97,77%
MULTIPOLYGON (((-58.453999680785707 -34.553492337205682,-58.453360935542676 -34.554238873589554,-58.45327350405649 -34.554341547633705,-58.454301032346358 -34.554950453331152,-58.454785351324695 -34.555237400210011,-58.454873703723301 -34.555289732239373,-58.455023256148294 -34.555378407755306,-58.455095521494158 -34.555421231134105,-58.455180818810945 -34.555374051163952,-58.455780611479987 -34.55501603476452,-58.456203106675154 -34.554751194041899,-58.455983619364012 -34.55462464808447,-58.455863740513578 -34.554557715950928,-58.455530419307799 -34.554367265573568,-58.455040739515219 -34.554087363849852,-58.455778728859677 -34.55322588945937,-58.456821671324064 -34.55379646330988,-58.457592753828251 -34.552897512986661,-58.457405495408509 -34.552800528710705,-58.457277734347493 -34.552734322869419,-58.456489893153389 -34.552325745367675,-58.455741808637498 -34.551937799784291,-58.455457948829917 -34.551787917193238,-58.454723629341672 -34.552646220928168,-58.453999680785707 -34.553492337205682)));;945;13_10_2;COMUNA 13;10;2;900;436;464;93,97%;528;527;99,81%;1;0,19%;404;6;1,49%;398;98,51%
MULTIPOLYGON (((-58.45427792004898 -34.551164854909146,-58.453006326426348 -34.550504025690991,-58.452308599637384 -34.551317668025362,-58.451575614336662 -34.552172361289948,-58.45283811471846 -34.552828485967169,-58.453551682626092 -34.552001531522798,-58.454723629341672 -34.552646220928168,-58.455457948829917 -34.551787917193238,-58.45427792004898 -34.551164854909146)));;946;13_10_3;COMUNA 13;10;3;964;448;516;86,82%;526;526;100,00%;0;0,00%;427;5;1,17%;422;98,83%
MULTIPOLYGON (((-58.451575614336662 -34.552172361289948,-58.451149607627279 -34.552669105219707,-58.450913326661308 -34.552941729390795,-58.450912680050457 -34.552942475456049,-58.450335040189074 -34.553609068709378,-58.450102874593426 -34.55387898695114,-58.449297562519845 -34.554815141293822,-58.450512491831098 -34.555535794491519,-58.451314733400118 -34.554595617690701,-58.45139620805503 -34.554500127929998,-58.452121638128993 -34.553658957164458,-58.452247890935944 -34.553512482432971,-58.45283811471846 -34.552828485967169,-58.451575614336662 -34.552172361289948)));;947;13_10_4;COMUNA 13;10;4;1110;533;577;92,37%;555;552;99,46%;3;0,54%;417;1;0,24%;416;99,76%
MULTIPOLYGON (((-58.452121638128993 -34.553658957164458,-58.45139620805503 -34.554500127929998,-58.451314733400118 -34.554595617690701,-58.450512491831098 -34.555535794491519,-58.451664370391626 -34.556219033765814,-58.45235660972584 -34.555418917050524,-58.452473925839897 -34.555281103737869,-58.452890488576053 -34.554791678921099,-58.45327350405649 -34.554341547633705,-58.453360935542676 -34.554238873589554,-58.453999680785707 -34.553492337205682,-58.454723629341672 -34.552646220928168,-58.453551682626092 -34.552001531522798,-58.45283811471846 -34.552828485967169,-58.452247890935944 -34.553512482432971,-58.452121638128993 -34.553658957164458)));;948;13_10_5;COMUNA 13;10;5;568;270;298;90,60%;351;351;100,00%;0;0,00%;252;6;2,38%;246;97,62%
MULTIPOLYGON (((-58.452448983016772 -34.556684334591765,-58.452639221874904 -34.5567967498895,-58.452672338266531 -34.556771188072275,-58.452690472251788 -34.556750061839843,-58.453355842537434 -34.55639502801003,-58.453889693953506 -34.556126531987857,-58.453939568645197 -34.556088930593468,-58.453907738003664 -34.556036179423913,-58.454547731612799 -34.555672334007653,-58.454575051733094 -34.555717478732802,-58.455095521494158 -34.555421231134105,-58.455023256148294 -34.555378407755306,-58.454873703723301 -34.555289732239373,-58.454785351324695 -34.555237400210011,-58.454301032346358 -34.554950453331152,-58.45327350405649 -34.554341547633705,-58.452890488576053 -34.554791678921099,-58.452473925839897 -34.555281103737869,-58.45235660972584 -34.555418917050524,-58.451664370391626 -34.556219033765814,-58.452448983016772 -34.556684334591765)));;949;13_10_6;COMUNA 13;10;6;900;440;460;95,65%;464;464;100,00%;0;0,00%;388;35;9,02%;353;90,98%
MULTIPOLYGON (((-58.452800776302489 -34.5568926125191,-58.452000574977006 -34.557812657151914,-58.452902499094307 -34.558351348764788,-58.453697758977384 -34.557426016007632,-58.454011311801985 -34.557061163020684,-58.454502110212253 -34.556493495114061,-58.455316063187141 -34.555551954862651,-58.455780611479987 -34.55501603476452,-58.455180818810945 -34.555374051163952,-58.455095521494158 -34.555421231134105,-58.454575051733094 -34.555717478732802,-58.454547731612799 -34.555672334007653,-58.453907738003664 -34.556036179423913,-58.453939568645197 -34.556088930593468,-58.453889693953506 -34.556126531987857,-58.453355842537434 -34.55639502801003,-58.452690472251788 -34.556750061839843,-58.452672338266531 -34.556771188072275,-58.452639221874904 -34.5567967498895,-58.452800776302489 -34.5568926125191)));;950;13_10_7;COMUNA 13;10;7;661;292;369;79,13%;416;416;100,00%;0;0,00%;321;2;0,62%;319;99,38%
MULTIPOLYGON (((-58.452902499094307 -34.558351348764788,-58.452000574977006 -34.557812657151914,-58.451152592631978 -34.558787694370452,-58.451964209404345 -34.559270818372681,-58.452062097739109 -34.559329139425408,-58.452150472335923 -34.559226395989143,-58.452902499094307 -34.558351348764788)));;951;13_10_8;COMUNA 13;10;8;910;346;564;61,35%;608;607;99,84%;1;0,16%;432;2;0,46%;430;99,54%
MULTIPOLYGON (((-58.452800776302489 -34.5568926125191,-58.452639221874904 -34.5567967498895,-58.452448983016772 -34.556684334591765,-58.452382326081107 -34.556722851854254,-58.451819187331139 -34.557049155814276,-58.451341345681591 -34.557328139035207,-58.451263876071593 -34.557372500011866,-58.450817530329914 -34.55762810277308,-58.450288092022618 -34.557934261140367,-58.450046539737428 -34.558088959198017,-58.450150121866535 -34.558156552714735,-58.450150070384005 -34.558156581028165,-58.450504074024543 -34.558388035810786,-58.450585106152516 -34.558441004016601,-58.450738318448465 -34.558541094064353,-58.451152592631978 -34.558787694370452,-58.452000574977006 -34.557812657151914,-58.452800776302489 -34.5568926125191)));;952;13_10_9;COMUNA 13;10;9;701;297;404;73,51%;389;389;100,00%;0;0,00%;325;1;0,31%;324;99,69%
MULTIPOLYGON (((-58.450810111510428 -34.548743749560757,-58.451541528241144 -34.548633461319199,-58.452159736879715 -34.548540202025215,-58.452754622004363 -34.54845052941964,-58.453255025890869 -34.54837507266074,-58.453663417440239 -34.548313480964275,-58.452847198493956 -34.547255833013899,-58.452174988649318 -34.546384679589501,-58.452124018284813 -34.546284318341883,-58.452040202533453 -34.546119091993866,-58.45091528282866 -34.544744839121741,-58.450749608309096 -34.544529281190542,-58.450748565489071 -34.544527924380589,-58.450513950937285 -34.544244020436835,-58.450447922744132 -34.544164457141576,-58.450369272397801 -34.544064802462479,-58.450003212354915 -34.543591442806068,-58.449407587419444 -34.542758616684495,-58.449269631769504 -34.542651774511455,-58.450005390894724 -34.542239346960677,-58.451704125466392 -34.541319389307276,-58.451706508411874 -34.541319256617214,-58.451925930788001 -34.541220327764826,-58.452087475065014 -34.541152592180786,-58.452343748384713 -34.541053806623651,-58.452581380346587 -34.540972202907668,-58.452638660191539 -34.540954882864803,-58.452853225364208 -34.540889826806541,-58.452972465351422 -34.540858567255391,-58.453060214344006 -34.54083561536423,-58.453215200830599 -34.540792738115655,-58.454747017784882 -34.540325923620614,-58.457494283656708 -34.539004317733571,-58.458284174955189 -34.538597639032311,-58.459442664832935 -34.537798763456507,-58.459446457365139 -34.537795896594524,-58.45887722949476 -34.537331742756201,-58.458666184395568 -34.537159652575738,-58.458471730024982 -34.537268214964001,-58.458447816355779 -34.53725539660892,-58.458429094132889 -34.537241099485634,-58.458410286624236 -34.537230464506379,-58.458377011754166 -34.537212786416895,-58.458351736410307 -34.537200672254272,-58.45831488703422 -34.537185881484859,-58.458276591025651 -34.537168696169196,-58.458251400682776 -34.537159046897465,-58.458199232742601 -34.537141297643672,-58.458165361787906 -34.537131648033935,-58.458120682997631 -34.53711488498783,-58.458098045825942 -34.53710502450221,-58.458075918926376 -34.537101643220218,-58.458052600742391 -34.537095163146553,-58.458027240195925 -34.537086288507574,-58.458006134688446 -34.537080512769293,-58.457982135515714 -34.53707699054641,-58.457958902414077 -34.537071144291765,-58.457835248583216 -34.537028320443333,-58.457808526509368 -34.537017825907419,-58.457762060877961 -34.536997470934104,-58.457733722071872 -34.536983173314411,-58.457710234029278 -34.536971833776832,-58.457674491067507 -34.536959578193517,-58.457652619824657 -34.536951407879755,-58.457582581002647 -34.536922178189883,-58.457553731403529 -34.536911542656973,-58.457527435026698 -34.536899357854182,-58.457493734854424 -34.536883299302247,-58.45746548090623 -34.536874283570995,-58.457440800868817 -34.536872592287494,-58.45741288784432 -34.536855688850686,-58.457393059398477 -34.536843574724664,-58.457320298090124 -34.536804133000537,-58.457300724845091 -34.536794131649643,-58.457271449925607 -34.536781664955903,-58.457241153897506 -34.536767226282443,-58.457218176489889 -34.536757647321842,-58.457173413018083 -34.536740390942597,-58.457146776484947 -34.536725952411189,-58.457116735922746 -34.536709823495165,-58.45709026949384 -34.536697216034263,-58.457056824760208 -34.536681720780692,-58.457026018240299 -34.536666436918438,-58.457003296292136 -34.536655449409771,-58.456970021885567 -34.53663868647287,-58.45694908699425 -34.536629670964984,-58.456924833097752 -34.536620162314811,-58.456889600930467 -34.536609244618617,-58.456866453291141 -34.536601214954793,-58.456842369935288 -34.536587199034393,-58.456810286676955 -34.536575577206598,-58.456790202830085 -34.536566913842265,-58.456747992697188 -34.536549094022348,-58.45672722812985 -34.536539092521053,-58.456675657076538 -34.536515074732613,-58.456636511003204 -34.536493381596848,-58.456602045079705 -34.536479435538851,-58.45652928395203 -34.536446895086158,-58.456497711490378 -34.536434216812239,-58.4564678411027 -34.536421609042961,-58.456446991570779 -34.536410621525889,-58.456422057152231 -34.536398647831732,-58.456317809546974 -34.536344484856983,-58.456294406887459 -34.536334342291902,-58.456267514848641 -34.536326101039826,-58.456241303707372 -34.536317014706164,-58.456198072544424 -34.536299617197294,-58.456177223056393 -34.536288911337834,-58.4561449704441 -34.536269049486968,-58.456113738859443 -34.536252075147424,-58.456050168959976 -34.536223478757883,-58.456028638453361 -34.536215660300705,-58.456002002318876 -34.536200798962568,-58.455983450939726 -34.536186712749213,-58.455965495090972 -34.536175091474853,-58.455937327339122 -34.536157553851091,-58.455884566158439 -34.536123042191214,-58.45586337633037 -34.536112477110812,-58.45583869785019 -34.536094939659399,-58.455810445710171 -34.536069373440355,-58.455786958604165 -34.536052962861149,-58.455751216890441 -34.536033804967722,-58.455719729864576 -34.53602042223693,-58.455699561202202 -34.53601126570581,-58.455681265053812 -34.535999221813995,-58.4556491820993 -34.535988585643722,-58.455627055826469 -34.535982457304456,-58.455604078986681 -34.535970906111679,-58.455572677489151 -34.53595308651137,-58.455536425225169 -34.535934210228881,-58.455509108474288 -34.535918996612772,-58.455479409081647 -34.535901106662564,-58.455456517393628 -34.535889485020931,-58.45543796599199 -34.535877511503266,-58.45541005356943 -34.535862156977501,-58.455382226352427 -34.535845746060744,-58.455349633508867 -34.535827926331343,-58.455309381739134 -34.535806514405124,-58.455280277961577 -34.535790737221539,-58.455261471029225 -34.535781791978373,-58.455238749415045 -34.535772353511348,-58.455217900004861 -34.535763619414574,-58.455182328643147 -34.535745658605826,-58.455157309374144 -34.535735093166494,-58.45513084334516 -34.535724738910304,-58.45506097681114 -34.535693606277782,-58.455009321447825 -34.535671841408472,-58.454980387875146 -34.535657190979457,-58.454963453713731 -34.535643386416034,-58.454946094220823 -34.535627680321795,-58.454897333246194 -34.535597041915238,-58.454819894319385 -34.535549499406848,-58.454799896220642 -34.53553879336588,-58.454766962702841 -34.535526325832549,-58.454739645574961 -34.535517943363388,-58.454711562832287 -34.535506391668918,-58.454683140004491 -34.535491529924556,-58.454663227087018 -34.535480330884837,-58.454631910818506 -34.535465187234124,-58.454579830680991 -34.535438421909639,-58.454513964571916 -34.535405599005124,-58.454492009287428 -34.535393906818562,-58.454461544286872 -34.535376932105621,-58.454427249829898 -34.535358548606055,-58.454406060672994 -34.535345025380309,-58.454356278144203 -34.535321288433231,-58.454328195337219 -34.535311567725763,-58.454292369044772 -34.53529367706502,-58.45427288178805 -34.535281985008723,-58.454244629653729 -34.535263813152341,-58.454222760424422 -34.535243458527106,-58.454189061769036 -34.535225286279562,-58.454160213805345 -34.535208593307622,-58.454137067313312 -34.535195703731851,-58.454117835024768 -34.535187744245661,-58.454083794830424 -34.535180980954351,-58.454062009549432 -34.535172387445357,-58.454038522710235 -34.535159145696831,-58.454018780374575 -34.535145904209998,-58.45399776186435 -34.535129282181757,-58.453983211089216 -34.535113012741562,-58.453964234383513 -34.535102729191834,-58.453944577624796 -34.535085191713897,-58.453923643832823 -34.535072513533983,-58.453898624961269 -34.535061595705763,-58.453876755237552 -34.535047227226656,-58.453856757282836 -34.535037436568224,-58.453833780320103 -34.53503180082344,-58.453804336749741 -34.535015389427599,-58.453780338985119 -34.535005880169145,-58.45375574530086 -34.534998342789926,-58.453734641559059 -34.534983763063344,-58.453717112123911 -34.534969042744095,-58.453692008534453 -34.534955096549695,-58.453634313446166 -34.534917625655495,-58.453619337612977 -34.534898186970423,-58.453624105476322 -34.534878327196381,-58.453644957023108 -34.534863750564746,-58.453630492556783 -34.534837410171974,-58.45361866510968 -34.534821633871715,-58.453613646234899 -34.534801984647672,-58.453621392581155 -34.534782829354882,-58.453639690913285 -34.534769520201877,-58.453655521371523 -34.534755436177491,-58.453664800882294 -34.53472381559525,-58.453659186305643 -34.534704025476692,-58.453649486628343 -34.534686277408866,-58.453637489354271 -34.534667191075933,-58.453627197839729 -34.534613807411155,-58.453626944834376 -34.534592609169152,-58.453631033278391 -34.534559720535007,-58.453635886579924 -34.534536550744136,-58.453644826109944 -34.534500845429498,-58.453645849501065 -34.534480774097638,-58.453644830936383 -34.534456265776818,-58.45366611304668 -34.534393869923306,-58.453671136600079 -34.534370066309066,-58.453669012228602 -34.534340768938662,-58.453663908056463 -34.534323091636651,-58.453652421461996 -34.53430379406386,-58.45363446737953 -34.53428259450817,-58.453609960055672 -34.534265549595858,-58.453582048468299 -34.534250546778317,-58.453557795906342 -34.534238642972099,-58.453537628473555 -34.534224344983762,-58.453507845003166 -34.534206454542911,-58.453483252082975 -34.534194339418207,-58.453439002086277 -34.534170532084218,-58.453397475054494 -34.534149401129412,-58.453377136950202 -34.534139751217111,-58.453358245932023 -34.534126861816283,-58.453341993267578 -34.53411207111278,-58.45329561702264 -34.53407762923807,-58.453275449840135 -34.534061852260173,-58.453261324856776 -34.534045934894003,-58.453240477445512 -34.534025157611836,-58.453216992447885 -34.533999661579429,-58.453191890457681 -34.533974940102517,-58.453173510464083 -34.533958951968629,-58.453170363894444 -34.533939936703611,-58.4531452621612 -34.533913243288929,-58.45312381921029 -34.533891550401812,-58.453085528521356 -34.533850489035913,-58.453070637475172 -34.53383654351483,-58.453056512398327 -34.533822105070378,-58.453043153453287 -34.533805765182841,-58.453032092658496 -34.533785763323749,-58.45301609608898 -34.53376519766433,-58.453004354018255 -34.533749350882587,-58.452985719347694 -34.533728714583582,-58.452975849823169 -34.533710121333925,-58.452955513031242 -34.53369054128467,-58.452925135808528 -34.533658635878496,-58.452909820086589 -34.533638140685206,-58.452892886989474 -34.533621659642201,-58.452872296260651 -34.533590811398035,-58.452849322357778 -34.533563132128165,-58.452827029848081 -34.533530593514747,-58.452810862860318 -34.533512704001922,-58.452802185632258 -34.533487138659765,-58.452784827343358 -34.53346847436076,-58.452767979506049 -34.53345114819485,-58.452754961396593 -34.533432132114378,-58.452738030300942 -34.533399453068469,-58.45272986265983 -34.533382691012861,-58.452714291894878 -34.53336085767922,-58.452691658466669 -34.533333530536531,-58.452638480742252 -34.533250493906266,-58.452612782027828 -34.533237533401241,-58.452597211175856 -34.533216897294253,-58.452579682302641 -34.533202247233589,-58.452565472744119 -34.533184287423509,-58.452558496774436 -34.533165764804551,-58.452549137772884 -34.533149143489311,-58.452524375479143 -34.533133929411036,-58.452510250692441 -34.533118857067727,-58.452497573291268 -34.533098221189043,-58.452484384745389 -34.533082092530719,-58.452473579583391 -34.533061245527982,-58.452458433902123 -34.533043849034719,-58.452450436784794 -34.533025185471502,-58.452434269551723 -34.533010746781791,-58.45238559961404 -34.532951796111277,-58.452362881182118 -34.532925454862799,-58.452344843773304 -34.532894958872383,-58.45233225206178 -34.532870167848408,-58.452313021887775 -34.532850869487483,-58.452298982899798 -34.532830867305556,-58.45228783750489 -34.532809315996445,-58.452273713605706 -34.53278790528401,-58.452256357329702 -34.532755226131606,-58.452237808385064 -34.532732829072202,-58.452212706499282 -34.532712614653747,-58.452199092561806 -34.532696556353095,-58.452188627583084 -34.53267838554158,-58.452183183426556 -34.532660708143645,-58.452170506352815 -34.532638663709236,-58.452154084929518 -34.532616407672101,-58.452132217755299 -34.532589291766641,-58.452113243338331 -34.532567246780957,-58.452066190784358 -34.532508225693107,-58.452047216582571 -34.532484772176566,-58.452024923189221 -34.532463853703504,-58.452001695658872 -34.532427723125082,-58.451985189348804 -34.53240448109284,-58.45197115078512 -34.53238236609134,-58.451961111364852 -34.532364406574821,-58.451952773881317 -34.532346869763302,-58.451939756264913 -34.532326797202316,-58.45192299506612 -34.532300667672125,-58.451909127007404 -34.532276439897643,-58.451872966884856 -34.532221856533596,-58.45184386705035 -34.532190303094218,-58.451824892433621 -34.532171075103044,-58.451810003418586 -34.532145438705513,-58.451801155467265 -34.532127338429355,-58.451783202265965 -34.532106561150222,-58.451774524393933 -34.532089446851494,-58.451759208872708 -34.5320717685495,-58.451744914426506 -34.532055005875399,-58.451735046270713 -34.532029581196561,-58.45173190166124 -34.531998663891216,-58.451734031462458 -34.531980916725217,-58.451740076137227 -34.531960704999811,-58.451758462234828 -34.531924578099428,-58.451763401461257 -34.53189788707963,-58.451775149963218 -34.531860703191469,-58.451786300879434 -34.531837956583203,-58.451800516217979 -34.531808519775169,-58.451807071089988 -34.531791125132315,-58.45180316064755 -34.531759644351091,-58.451796950743748 -34.531741966864963,-58.451789123958036 -34.53172435966006,-58.451780190938678 -34.531706400225602,-58.451761388006688 -34.531676749186808,-58.45174888040389 -34.53166224030489,-58.451705909219427 -34.531634629442578,-58.45168012639062 -34.531619062967437,-58.451666427467565 -34.531604272265355,-58.451669663813938 -34.531584553270598,-58.451663283754272 -34.531566875761811,-58.451639626759885 -34.531563845302607,-58.451622353416539 -34.531551307904508,-58.451602952475383 -34.531539826701049,-58.451580570611029 -34.531547008120015,-58.451552995761681 -34.531568978526387,-58.451535973787507 -34.531585949643755,-58.451509757928306 -34.531627076043257,-58.451462607407535 -34.531670947127417,-58.451441671253754 -34.531684959978115,-58.451405498768743 -34.531726085436333,-58.451390859287379 -34.531744606125855,-58.451378857517405 -34.531765662394932,-58.451329917736231 -34.53182453400381,-58.451311874143336 -34.531843969904905,-58.451292298868516 -34.531862630973947,-58.451278510701847 -34.531878405114234,-58.451238505832848 -34.531939742431369,-58.451196715405189 -34.53198960012525,-58.45118131015392 -34.532006571344269,-58.451136456735874 -34.532051780610715,-58.451113135678369 -34.53208008966039,-58.45108760075761 -34.532117553877519,-58.451055682574506 -34.532160792414182,-58.45103797836812 -34.532186496221698,-58.451001292892578 -34.532241777137415,-58.450978651592848 -34.532276776697259,-58.450965033220676 -34.532294522745858,-58.450936179730398 -34.532328887866342,-58.450924008247569 -34.532345084677189,-58.450901792602906 -34.532378534890903,-58.450877619076898 -34.532416069619792,-58.450841443592061 -34.532474167575344,-58.450817781618781 -34.532504589313973,-58.450799906726807 -34.532532687553413,-58.450785095898304 -34.532557335214378,-58.450775647458748 -34.532574095683572,-58.45076398534087 -34.532598461945128,-58.450756152568182 -34.532623744118219,-58.45075172428956 -34.532645434897155,-58.450747720772306 -34.532672266816355,-58.450744225303858 -34.532716916566152,-58.450744219978695 -34.532754171926008,-58.450742088075025 -34.532785018310399,-58.450734672223987 -34.532870092205378,-58.45072589772267 -34.532934460718664,-58.450721977901551 -34.532970941007228,-58.450718227681818 -34.533011576446604,-58.450716265508007 -34.533045592016279,-58.450712346404188 -34.533077001631362,-58.45070876937389 -34.533096720562448,-58.450704681892695 -34.533115383053115,-58.450698977709152 -34.533132636864579,-58.450697354763136 -34.533174751457423,-58.450694542080292 -34.533205245641902,-58.45069096444373 -34.533229119706384,-58.450684663515929 -34.533253556910793,-58.450674022530762 -34.533277571131471,-58.450660146126111 -34.533312712341072,-58.450637756850888 -34.533367431137776,-58.450628731708605 -34.53339862896609,-58.450626005771063 -34.53341750286576,-58.450618002180541 -34.533446235883879,-58.45061136181063 -34.533463771301726,-58.45060838048412 -34.533483208583561,-58.450609143028991 -34.53350644924015,-58.450601395652797 -34.53352877351584,-58.4505916910921 -34.533550182058924,-58.450564877161085 -34.533600181859235,-58.450547850439179 -34.533645604937377,-58.450533975047229 -34.533672999270479,-58.450522654164573 -34.533690111660484,-58.450505886287019 -34.533710956083695,-58.450485203581742 -34.53373306778105,-58.450461797805815 -34.53375405238598,-58.450441030710294 -34.533771163821228,-58.4503881762706 -34.533817710090283,-58.450351322900154 -34.5338496093472,-58.450335320980848 -34.533869608711903,-58.450337871092863 -34.533889328249742,-58.450318113285007 -34.533986584551634,-58.45030329885244 -34.534032852929023,-58.450285162596366 -34.534098417689627,-58.45027545539871 -34.534136587592336,-58.45026736577443 -34.534170320820998,-58.450254171118054 -34.534197010929269,-58.450241996042273 -34.534234617169218,-58.450239099378408 -34.534256237654049,-58.450238412450794 -34.534297295938586,-58.450234577296932 -34.534334832601871,-58.450230828731911 -34.534362368782617,-58.450225975116965 -34.53438138330511,-58.450195755800145 -34.53443701674901,-58.45018392377763 -34.534456523536861,-58.450157707641992 -34.534489057655605,-58.45013455616801 -34.534514760762718,-58.450122979636696 -34.53453285905087,-58.450121018667815 -34.534557014963859,-58.450113611491574 -34.534579198387817,-58.450104247726948 -34.53459638136416,-58.450091990120455 -34.534616099376642,-58.450079817684248 -34.534635324414715,-58.450075643897122 -34.534660536487735,-58.450074023095141 -34.534686171380407,-58.450062613740307 -34.53472405938254,-58.450058015275623 -34.534743707757535,-58.45005256608902 -34.534761384116514,-58.450044648979571 -34.5347788489415,-58.450044220188282 -34.53480054010145,-58.450039960917863 -34.5348281466473,-58.450024550276744 -34.534875682590425,-58.450016459433037 -34.534916317544941,-58.450010747569259 -34.534982446952846,-58.45000835871739 -34.535021955682687,-58.450010737835271 -34.535046605024803,-58.450009372023665 -34.535074141443069,-58.450010723923413 -34.535138299655543,-58.450015656367647 -34.535161259038759,-58.4500299504111 -34.535181895335803,-58.450050370693901 -34.535209997420061,-58.450064664573375 -34.535231830954594,-58.450090104853885 -34.535266976149522,-58.4501158001449 -34.535304234144697,-58.450131966203799 -34.535326772123724,-58.450152302045538 -34.535350930326622,-58.450166852306658 -34.535365932554818,-58.450185232055546 -34.535381780285491,-58.45025977388007 -34.535434889091135,-58.450294152721604 -34.535452146953546,-58.450334998379169 -34.535476095929283,-58.450365377465097 -34.535493142088576,-58.450390906287879 -34.535506314322575,-58.450426391653586 -34.535522656721341,-58.450450217917336 -34.535539420496733,-58.450472087891356 -34.535548930195688,-58.450495661607832 -34.535546890200337,-58.45051608788161 -34.535535553657148,-58.45053778961303 -34.535531611965439,-58.45056042694938 -34.535531262087822,-58.450600679581292 -34.535537393142633,-58.450666888356544 -34.53554458313409,-58.450702290316379 -34.535549586861677,-58.45077343433784 -34.535561847950603,-58.450805517289467 -34.535566992176051,-58.450910446318424 -34.535584679271381,-58.450984228069203 -34.535600602642972,-58.45107009399527 -34.535619625864385,-58.451092050238685 -34.535621388602749,-58.451131708159707 -34.535620828957938,-58.451182854193398 -34.535625693184542,-58.451215363259365 -34.535626823061669,-58.451239703058143 -34.535623656179091,-58.451283192041458 -34.535612532947731,-58.451404210162181 -34.535596698355732,-58.451437059374399 -34.535599729706739,-58.451494759194595 -34.535598044790952,-58.451520034698675 -34.53559790625544,-58.451561479592414 -34.535598614302252,-58.451604285914279 -34.535600942256231,-58.451627093171908 -34.535602845827682,-58.451658580092051 -34.535610877240096,-58.451703681916861 -34.535630530157519,-58.451722998995194 -34.5356398985505,-58.451753717857365 -34.535664409548225,-58.451772949459937 -34.535676735816665,-58.451793202732695 -34.535685752152332,-58.451817881563173 -34.535693149081546,-58.451846730926206 -34.53569674337367,-58.451869964349356 -34.535693857971118,-58.451891581192015 -34.535688084955972,-58.451923326055123 -34.535676115345069,-58.451975920847651 -34.535665908207982,-58.452056344264932 -34.535655280920899,-58.452100683718939 -34.535647819623463,-58.452128427589123 -34.535644723285138,-58.452183829352819 -34.535645432328096,-58.452218891317862 -34.535648181955409,-58.45224748540096 -34.535651564853033,-58.452289950131053 -34.535663752174408,-58.452317012049996 -34.535669740686338,-58.452340925695424 -34.535671503366579,-58.452389094190316 -34.535668619977763,-58.452517175338514 -34.535655813196243,-58.452559386672 -34.535652577113524,-58.452591639905741 -34.535658284291642,-58.4526131705165 -34.535661384814887,-58.452671550586217 -34.535664629217777,-58.452703889145425 -34.535668575723797,-58.452725930236547 -34.535672873510578,-58.452752140810581 -34.53568181974763,-58.452774692624374 -34.53568527245546,-58.452801329596454 -34.535686823988904,-58.452867793946297 -34.535694364937619,-58.452923195419928 -34.535697890684268,-58.452982681592907 -34.535703459084232,-58.453019615616505 -34.535708391835882,-58.453066506229511 -34.535717128364958,-58.453120544969124 -34.535730372699511,-58.453155776354286 -34.535740587224716,-58.453181731566922 -34.53575058973918,-58.453209473113638 -34.535767916688599,-58.453229640655117 -34.535784045802934,-58.453259678966418 -34.535810528295933,-58.453286483957761 -34.535831939861929,-58.453321883969174 -34.535856802955117,-58.453344519286475 -34.535875185870971,-58.453369962398114 -34.535899062223237,-58.453389364389068 -34.535912374213368,-58.453420935713538 -34.535929278850347,-58.453463143346639 -34.535960480757026,-58.453517349558588 -34.536000627650495,-58.453552834458812 -34.536028730277266,-58.453572576560092 -34.536045352284255,-58.453591381867668 -34.536068101277877,-58.453604996536868 -34.536084934100273,-58.453673669488182 -34.536133885246727,-58.453698943157242 -34.53615226829104,-58.453716217429118 -34.536167904128959,-58.453728129780231 -34.536187483425046,-58.454110124073509 -34.536520203175662,-58.454128248805191 -34.536542952037003,-58.454140927382966 -34.536561122826051,-58.454144755201746 -34.536579152142082,-58.454155050734954 -34.536598801707903,-58.4541664528724 -34.536615986441291,-58.45420474445654 -34.536665921121731,-58.454247205851402 -34.536719025246931,-58.45428158356971 -34.536760860645423,-58.454306516022662 -34.536790441267151,-58.454329065929791 -34.536816570848046,-58.454348467407158 -34.536838685929432,-58.45437791010027 -34.536871436012959,-58.454483171185032 -34.536998562005387,-58.454593625754931 -34.537107025369437,-58.454684678068304 -34.537202599408971,-58.454765859030175 -34.537292397809487,-58.454831975391514 -34.537395857821096,-58.454834351745944 -34.537465720524693,-58.454834007770586 -34.53750353924174,-58.454834935641792 -34.537591571747534,-58.454813908451861 -34.537658756753466,-58.454769900805736 -34.537748335718497,-58.454756109909262 -34.537789534005448,-58.454685629203347 -34.537934254734225,-58.454813702053826 -34.538042507759783,-58.454828847870651 -34.53807328487747,-58.454914373196779 -34.538130898787372,-58.454898201489726 -34.538149278928259,-58.454828669228498 -34.538162866674675,-58.454825610048147 -34.5381139204422,-58.454780762386171 -34.538084549920853,-58.454636260487923 -34.538015170903094,-58.454607398428571 -34.538133273313285,-58.454354857908243 -34.538467145737073,-58.454267605772479 -34.538654895313151,-58.454235773354434 -34.538683204340408,-58.454096612688787 -34.53880672171978,-58.454033291731427 -34.538827563321291,-58.453210356284117 -34.539234634502783,-58.453183205099819 -34.539254492504185,-58.453141501097122 -34.539270968916306,-58.45311869160227 -34.539279559093131,-58.453092307172746 -34.539292163262857,-58.453058858261265 -34.539310330518312,-58.453025579368862 -34.53933004714861,-58.452999110072525 -34.5393403272355,-58.452973662358517 -34.539347931212419,-58.452949916186256 -34.539360535561357,-58.452930765724133 -34.539373421977096,-58.452871613587334 -34.539400038234362,-58.45282769654785 -34.539417641175739,-58.45280752548345 -34.539424541285065,-58.452781653496771 -34.539421158741639,-58.45275833382059 -34.539425241549665,-58.452743012857425 -34.539440241025574,-58.452723096755804 -34.539450028605025,-58.452700373101024 -34.53945171696887,-58.452677137556655 -34.539463828324799,-58.452654752479262 -34.539480869561636,-58.452623600333851 -34.539506854164884,-58.4525938098244 -34.539533261428375,-58.452577636986568 -34.539554528720849,-58.452563081509155 -34.539572979108044,-58.452546058349817 -34.539587978417558,-58.452524525016692 -34.539598963070766,-58.452496354582053 -34.53959987625737,-58.452470397653755 -34.539594803418609,-58.45243380189752 -34.539593743958605,-58.452403503691812 -34.539595502056102,-58.452372780299171 -34.539594443072794,-58.452338823192648 -34.539590637196049,-58.452299419452899 -34.539585281475581,-58.452239250441963 -34.539573867335122,-58.452171846714783 -34.539567734486525,-58.451897342754648 -34.539179100200187,-58.451935747139387 -34.539012475820329,-58.451671275004237 -34.538726734178141,-58.451650682334396 -34.538704477718667,-58.451429607066068 -34.538484728569166,-58.45133004691241 -34.538386334293314,-58.451308684870604 -34.538390487433404,-58.451280855809593 -34.538387315666782,-58.451251835862088 -34.538379847799398,-58.451276620978426 -34.538237660131799,-58.451187273296263 -34.538143844377181,-58.451094426847554 -34.538119609062292,-58.451066599569891 -34.538104323983475,-58.451015454634756 -34.538080796833263,-58.450984049919214 -34.538087273011868,-58.450861080286636 -34.538035357227081,-58.450838529676304 -34.538019509199898,-58.450684246804997 -34.53793117997396,-58.450666376220667 -34.537920966451289,-58.450368108311977 -34.537750435463821,-58.450349897458395 -34.537739728878499,-58.450248461359486 -34.537680279072568,-58.45007614632793 -34.537533775393847,-58.45006099966519 -34.537520815451188,-58.449877878439843 -34.537365084569529,-58.449875482920405 -34.536892244414098,-58.450026318876574 -34.536121236657941,-58.449090359378069 -34.535566038397924,-58.449070531973256 -34.535556810383447,-58.449049172312371 -34.535550117529766,-58.449026876088922 -34.535546100754715,-58.449004153870305 -34.535545041818942,-58.44898134607606 -34.535546870334485,-58.44895938884391 -34.535551515980664,-58.448938367286004 -34.535558908341486,-58.448918962256222 -34.535568836216392,-58.44890210998684 -34.535580665878058,-58.448863128789846 -34.535606014820104,-58.448779115581303 -34.535707489106997,-58.448803197413994 -34.53572101363735,-58.448792470413153 -34.535745379804368,-58.448789317322579 -34.53577115535284,-58.448793908612416 -34.535796790931222,-58.448805904159052 -34.535820596276558,-58.448824623378599 -34.535841162789815,-58.449282773402189 -34.536115100598323,-58.449306344363485 -34.536131442011353,-58.449327532117763 -34.536149825512069,-58.449346081377776 -34.536170110221818,-58.449361566671627 -34.536192014391439,-58.449374158237973 -34.536215326762729,-58.449383430637049 -34.536239554308388,-58.449389213704478 -34.536264415306732,-58.449391677666348 -34.536289768924831,-58.449390652380231 -34.536315192588539,-58.449386223002371 -34.536340334177197,-58.449378304471203 -34.536364911977252,-58.449367067046836 -34.53638857387682,-58.449352680978741 -34.536411038189677,-58.448973468670367 -34.536876159666278,-58.448711716464693 -34.537220372067779,-58.448720645540561 -34.537261501850764,-58.448849548633461 -34.53744251125174,-58.448894721660068 -34.537548366579912,-58.449090087673468 -34.537758609984728,-58.449210147816544 -34.537899897767744,-58.44917320716084 -34.537931374082213,-58.449117215002481 -34.537888619314458,-58.449033489236299 -34.537781351247062,-58.448896919606362 -34.53763787821817,-58.4488375258518 -34.537581530726179,-58.448786049975404 -34.537506732506515,-58.448701132103579 -34.537408126461663,-58.448589742975827 -34.537333180422706,-58.448467865312786 -34.53738105593176,-58.448124606485379 -34.537567785084342,-58.444894507017082 -34.539343358342819,-58.443134622850415 -34.540296867425603,-58.443170697048515 -34.540345467087242,-58.442877125951142 -34.540494863593345,-58.442660489107645 -34.540653145704901,-58.441785633103962 -34.541125556908888,-58.441785640572682 -34.541095696322522,-58.442183329369534 -34.540838497914173,-58.442385743744346 -34.540724864321753,-58.442573801719114 -34.540497560590239,-58.442675037643056 -34.540318202408336,-58.442718387371343 -34.540192499234337,-58.442855752000035 -34.54018653542974,-58.443087090500832 -34.540114808785034,-58.443332927308155 -34.539911457942758,-58.443470327190717 -34.539749993000157,-58.44352822864856 -34.5396244326691,-58.443535416012175 -34.539456890503516,-58.443586091331419 -34.539295411777715,-58.443607826265541 -34.539151746267621,-58.4437741441984 -34.539062049511827,-58.443896946996126 -34.539086083726602,-58.443969293962269 -34.539056163820867,-58.443976544053868 -34.538984400901121,-58.444041575789669 -34.538936521215668,-58.444113942516076 -34.53881687857821,-58.444294735120167 -34.538691336505714,-58.444432015988632 -34.538667412298139,-58.444511608091219 -34.538583687731716,-58.444605571237766 -34.538553770663988,-58.444858608212918 -34.538470001019654,-58.445003217752813 -34.538398258022298,-58.445256172485323 -34.538296599349437,-58.44541526040895 -34.538171052504666,-58.445530928289401 -34.538123179175884,-58.445624913748503 -34.537979664266757,-58.445805687791328 -34.537925813556058,-58.445885197508318 -34.537818213674534,-58.44603705089267 -34.537686537955281,-58.446203259322282 -34.537692546726547,-58.446318913191647 -34.53771052091308,-58.44646350158397 -34.537734485046464,-58.44664426192859 -34.537746410931469,-58.446723755542898 -34.537716560752351,-58.446868370113179 -34.537602912094385,-58.446969586578064 -34.537459397074933,-58.447078024294512 -34.537381590311334,-58.447222652193361 -34.537190190969532,-58.447302152787763 -34.537118436965265,-58.447367261882889 -34.537094500330326,-58.447482914086628 -34.537118459622675,-58.447547932590233 -34.537124524339596,-58.447714219765679 -34.537160391672046,-58.447793706051847 -34.537166387606611,-58.447938296040029 -34.53717837758289,-58.448010541162027 -34.537226135095196,-58.448111718687642 -34.537291995495529,-58.448147973147783 -34.537291999820951,-58.44811905226274 -34.537208259905299,-58.447923852631376 -34.537040763507854,-58.44780642507498 -34.536950251881493,-58.447826173541095 -34.536925886905046,-58.447826179315278 -34.536893420536551,-58.447786869975801 -34.536844680975491,-58.447752498896321 -34.536783687888033,-58.447562907380302 -34.536673940881137,-58.447472804680189 -34.536552233608901,-58.447335378025841 -34.536466860122999,-58.447171051799096 -34.53642007649502,-58.447009130295399 -34.536257935215176,-58.446830260529282 -34.536166217487683,-58.446634365105211 -34.536102738073446,-58.4462424734024 -34.536060359881269,-58.445884620492961 -34.536032070317546,-58.445671600291057 -34.536067324213626,-58.445151857780409 -34.536151902656712,-58.444802913781686 -34.53624932156275,-58.444562397747077 -34.536314289249546,-58.444359500579068 -34.536363204996228,-58.444061284039108 -34.536426684070442,-58.44372051369016 -34.536497127980553,-58.443320070420754 -34.536631015279845,-58.443141072618239 -34.536736766543676,-58.442979180248386 -34.536842520306678,-58.442842903794187 -34.536948207594968,-58.442723484323828 -34.537025797529282,-58.442595715974953 -34.537138528525922,-58.442476469635245 -34.537201962626831,-58.442357115705626 -34.537357091190273,-58.44222934806335 -34.537462849627737,-58.442135542064079 -34.537547415440677,-58.442016280857686 -34.537667189848783,-58.441862883466442 -34.537822241720477,-58.441769071387768 -34.537928005457033,-58.441564590343994 -34.538160657576583,-58.441470841142035 -34.5383510026507,-58.441325930408361 -34.538590707289487,-58.441164008558133 -34.538788082757641,-58.441087302636546 -34.53888680637484,-58.441010507774479 -34.53899961511415,-58.440942386209656 -34.539140595723417,-58.440916681080061 -34.539478987758073,-58.440899613807105 -34.539655260820041,-58.440848507381993 -34.539817372176721,-58.440839808371379 -34.54021217836511,-58.440746082989286 -34.540296743086195,-58.440643878283247 -34.540261441281721,-58.440541668027592 -34.540247408019603,-58.440405310998351 -34.540303723940447,-58.440388245783609 -34.540148642938583,-58.440354265037072 -34.539916019890313,-58.440286188867773 -34.539880724024599,-58.44029474491132 -34.539711492086909,-58.439936774741561 -34.54006397081065,;"58.439715203923946 -34.540197886688411,-58.439493640234204 -34.54030355409688,-58.43935738520927 -34.540296485535706,-58.439237997283151 -34.540233079325404,-58.439093251581625 -34.540155442061689,-58.438939906279828 -34.540092028989534,-58.438769525693381 -34.540077840109404,-58.438505365200598 -34.540035462077107,-58.438309469095195 -34.539964926755871,-58.438070943026261 -34.539866141732389,-58.437960135820461 -34.539859076741621,-58.43781536676223 -34.539866089920075,-58.437679014821484 -34.539901345448747,-58.4375086263097 -34.539915466030294,-58.437346665494623 -34.539922475105392,-58.437227417662619 -34.539964705846032,-58.437125108160267 -34.539999967851699,-58.43700585359241 -34.540063396577587,-58.436852462130574 -34.540154988335495,-58.436733132984259 -34.540183133389696,-58.436613882230048 -34.540232546972831,-58.436426370816207 -34.540295890104616,-58.43623902485394 -34.540373388593906,-58.436111090327593 -34.540429842394545,-58.436025870708001 -34.540514334914484,-58.435949161621124 -34.540599040516106,-58.435838404797259 -34.540697612489573,-58.435736151623836 -34.540817525291622,-58.435667860875959 -34.540923219493479,-58.435599731018932 -34.541057154482452,-58.435505893647715 -34.541205168890741,-58.435429250133602 -34.541346214899008,-58.435326880499716 -34.541557681000185,-58.43525871948637 -34.541783310307039,-58.435224429259478 -34.54201591935729,-58.435122233127764 -34.542213370548268,-58.435034334128439 -34.542413219367639,-58.435011308693745 -34.542551671462697,-58.434892662288235 -34.5425620675354,-58.434759200240691 -34.542591968076927,-58.434603522148763 -34.54262869467474,-58.434458909743974 -34.542660845950309,-58.434289355326143 -34.542706865155253,-58.434094690164194 -34.542762033610963,-58.43390283257451 -34.542819526472364,-58.433768854643269 -34.542862313746724,-58.433746041936651 -34.542871604557625,-58.433712334675072 -34.542882230870518,-58.433681435792472 -34.542893562100403,-58.433651898589225 -34.542905104924053,-58.43362227629224 -34.542916577294385,-58.43359256895058 -34.542927838359546,-58.433562776490831 -34.542939099397152,-58.433533154218729 -34.542950430894003,-58.433503531864808 -34.542961973661299,-58.433474164783917 -34.542973657334272,-58.433444712535376 -34.542985481831529,-58.433415260303178 -34.542997235895768,-58.43338563786704 -34.543008919486148,-58.433356270703769 -34.543020743982424,-58.433326988568176 -34.543032779769739,-58.433297791460056 -34.543045026848141,-58.433269019696198 -34.543057837429195,-58.433240588215618 -34.543071070640835,-58.433212582028929 -34.543085008207449,-58.433185341551855 -34.54309972063745,-58.433158696538598 -34.543115278316066,-58.433132306671993 -34.543131329031844,-58.433106172051417 -34.543147591081393,-58.433080037395747 -34.543163923551184,-58.433053732584071 -34.543180044696363,-58.43302700238538 -34.543195672751224,-58.43299976176457 -34.543210596417175,-58.432972095782368 -34.543224956566355,-58.432943919328707 -34.543238753177747,-58.432915657830591 -34.543252338484194,-58.432887226152651 -34.543265782890735,-58.432858879550864 -34.543279297737314,-58.432830788145544 -34.543293164769125,-58.432803037046902 -34.5433073840072,-58.432775796349745 -34.543322307622873,-58.43274898106926 -34.54333758346624,-58.432722335848553 -34.5433532819007,-58.432695945848366 -34.543369262095588,-58.432669726008626 -34.543385383178332,-58.43264359116808 -34.543401785979867,-58.432617711623728 -34.543418259264541,-58.4325919171037 -34.543434943842307,-58.432566292769252 -34.543451698882464,-58.432540753458987 -34.54346866521584,-58.432515384385084 -34.543485561160018,-58.432490015250039 -34.543502597950642,-58.432464816249656 -34.543519846055723,-58.432439702298616 -34.543537235028388,-58.432414843592788 -34.543554835336785,-58.432390155123514 -34.543572365256452,-58.432365381430927 -34.543590176853428,-58.432340777949371 -34.543607988487651,-58.43231625954251 -34.543625870563915,-58.432291656039979 -34.543643682188119,-58.432267222697376 -34.543661634701479,-58.432242789344286 -34.543679587209901,-58.432218611236308 -34.543697751054744,-58.43219460328821 -34.543716055789012,-58.432170680363392 -34.543734571817396,-58.432146842538884 -34.543753087862335,-58.43212300470384 -34.543771603902556,-58.432099166909779 -34.543789979086313,-58.432057023789682 -34.543825956143444,-58.432034206936322 -34.543845317532877,-58.432011304987185 -34.543864608470706,-58.431988403027489 -34.543883899404165,-58.431965415920232 -34.543903260737714,-58.431942599050466 -34.543922551683899,-58.431919867203511 -34.543942053924802,-58.431897305542286 -34.543961626630228,-58.431874914040904 -34.543981340226111,-58.431852777810548 -34.544001194734086,-58.431830981936514 -34.54402126060166,-58.431809356196396 -34.54404153778593,-58.431788241009116 -34.544062096799067,-58.431767466126246 -34.544083008024074,-58.431746946540784 -34.544103989736065,-58.431726682200697 -34.544125182786907,-58.431706587994661 -34.544146587155119,-58.43168666400107 -34.544167991563171,-58.431666825082488 -34.544189466415403,-58.431646815904777 -34.544211011646908,-58.431626891880519 -34.544232416044977,-58.431606797649344 -34.54425374997048,-58.431586533237414 -34.544274942997511,-58.431565843336465 -34.544295924634987,-58.431545068339844 -34.544316835821292,-58.431524293280333 -34.544337887855718,-58.431503688459728 -34.544358869504158,-58.431483594193026 -34.544380132983058,-58.431464010454079 -34.544401748718549,-58.431445362722194 -34.544423928097366,-58.431427395768118 -34.544446389351108,-58.431409854230914 -34.544469202840503,-58.431392738137077 -34.544492298139843,-58.431375962427815 -34.544515534375769,-58.431359441991667 -34.544538911526558,-58.43134309171694 -34.544562429570476,-58.431326911656569 -34.544585947655833,-58.431310816698904 -34.544609465760814,-58.431294636646804 -34.544632913415839,-58.431278626756395 -34.544656501964141,-58.431262872139612 -34.544680231427726,-58.431247372823094 -34.54470403138081,-58.43123204369509 -34.544727901801551,-58.431216884729174 -34.544751913115881,-58.431201896005049 -34.544775854046307,-58.431186992331227 -34.544799935848459,-58.431172088648836 -34.544824017648693,-58.431157099845777 -34.544848099425025,-58.431142196146169 -34.544872181221429,-58.431127292437964 -34.544896263015893,-58.431112473833295 -34.544920344830452,-58.431097655193476 -34.544944497068983,-58.431083006769406 -34.544968649349691,-58.43106844342244 -34.544992872076449,-58.431054135377025 -34.545017165293395,-58.431039997494445 -34.545041599404442,-58.431025944742537 -34.545065963109941,-58.431012147239237 -34.545090538157574,-58.430998605091489 -34.54511504284396,-58.430985062909073 -34.545139617954618,-58.430971690889976 -34.545164333959598,-58.430958403975353 -34.545189049985147,-58.43094520213856 -34.54521383645713,-58.430932170518808 -34.545238622971866,-58.430919309062745 -34.545263550381144,-58.430906617823979 -34.54528847783326,-58.430894011663376 -34.54531347573198,-58.430881660806051 -34.545338544121691,-58.430869565279046 -34.545363612576594,-58.430857639943142 -34.545388751500433,-58.430845969911118 -34.545413960915475,-58.430834470043635 -34.545439311225422,-58.430823055281856 -34.545464661556395,-58.430811810711688 -34.545490082356501,-58.430800736333268 -34.545515573625771,-58.43078991725946 -34.545541135386529,-58.430779268404585 -34.545566697190708,-58.430768959940629 -34.545592399934584,-58.43075890678189 -34.545618173170126,-58.430749279127411 -34.545644087367769,-58.430739906832535 -34.545669931205524,-58.430730874929644 -34.545695915983302,-58.43072226855886 -34.54572197129756,-58.430714172833547 -34.545748097170758,-58.430706247275246 -34.545774363939572,-58.430698577024046 -34.545800701200555,-58.430691247247175 -34.545826968124302,-58.430684087610871 -34.545853446369705,-58.430677268449408 -34.545879854277985,-58.430670619482918 -34.545906332656273,-58.430664225797685 -34.545932951952771,-58.43065800236171 -34.545959500867646,-58.430651949121184 -34.545986120252607,-58.430646151189514 -34.546012810130009,-58.430640523507634 -34.54603942962585,-58.430635066021743 -34.546066119591906,-58.430629863872312 -34.546092809624625,-58.430624661719534 -34.546119499657024,-58.430619800016899 -34.546146189778511,-58.430615193624327 -34.546172950392652,-58.430611012768871 -34.546199781544146,-58.430606916997142 -34.546226683143622,-58.430603161703708 -34.54625351440648,-58.430599576607854 -34.54628041613968,-58.430596246823214 -34.546307388365648,-58.430593087317646 -34.546334219784477,-58.430590097983099 -34.546361192099553,-58.430587278873858 -34.546388164459188,-58.430584715103713 -34.546415136885813,-58.430582151331912 -34.54644210931226,-58.430579842926583 -34.546469011379848,-58.430577619579388 -34.546496054321352,-58.430575651599057 -34.546523026904048,-58.430573768731215 -34.546549999508962,-58.430572141176519 -34.546577042606749,-58.430570513620758 -34.546604085704416,-58.430569141405527 -34.546631128869123,-58.430567854330377 -34.546658101630243,-58.430566652341206 -34.546685144839465,-58.430565705693091 -34.546712188115769,-58.430564844158326 -34.546739231414328,-58.430564152851005 -34.546766274757573,-58.430563461516172 -34.546793388526524,-58.4305630255501 -34.546820431936716,-58.430562759811892 -34.546847475391601,-58.430563855601477 -34.546875293888966,-58.430566823523876 -34.54690409884072,-58.430570812628865 -34.546933397041897,-58.430575227280578 -34.546962765780592,-58.430579131412365 -34.546991711829612,-58.430582184701898 -34.547019882970318,-58.430583451134574 -34.54704664512397,-58.430582249929415 -34.547071645982392,-58.430577985473377 -34.547094392407928,-58.43056793445686 -34.547113968147734,-58.430467662172703 -34.547133590530329,-58.429996165424775 -34.546821619522603,-58.430052274206822 -34.546773956239356,-58.429954919230568 -34.54673449169681,-58.429932608329814 -34.546762656050426,-58.429910470901518 -34.546782510196579,-58.429889014153872 -34.546802927928304,-58.429867812654926 -34.546823557002377,-58.42984814283917 -34.546845102020768,-58.429830259938633 -34.546867844756306,-58.429813653546347 -34.54689108081385,-58.429797472604676 -34.546914598687074,-58.429781717141587 -34.546938327950315,-58.429767493503185 -34.546962621031284,-58.429755397406801 -34.546987689368834,-58.429744662909037 -34.547013321479305,-58.429734353948305 -34.547039024129468,-58.429723619437489 -34.547064656237879,-58.429712459431833 -34.547090076952756,-58.429702746224407 -34.5471158501867,-58.429695501077795 -34.547142257919447,-58.429690724077595 -34.547169088873936,-58.429688755822937 -34.547195991013353,-58.429690532547738 -34.547223035016735,-58.429693841362358 -34.547250009008273,-58.429697660921825 -34.54727684228596,-58.429701906056458 -34.547303675678414,-58.429705470277227 -34.547330508886624,-58.429707672555502 -34.547357623429995,-58.429712173096902 -34.547384316039086,-58.429721355252816 -34.547410235228156,-58.429732495218701 -34.547435732389999,-58.429742358304196 -34.547461651761125,-58.429752732167479 -34.547487359991642,-58.429766681439638 -34.547511590242969,-58.429784546637649 -34.547534201753983,-58.429802837447042 -34.54755674295113,-58.429817723091517 -34.547580762171116,-58.429829714313428 -34.547606118700948,-58.429843663600018 -34.547630419368843,-58.429862550444355 -34.547652467736228,-58.429884076497139 -34.547672897015708,-58.429906368788316 -34.547692833516273,-58.429929427428462 -34.547711995534186,-58.429953592960153 -34.547730171882826,-58.429978184049801 -34.54774841876651,-58.430003711828533 -34.547765609508495,-58.430030942991827 -34.547780054093288,-58.430060984830803 -34.547789710466546,-58.430093155926492 -34.547795846109267,-58.4301253270269 -34.547801981743518,-58.430149269338692 -34.547737830192702,-58.430069193288283 -34.547693863098587,-58.430479160937672 -34.547332828269944,-58.430607082252017 -34.547348214791199,-58.430614648017304 -34.547372795397536,-58.430618297135133 -34.547400966692159,-58.430619647510589 -34.547430827602739,-58.430620487225774 -34.547460617953163,-58.430622434189793 -34.547488436670861,-58.430624807053185 -34.547515410390204,-58.430626754344139 -34.547542383997602,-58.430628361177064 -34.547569357515442,-58.43062971263948 -34.547596401391907,-58.430630808758139 -34.547623445201161,-58.430631649532806 -34.547650488943241,-58.430632490308007 -34.547677532685178,-58.430633075738896 -34.547704576359948,-58.430639173656935 -34.547783736600159,-58.430516507517851 -34.547823635778933,-58.430390164680666 -34.547906564045725,-58.430304678056544 -34.54798654514186,-58.430215435494183 -34.548094061677951,-58.430103975122996 -34.548207840116689,-58.430033373560711 -34.548312333179837,-58.429940361117502 -34.548481330247334,-58.429825154785128 -34.548595036993191,-58.429732247303086 -34.548711848387022,-58.429628190550503 -34.548825628378225,-58.429531543543078 -34.548927015346983,-58.429353156444819 -34.549099087464576,-58.42927508631346 -34.549145124604223,-58.429167307934691 -34.549197421436389,-58.429067032058128 -34.549218944157346,-58.428996382896564 -34.549225051723063,-58.428918345978055 -34.54918812702936,-58.428814348618523 -34.549151195083937,-58.428736388209963 -34.549135820595389,-58.428636033465231 -34.549141919686384,-58.428572867049709 -34.549166480658855,-58.428524594683076 -34.549194214929926,-58.428468815709422 -34.549261808090307,-58.428439089889935 -34.549310956973471,-58.428294207542606 -34.549344720627069,-58.428190153059347 -34.549240179350477,-58.428130774787093 -34.549160229250795,-58.427970950378239 -34.549101800894086,-58.42784838535254 -34.54909563892614,-58.427748100307667 -34.549138570010484,-58.427655216364734 -34.549190869770314,-58.427521347336757 -34.549347528718172,-58.427443251281588 -34.549452088529236,-58.427413500891923 -34.54975948860929,-58.427309388434551 -34.549793262866764,-58.427238827690907 -34.549790143659187,-58.427134764835358 -34.549707081361312,-58.426978748009731 -34.549700908772607,-58.426937899721153 -34.54968251567869,-58.426900808509849 -34.549636305476753,-58.426848734081929 -34.549596358762187,-58.426778178757644 -34.549581055624294,-58.426689056124005 -34.549593283464041,-58.426618406473501 -34.549599389653181,-58.426566404047449 -34.549590148493856,-58.426514406968053 -34.549568582796645,-58.426455004690474 -34.549547155730934,-58.426336107205692 -34.549522471344879,-58.426202989600966 -34.549510811368961,-58.426059896176234 -34.549538375433045,-58.425940616265677 -34.549609399227215,-58.425826182631241 -34.549692185478122,-58.42583090218416 -34.549798741155321,-58.425806952952357 -34.549869723137917,-58.425756283811474 -34.549924992078076,-58.425756256638721 -34.549986473800722,-58.425744661011812 -34.550030979402365,-58.425729585652633 -34.550052665987479,-58.425603977791283 -34.549803743082698,-58.425624068860053 -34.549796002345779,-58.425580441639163 -34.549710773859701,-58.425560606282048 -34.5497177399834,-58.425371641196833 -34.549348439821522,-58.425399989620665 -34.549338166315579,-58.425344117448411 -34.549227510277809,-58.425315769401699 -34.549237009087101,-58.425183103993362 -34.548977730960452,-58.425194434344263 -34.548955691159627,-58.425185676759952 -34.54893477200077,-58.425164147009362 -34.548924412788672,-58.425142441874151 -34.548925532927527,-58.425121241166941 -34.548940597530169,-58.425117655742561 -34.548964048224711,-58.425244877982848 -34.549213253861588,-58.425317588392808 -34.54935680395706,-58.425510549746853 -34.549735119923078,-58.425490714315451 -34.549742226887005,-58.425534000992769 -34.549827455301028,-58.425553751323633 -34.549820348304273,-58.42567102270678 -34.550057648473953,-58.42657488590639 -34.551825606750043,-58.426698554231969 -34.552046005560896,-58.426901681539753 -34.551970216714203,-58.428134865433414 -34.551412236387598,-58.428462621519522 -34.551292745734806,-58.428699473134884 -34.551165834211332,-58.429168861736734 -34.550874354398694,-58.429571949965592 -34.550916308800588,-58.4297876247388 -34.550938520028993,-58.430040485013848 -34.55096443297888,-58.430560901136637 -34.551017810356427,-58.430879990554921 -34.55106831880034,-58.431089087102933 -34.551140701458131,-58.431353807133007 -34.551276148549675,-58.431627038931616 -34.551449208554644,-58.431629223409878 -34.551450541180415,-58.431827477777823 -34.551577764839628,-58.431940847155211 -34.551640282926265,-58.432035584136329 -34.551692587017214,-58.432332249079224 -34.551857668786127,-58.436036216667851 -34.549828667697454,-58.436430374685813 -34.549610235625835,-58.43734554941021 -34.549121151570546,-58.437774889849337 -34.548887777209693,-58.440180535963464 -34.547595015029465,-58.440598851966215 -34.547361981928667,-58.44102814698013 -34.547122822286028,-58.442823188938299 -34.546133785329424,-58.443093458735071 -34.54598516003994,-58.44545076651761 -34.544688693893107,-58.445790712593222 -34.54450820008725,-58.445855298270494 -34.54471396282927,-58.445855333418642 -34.544736959057488,-58.445852093594453 -34.544769063878476,-58.445845622028841 -34.544793141936253,-58.445840765519797 -34.544825246533463,-58.445839141826582 -34.544860027015716,-58.445840746097538 -34.544921562332725,-58.445843971098384 -34.544963032081078,-58.445850427580062 -34.545013866311109,-58.445858502100528 -34.5450580121664,-58.445879507412599 -34.545115536996896,-58.445894047893177 -34.545163696897824,-58.445924756865253 -34.545203832702533,-58.447289776557689 -34.5470121481004,-58.448044164174526 -34.546898573657451,-58.448773866052903 -34.546788724308634,-58.449486627943962 -34.5466814040957,-58.449630863018896 -34.54665953363255,-58.449852989303587 -34.547705640308514,-58.450106981868174 -34.548849164087265,-58.450810111510428 -34.548743749560757)))""";953;13_11_1;13;11;1;568;296;272;123,64%;220;217;98,64%;3;1,38%;172;7;4,07%;165;95,93%
MULTIPOLYGON (((-58.447289776557689 -34.5470121481004,-58.445924756865253 -34.545203832702533,-58.445894047893177 -34.545163696897824,-58.445879507412599 -34.545115536996896,-58.445858502100528 -34.5450580121664,-58.445850427580062 -34.545013866311109,-58.445843971098384 -34.544963032081078,-58.445840746097538 -34.544921562332725,-58.445839141826582 -34.544860027015716,-58.445840765519797 -34.544825246533463,-58.445845622028841 -34.544793141936253,-58.445852093594453 -34.544769063878476,-58.445855333418642 -34.544736959057488,-58.445855298270494 -34.54471396282927,-58.445790712593222 -34.54450820008725,-58.44545076651761 -34.544688693893107,-58.443093458735071 -34.54598516003994,-58.442823188938299 -34.546133785329424,-58.44102814698013 -34.547122822286028,-58.440598851966215 -34.547361981928667,-58.440666923239128 -34.547439462656065,-58.441061219705212 -34.547922513565652,-58.441131924421768 -34.548023305444737,-58.441161206548202 -34.548013732699999,-58.441366860154268 -34.547954611101751,-58.441766671053557 -34.547855943276488,-58.442192011454544 -34.547773828502571,-58.443138444515611 -34.548334784708658,-58.443338864264881 -34.548453554601963,-58.444277312811998 -34.549009852550292,-58.445373646240625 -34.54965969122771,-58.446477486220161 -34.550313887392612,-58.447632834522004 -34.550998715101237,-58.448026025469417 -34.550346267907074,-58.448781463659195 -34.550232266546338,-58.449508980619257 -34.550122412619004,-58.450015244576996 -34.550049153967727,-58.450078400835388 -34.549966540584705,-58.450193273837428 -34.549893812013934,-58.45031336753847 -34.549876654724187,-58.450106981868174 -34.548849164087265,-58.449852989303587 -34.547705640308514,-58.449630863018896 -34.54665953363255,-58.449486627943962 -34.5466814040957,-58.448773866052903 -34.546788724308634,-58.448044164174526 -34.546898573657451,-58.447289776557689 -34.5470121481004)));;954;13_11_2;COMUNA 13;11;2;746;344;402;85,57%;330;329;99,70%;1;0,30%;241;0;0,00%;241;100,00%
MULTIPOLYGON (((-58.45031336753847 -34.549876654724187,-58.450545370324903 -34.549969017959768,-58.451061640201537 -34.549888615935053,-58.451792470835919 -34.549778044452914,-58.453006326426348 -34.550504025690991,-58.453393237153797 -34.550052767206004,-58.454022905703113 -34.549518633765949,-58.454157487045926 -34.54940455342846,-58.454161083140811 -34.549197079211055,-58.454121185299549 -34.54898474255652,-58.453958126055618 -34.54875972047725,-58.453818641312694 -34.548567236622297,-58.453663417440239 -34.548313480964275,-58.453255025890869 -34.54837507266074,-58.452754622004363 -34.54845052941964,-58.452159736879715 -34.548540202025215,-58.451541528241144 -34.548633461319199,-58.450810111510428 -34.548743749560757,-58.450106981868174 -34.548849164087265,-58.45031336753847 -34.549876654724187)));;955;13_11_3;COMUNA 13;11;3;579;264;315;83,81%;259;259;100,00%;0;0,00%;207;1;0,48%;206;99,52%
MULTIPOLYGON (((-58.453006326426348 -34.550504025690991,-58.451792470835919 -34.549778044452914,-58.451061640201537 -34.549888615935053,-58.450545370324903 -34.549969017959768,-58.450634939113669 -34.55001884179957,-58.450686325069675 -34.550089316804147,-58.450681907459234 -34.550174366293376,-58.450640781400622 -34.550237542181314,-58.450615811199675 -34.550281279672596,-58.450554127584049 -34.550337163500714,-58.450464544274624 -34.550384539512557,-58.450668034997229 -34.551233217702737,-58.450923901440035 -34.552520747236457,-58.45102656548638 -34.552617163842044,-58.451023442369831 -34.552703820174415,-58.450913326661308 -34.552941729390795,-58.451149607627279 -34.552669105219707,-58.451575614336662 -34.552172361289948,-58.452308599637384 -34.551317668025362,-58.453006326426348 -34.550504025690991)));;956;13_11_4;COMUNA 13;11;4;557;245;312;78,53%;308;308;100,00%;0;0,00%;229;1;0,44%;228;99,56%
MULTIPOLYGON (((-58.45102656548638 -34.552617163842044,-58.450923901440035 -34.552520747236457,-58.450668034997229 -34.551233217702737,-58.450464544274624 -34.550384539512557,-58.450554127584049 -34.550337163500714,-58.450615811199675 -34.550281279672596,-58.450640781400622 -34.550237542181314,-58.450681907459234 -34.550174366293376,-58.450686325069675 -34.550089316804147,-58.450634939113669 -34.55001884179957,-58.450545370324903 -34.549969017959768,-58.45031336753847 -34.549876654724187,-58.450193273837428 -34.549893812013934,-58.450078400835388 -34.549966540584705,-58.450015244576996 -34.550049153967727,-58.449508980619257 -34.550122412619004,-58.448781463659195 -34.550232266546338,-58.448026025469417 -34.550346267907074,-58.447632834522004 -34.550998715101237,-58.448739263180627 -34.551654440367209,-58.449854645942246 -34.552315508840877,-58.449910734723503 -34.552348685273884,-58.450855824460398 -34.552908806431624,-58.450912680050457 -34.552942475456049,-58.450913326661308 -34.552941729390795,-58.451023442369831 -34.552703820174415,-58.45102656548638 -34.552617163842044)));;957;13_11_5;COMUNA 13;11;5;591;278;313;88,82%;262;262;100,00%;0;0,00%;222;0;0,00%;222;100,00%
MULTIPOLYGON (((-58.446477486220161 -34.550313887392612,-58.445373646240625 -34.54965969122771,-58.444277312811998 -34.549009852550292,-58.443459722463956 -34.549959418610925,-58.443904655733718 -34.55022527492072,-58.444563636928812 -34.550611800984413,-58.445669271788489 -34.551260300131666,-58.446147923136564 -34.551541012753724,-58.446815775905158 -34.551935838028044,-58.447927232418309 -34.552592768444725,-58.449052835046601 -34.553258141350469,-58.449412946560308 -34.553471007758453,-58.450102874593426 -34.55387898695114,-58.450335040189074 -34.553609068709378,-58.450912680050457 -34.552942475456049,-58.450855824460398 -34.552908806431624,-58.449910734723503 -34.552348685273884,-58.449854645942246 -34.552315508840877,-58.448739263180627 -34.551654440367209,-58.447632834522004 -34.550998715101237,-58.446477486220161 -34.550313887392612)));;958;13_11_6;COMUNA 13;11;6;1081;521;560;93,04%;482;482;100,00%;0;0,00%;408;1;0,25%;407;99,75%
MULTIPOLYGON (((-58.444563636928812 -34.550611800984413,-58.443904655733718 -34.55022527492072,-58.443459722463956 -34.549959418610925,-58.442665953325381 -34.550881094339395,-58.443783149960012 -34.551543838442058,-58.444876874276616 -34.552192694949589,-58.446017000586814 -34.552869084422319,-58.447137825042709 -34.553533981317159,-58.448254581911748 -34.554196472895988,-58.449297562519845 -34.554815141293822,-58.450102874593426 -34.55387898695114,-58.449412946560308 -34.553471007758453,-58.449052835046601 -34.553258141350469,-58.447927232418309 -34.552592768444725,-58.446815775905158 -34.551935838028044,-58.446147923136564 -34.551541012753724,-58.445669271788489 -34.551260300131666,-58.444563636928812 -34.550611800984413)));;959;13_11_7;COMUNA 13;11;7;726;343;383;89,56%;355;355;100,00%;0;0,00%;284;22;7,75%;262;92,25%
MULTIPOLYGON (((-58.446648660821218 -34.556059878612984,-58.447347704111003 -34.556472592924813,-58.447693525301382 -34.556679758010901,-58.448515986450253 -34.555723686046186,-58.449297562519845 -34.554815141293822,-58.448254581911748 -34.554196472895988,-58.447137825042709 -34.553533981317159,-58.447042042456893 -34.553649115206781,-58.446357940281068 -34.55444068159013,-58.445529508009002 -34.555399062427085,-58.446648660821218 -34.556059878612984)));;960;13_12_1;COMUNA 13;12;1;703;329;374;87,97%;420;418;99,52%;2;0,48%;277;0;0,00%;277;100,00%
MULTIPOLYGON (((-58.442581338160139 -34.560813645688832,-58.443382526970957 -34.559877324657634,-58.444197491888453 -34.558924802397286,-58.443989300301119 -34.558801666527842,-58.443064447698077 -34.558250862633329,-58.441963421906934 -34.557604665460659,-58.440838416802258 -34.556925072205551,-58.440487164198508 -34.556715844379298,-58.440268940764483 -34.556585939427102,-58.440042717816006 -34.55645068024198,-58.439706448714539 -34.556249622319577,-58.438582414348318 -34.555577684722472,-58.437462227882691 -34.554907991126669,-58.436345293372113 -34.554240259807379,-58.435615601990982 -34.553803953364266,-58.435511823890693 -34.553749628963978,-58.435353465772693 -34.553690861577437,-58.435165101487321 -34.553664691283416,-58.434653547934566 -34.553593585673084,-58.43410985399661 -34.553956976872357,-58.435181695211142 -34.554455083368239,-58.435335401743906 -34.55452688176242,-58.435455914848831 -34.554586770607095,-58.435717112328845 -34.554716412003337,-58.435982221964395 -34.554859434587748,-58.436243408450288 -34.55502907667784,-58.436536667459023 -34.555261826553966,-58.436687212587849 -34.555380244405711,-58.436869918012 -34.555552333296859,-58.437099094965191 -34.555745488960689,-58.437330916846825 -34.555922024262877,-58.437500959301502 -34.556034670237914,-58.437698837639132 -34.556147251251588,-58.437986351737457 -34.556259850119368,-58.438343159406124 -34.556365490003586,-58.438490751331642 -34.556409394592606,-58.438811725980052 -34.556504955114441,-58.439148778370857 -34.556641083116709,-58.439539199093197 -34.556797573358146,-58.439835138784062 -34.556933691653562,-58.440158991061836 -34.557103970864169,-58.440442828375424 -34.557303046045519,-58.440692955450984 -34.557510143021709,-58.44091422532756 -34.557721107747554,-58.441058552244748 -34.557896282184906,-58.441164403031877 -34.558071449665945,-58.441250917442588 -34.558298376555967,-58.441337505242153 -34.558573052022467,-58.441375938519052 -34.558744263646119,-58.441385539511202 -34.558815888269898,-58.441332895472847 -34.558956660059998,-58.441299420786649 -34.559034756306652,-58.441259802721085 -34.559168206069351,-58.441208005549541 -34.559324401175253,-58.441128780414765 -34.559546016888902,-58.441031338943326 -34.559762558660907,-58.440958260444667 -34.559913679216294,-58.440845513569172 -34.560059721979549,-58.440653664053002 -34.560276316920913,-58.440489244166642 -34.560419885104992,-58.440327890361843 -34.560555847651571,-58.440166452935919 -34.560684274417717,-58.439892368957224 -34.560890711635267,-58.439694493811345 -34.5610242016066,-58.439469118694589 -34.5611676864713,-58.439240770354225 -34.561286028377097,-58.438924134085909 -34.561434565307621,-58.438686596094378 -34.561532762637491,-58.438473495449436 -34.561610822611748,-58.438248137285093 -34.56168380910983,-58.437980214090913 -34.561756786579728,-58.437657467889558 -34.56182721690304,-58.437277010493666 -34.561874323469929,-58.437203371270101 -34.561881843659975,-58.437105043901177 -34.561891330551013,-58.437025020005898 -34.561898638017681,-58.436891363297825 -34.561910018794634,-58.436779160199109 -34.561918093975542,-58.436678961054227 -34.561923847565239,-58.436617837301426 -34.561926440271812,-58.436550158731727 -34.561928538564231,-58.436444682971079 -34.561929713162542,-58.436362703490438 -34.561929132099067,-58.436300303983948 -34.561927921385099,-58.436217388617948 -34.561925649805517,-58.436115915441682 -34.561922106467875,-58.43602525398228 -34.561917720300634,-58.435935615100774 -34.561910165134961,-58.435818820947553 -34.561899505197616,-58.435743654081151 -34.561892023502338,-58.435668657692091 -34.56188390796747,-58.435570166611555 -34.561872688438072,-58.435496277168035 -34.561863868786531,-58.435385783699168 -34.561850181534716,-58.435275290428379 -34.561836001203197,-58.435124447865114 -34.561815825482178,-58.43502757516498 -34.561802281833252,-58.434957857598199 -34.561792195139205,-58.434858497864759 -34.562089157581006,-58.434944710717218 -34.56215974373341,-58.435319180204345 -34.562468363146429,-58.435319155949458 -34.562468371146714,-58.435410487681594 -34.562543751291685,-58.435948912522093 -34.562542176837063,-58.436820711302076 -34.562531806576281,-58.436978968760407 -34.562529322305529,-58.437125052619145 -34.562526835280011,-58.437279048843152 -34.562525860357077,-58.437425132534806 -34.562523876515627,-58.437570607994516 -34.562520381744577,-58.437695388039593 -34.562517889649541,-58.437834776383767 -34.562515400403214,-58.43795955775564 -34.562508376149687,-58.438091034579323 -34.562501353118456,-58.438221904176935 -34.562489294391909,-58.438361295685134 -34.562475726594705,-58.438525034601625 -34.562461156375669,-58.438658947468696 -34.562449097783102,-58.438786164685531 -34.56243754127545,-58.43893286059118 -34.562422463626476,-58.439088078229744 -34.56240638036325,-58.439246947879859 -34.562390297604267,-58.439402165538858 -34.56237371039839,-58.439550687256599 -34.562358632355242,-58.439666340298494 -34.562343547934361,-58.43981973285662 -34.562322931507381,-58.439947560044928 -34.56230533138492,-58.440090605077948 -34.562284209145332,-58.440228780482457 -34.562263589385026,-58.440376694927323 -34.562241964163029,-58.440510000505618 -34.562222350280138,-58.440657916398976 -34.562194682198836,-58.440816180229504 -34.562165001620606,-58.440965922212186 -34.562136326406666,-58.441164038222965 -34.562098731534668,-58.441100993516343 -34.562005369242705,-58.44119574315777 -34.561986630891958,-58.441325062016354 -34.561958765035634,-58.441420669149032 -34.561932372109958,-58.441877928035559 -34.561817727530901,-58.442544191920547 -34.561645014738623,-58.443214198744521 -34.561472228476653,-58.443409075448088 -34.561400988637359,-58.443479079887197 -34.561376311659018,-58.443495743706897 -34.561370437556057,-58.442581338160139 -34.560813645688832)));;961;13_12_10;COMUNA 13;12;10;564;281;283;99,29%;302;301;99,67%;1;0,33%;249;2;0,80%;247;99,20%
MULTIPOLYGON (((-58.446017000586814 -34.552869084422319,-58.444876874276616 -34.552192694949589,-58.443783149960012 -34.551543838442058,-58.443003503784155 -34.552446151220302,-58.444104893342264 -34.553101072401041,-58.445237365519269 -34.553774439580124,-58.446357940281068 -34.55444068159013,-58.447042042456893 -34.553649115206781,-58.447137825042709 -34.553533981317159,-58.446017000586814 -34.552869084422319)));;962;13_12_2;COMUNA 13;12;2;897;439;458;95,85%;392;392;100,00%;0;0,00%;320;2;0,63%;318;99,38%
MULTIPOLYGON (((-58.445237365519269 -34.553774439580124,-58.444104893342264 -34.553101072401041,-58.443422637913251 -34.553903890809352,-58.443285640562237 -34.554064087719723,-58.442477694629112 -34.555008718137422,-58.443598177883402 -34.555678999592899,-58.444711784982758 -34.556345114563413,-58.445529508009002 -34.555399062427085,-58.446357940281068 -34.55444068159013,-58.445237365519269 -34.553774439580124)));;963;13_12_3;COMUNA 13;12;3;624;309;315;98,10%;298;297;99,66%;1;0,34%;237;1;0,42%;236;99,58%
MULTIPOLYGON (((-58.443783149960012 -34.551543838442058,-58.442665953325381 -34.550881094339395,-58.441888939953309 -34.551783470955527,-58.441076148654986 -34.552727316943667,-58.440952091210463 -34.552871386053951,-58.440243162585844 -34.553681294969529,-58.441363697162586 -34.554344061523217,-58.441620981766313 -34.554496225855651,-58.442477694629112 -34.555008718137422,-58.443285640562237 -34.554064087719723,-58.443422637913251 -34.553903890809352,-58.444104893342264 -34.553101072401041,-58.443003503784155 -34.552446151220302,-58.443783149960012 -34.551543838442058)));;964;13_12_4;COMUNA 13;12;4;860;404;456;88,60%;454;454;100,00%;0;0,00%;352;0;0,00%;352;100,00%
MULTIPOLYGON (((-58.434634961228959 -34.553323647544296,-58.434653547934566 -34.553593585673084,-58.435165101487321 -34.553664691283416,-58.435353465772693 -34.553690861577437,-58.435511823890693 -34.553749628963978,-58.435615601990982 -34.553803953364266,-58.436345293372113 -34.554240259807379,-58.437462227882691 -34.554907991126669,-58.438291001028098 -34.553956848463109,-58.438386113286484 -34.553847777929072,-58.439108262845835 -34.553009993770104,-58.440243162585844 -34.553681294969529,-58.440952091210463 -34.552871386053951,-58.441076148654986 -34.552727316943667,-58.441888939953309 -34.551783470955527,-58.442665953325381 -34.550881094339395,-58.443459722463956 -34.549959418610925,-58.444277312811998 -34.549009852550292,-58.443338864264881 -34.548453554601963,-58.443138444515611 -34.548334784708658,-58.442192011454544 -34.547773828502571,-58.441766671053557 -34.547855943276488,-58.441366860154268 -34.547954611101751,-58.441161206548202 -34.548013732699999,-58.441131924421768 -34.548023305444737,-58.441061219705212 -34.547922513565652,-58.440666923239128 -34.547439462656065,-58.440598851966215 -34.547361981928667,-58.440180535963464 -34.547595015029465,-58.437774889849337 -34.548887777209693,-58.43734554941021 -34.549121151570546,-58.436430374685813 -34.549610235625835,-58.436036216667851 -34.549828667697454,-58.432332249079224 -34.551857668786127,-58.432640999837695 -34.552029161552582,-58.434212381017659 -34.552938249625491,-58.434634961228959 -34.553323647544296)));;965;13_12_5;COMUNA 13;12;5;707;334;373;89,54%;271;270;99,63%;1;0,37%;218;3;1,38%;215;98,62%
MULTIPOLYGON (((-58.440243162585844 -34.553681294969529,-58.439108262845835 -34.553009993770104,-58.438386113286484 -34.553847777929072,-58.438291001028098 -34.553956848463109,-58.437462227882691 -34.554907991126669,-58.438582414348318 -34.555577684722472,-58.439306785855365 -34.5547549711805,-58.439411264535437 -34.554633647574441,-58.439623012800489 -34.554761580954988,-58.440526439630631 -34.555307407104507,-58.441221331289 -34.554508832841009,-58.441363697162586 -34.554344061523217,-58.440243162585844 -34.553681294969529)));;966;13_12_6;COMUNA 13;12;6;570;267;303;88,12%;329;329;100,00%;0;0,00%;240;7;2,92%;233;97,08%
MULTIPOLYGON (((-58.439706448714539 -34.556249622319577,-58.440042717816006 -34.55645068024198,-58.440268940764483 -34.556585939427102,-58.440487164198508 -34.556715844379298,-58.440838416802258 -34.556925072205551,-58.441644441373221 -34.555982776657629,-58.442477694629112 -34.555008718137422,-58.441620981766313 -34.554496225855651,-58.441363697162586 -34.554344061523217,-58.441221331289 -34.554508832841009,-58.440526439630631 -34.555307407104507,-58.439623012800489 -34.554761580954988,-58.439411264535437 -34.554633647574441,-58.439306785855365 -34.5547549711805,-58.438582414348318 -34.555577684722472,-58.439706448714539 -34.556249622319577)));;967;13_12_7;COMUNA 13;12;7;896;417;479;87,06%;419;418;99,76%;1;0,24%;341;2;0,59%;339;99,41%
MULTIPOLYGON (((-58.445831623182016 -34.557014882305936,-58.446648660821218 -34.556059878612984,-58.445529508009002 -34.555399062427085,-58.444711784982758 -34.556345114563413,-58.443598177883402 -34.555678999592899,-58.442477694629112 -34.555008718137422,-58.441644441373221 -34.555982776657629,-58.441803938539472 -34.556079076048881,-58.4425282358064 -34.556508583594386,-58.442768251356 -34.556650882999605,-58.443878716991975 -34.557308905991952,-58.445007670007548 -34.557977907908977,-58.445831623182016 -34.557014882305936)));;968;13_12_8;COMUNA 13;12;8;629;282;347;81,27%;373;373;100,00%;0;0,00%;282;0;0,00%;282;100,00%
MULTIPOLYGON (((-58.443878716991975 -34.557308905991952,-58.442768251356 -34.556650882999605,-58.4425282358064 -34.556508583594386,-58.441803938539472 -34.556079076048881,-58.441644441373221 -34.555982776657629,-58.440838416802258 -34.556925072205551,-58.441963421906934 -34.557604665460659,-58.443064447698077 -34.558250862633329,-58.443989300301119 -34.558801666527842,-58.444197491888453 -34.558924802397286,-58.445007670007548 -34.557977907908977,-58.443878716991975 -34.557308905991952)));;969;13_12_9;COMUNA 13;12;9;945;473;472;100,21%;514;513;99,81%;1;0,19%;384;4;1,04%;380;98,96%
MULTIPOLYGON (((-58.449398083391777 -34.559146546082751,-58.44904722550509 -34.558938188106531,-58.448951552832874 -34.558880991693947,-58.449029451034264 -34.558834589898211,-58.448881005544727 -34.558745202958754,-58.448803107250612 -34.558792168066169,-58.448685536490714 -34.558860115437646,-58.447786940545527 -34.559350664883986,-58.447545582249184 -34.559481556546494,-58.447719903791501 -34.55958461086275,-58.448191629561741 -34.559863553605048,-58.449343464027613 -34.560544490243295,-58.44932719373967 -34.560612167550744,-58.449350085865539 -34.560658087605859,-58.449382770420392 -34.560687317836617,-58.449473000101911 -34.56072648432874,-58.449486027115441 -34.560711344216323,-58.449533111640335 -34.560656628542887,-58.450442201524027 -34.561194141617662,-58.451261013201609 -34.560252559196698,-58.451898459401981 -34.559519556161064,-58.452062097739109 -34.559329139425408,-58.451964209404345 -34.559270818372681,-58.451152592631978 -34.558787694370452,-58.450738318448465 -34.558541094064353,-58.450259896516656 -34.558633726492452,-58.449398083391777 -34.559146546082751)));;970;13_13_1;COMUNA 13;13;1;1028;461;567;81,31%;466;466;100,00%;0;0,00%;376;2;0,53%;374;99,47%
MULTIPOLYGON (((-58.44962396722071 -34.562136211441022,-58.44872006487757 -34.561600805720268,-58.448590217496289 -34.5617516425839,-58.447911000739083 -34.56254561164797,-58.448813972239812 -34.563077642739124,-58.448893669923834 -34.562984337775951,-58.44962396722071 -34.562136211441022)));;971;13_13_10;COMUNA 13;13;10;919;388;531;73,07%;456;456;100,00%;0;0,00%;358;0;0,00%;358;100,00%
MULTIPOLYGON (((-58.447911000739083 -34.56254561164797,-58.447002507928033 -34.562010333542403,-58.446205341204404 -34.562942312158285,-58.447114094522668 -34.563477103168672,-58.448018347985332 -34.564009140227718,-58.448813972239812 -34.563077642739124,-58.447911000739083 -34.56254561164797)));;972;13_13_11;COMUNA 13;13;11;603;278;325;85,54%;278;278;100,00%;0;0,00%;215;0;0,00%;215;100,00%
MULTIPOLYGON (((-58.444186734774064 -34.561755068500233,-58.444477498806307 -34.561927373448455,-58.444619902363208 -34.562010637767429,-58.444928799054175 -34.562191184121453,-58.446205341204404 -34.562942312158285,-58.447002507928033 -34.562010333542403,-58.445527647039128 -34.561141293399871,-58.445527941349212 -34.561141106077464,-58.445173583993324 -34.561076575256422,-58.444323031885148 -34.561439287369076,-58.444166243562798 -34.56148750396158,-58.444160520960217 -34.56148926380969,-58.444186734774064 -34.561755068500233)));;973;13_13_12;COMUNA 13;13;12;997;435;562;77,40%;397;396;99,75%;1;0,25%;327;1;0,31%;326;99,69%
MULTIPOLYGON (((-58.445234543687718 -34.559538081350816,-58.444197491888453 -34.558924802397286,-58.443382526970957 -34.559877324657634,-58.444417797640646 -34.560487300164802,-58.443912687919614 -34.561067742422203,-58.443776840164531 -34.560990675742431,-58.443537477452473 -34.56128065137036,-58.443495743706897 -34.561370437556057,-58.443479079887197 -34.561376311659018,-58.444166243562798 -34.56148750396158,-58.444323031885148 -34.561439287369076,-58.445173583993324 -34.561076575256422,-58.445527941349212 -34.561141106077464,-58.446692178748215 -34.560400080431272,-58.446691673322547 -34.560399782526538,-58.446535744216327 -34.560307875598376,-58.446291102673349 -34.56016290387339,-58.44624777774527 -34.560137263089651,-58.446246393819528 -34.560136444708903,-58.445234543687718 -34.559538081350816)));;974;13_13_13;COMUNA 13;13;13;1219;588;631;93,19%;685;685;100,00%;0;0,00%;556;2;0,36%;554;99,64%
MULTIPOLYGON (((-58.444417797640646 -34.560487300164802,-58.443382526970957 -34.559877324657634,-58.442581338160139 -34.560813645688832,-58.443495743706897 -34.561370437556057,-58.443537477452473 -34.56128065137036,-58.443776840164531 -34.560990675742431,-58.443912687919614 -34.561067742422203,-58.444417797640646 -34.560487300164802)));;975;13_13_14;COMUNA 13;13;14;677;330;347;95,10%;530;530;100,00%;0;0,00%;348;2;0,57%;346;99,43%
MULTIPOLYGON (((-58.450036047308863 -34.558082623235428,-58.448900550906416 -34.557402609255995,-58.448488636388475 -34.55787610457422,-58.448071438526746 -34.558354598058266,-58.448803107250612 -34.558792168066169,-58.448881005544727 -34.558745202958754,-58.449029451034264 -34.558834589898211,-58.448951552832874 -34.558880991693947,-58.44904722550509 -34.558938188106531,-58.449398083391777 -34.559146546082751,-58.450259896516656 -34.558633726492452,-58.450738318448465 -34.558541094064353,-58.450585106152516 -34.558441004016601,-58.450504074024543 -34.558388035810786,-58.450150070384005 -34.558156581028165,-58.450150121866535 -34.558156552714735,-58.450046539737428 -34.558088959198017,-58.450036047308863 -34.558082623235428)));;976;13_13_2;COMUNA 13;13;2;314;140;174;80,46%;200;200;100,00%;0;0,00%;155;4;2,58%;151;97,42%
MULTIPOLYGON (((-58.448900550906416 -34.557402609255995,-58.447693525301382 -34.556679758010901,-58.447347704111003 -34.556472592924813,-58.446648660821218 -34.556059878612984,-58.445831623182016 -34.557014882305936,-58.446870619599373 -34.557636387630879,-58.448071438526746 -34.558354598058266,-58.448488636388475 -34.55787610457422,-58.448900550906416 -34.557402609255995)));;977;13_13_3;COMUNA 13;13;3;737;330;407;81,08%;434;434;100,00%;0;0,00%;322;3;0,93%;319;99,07%
MULTIPOLYGON (((-58.448803107250612 -34.558792168066169,-58.448071438526746 -34.558354598058266,-58.446870619599373 -34.557636387630879,-58.44604692877958 -34.558593715701626,-58.447244180681331 -34.559303130454083,-58.447392966136874 -34.559391322181099,-58.447545582249184 -34.559481556546494,-58.447786940545527 -34.559350664883986,-58.448685536490714 -34.558860115437646,-58.448803107250612 -34.558792168066169)));;978;13_13_4;COMUNA 13;13;4;842;370;472;78,39%;513;513;100,00%;0;0,00%;394;4;1,02%;390;98,98%
MULTIPOLYGON (((-58.446870619599373 -34.557636387630879,-58.445831623182016 -34.557014882305936,-58.445007670007548 -34.557977907908977,-58.44604692877958 -34.558593715701626,-58.446870619599373 -34.557636387630879)));;979;13_13_5;COMUNA 13;13;5;827;376;451;83,37%;512;512;100,00%;0;0,00%;411;0;0,00%;411;100,00%
MULTIPOLYGON (((-58.44604692877958 -34.558593715701626,-58.445007670007548 -34.557977907908977,-58.444197491888453 -34.558924802397286,-58.445234543687718 -34.559538081350816,-58.44604692877958 -34.558593715701626)));;980;13_13_6;COMUNA 13;13;6;261;118;143;82,52%;188;188;100,00%;0;0,00%;132;3;2,27%;129;97,73%
MULTIPOLYGON (((-58.447545582249184 -34.559481556546494,-58.447392966136874 -34.559391322181099,-58.447244180681331 -34.559303130454083,-58.44604692877958 -34.558593715701626,-58.445234543687718 -34.559538081350816,-58.446246393819528 -34.560136444708903,-58.44624777774527 -34.560137263089651,-58.446291102673349 -34.56016290387339,-58.446688689218156 -34.559952102128982,-58.44690612638108 -34.559837406989459,-58.44742239133204 -34.559548304758934,-58.447545582249184 -34.559481556546494)));;981;13_13_7;COMUNA 13;13;7;629;295;334;88,32%;408;408;100,00%;0;0,00%;305;1;0,33%;304;99,67%
MULTIPOLYGON (((-58.448191629561741 -34.559863553605048,-58.447719903791501 -34.55958461086275,-58.447545582249184 -34.559481556546494,-58.44742239133204 -34.559548304758934,-58.44690612638108 -34.559837406989459,-58.446688689218156 -34.559952102128982,-58.446291102673349 -34.56016290387339,-58.446535744216327 -34.560307875598376,-58.446691673322547 -34.560399782526538,-58.446692178748215 -34.560400080431272,-58.445527941349212 -34.561141106077464,-58.445527647039128 -34.561141293399871,-58.447002507928033 -34.562010333542403,-58.447708464993724 -34.561185103746944,-58.44781370654561 -34.561058913799116,-58.44872006487757 -34.561600805720268,-58.44962396722071 -34.562136211441022,-58.449720266245492 -34.56202438574843,-58.450442201524027 -34.561194141617662,-58.449533111640335 -34.560656628542887,-58.449486027115441 -34.560711344216323,-58.449473000101911 -34.56072648432874,-58.449382770420392 -34.560687317836617,-58.449350085865539 -34.560658087605859,-58.44932719373967 -34.560612167550744,-58.449343464027613 -34.560544490243295,-58.448191629561741 -34.559863553605048)));;982;13_13_8;COMUNA 13;13;8;649;277;372;74,46%;360;360;100,00%;0;0,00%;249;0;0,00%;249;100,00%
MULTIPOLYGON (((-58.44872006487757 -34.561600805720268,-58.44781370654561 -34.561058913799116,-58.447708464993724 -34.561185103746944,-58.447002507928033 -34.562010333542403,-58.447911000739083 -34.56254561164797,-58.448590217496289 -34.5617516425839,-58.44872006487757 -34.561600805720268)));;983;13_13_9;COMUNA 13;13;9;780;338;442;76,47%;342;342;100,00%;0;0,00%;287;1;0,35%;286;99,65%
MULTIPOLYGON (((-58.455581782853876 -34.559950972617003,-58.454676844870363 -34.55941110350075,-58.453836454002328 -34.560385244070964,-58.454741652596191 -34.560923992536566,-58.455400783687715 -34.56015963326989,-58.455581782853876 -34.559950972617003)));;984;13_14_1;COMUNA 13;14;1;776;367;409;89,73%;441;441;100,00%;0;0,00%;341;18;5,28%;323;94,72%
MULTIPOLYGON (((-58.453040146140658 -34.561308816555332,-58.452149850510999 -34.56078026852208,-58.451336151324185 -34.561722631981858,-58.452228835575617 -34.562250411390316,-58.453040146140658 -34.561308816555332)));;985;13_14_10;COMUNA 13;14;10;727;317;410;77,32%;369;369;100,00%;0;0,00%;298;1;0,34%;297;99,66%
MULTIPOLYGON (((-58.452149850510999 -34.56078026852208,-58.451261013201609 -34.560252559196698,-58.450442201524027 -34.561194141617662,-58.451336151324185 -34.561722631981858,-58.452149850510999 -34.56078026852208)));;986;13_14_11;COMUNA 13;14;11;806;357;449;79,51%;347;347;100,00%;0;0,00%;284;4;1,41%;280;98,59%
MULTIPOLYGON (((-58.454676844870363 -34.55941110350075,-58.454525412965644 -34.559320807701575,-58.453789538666776 -34.558881229369007,-58.452947695522987 -34.559856208907988,-58.453836454002328 -34.560385244070964,-58.454676844870363 -34.55941110350075)));;987;13_14_2;COMUNA 13;14;2;381;165;216;76,39%;212;212;100,00%;0;0,00%;162;0;0,00%;162;100,00%
MULTIPOLYGON (((-58.453734635684562 -34.558848477394179,-58.452902499094307 -34.558351348764788,-58.452150472335923 -34.559226395989143,-58.452062097739109 -34.559329139425408,-58.452947695522987 -34.559856208907988,-58.453789538666776 -34.558881229369007,-58.453734635684562 -34.558848477394179)));;988;13_14_3;COMUNA 13;14;3;660;289;371;77,90%;534;534;100,00%;0;0,00%;367;2;0,54%;365;99,46%
MULTIPOLYGON (((-58.452947695522987 -34.559856208907988,-58.452062097739109 -34.559329139425408,-58.451898459401981 -34.559519556161064,-58.451261013201609 -34.560252559196698,-58.452149850510999 -34.56078026852208,-58.452947695522987 -34.559856208907988)));;989;13_14_4;COMUNA 13;14;4;734;327;407;80,34%;360;360;100,00%;0;0,00%;291;1;0,34%;290;99,66%
MULTIPOLYGON (((-58.453836454002328 -34.560385244070964,-58.452947695522987 -34.559856208907988,-58.452149850510999 -34.56078026852208,-58.453040146140658 -34.561308816555332,-58.453418592551223 -34.560869600916284,-58.453836454002328 -34.560385244070964)));;990;13_14_5;COMUNA 13;14;5;531;246;285;86,32%;291;291;100,00%;0;0,00%;228;3;1,32%;225;98,68%
MULTIPOLYGON (((-58.455271339974828 -34.562633397950357,-58.4556763691265 -34.562873855147579,-58.455872329945144 -34.562988941799027,-58.456693312239103 -34.562035632676761,-58.457121547148574 -34.561538377289715,-58.457506869426503 -34.5610852754467,-58.456505375190723 -34.56049583615065,-58.45573747320762 -34.560043802664758,-58.455581782853876 -34.559950972617003,-58.455400783687715 -34.56015963326989,-58.454741652596191 -34.560923992536566,-58.453836454002328 -34.560385244070964,-58.453418592551223 -34.560869600916284,-58.453040146140658 -34.561308816555332,-58.45394603073396 -34.561846655359382,-58.45486793053081 -34.562393925463347,-58.455271339974828 -34.562633397950357)));;991;13_14_6;COMUNA 13;14;6;846;373;473;78,86%;439;439;100,00%;0;0,00%;359;2;0,56%;357;99,44%
MULTIPOLYGON (((-58.455271339974828 -34.562633397950357,-58.45486793053081 -34.562393925463347,-58.454058503265841 -34.563332011128708,-58.454852134440102 -34.563801170023581,-58.455064440570197 -34.563926893277539,-58.455872329945144 -34.562988941799027,-58.4556763691265 -34.562873855147579,-58.455271339974828 -34.562633397950357)));;992;13_14_7;COMUNA 13;14;7;384;172;212;81,13%;224;224;100,00%;0;0,00%;165;1;0,61%;164;99,39%
MULTIPOLYGON (((-58.45486793053081 -34.562393925463347,-58.45394603073396 -34.561846655359382,-58.453135576665332 -34.562786425131698,-58.454058503265841 -34.563332011128708,-58.45486793053081 -34.562393925463347)));;993;13_14_8;COMUNA 13;14;8;604;282;322;87,58%;409;408;99,76%;1;0,25%;254;1;0,39%;253;99,61%
MULTIPOLYGON (((-58.45394603073396 -34.561846655359382,-58.453040146140658 -34.561308816555332,-58.452228835575617 -34.562250411390316,-58.453135576665332 -34.562786425131698,-58.45394603073396 -34.561846655359382)));;994;13_14_9;COMUNA 13;14;9;534;225;309;72,82%;328;328;100,00%;0;0,00%;238;2;0,84%;236;99,16%
MULTIPOLYGON (((-58.460172580667106 -34.561271283541998,-58.459281048554907 -34.560741871947101,-58.458489735013423 -34.561664494106509,-58.459380761196535 -34.562193418406657,-58.45949024291491 -34.562066091717071,-58.460172580667106 -34.561271283541998)));;995;13_15_1;COMUNA 13;15;1;745;332;413;80,39%;470;470;100,00%;0;0,00%;350;3;0,86%;347;99,14%
MULTIPOLYGON (((-58.457749052396416 -34.5640916164174,-58.45685444056371 -34.563565990206477,-58.456753466710154 -34.563683173621129,-58.456042214750454 -34.56450577892624,-58.456937342038941 -34.565035636571203,-58.457749052396416 -34.5640916164174)));;996;13_15_10;COMUNA 13;15;10;632;244;388;62,89%;451;451;100,00%;0;0,00%;331;3;0,91%;328;99,09%
MULTIPOLYGON (((-58.458640014908134 -34.564615052711432,-58.457749052396416 -34.5640916164174,-58.456937342038941 -34.565035636571203,-58.457825244610206 -34.565561261781014,-58.458640014908134 -34.564615052711432)));;997;13_15_11;COMUNA 13;15;11;735;305;430;70,93%;522;522;100,00%;0;0,00%;369;19;5,15%;350;94,85%
MULTIPOLYGON (((-58.459533883033274 -34.565140172749203,-58.458640014908134 -34.564615052711432,-58.457825244610206 -34.565561261781014,-58.458716308210867 -34.566088782083192,-58.459533883033274 -34.565140172749203)));;998;13_15_12;COMUNA 13;15;12;654;272;382;71,20%;410;410;100,00%;0;0,00%;328;14;4,27%;314;95,73%
MULTIPOLYGON (((-58.457506869426503 -34.5610852754467,-58.457121547148574 -34.561538377289715,-58.456693312239103 -34.562035632676761,-58.457674225383101 -34.562614646438973,-58.457795714385291 -34.562473729617494,-58.458489735013423 -34.561664494106509,-58.459281048554907 -34.560741871947101,-58.458296315818657 -34.560157095873166,-58.457506869426503 -34.5610852754467)));;999;13_15_2;COMUNA 13;15;2;712;294;418;70,33%;498;498;100,00%;0;0,00%;360;0;0,00%;360;100,00%
MULTIPOLYGON (((-58.460273245996412 -34.562718181072782,-58.459547271210951 -34.562292230037933,-58.459380761196535 -34.562193418406657,-58.458489735013423 -34.561664494106509,-58.457795714385291 -34.562473729617494,-58.457674225383101 -34.562614646438973,-58.458566193091329 -34.563141182168351,-58.458826685878364 -34.563294929928134,-58.459455447835047 -34.563667922540567,-58.460273245996412 -34.562718181072782)));;1000;13_15_3;COMUNA 13;15;3;746;293;453;64,68%;425;425;100,00%;0;0,00%;349;2;0,57%;347;99,43%
MULTIPOLYGON (((-58.46116855131347 -34.56324350061017,-58.460273245996412 -34.562718181072782,-58.459455447835047 -34.563667922540567,-58.460204163716632 -34.564112044310541,-58.460347012290171 -34.564196769204166,-58.46116855131347 -34.56324350061017)));;1001;13_15_4;COMUNA 13;15;4;492;197;295;66,78%;287;286;99,65%;1;0,35%;199;1;0,50%;198;99,50%
MULTIPOLYGON (((-58.4621297592658 -34.563808886059377,-58.461881687889445 -34.563661835881568,-58.46116855131347 -34.56324350061017,-58.460347012290171 -34.564196769204166,-58.461302010972403 -34.564763146921578,-58.4621297592658 -34.563808886059377)));;1002;13_15_5;COMUNA 13;15;5;802;361;441;81,86%;530;530;100,00%;0;0,00%;391;2;0,51%;389;99,49%
MULTIPOLYGON (((-58.461302010972403 -34.564763146921578,-58.460347012290171 -34.564196769204166,-58.459533883033274 -34.565140172749203,-58.46048846146725 -34.565700993107562,-58.461302010972403 -34.564763146921578)));;1003;13_15_6;COMUNA 13;15;6;659;294;365;80,55%;358;358;100,00%;0;0,00%;281;1;0,36%;280;99,64%
MULTIPOLYGON (((-58.460347012290171 -34.564196769204166,-58.460204163716632 -34.564112044310541,-58.459455447835047 -34.563667922540567,-58.458640014908134 -34.564615052711432,-58.459533883033274 -34.565140172749203,-58.460347012290171 -34.564196769204166)));;1004;13_15_7;COMUNA 13;15;7;803;346;457;75,71%;475;475;100,00%;0;0,00%;383;3;0,78%;380;99,22%
MULTIPOLYGON (((-58.459455447835047 -34.563667922540567,-58.458826685878364 -34.563294929928134,-58.458566193091329 -34.563141182168351,-58.457855048459457 -34.563968375780441,-58.457749052396416 -34.5640916164174,-58.458640014908134 -34.564615052711432,-58.459455447835047 -34.563667922540567)));;1005;13_15_8;COMUNA 13;15;8;713;324;389;83,29%;457;457;100,00%;0;0,00%;372;2;0,54%;370;99,46%
MULTIPOLYGON (((-58.457674225383101 -34.562614646438973,-58.456693312239103 -34.562035632676761,-58.455872329945144 -34.562988941799027,-58.455064440570197 -34.563926893277539,-58.456042214750454 -34.56450577892624,-58.456753466710154 -34.563683173621129,-58.45685444056371 -34.563565990206477,-58.457749052396416 -34.5640916164174,-58.457855048459457 -34.563968375780441,-58.458566193091329 -34.563141182168351,-58.457674225383101 -34.562614646438973)));;1006;13_15_9;COMUNA 13;15;9;867;357;510;70,00%;614;614;100,00%;0;0,00%;416;2;0,48%;414;99,52%
MULTIPOLYGON (((-58.46422553341246 -34.559696370417001,-58.464014586346792 -34.559574958960326,-58.463320287094945 -34.559175016883039,-58.462798546574632 -34.559785045865624,-58.462676644281856 -34.55992667198484,-58.463569891778661 -34.560456903950346,-58.4645226562007 -34.561022411728921,-58.464670264073895 -34.560810287266015,-58.465162884713415 -34.560236027231355,-58.46422553341246 -34.559696370417001)));;1007;13_16_1;COMUNA 13;16;1;854;365;489;74,64%;521;520;99,81%;1;0,19%;392;3;0,77%;389;99,23%
MULTIPOLYGON (((-58.461868179863885 -34.560865654921486,-58.460974342862315 -34.560337312026263,-58.460080942794406 -34.55980917382783,-58.459281048554907 -34.560741871947101,-58.460172580667106 -34.561271283541998,-58.461063528178869 -34.561800336444492,-58.461868179863885 -34.560865654921486)));;1008;13_16_10;COMUNA 13;16;10;839;358;481;74,43%;581;581;100,00%;0;0,00%;391;3;0,77%;388;99,23%
MULTIPOLYGON (((-58.461063528178869 -34.561800336444492,-58.460172580667106 -34.561271283541998,-58.45949024291491 -34.562066091717071,-58.459380761196535 -34.562193418406657,-58.459547271210951 -34.562292230037933,-58.460273245996412 -34.562718181072782,-58.461063528178869 -34.561800336444492)));;1009;13_16_11;COMUNA 13;16;11;724;299;425;70,35%;499;499;100,00%;0;0,00%;381;3;0,79%;378;99,21%
MULTIPOLYGON (((-58.461955678785493 -34.562330087063337,-58.461063528178869 -34.561800336444492,-58.460273245996412 -34.562718181072782,-58.46116855131347 -34.56324350061017,-58.461955678785493 -34.562330087063337)));;1010;13_16_12;COMUNA 13;16;12;730;315;415;75,90%;425;425;100,00%;0;0,00%;347;21;6,05%;326;93,95%
MULTIPOLYGON (((-58.462917307222817 -34.562901100452144,-58.461955678785493 -34.562330087063337,-58.46116855131347 -34.56324350061017,-58.461881687889445 -34.563661835881568,-58.4621297592658 -34.563808886059377,-58.462917307222817 -34.562901100452144)));;1011;13_16_13;COMUNA 13;16;13;552;259;293;88,40%;257;257;100,00%;0;0,00%;223;0;0,00%;223;100,00%
MULTIPOLYGON (((-58.463320287094945 -34.559175016883039,-58.462412583421283 -34.558652107220858,-58.461511445723843 -34.558132993818198,-58.460984931351817 -34.558747170225004,-58.460885841909338 -34.558863652919804,-58.461777960037196 -34.559393193814444,-58.462676644281856 -34.55992667198484,-58.462798546574632 -34.559785045865624,-58.463320287094945 -34.559175016883039)));;1012;13_16_2;COMUNA 13;16;2;876;376;500;75,20%;550;549;99,82%;1;0,18%;430;0;0,00%;430;100,00%
MULTIPOLYGON (((-58.459914654792058 -34.558287129728811,-58.459243236219628 -34.559056231777866,-58.459095874837658 -34.559226869006324,-58.458532473774802 -34.55987934521189,-58.458296315818657 -34.560157095873166,-58.459281048554907 -34.560741871947101,-58.460080942794406 -34.55980917382783,-58.4601821627042 -34.559691212908618,-58.460885841909338 -34.558863652919804,-58.460984931351817 -34.558747170225004,-58.461511445723843 -34.558132993818198,-58.460564692863464 -34.557587533709615,-58.459958921840801 -34.558236494639544,-58.459914654792058 -34.558287129728811)));;1013;13_16_3;COMUNA 13;16;3;509;210;299;70,23%;405;405;100,00%;0;0,00%;252;3;1,19%;249;98,81%
MULTIPOLYGON (((-58.461777960037196 -34.559393193814444,-58.460885841909338 -34.558863652919804,-58.4601821627042 -34.559691212908618,-58.460080942794406 -34.55980917382783,-58.460974342862315 -34.560337312026263,-58.461059983420995 -34.560237590423327,-58.461777960037196 -34.559393193814444)));;1014;13_16_4;COMUNA 13;16;4;696;308;388;79,38%;492;492;100,00%;0;0,00%;368;0;0,00%;368;100,00%
MULTIPOLYGON (((-58.462676644281856 -34.55992667198484,-58.461777960037196 -34.559393193814444,-58.461059983420995 -34.560237590423327,-58.460974342862315 -34.560337312026263,-58.461868179863885 -34.560865654921486,-58.462676644281856 -34.55992667198484)));;1015;13_16_5;COMUNA 13;16;5;526;229;297;77,10%;359;359;100,00%;0;0,00%;252;3;1,19%;249;98,81%
MULTIPOLYGON (((-58.463569891778661 -34.560456903950346,-58.462676644281856 -34.55992667198484,-58.461868179863885 -34.560865654921486,-58.462762283556266 -34.561394132078057,-58.463569891778661 -34.560456903950346)));;1016;13_16_6;COMUNA 13;16;6;412;189;223;84,75%;249;249;100,00%;0;0,00%;183;4;2,19%;179;97,81%
MULTIPOLYGON (((-58.4645226562007 -34.561022411728921,-58.463569891778661 -34.560456903950346,-58.462762283556266 -34.561394132078057,-58.463728844248706 -34.561965491287914,-58.464423824902326 -34.561164320920078,-58.4645226562007 -34.561022411728921)));;1017;13_16_7;COMUNA 13;16;7;765;323;442;73,08%;467;467;100,00%;0;0,00%;369;0;0,00%;369;100,00%
MULTIPOLYGON (((-58.463728844248706 -34.561965491287914,-58.462762283556266 -34.561394132078057,-58.461955678785493 -34.562330087063337,-58.462917307222817 -34.562901100452144,-58.463728844248706 -34.561965491287914)));;1018;13_16_8;COMUNA 13;16;8;671;281;390;72,05%;411;411;100,00%;0;0,00%;352;1;0,28%;351;99,72%
MULTIPOLYGON (((-58.462762283556266 -34.561394132078057,-58.461868179863885 -34.560865654921486,-58.461063528178869 -34.561800336444492,-58.461955678785493 -34.562330087063337,-58.462762283556266 -34.561394132078057)));;1019;13_16_9;COMUNA 13;16;9;827;361;466;77,47%;461;461;100,00%;0;0,00%;380;2;0,53%;378;99,47%
MULTIPOLYGON (((-58.466171076545521 -34.560816451281035,-58.465162884713415 -34.560236027231355,-58.464670264073895 -34.560810287266015,-58.4645226562007 -34.561022411728921,-58.465497993181167 -34.561601292383173,-58.466490199815986 -34.562190235538701,-58.466913796287713 -34.562011270016434,-58.46768394391259 -34.56168735331935,-58.467037197982933 -34.561315107862242,-58.466171076545521 -34.560816451281035)));;1020;13_17_1;COMUNA 13;17;1;1065;487;578;84,26%;613;613;100,00%;0;0,00%;476;3;0,63%;473;99,37%
MULTIPOLYGON (((-58.463151083599207 -34.564414335873948,-58.4621297592658 -34.563808886059377,-58.461302010972403 -34.564763146921578,-58.462324277431534 -34.565369448676989,-58.463358562619689 -34.565982854736106,-58.4640888244829 -34.565138022711572,-58.464185022478972 -34.565026396941235,-58.4632826130646 -34.564492226082031,-58.463151083599207 -34.564414335873948)));;1021;13_17_10;COMUNA 13;17;10;944;431;513;84,02%;498;498;100,00%;0;0,00%;398;0;0,00%;398;100,00%
MULTIPOLYGON (((-58.465224425139908 -34.565641899933112,-58.465108046008275 -34.565572744312561,-58.464185022478972 -34.565026396941235,-58.4640888244829 -34.565138022711572,-58.463358562619689 -34.565982854736106,-58.464396098135296 -34.566598153417189,-58.465224425139908 -34.565641899933112)));;1022;13_17_11;COMUNA 13;17;11;570;239;331;72,21%;314;314;100,00%;0;0,00%;247;0;0,00%;247;100,00%
MULTIPOLYGON (((-58.465497993181167 -34.561601292383173,-58.4645226562007 -34.561022411728921,-58.464423824902326 -34.561164320920078,-58.463728844248706 -34.561965491287914,-58.462917307222817 -34.562901100452144,-58.463419664557627 -34.56319942163119,-58.463706216693545 -34.563367948209851,-58.465098430859307 -34.562777973023294,-58.466490199815986 -34.562190235538701,-58.465497993181167 -34.561601292383173)));;1023;13_17_2;COMUNA 13;17;2;1083;484;599;80,80%;662;660;99,70%;2;0,30%;472;4;0,85%;468;99,15%
MULTIPOLYGON (((-58.466575843256642 -34.562253615954667,-58.466490199815986 -34.562190235538701,-58.465098430859307 -34.562777973023294,-58.463706216693545 -34.563367948209851,-58.463943393394459 -34.563499078600152,-58.464972644558621 -34.56411296420324,-58.465775231787795 -34.563182130732983,-58.466575843256642 -34.562253615954667)));;1024;13_17_3;COMUNA 13;17;3;817;389;428;90,89%;555;555;100,00%;0;0,00%;389;3;0,77%;386;99,23%
MULTIPOLYGON (((-58.466816326153271 -34.563803888198152,-58.465775231787795 -34.563182130732983,-58.464972644558621 -34.56411296420324,-58.466016723883605 -34.564727192792908,-58.466816326153271 -34.563803888198152)));;1025;13_17_4;COMUNA 13;17;4;552;243;309;78,64%;303;303;100,00%;0;0,00%;247;2;0,81%;245;99,19%
MULTIPOLYGON (((-58.467540490244545 -34.562967768213412,-58.466575843256642 -34.562253615954667,-58.465775231787795 -34.563182130732983,-58.466816326153271 -34.563803888198152,-58.467715856420519 -34.564341061417245,-58.467926565550513 -34.564463241075408,-58.468157085895491 -34.564199698214843,-58.468610375449849 -34.563675006001681,-58.467648951279401 -34.563048119546295,-58.467540490244545 -34.562967768213412)));;1026;13_17_5;COMUNA 13;17;5;707;296;411;72,02%;367;367;100,00%;0;0,00%;345;3;0,87%;342;99,13%
MULTIPOLYGON (((-58.467926565550513 -34.564463241075408,-58.467715856420519 -34.564341061417245,-58.466816326153271 -34.563803888198152,-58.466016723883605 -34.564727192792908,-58.46712909729753 -34.565381482118866,-58.467545710060783 -34.564898557690469,-58.467926565550513 -34.564463241075408)));;1027;13_17_6;COMUNA 13;17;6;768;338;430;78,60%;414;414;100,00%;0;0,00%;360;0;0,00%;360;100,00%
MULTIPOLYGON (((-58.465224425139908 -34.565641899933112,-58.464396098135296 -34.566598153417189,-58.464868940838429 -34.566878510325111,-58.464972548635458 -34.566845830953298,-58.465755351384907 -34.566608831659209,-58.466374609463777 -34.566420778177388,-58.466242393058408 -34.566344088581005,-58.46630096483684 -34.566335213238631,-58.466335016977929 -34.566302182611381,-58.46712909729753 -34.565381482118866,-58.466016723883605 -34.564727192792908,-58.465224425139908 -34.565641899933112)));;1028;13_17_7;COMUNA 13;17;7;840;373;467;79,87%;484;484;100,00%;0;0,00%;386;0;0,00%;386;100,00%
MULTIPOLYGON (((-58.466016723883605 -34.564727192792908,-58.464972644558621 -34.56411296420324,-58.464185022478972 -34.565026396941235,-58.465108046008275 -34.565572744312561,-58.465224425139908 -34.565641899933112,-58.466016723883605 -34.564727192792908)));;1029;13_17_8;COMUNA 13;17;8;739;353;386;91,45%;389;389;100,00%;0;0,00%;316;2;0,63%;314;99,37%
MULTIPOLYGON (((-58.463706216693545 -34.563367948209851,-58.463419664557627 -34.56319942163119,-58.462917307222817 -34.562901100452144,-58.4621297592658 -34.563808886059377,-58.463151083599207 -34.564414335873948,-58.4632826130646 -34.564492226082031,-58.464185022478972 -34.565026396941235,-58.464972644558621 -34.56411296420324,-58.463943393394459 -34.563499078600152,-58.463706216693545 -34.563367948209851)));;1030;13_17_9;COMUNA 13;17;9;1006;434;572;75,87%;532;531;99,81%;1;0,19%;403;4;0,99%;399;99,01%
MULTIPOLYGON (((-58.472185258508603 -34.566384618339747,-58.472055767982546 -34.566369275546407,-58.471623027225107 -34.566324939800843,-58.471166873765192 -34.566267364129487,-58.470897764007702 -34.566251325454985,-58.470802668844435 -34.566244711795058,-58.470631804258836 -34.566234793003204,-58.470531941759404 -34.566229447103282,-58.470436421450387 -34.566227903830345,-58.469651630471567 -34.566923192780315,-58.470125429740072 -34.567210360542283,-58.471045367362422 -34.567767931107689,-58.471767277964709 -34.568205504332234,-58.471961400861716 -34.568324156898427,-58.47278310119502 -34.567353133949787,-58.473368486143315 -34.566661504640933,-58.47319590645202 -34.566561937772896,-58.472902782294597 -34.566503086803372,-58.472294316984311 -34.566400526008188,-58.472185258508603 -34.566384618339747)));;1031;13_18_1;COMUNA 13;18;1;888;403;485;83,09%;433;431;99,54%;2;0,46%;334;1;0,30%;333;99,70%
MULTIPOLYGON (((-58.464936650377417 -34.571089255372627,-58.464154046697303 -34.570634881410406,-58.463155806091748 -34.571787967050177,-58.461730296292828 -34.573432189416749,-58.462522533334159 -34.574202155549401,-58.462903118866492 -34.574592805933023,-58.463355568645603 -34.575008385375881,-58.464991559484496 -34.573995012669833,-58.466037414444052 -34.573335875926468,-58.46736429130177 -34.572496148620381,-58.467117632563244 -34.572354250304443,-58.465999802739788 -34.571703694327859,-58.464936650377417 -34.571089255372627)));;1032;13_18_10;COMUNA 13;18;10;812;368;444;82,88%;364;363;99,73%;1;0,28%;274;5;1,82%;269;98,18%
MULTIPOLYGON (((-58.470846401595892 -34.565977584481288,-58.470729780612629 -34.566102668122944,-58.470436421450387 -34.566227903830345,-58.470531941759404 -34.566229447103282,-58.470631804258836 -34.566234793003204,-58.470802668844435 -34.566244711795058,-58.470897764007702 -34.566251325454985,-58.471166873765192 -34.566267364129487,-58.471623027225107 -34.566324939800843,-58.472055767982546 -34.566369275546407,-58.472185258508603 -34.566384618339747,-58.472294316984311 -34.566400526008188,-58.472902782294597 -34.566503086803372,-58.47319590645202 -34.566561937772896,-58.473002120703384 -34.56644752734686,-58.472741853664516 -34.566293865619684,-58.472460466747016 -34.566128106518931,-58.472420535485838 -34.566097685834237,-58.471371280699032 -34.565451961838548,-58.470649820726763 -34.56500487858191,-58.470439189978535 -34.564867562117449,-58.469610891692355 -34.564327447123731,-58.468961902023707 -34.565073712255284,-58.469124002016365 -34.56517004610641,-58.470470280001841 -34.565962185788422,-58.470846401595892 -34.565977584481288)));;1033;13_18_2;COMUNA 13;18;2;867;391;476;82,14%;521;521;100,00%;0;0,00%;407;6;1,47%;401;98,53%
MULTIPOLYGON (((-58.468119247263758 -34.566045875170559,-58.467884855692759 -34.566311891217239,-58.468015478430665 -34.566351841497706,-58.468425651400281 -34.566315905880252,-58.468473243284627 -34.566345130273014,-58.46849120557772 -34.566331114722935,-58.4686339812204 -34.566415900317686,-58.468709404877508 -34.566345118876008,-58.468748308265305 -34.566306030733053,-58.468672876650132 -34.566264553753832,-58.469245229777549 -34.566240227567597,-58.469706398819199 -34.566228088762941,-58.470087117334266 -34.566228066318502,-58.470436421450387 -34.566227903830345,-58.470729780612629 -34.566102668122944,-58.470846401595892 -34.565977584481288,-58.470470280001841 -34.565962185788422,-58.469124002016365 -34.56517004610641,-58.468961902023707 -34.565073712255284,-58.469610891692355 -34.564327447123731,-58.468610375449849 -34.563675006001681,-58.468157085895491 -34.564199698214843,-58.467926565550513 -34.564463241075408,-58.467545710060783 -34.564898557690469,-58.46712909729753 -34.565381482118866,-58.466335016977929 -34.566302182611381,-58.46630096483684 -34.566335213238631,-58.46645233196751 -34.566312390777384,-58.467424125600431 -34.566133898502848,-58.468119247263758 -34.566045875170559)));;1034;13_18_3;COMUNA 13;18;3;940;423;517;81,82%;500;500;100,00%;0;0,00%;397;8;2,02%;389;97,98%
MULTIPOLYGON (((-58.467884855692759 -34.566311891217239,-58.467860815835124 -34.566345453722903,-58.467373685027127 -34.566915624853031,-58.468744324499234 -34.567724895829592,-58.469651630471567 -34.566923192780315,-58.470436421450387 -34.566227903830345,-58.470087117334266 -34.566228066318502,-58.469706398819199 -34.566228088762941,-58.469245229777549 -34.566240227567597,-58.468672876650132 -34.566264553753832,-58.468748308265305 -34.566306030733053,-58.468709404877508 -34.566345118876008,-58.4686339812204 -34.566415900317686,-58.46849120557772 -34.566331114722935,-58.468473243284627 -34.566345130273014,-58.468425651400281 -34.566315905880252,-58.468015478430665 -34.566351841497706,-58.467884855692759 -34.566311891217239)));;1035;13_18_4;COMUNA 13;18;4;719;324;395;82,03%;367;367;100,00%;0;0,00%;294;0;0,00%;294;100,00%
MULTIPOLYGON (((-58.470125429740072 -34.567210360542283,-58.469651630471567 -34.566923192780315,-58.468744324499234 -34.567724895829592,-58.468680136500083 -34.567781662031059,-58.467762340681787 -34.56859258393682,-58.467999709459249 -34.568733213780973,-58.468509441795533 -34.569031865535926,-58.468730210582265 -34.56916122664353,-58.469474171518314 -34.569597122023723,-58.469693208168842 -34.569339774572413,-58.470242709941935 -34.56870175640487,-58.470932831426495 -34.567900550167302,-58.471045367362422 -34.567767931107689,-58.470125429740072 -34.567210360542283)));;1036;13_18_5;COMUNA 13;18;5;702;315;387;81,40%;356;356;100,00%;0;0,00%;282;1;0,35%;281;99,65%
MULTIPOLYGON (((-58.470242709941935 -34.56870175640487,-58.469693208168842 -34.569339774572413,-58.469474171518314 -34.569597122023723,-58.468730210582265 -34.56916122664353,-58.468509441795533 -34.569031865535926,-58.467999709459249 -34.568733213780973,-58.467762340681787 -34.56859258393682,-58.466814985766547 -34.569429627728702,-58.467774518639075 -34.570051167827437,-58.468538153535221 -34.570545732533986,-58.46862525340876 -34.570594462835587,-58.46958565754322 -34.571131337001965,-58.470416011098052 -34.570150259083256,-58.471176371054035 -34.569251789458477,-58.471961400861716 -34.568324156898427,-58.471767277964709 -34.568205504332234,-58.471045367362422 -34.567767931107689,-58.470932831426495 -34.567900550167302,-58.470242709941935 -34.56870175640487)));;1037;13_18_6;COMUNA 13;18;6;739;346;393;88,04%;409;409;100,00%;0;0,00%;302;1;0,33%;301;99,67%
MULTIPOLYGON (((-58.463879284197979 -34.569139397105225,-58.464918565424959 -34.569751662709628,-58.46573823414186 -34.568804843420018,-58.466814985766547 -34.569429627728702,-58.467762340681787 -34.56859258393682,-58.468680136500083 -34.567781662031059,-58.468744324499234 -34.567724895829592,-58.467373685027127 -34.566915624853031,-58.467860815835124 -34.566345453722903,-58.467884855692759 -34.566311891217239,-58.468119247263758 -34.566045875170559,-58.467424125600431 -34.566133898502848,-58.46645233196751 -34.566312390777384,-58.46630096483684 -34.566335213238631,-58.466242393058408 -34.566344088581005,-58.466374609463777 -34.566420778177388,-58.465755351384907 -34.566608831659209,-58.464972548635458 -34.566845830953298,-58.464868940838429 -34.566878510325111,-58.464996729805698 -34.566954285952676,-58.465507802846375 -34.56725703498963,-58.464700235676467 -34.56819054233533,-58.463879284197979 -34.569139397105225)));;1038;13_18_7;COMUNA 13;18;7;971;464;507;91,52%;480;480;100,00%;0;0,00%;383;2;0,52%;381;99,48%
MULTIPOLYGON (((-58.463114504674984 -34.570023313642515,-58.462287897985 -34.570978707022277,-58.462083222846282 -34.571216392457359,-58.461406952239408 -34.572001702628526,-58.460882733730422 -34.572610384027826,-58.461730296292828 -34.573432189416749,-58.463155806091748 -34.571787967050177,-58.464154046697303 -34.570634881410406,-58.464936650377417 -34.571089255372627,-58.465837729437688 -34.570293144844278,-58.466814985766547 -34.569429627728702,-58.46573823414186 -34.568804843420018,-58.464918565424959 -34.569751662709628,-58.463879284197979 -34.569139397105225,-58.463114504674984 -34.570023313642515)));;1039;13_18_8;COMUNA 13;18;8;801;339;462;73,38%;361;359;99,45%;2;0,56%;280;1;0,36%;279;99,64%
MULTIPOLYGON (((-58.467774518639075 -34.570051167827437,-58.466814985766547 -34.569429627728702,-58.465837729437688 -34.570293144844278,-58.464936650377417 -34.571089255372627,-58.465999802739788 -34.571703694327859,-58.467117632563244 -34.572354250304443,-58.46736429130177 -34.572496148620381,-58.46808128372858 -34.572908812846634,-58.468840587191586 -34.572011696306838,-58.46958565754322 -34.571131337001965,-58.46862525340876 -34.570594462835587,-58.468538153535221 -34.570545732533986,-58.467774518639075 -34.570051167827437)));;1040;13_18_9;COMUNA 13;18;9;525;228;297;76,77%;210;208;99,05%;2;0,96%;170;0;0,00%;170;100,00%
MULTIPOLYGON (((-58.464868940838429 -34.566878510325111,-58.464396098135296 -34.566598153417189,-58.463358562619689 -34.565982854736106,-58.462550643209255 -34.566917474868511,-58.463175107163025 -34.567288053625759,-58.463316006065064 -34.567371366496488,-58.463315908785191 -34.567371347944054,-58.463500496391639 -34.567480496153372,-58.463500409525167 -34.567480525125411,-58.463587247886643 -34.567531935221282,-58.464700235676467 -34.56819054233533,-58.465507802846375 -34.56725703498963,-58.464996729805698 -34.566954285952676,-58.464868940838429 -34.566878510325111)));;1041;13_19_1;COMUNA 13;19;1;805;351;454;77,31%;417;416;99,76%;1;0,24%;340;16;4,71%;324;95,29%
MULTIPOLYGON (((-58.459650069806422 -34.568003399791529,-58.458888467221428 -34.567545259807517,-58.457628037821834 -34.568998023694014,-58.45771339766948 -34.569537768937991,-58.457805943854737 -34.569502982443055,-58.457793859517693 -34.569415442951467,-58.458787084402331 -34.569081379825775,-58.458883293409492 -34.568983209594471,-58.459650069806422 -34.568003399791529)));;1042;13_19_10;COMUNA 13;19;10;693;315;378;83,33%;418;418;100,00%;0;0,00%;312;2;0,64%;310;99,36%
MULTIPOLYGON (((-58.459911856713454 -34.568159328339739,-58.459650069806422 -34.568003399791529,-58.458883293409492 -34.568983209594471,-58.45966102607364 -34.568724417369964,-58.46039857012768 -34.56844906941226,-58.459911856713454 -34.568159328339739)));;1043;13_19_11;COMUNA 13;19;11;405;199;206;96,60%;224;224;100,00%;0;0,00%;193;0;0,00%;193;100,00%
MULTIPOLYGON (((-58.46094871299124 -34.568764655651002,-58.46062962621864 -34.568581614527922,-58.46042428082896 -34.56846378884471,-58.46039857012768 -34.56844906941226,-58.45966102607364 -34.568724417369964,-58.458883293409492 -34.568983209594471,-58.458787084402331 -34.569081379825775,-58.457793859517693 -34.569415442951467,-58.457805943854737 -34.569502982443055,-58.45771339766948 -34.569537768937991,-58.457785675456215 -34.569600732344114,-58.457984545234225 -34.569793706293233,-58.458794080649518 -34.570580529461687,-58.459679402434126 -34.571440873350376,-58.460261652513594 -34.572008305126033,-58.460882733730422 -34.572610384027826,-58.461406952239408 -34.572001702628526,-58.460060578230006 -34.571193336319133,-58.460950632423561 -34.570612763904649,-58.459959214191549 -34.570084412982226,-58.460851059144282 -34.568871771542462,-58.46094871299124 -34.568764655651002)));;1044;13_19_12;COMUNA 13;19;12;753;323;430;75,12%;356;354;99,44%;2;0,56%;268;3;1,12%;265;98,88%
MULTIPOLYGON (((-58.463358562619689 -34.565982854736106,-58.462324277431534 -34.565369448676989,-58.461515160506423 -34.566304132472361,-58.461696834998236 -34.566410828921462,-58.462550643209255 -34.566917474868511,-58.463358562619689 -34.565982854736106)));;1045;13_19_2;COMUNA 13;19;2;933;427;506;84,39%;498;498;100,00%;0;0,00%;397;2;0,50%;395;99,50%
MULTIPOLYGON (((-58.462324277431534 -34.565369448676989,-58.461302010972403 -34.564763146921578,-58.46048846146725 -34.565700993107562,-58.461515160506423 -34.566304132472361,-58.462324277431534 -34.565369448676989)));;1046;13_19_3;COMUNA 13;19;3;699;314;385;81,56%;371;371;100,00%;0;0,00%;295;3;1,02%;292;98,98%
MULTIPOLYGON (((-58.461515160506423 -34.566304132472361,-58.46048846146725 -34.565700993107562,-58.459664932573084 -34.566650242430164,-58.460690104814539 -34.567257121159756,-58.461515160506423 -34.566304132472361)));;1047;13_19_4;COMUNA 13;19;4;500;230;270;85,19%;314;314;100,00%;0;0,00%;227;0;0,00%;227;100,00%
MULTIPOLYGON (((-58.46350044618648 -34.5674805468297,-58.463500529325529 -34.567480519472497,-58.463500409525167 -34.567480525125411,-58.46350044618648 -34.5674805468297)),((-58.463500496391639 -34.567480496153372,-58.463315908785191 -34.567371347944054,-58.463316006065064 -34.567371366496488,-58.463175107163025 -34.567288053625759,-58.462550643209255 -34.566917474868511,-58.461696834998236 -34.566410828921462,-58.461515160506423 -34.566304132472361,-58.460690104814539 -34.567257121159756,-58.461726700031356 -34.567870681744211,-58.461812430951959 -34.567921388834442,-58.462033952642223 -34.568052241019288,-58.462763991563669 -34.568482402398807,-58.463879284197979 -34.569139397105225,-58.464700235676467 -34.56819054233533,-58.463587247886643 -34.567531935221282,-58.46350044618648 -34.5674805468297,-58.463397992265875 -34.56751425962176,-58.463500496391639 -34.567480496153372)));;1048;13_19_5;COMUNA 13;19;5;929;406;523;77,63%;483;480;99,38%;3;0,63%;366;10;2,73%;356;97,27%
MULTIPOLYGON (((-58.463879284197979 -34.569139397105225,-58.462763991563669 -34.568482402398807,-58.46210418109029 -34.569244053776586,-58.461998184579841 -34.569369833317602,-58.462269685790275 -34.56952632023475,-58.463114504674984 -34.570023313642515,-58.463879284197979 -34.569139397105225)));;1049;13_19_6;COMUNA 13;19;6;497;222;275;80,73%;252;252;100,00%;0;0,00%;215;0;0,00%;215;100,00%
MULTIPOLYGON (((-58.460950632423561 -34.570612763904649,-58.460060578230006 -34.571193336319133,-58.461406952239408 -34.572001702628526,-58.462083222846282 -34.571216392457359,-58.462287897985 -34.570978707022277,-58.463114504674984 -34.570023313642515,-58.462269685790275 -34.56952632023475,-58.461998184579841 -34.569369833317602,-58.461119494786701 -34.568863324241683,-58.46094871299124 -34.568764655651002,-58.460851059144282 -34.568871771542462,-58.459959214191549 -34.570084412982226,-58.460950632423561 -34.570612763904649)));;1050;13_19_7;COMUNA 13;19;7;733;319;414;77,05%;278;277;99,64%;1;0,36%;257;38;14,79%;219;85,21%
MULTIPOLYGON (((-58.461726700031356 -34.567870681744211,-58.460690104814539 -34.567257121159756,-58.459911856713454 -34.568159328339739,-58.46039857012768 -34.56844906941226,-58.46042428082896 -34.56846378884471,-58.46062962621864 -34.568581614527922,-58.46094871299124 -34.568764655651002,-58.461119494786701 -34.568863324241683,-58.461998184579841 -34.569369833317602,-58.46210418109029 -34.569244053776586,-58.462763991563669 -34.568482402398807,-58.462033952642223 -34.568052241019288,-58.461812430951959 -34.567921388834442,-58.461726700031356 -34.567870681744211)));;1051;13_19_8;COMUNA 13;19;8;744;317;427;74,24%;405;404;99,75%;1;0,25%;329;0;0,00%;329;100,00%
MULTIPOLYGON (((-58.460690104814539 -34.567257121159756,-58.459664932573084 -34.566650242430164,-58.458888467221428 -34.567545259807517,-58.459650069806422 -34.568003399791529,-58.459911856713454 -34.568159328339739,-58.460690104814539 -34.567257121159756)));;1052;13_19_9;COMUNA 13;19;9;661;277;384;72,14%;422;421;99,76%;1;0,24%;332;3;0,90%;329;99,10%
MULTIPOLYGON (((-58.469782129755188 -34.544683298067625,-58.469207344762502 -34.545463507838896,-58.468733739064341 -34.546106449851905,-58.468210849493673 -34.546816367178458,-58.469400706611808 -34.547410490548373,-58.469939507387338 -34.54671542710841,-58.470430895342488 -34.54606600017982,-58.471012566490423 -34.545278952949005,-58.471537039808531 -34.544569305037278,-58.470302609826604 -34.543976613506651,-58.469782129755188 -34.544683298067625)));;1053;13_2_1;COMUNA 13;2;1;1073;497;576;86,28%;708;707;99,86%;1;0,14%;545;38;6,97%;507;93,03%
MULTIPOLYGON (((-58.464206043776485 -34.545773686595119,-58.463975726286591 -34.545661923374382,-58.463853503324444 -34.54560002025589,-58.463008416497964 -34.54517141349065,-58.46206520463209 -34.544693079708743,-58.461881108502077 -34.544599693902548,-58.461127365643101 -34.544211287805034,-58.460622235884472 -34.543950915770516,-58.459795439529977 -34.544718752258532,-58.460477346339552 -34.545093432214095,-58.461427277628353 -34.54556649635996,-58.462372112880779 -34.54603708816078,-58.463254144613686 -34.5464761221332,-58.463724230524626 -34.546708665260468,-58.463764233182125 -34.546637886937418,-58.464024418388533 -34.546137226989387,-58.464171829682364 -34.545849394813573,-58.464206043776485 -34.545773686595119)));;1054;13_2_10;COMUNA 13;2;10;1102;494;608;81,25%;562;562;100,00%;0;0,00%;468;12;2,56%;456;97,44%
MULTIPOLYGON (((-58.466974811592976 -34.543262938558414,-58.4668551543134 -34.543424077125131,-58.466724262631722 -34.543599371544424,-58.466394222528379 -34.54404151567843,-58.466539085210307 -34.544114542849272,-58.467338387978394 -34.544518759648525,-58.468269796962389 -34.544989799386421,-58.468419684742578 -34.545065641120274,-58.469207344762502 -34.545463507838896,-58.469782129755188 -34.544683298067625,-58.470302609826604 -34.543976613506651,-58.469365242611893 -34.543501575245564,-58.468437503834572 -34.54303138868606,-58.467499732247376 -34.542556054345532,-58.466974811592976 -34.543262938558414)));;1055;13_2_2;COMUNA 13;2;2;860;408;452;90,27%;402;402;100,00%;0;0,00%;359;1;0,28%;358;99,72%
MULTIPOLYGON (((-58.469207344762502 -34.545463507838896,-58.468419684742578 -34.545065641120274,-58.468269796962389 -34.544989799386421,-58.467338387978394 -34.544518759648525,-58.46686324123808 -34.545161764991178,-58.466338043673595 -34.545872519597488,-58.467273207118247 -34.546343848423575,-58.468210849493673 -34.546816367178458,-58.468733739064341 -34.546106449851905,-58.469207344762502 -34.545463507838896)));;1056;13_2_3;COMUNA 13;2;3;591;272;319;85,27%;344;344;100,00%;0;0,00%;259;2;0,77%;257;99,23%
MULTIPOLYGON (((-58.466394222528379 -34.54404151567843,-58.466724262631722 -34.543599371544424,-58.4668551543134 -34.543424077125131,-58.466974811592976 -34.543262938558414,-58.467499732247376 -34.542556054345532,-58.466572695341014 -34.542086205646548,-58.46624476236051 -34.541920010468914,-58.466119394097504 -34.541856701153428,-58.466076668501749 -34.54183515201467,-58.466073792718731 -34.541842147185392,-58.465844481501684 -34.541733149813936,-58.465811723360041 -34.541812411485147,-58.465658540613113 -34.542191095386883,-58.465524164423186 -34.542531044394906,-58.465487995848179 -34.542622458042885,-58.465319406709021 -34.54304903142755,-58.465170985515847 -34.543422784726559,-58.465141198994623 -34.543497859323118,-58.465034222631189 -34.543776114093355,-58.464887926984417 -34.544162402769956,-58.464863161267168 -34.544227688002231,-58.464670395312318 -34.544712714280628,-58.464656076119681 -34.544753161159193,-58.464590905009061 -34.544899837082646,-58.464558478978581 -34.54497561581843,-58.464554063504401 -34.544985927830439,-58.464749135112228 -34.545075419190866,-58.464750494453924 -34.545072448317342,-58.464905011301234 -34.544734945221101,-58.465010261920959 -34.545203336129823,-58.465384335920369 -34.545391817341617,-58.466338043673595 -34.545872519597488,-58.46686324123808 -34.545161764991178,-58.467338387978394 -34.544518759648525,-58.466539085210307 -34.544114542849272,-58.466394222528379 -34.54404151567843)));;1057;13_2_4;COMUNA 13;2;4;666;322;344;93,60%;302;302;100,00%;0;0,00%;239;3;1,26%;236;98,74%
MULTIPOLYGON (((-58.461294283993617 -34.543326740722129,-58.460622235884472 -34.543950915770516,-58.461127365643101 -34.544211287805034,-58.461881108502077 -34.544599693902548,-58.46206520463209 -34.544693079708743,-58.463008416497964 -34.54517141349065,-58.46353244637946 -34.544458419502803,-58.462587367110579 -34.543982061635724,-58.463117606172425 -34.543265266296579,-58.46198317395762 -34.542686997887799,-58.461294283993617 -34.543326740722129)));;1058;13_2_6;COMUNA 13;2;6;949;465;484;96,07%;687;687;100,00%;0;0,00%;470;7;1,49%;463;98,51%
MULTIPOLYGON (((-58.46353244637946 -34.544458419502803,-58.463008416497964 -34.54517141349065,-58.463853503324444 -34.54560002025589,-58.463975726286591 -34.545661923374382,-58.464206043776485 -34.545773686595119,-58.46437319830919 -34.545403737354363,-58.464526393319936 -34.545050549429142,-58.464554063504401 -34.544985927830439,-58.464558478978581 -34.54497561581843,-58.464590905009061 -34.544899837082646,-58.464656076119681 -34.544753161159193,-58.464388148005739 -34.543911764987406,-58.464057914189837 -34.543744225926844,-58.463928033933769 -34.543678379098736,-58.463117606172425 -34.543265266296579,-58.462587367110579 -34.543982061635724,-58.46353244637946 -34.544458419502803)));;1059;13_2_7;COMUNA 13;2;7;667;322;345;93,33%;372;372;100,00%;0;0,00%;300;1;0,33%;299;99,67%
MULTIPOLYGON (((-58.465158711165628 -34.545690498185479,-58.465249872261985 -34.545859729662411,-58.465446752777531 -34.546283970764819,-58.465562769296419 -34.546482216881891,-58.465750111380302 -34.546667995745757,-58.465814198927156 -34.546581299904012,-58.466750218565849 -34.547054182027239,-58.467687014847428 -34.547527409035816,-58.46884785344615 -34.548113792063226,-58.469128962436905 -34.547761084994733,-58.469400706611808 -34.547410490548373,-58.468210849493673 -34.546816367178458,-58.467273207118247 -34.546343848423575,-58.466338043673595 -34.545872519597488,-58.465384335920369 -34.545391817341617,-58.465010261920959 -34.545203336129823,-58.464905011301234 -34.544734945221101,-58.464750494453924 -34.545072448317342,-58.464751947231875 -34.545076709279655,-58.465022620613198 -34.545870579778978,-58.465158711165628 -34.545690498185479)));;1060;13_2_8;COMUNA 13;2;8;618;263;355;74,08%;325;324;99,69%;1;0,31%;253;1;0,40%;252;99,60%
MULTIPOLYGON (((-58.464206043776485 -34.545773686595119,-58.464171829682364 -34.545849394813573,-58.464024418388533 -34.546137226989387,-58.463764233182125 -34.546637886937418,-58.463724230524626 -34.546708665260468,-58.463939400178639 -34.54681507672646,-58.464457069290809 -34.547071209186093,-58.465186765146399 -34.547432974071654,-58.466122109937778 -34.547907973732343,-58.467061976186727 -34.548377191111229,-58.468189284851512 -34.548939988859246,-58.468225881807179 -34.548894280847655,-58.468508527994246 -34.548539603259528,-58.468553039656761 -34.548483753450547,-58.468553741556313 -34.548482872648975,-58.468663322020241 -34.548345361747231,-58.468718659964829 -34.54827591876947,-58.46884785344615 -34.548113792063226,-58.467687014847428 -34.547527409035816,-58.466750218565849 -34.547054182027239,-58.465814198927156 -34.546581299904012,-58.465750111380302 -34.546667995745757,-58.465562769296419 -34.546482216881891,-58.465446752777531 -34.546283970764819,-58.465249872261985 -34.545859729662411,-58.465158711165628 -34.545690498185479,-58.465022620613198 -34.545870579778978,-58.464751947231875 -34.545076709279655,-58.464750494453924 -34.545072448317342,-58.464749135112228 -34.545075419190866,-58.464554063504401 -34.544985927830439,-58.464526393319936 -34.545050549429142,-58.46437319830919 -34.545403737354363,-58.464206043776485 -34.545773686595119)));;1061;13_2_9;COMUNA 13;2;9;1055;496;559;88,73%;498;497;99,80%;1;0,20%;396;1;0,25%;395;99,75%
MULTIPOLYGON (((-58.46048846146725 -34.565700993107562,-58.459533883033274 -34.565140172749203,-58.458716308210867 -34.566088782083192,-58.459664932573084 -34.566650242430164,-58.46048846146725 -34.565700993107562)));;1062;13_20_1;COMUNA 13;20;1;646;282;364;77,47%;414;414;100,00%;0;0,00%;301;0;0,00%;301;100,00%
MULTIPOLYGON (((-58.45632302201853 -34.567305776094365,-58.455433237005948 -34.566784717661463,-58.45478699569788 -34.567536189218877,-58.455676444186743 -34.56805668887398,-58.45632302201853 -34.567305776094365)));;1063;13_20_10;COMUNA 13;20;10;564;237;327;72,48%;369;369;100,00%;0;0,00%;272;2;0,74%;270;99,26%
MULTIPOLYGON (((-58.455433237005948 -34.566784717661463,-58.454526607545027 -34.566253862410782,-58.453875765172903 -34.567002934430313,-58.45478699569788 -34.567536189218877,-58.455433237005948 -34.566784717661463)));;1064;13_20_11;COMUNA 13;20;11;598;271;327;82,87%;341;341;100,00%;0;0,00%;261;4;1,53%;257;98,47%
MULTIPOLYGON (((-58.453312848804281 -34.565543039660092,-58.45315440555013 -34.565634791973494,-58.452865443657466 -34.565802170762581,-58.452287519971293 -34.56610826304464,-58.453875765172903 -34.567002934430313,-58.454526607545027 -34.566253862410782,-58.453312848804281 -34.565543039660092)));;1065;13_20_12;COMUNA 13;20;12;564;232;332;69,88%;440;440;100,00%;0;0,00%;277;2;0,72%;275;99,28%
MULTIPOLYGON (((-58.459664932573084 -34.566650242430164,-58.458716308210867 -34.566088782083192,-58.457946137956633 -34.566982385241971,-58.458177867024624 -34.567117752080662,-58.458888467221428 -34.567545259807517,-58.459664932573084 -34.566650242430164)));;1066;13_20_2;COMUNA 13;20;2;943;406;537;75,61%;471;471;100,00%;0;0,00%;394;0;0,00%;394;100,00%
MULTIPOLYGON (((-58.458716308210867 -34.566088782083192,-58.457825244610206 -34.565561261781014,-58.457020332193352 -34.566495986347569,-58.457914295500153 -34.567019287021061,-58.457946137956633 -34.566982385241971,-58.458716308210867 -34.566088782083192)));;1067;13_20_3;COMUNA 13;20;3;412;190;222;85,59%;232;232;100,00%;0;0,00%;175;0;0,00%;175;100,00%
MULTIPOLYGON (((-58.457825244610206 -34.565561261781014,-58.456937342038941 -34.565035636571203,-58.456129785269397 -34.565974721610409,-58.457020332193352 -34.566495986347569,-58.457825244610206 -34.565561261781014)));;1068;13_20_4;COMUNA 13;20;4;685;267;418;63,88%;412;412;100,00%;0;0,00%;316;1;0,32%;315;99,68%
MULTIPOLYGON (((-58.456937342038941 -34.565035636571203,-58.456042214750454 -34.56450577892624,-58.455064440570197 -34.563926893277539,-58.454249040501196 -34.56487371237526,-58.455228012495773 -34.565446759210957,-58.456129785269397 -34.565974721610409,-58.456937342038941 -34.565035636571203)));;1069;13_20_5;COMUNA 13;20;5;602;250;352;71,02%;421;421;100,00%;0;0,00%;312;1;0,32%;311;99,68%
MULTIPOLYGON (((-58.456129785269397 -34.565974721610409,-58.455228012495773 -34.565446759210957,-58.454249040501196 -34.56487371237526,-58.453535911800728 -34.565413825569912,-58.453312848804281 -34.565543039660092,-58.454526607545027 -34.566253862410782,-58.455433237005948 -34.566784717661463,-58.456129785269397 -34.565974721610409)));;1070;13_20_6;COMUNA 13;20;6;815;327;488;67,01%;609;609;100,00%;0;0,00%;428;2;0,47%;426;99,53%
MULTIPOLYGON (((-58.457914295500153 -34.567019287021061,-58.457020332193352 -34.566495986347569,-58.456129785269397 -34.565974721610409,-58.455433237005948 -34.566784717661463,-58.45632302201853 -34.567305776094365,-58.457219373313166 -34.56783063127564,-58.457471052175244 -34.567536474546799,-58.457832560719723 -34.567114076668773,-58.457914295500153 -34.567019287021061)));;1071;13_20_7;COMUNA 13;20;7;835;370;465;79,57%;503;503;100,00%;0;0,00%;372;1;0,27%;371;99,73%
MULTIPOLYGON (((-58.457946137956633 -34.566982385241971,-58.457914295500153 -34.567019287021061,-58.457832560719723 -34.567114076668773,-58.457471052175244 -34.567536474546799,-58.457219373313166 -34.56783063127564,-58.456575523736404 -34.568582886961771,-58.457475040288919 -34.569109219252852,-58.457628037821834 -34.568998023694014,-58.458888467221428 -34.567545259807517,-58.458177867024624 -34.567117752080662,-58.457946137956633 -34.566982385241971)));;1072;13_20_8;COMUNA 13;20;8;783;341;442;77,15%;584;584;100,00%;0;0,00%;386;1;0,26%;385;99,74%
MULTIPOLYGON (((-58.457219373313166 -34.56783063127564,-58.45632302201853 -34.567305776094365,-58.455676444186743 -34.56805668887398,-58.456575523736404 -34.568582886961771,-58.457219373313166 -34.56783063127564)));;1073;13_20_9;COMUNA 13;20;9;551;234;317;73,82%;389;389;100,00%;0;0,00%;258;2;0,78%;256;99,22%
MULTIPOLYGON (((-58.453241480100445 -34.564278823473721,-58.452319314630785 -34.563732668043755,-58.451511889434556 -34.564667145077266,-58.452369193828858 -34.565172172479279,-58.45315440555013 -34.565634791973494,-58.453312848804281 -34.565543039660092,-58.453535911800728 -34.565413825569912,-58.454249040501196 -34.56487371237526,-58.455064440570197 -34.563926893277539,-58.454852134440102 -34.563801170023581,-58.454058503265841 -34.563332011128708,-58.453241480100445 -34.564278823473721)));;1074;13_21_1;COMUNA 13;21;1;601;257;344;74,71%;367;366;99,73%;1;0,27%;244;2;0,82%;242;99,18%
MULTIPOLYGON (((-58.450609309188664 -34.564135415817248,-58.449714146176007 -34.563607976593232,-58.448813972239812 -34.563077642739124,-58.448018347985332 -34.564009140227718,-58.448916569166947 -34.56453764858086,-58.449815397588402 -34.565066502473087,-58.450609309188664 -34.564135415817248)));;1075;13_21_10;COMUNA 13;21;10;916;382;534;71,54%;430;430;100,00%;0;0,00%;342;1;0,29%;341;99,71%
MULTIPOLYGON (((-58.454058503265841 -34.563332011128708,-58.453135576665332 -34.562786425131698,-58.452435279943089 -34.56359844655077,-58.452319314630785 -34.563732668043755,-58.453241480100445 -34.564278823473721,-58.454058503265841 -34.563332011128708)));;1076;13_21_2;COMUNA 13;21;2;309;132;177;74,58%;206;206;100,00%;0;0,00%;149;1;0,67%;148;99,33%
MULTIPOLYGON (((-58.453135576665332 -34.562786425131698,-58.452228835575617 -34.562250411390316,-58.451413675258976 -34.563196296295985,-58.452319314630785 -34.563732668043755,-58.452435279943089 -34.56359844655077,-58.453135576665332 -34.562786425131698)));;1077;13_21_3;COMUNA 13;21;3;537;234;303;77,23%;312;312;100,00%;0;0,00%;233;0;0,00%;233;100,00%
MULTIPOLYGON (((-58.452228835575617 -34.562250411390316,-58.451336151324185 -34.561722631981858,-58.450626054571181 -34.562545065249793,-58.45052098619783 -34.562667525048511,-58.451413675258976 -34.563196296295985,-58.452228835575617 -34.562250411390316)));;1078;13_21_4;COMUNA 13;21;4;861;388;473;82,03%;403;403;100,00%;0;0,00%;319;0;0,00%;319;100,00%
MULTIPOLYGON (((-58.451336151324185 -34.561722631981858,-58.450442201524027 -34.561194141617662,-58.449720266245492 -34.56202438574843,-58.44962396722071 -34.562136211441022,-58.45052098619783 -34.562667525048511,-58.450626054571181 -34.562545065249793,-58.451336151324185 -34.561722631981858)));;1079;13_21_5;COMUNA 13;21;5;850;396;454;87,22%;378;378;100,00%;0;0,00%;291;2;0,69%;289;99,31%
MULTIPOLYGON (((-58.45052098619783 -34.562667525048511,-58.44962396722071 -34.562136211441022,-58.448893669923834 -34.562984337775951,-58.448813972239812 -34.563077642739124,-58.449714146176007 -34.563607976593232,-58.45052098619783 -34.562667525048511)));;1080;13_21_6;COMUNA 13;21;6;759;333;426;78,17%;387;387;100,00%;0;0,00%;312;2;0,64%;310;99,36%
MULTIPOLYGON (((-58.451413675258976 -34.563196296295985,-58.45052098619783 -34.562667525048511,-58.449714146176007 -34.563607976593232,-58.450609309188664 -34.564135415817248,-58.451068414306583 -34.563596915457495,-58.451413675258976 -34.563196296295985)));;1081;13_21_7;COMUNA 13;21;7;1125;497;628;79,14%;550;550;100,00%;0;0,00%;450;2;0,44%;448;99,56%
MULTIPOLYGON (((-58.452319314630785 -34.563732668043755,-58.451413675258976 -34.563196296295985,-58.451068414306583 -34.563596915457495,-58.450609309188664 -34.564135415817248,-58.451511889434556 -34.564667145077266,-58.452319314630785 -34.563732668043755)));;1082;13_21_8;COMUNA 13;21;8;735;329;406;81,03%;431;431;100,00%;0;0,00%;345;1;0,29%;344;99,71%
MULTIPOLYGON (((-58.451511889434556 -34.564667145077266,-58.450609309188664 -34.564135415817248,-58.449815397588402 -34.565066502473087,-58.449882135568139 -34.565105736579262,-58.451273209587647 -34.565685548114423,-58.452287519971293 -34.56610826304464,-58.452865443657466 -34.565802170762581,-58.45315440555013 -34.565634791973494,-58.452369193828858 -34.565172172479279,-58.451511889434556 -34.564667145077266)));;1083;13_21_9;COMUNA 13;21;9;842;404;438;92,24%;542;541;99,82%;1;0,18%;360;1;0,28%;359;99,72%
MULTIPOLYGON (((-58.448952771524723 -34.565960813925116,-58.448117782296521 -34.565468723581908,-58.447319743993567 -34.566398877772961,-58.447795763521057 -34.566678315258542,-58.447854500050511 -34.566712830969216,-58.448386076597927 -34.5672225646436,-58.449044406334956 -34.567853794378578,-58.449929972831939 -34.567381263965487,-58.450162920884964 -34.567256916479515,-58.450780452318035 -34.566919710065825,-58.45158409566065 -34.566480752574137,-58.451718276332038 -34.566409705264988,-58.452287519971293 -34.56610826304464,-58.451273209587647 -34.565685548114423,-58.450209806616762 -34.566275892411689,-58.449456986571512 -34.566693718708464,-58.448952771524723 -34.565960813925116)));;1084;13_22_1;COMUNA 13;22;1;589;231;358;64,53%;342;341;99,71%;1;0,29%;251;3;1,20%;248;98,80%
MULTIPOLYGON (((-58.449815397588402 -34.565066502473087,-58.449470376016059 -34.565471060851266,-58.450209806616762 -34.566275892411689,-58.451273209587647 -34.565685548114423,-58.449882135568139 -34.565105736579262,-58.449815397588402 -34.565066502473087)));;1085;13_22_2;COMUNA 13;22;2;520;228;292;78,08%;287;287;100,00%;0;0,00%;221;1;0,45%;220;99,55%
MULTIPOLYGON (((-58.449470376016059 -34.565471060851266,-58.449165030820502 -34.565829212142681,-58.448952771524723 -34.565960813925116,-58.449456986571512 -34.566693718708464,-58.450209806616762 -34.566275892411689,-58.449470376016059 -34.565471060851266)));;1086;13_22_3;COMUNA 13;22;3;471;218;253;86,17%;324;324;100,00%;0;0,00%;222;0;0,00%;222;100,00%
MULTIPOLYGON (((-58.449815397588402 -34.565066502473087,-58.448916569166947 -34.56453764858086,-58.448018347985332 -34.564009140227718,-58.447114094522668 -34.563477103168672,-58.446317681450402 -34.564407955577977,-58.44722228024618 -34.564941054884002,-58.448117782296521 -34.565468723581908,-58.448952771524723 -34.565960813925116,-58.449165030820502 -34.565829212142681,-58.449470376016059 -34.565471060851266,-58.449815397588402 -34.565066502473087)));;1087;13_22_4;COMUNA 13;22;4;895;395;500;79,00%;422;422;100,00%;0;0,00%;327;1;0,31%;326;99,69%
MULTIPOLYGON (((-58.445409519117504 -34.563872736249856,-58.444612402011984 -34.564804563329773,-58.445519973301607 -34.565340422254309,-58.446064504640773 -34.565661920261967,-58.446426194497747 -34.565874231863162,-58.447319743993567 -34.566398877772961,-58.448117782296521 -34.565468723581908,-58.44722228024618 -34.564941054884002,-58.446317681450402 -34.564407955577977,-58.447114094522668 -34.563477103168672,-58.446205341204404 -34.562942312158285,-58.445409519117504 -34.563872736249856)));;1088;13_22_5;COMUNA 13;22;5;1184;500;684;73,10%;484;483;99,79%;1;0,21%;394;1;0,25%;393;99,75%
MULTIPOLYGON (((-58.444619902363208 -34.562010637767429,-58.444468765859348 -34.562155340048051,-58.443634426904183 -34.562826580491034,-58.445409519117504 -34.563872736249856,-58.446205341204404 -34.562942312158285,-58.444928799054175 -34.562191184121453,-58.444619902363208 -34.562010637767429)));;1089;13_22_6;COMUNA 13;22;6;1122;510;612;83,33%;485;485;100,00%;0;0,00%;391;3;0,77%;388;99,23%
MULTIPOLYGON (((-58.443634426904183 -34.562826580491034,-58.442813783256874 -34.563486830984999,-58.442621864402781 -34.56362617194339,-58.443646194434237 -34.564234039056707,-58.444612402011984 -34.564804563329773,-58.445409519117504 -34.563872736249856,-58.443634426904183 -34.562826580491034)));;1090;13_22_7;COMUNA 13;22;7;1101;493;608;81,09%;600;600;100,00%;0;0,00%;455;3;0,66%;452;99,34%
MULTIPOLYGON (((-58.444160520960217 -34.56148926380969,-58.444166243562798 -34.56148750396158,-58.443479079887197 -34.561376311659018,-58.443409075448088 -34.561400988637359,-58.443214198744521 -34.561472228476653,-58.442544191920547 -34.561645014738623,-58.441877928035559 -34.561817727530901,-58.441420669149032 -34.561932372109958,-58.441325062016354 -34.561958765035634,-58.44119574315777 -34.561986630891958,-58.441100993516343 -34.562005369242705,-58.441164038222965 -34.562098731534668,-58.441220115310507 -34.56218177534366,-58.441344541606227 -34.56235075773052,-58.441344849831871 -34.562351104211452,-58.441497306168969 -34.562522482135975,-58.441969305838441 -34.563053009299409,-58.442535270813607 -34.563689047779995,-58.442621864402781 -34.56362617194339,-58.442813783256874 -34.563486830984999,-58.443634426904183 -34.562826580491034,-58.442806905575864 -34.562338891562916,-58.442969409498652 -34.562141385543931,-58.444186734774064 -34.561755068500233,-58.444160520960217 -34.56148926380969)));;1091;13_22_8;COMUNA 13;22;8;797;376;421;89,31%;543;543;100,00%;0;0,00%;377;3;0,80%;374;99,20%
MULTIPOLYGON (((-58.444619902363208 -34.562010637767429,-58.444477498806307 -34.561927373448455,-58.444186734774064 -34.561755068500233,-58.442969409498652 -34.562141385543931,-58.442806905575864 -34.562338891562916,-58.443634426904183 -34.562826580491034,-58.444468765859348 -34.562155340048051,-58.444619902363208 -34.562010637767429)));;1092;13_22_9;COMUNA 13;22;9;551;243;308;78,90%;289;289;100,00%;0;0,00%;220;2;0,91%;218;99,09%
MULTIPOLYGON (((-58.457475040288919 -34.569109219252852,-58.456575523736404 -34.568582886961771,-58.455359205948419 -34.5692828502875,-58.455253902647762 -34.569158261038915,-58.454765697745479 -34.56858158551006,-58.453838166772258 -34.569117249203607,-58.452918967914151 -34.569648187955188,-58.452080388854291 -34.570132505044057,-58.451589787080778 -34.570415783480918,-58.451193863409706 -34.570644348222473,-58.450512954777416 -34.57103739768484,-58.450340791069543 -34.571126468720124,-58.45017501290971 -34.571212230164946,-58.449394997627763 -34.571574275896445,-58.448781691921724 -34.571858938053595,-58.448640093987215 -34.571923220362279,-58.447560093868994 -34.572413746039921,-58.44658864490453 -34.57285490818753,-58.446914631794279 -34.573392297689793,-58.446942719626016 -34.57343864132546,-58.447020855049914 -34.573567459701316,-58.447049210050572 -34.573614178478074,-58.447049709047363 -34.573615000643649,-58.448281367393349 -34.573102383968013,-58.449205803997152 -34.572715712554192,-58.450261357174817 -34.572265594119806,-58.451781531317849 -34.571617190583247,-58.451912055938543 -34.571570510039777,-58.452281747200701 -34.571438212516263,-58.4529404955573 -34.571209031742036,-58.453880889400004 -34.570881835681639,-58.453914429466558 -34.570924938550036,-58.454984396220503 -34.570603729403388,-58.456216461210481 -34.570233925928285,-58.457719768754956 -34.569776018956262,-58.45789861967399 -34.570173860237837,-58.458123295834099 -34.570080324663053,-58.458091020259964 -34.570021047410414,-58.457984545234225 -34.569793706293233,-58.457785675456215 -34.569600732344114,-58.45771339766948 -34.569537768937991,-58.457628037821834 -34.568998023694014,-58.457475040288919 -34.569109219252852)));;1093;13_23_1;COMUNA 13;23;1;1192;536;656;81,71%;681;681;100,00%;0;0,00%;545;5;0,92%;540;99,08%
MULTIPOLYGON (((-58.451787766578725 -34.568205001222751,-58.450948004009902 -34.568686000539181,-58.451525555389111 -34.569423762858669,-58.45236336433662 -34.568939308608208,-58.451787766578725 -34.568205001222751)));;1094;13_23_10;COMUNA 13;23;10;562;249;313;79,55%;307;307;100,00%;0;0,00%;243;2;0,82%;241;99,18%
MULTIPOLYGON (((-58.450780452318035 -34.566919710065825,-58.450162920884964 -34.567256916479515,-58.449929972831939 -34.567381263965487,-58.450948004009902 -34.568686000539181,-58.451787766578725 -34.568205001222751,-58.450780452318035 -34.566919710065825)));;1095;13_23_11;COMUNA 13;23;11;819;333;486;68,52%;629;629;100,00%;0;0,00%;424;3;0,71%;421;99,29%
MULTIPOLYGON (((-58.455676444186743 -34.56805668887398,-58.454765697745479 -34.56858158551006,-58.455253902647762 -34.569158261038915,-58.455359205948419 -34.5692828502875,-58.456575523736404 -34.568582886961771,-58.455676444186743 -34.56805668887398)));;1096;13_23_2;COMUNA 13;23;2;515;241;274;87,96%;329;329;100,00%;0;0,00%;270;4;1,48%;266;98,52%
MULTIPOLYGON (((-58.455676444186743 -34.56805668887398,-58.45478699569788 -34.567536189218877,-58.453282644130965 -34.568407740154065,-58.453838166772258 -34.569117249203607,-58.454765697745479 -34.56858158551006,-58.455676444186743 -34.56805668887398)));;1097;13_23_3;COMUNA 13;23;3;1099;480;619;77,54%;707;707;100,00%;0;0,00%;538;2;0,37%;536;99,63%
MULTIPOLYGON (((-58.45478699569788 -34.567536189218877,-58.453875765172903 -34.567002934430313,-58.452710191579982 -34.5676766064486,-58.453282644130965 -34.568407740154065,-58.45478699569788 -34.567536189218877)));;1098;13_23_4;COMUNA 13;23;4;604;250;354;70,62%;413;413;100,00%;0;0,00%;294;0;0,00%;294;100,00%
MULTIPOLYGON (((-58.452287519971293 -34.56610826304464,-58.451718276332038 -34.566409705264988,-58.452710191579982 -34.5676766064486,-58.453875765172903 -34.567002934430313,-58.452287519971293 -34.56610826304464)));;1099;13_23_5;COMUNA 13;23;5;494;226;268;84,33%;348;348;100,00%;0;0,00%;236;1;0,42%;235;99,58%
MULTIPOLYGON (((-58.451718276332038 -34.566409705264988,-58.45158409566065 -34.566480752574137,-58.450780452318035 -34.566919710065825,-58.451787766578725 -34.568205001222751,-58.452710191579982 -34.5676766064486,-58.451718276332038 -34.566409705264988)));;1100;13_23_6;COMUNA 13;23;6;762;326;436;74,77%;461;461;100,00%;0;0,00%;368;3;0,82%;365;99,18%
MULTIPOLYGON (((-58.452710191579982 -34.5676766064486,-58.451787766578725 -34.568205001222751,-58.45236336433662 -34.568939308608208,-58.453282644130965 -34.568407740154065,-58.452710191579982 -34.5676766064486)));;1101;13_23_7;COMUNA 13;23;7;529;222;307;72,31%;326;325;99,69%;1;0,31%;257;1;0,39%;256;99,61%
MULTIPOLYGON (((-58.453282644130965 -34.568407740154065,-58.45236336433662 -34.568939308608208,-58.452918967914151 -34.569648187955188,-58.453838166772258 -34.569117249203607,-58.453282644130965 -34.568407740154065)));;1102;13_23_8;COMUNA 13;23;8;1044;460;584;78,77%;674;674;100,00%;0;0,00%;505;2;0,40%;503;99,60%
MULTIPOLYGON (((-58.45236336433662 -34.568939308608208,-58.451525555389111 -34.569423762858669,-58.450639885404804 -34.569935883854413,-58.451193863409706 -34.570644348222473,-58.451589787080778 -34.570415783480918,-58.452080388854291 -34.570132505044057,-58.452918967914151 -34.569648187955188,-58.45236336433662 -34.568939308608208)));;1103;13_23_9;COMUNA 13;23;9;1024;455;569;79,96%;495;494;99,80%;1;0,20%;429;4;0,93%;425;99,07%
MULTIPOLYGON (((-58.460521193202581 -34.57393804047522,-58.459798244024185 -34.574255855869303,-58.459576445415699 -34.574353389757711,-58.459402071900783 -34.574415570915463,-58.459850069401952 -34.575021030460199,-58.460043931219474 -34.575283158628515,-58.460178451476679 -34.575474859747558,-58.461261313628391 -34.574886119945909,-58.462355739852249 -34.574292652003223,-58.462522533334159 -34.574202155549401,-58.461730296292828 -34.573432189416749,-58.461549114818119 -34.573507965726421,-58.460521193202581 -34.57393804047522)));;1104;13_24_1;COMUNA 13;24;1;471;211;260;81,15%;250;250;100,00%;0;0,00%;198;0;0,00%;198;100,00%
MULTIPOLYGON (((-58.454425792200823 -34.571580847594156,-58.455377434623365 -34.571118282843834,-58.454984396220503 -34.570603729403388,-58.453914429466558 -34.570924938550036,-58.453880889400004 -34.570881835681639,-58.4529404955573 -34.571209031742036,-58.452281747200701 -34.571438212516263,-58.451912055938543 -34.571570510039777,-58.452452860126478 -34.572268755635953,-58.452605492469729 -34.572464551395434,-58.45271394444385 -34.57260365078249,-58.453376752043432 -34.573455077644439,-58.454318885714677 -34.572994069926303,-58.45499698423874 -34.57258501258223,-58.455144284464055 -34.57250234218985,-58.454425792200823 -34.571580847594156)));;1105;13_24_10;COMUNA 13;24;10;805;356;449;79,29%;359;358;99,72%;1;0,28%;283;4;1,41%;279;98,59%
MULTIPOLYGON (((-58.460882733730422 -34.572610384027826,-58.460707853578306 -34.572689610044712,-58.459533661835529 -34.573221720676109,-58.459762492780982 -34.574016901175455,-58.459798244024185 -34.574255855869303,-58.460521193202581 -34.57393804047522,-58.461549114818119 -34.573507965726421,-58.461730296292828 -34.573432189416749,-58.460882733730422 -34.572610384027826)));;1106;13_24_2;COMUNA 13;24;2;568;231;337;68,55%;356;355;99,72%;1;0,28%;252;0;0,00%;252;100,00%
MULTIPOLYGON (((-58.460261652513594 -34.572008305126033,-58.459679402434126 -34.571440873350376,-58.459525977920883 -34.571539958227532,-58.458800399351119 -34.572008478467161,-58.457933905130481 -34.572485228726599,-58.458173898349379 -34.572799758375389,-58.45877291019594 -34.573585728203419,-58.459290030977336 -34.574264012091639,-58.459402071900783 -34.574415570915463,-58.459576445415699 -34.574353389757711,-58.459798244024185 -34.574255855869303,-58.459762492780982 -34.574016901175455,-58.459533661835529 -34.573221720676109,-58.460707853578306 -34.572689610044712,-58.460882733730422 -34.572610384027826,-58.460261652513594 -34.572008305126033)));;1107;13_24_3;COMUNA 13;24;3;668;308;360;85,56%;316;316;100,00%;0;0,00%;283;29;10,25%;254;89,75%
MULTIPOLYGON (((-58.458091020259964 -34.570021047410414,-58.458123295834099 -34.570080324663053,-58.45789861967399 -34.570173860237837,-58.457719768754956 -34.569776018956262,-58.456216461210481 -34.570233925928285,-58.456480958831719 -34.570581701191749,-58.457123015671627 -34.571420712037373,-58.457987374497101 -34.570953052266766,-58.458170682686045 -34.570866928731739,-58.458231633164871 -34.571030177452386,-58.458800399351119 -34.572008478467161,-58.459525977920883 -34.571539958227532,-58.459679402434126 -34.571440873350376,-58.458794080649518 -34.570580529461687,-58.457984545234225 -34.569793706293233,-58.458091020259964 -34.570021047410414)));;1108;13_24_4;COMUNA 13;24;4;822;370;452;81,86%;484;483;99,79%;1;0,21%;364;1;0,27%;363;99,73%
MULTIPOLYGON (((-58.458170682686045 -34.570866928731739,-58.457987374497101 -34.570953052266766,-58.457123015671627 -34.571420712037373,-58.456480958831719 -34.570581701191749,-58.456216461210481 -34.570233925928285,-58.454984396220503 -34.570603729403388,-58.455377434623365 -34.571118282843834,-58.456050046341836 -34.57199878174238,-58.45686050228236 -34.573059713734395,-58.457933905130481 -34.572485228726599,-58.458800399351119 -34.572008478467161,-58.458231633164871 -34.571030177452386,-58.458170682686045 -34.570866928731739)));;1109;13_24_5;COMUNA 13;24;5;726;354;372;95,16%;353;353;100,00%;0;0,00%;286;1;0,35%;285;99,65%
MULTIPOLYGON (((-58.457933905130481 -34.572485228726599,-58.45686050228236 -34.573059713734395,-58.457262588014579 -34.573586022396853,-58.457665444908642 -34.574115358019483,-58.45821593344025 -34.574838720107742,-58.458922234578871 -34.575766811527316,-58.459866991577485 -34.575647184158804,-58.460178451476679 -34.575474859747558,-58.460043931219474 -34.575283158628515,-58.459850069401952 -34.575021030460199,-58.459402071900783 -34.574415570915463,-58.459290030977336 -34.574264012091639,-58.45877291019594 -34.573585728203419,-58.458173898349379 -34.572799758375389,-58.457933905130481 -34.572485228726599)));;1110;13_24_6;COMUNA 13;24;6;734;323;411;78,59%;385;384;99,74%;1;0,26%;318;2;0,63%;316;99,37%
MULTIPOLYGON (((-58.45674511499795 -34.574555335315459,-58.455997366415559 -34.574912776523526,-58.455867518762318 -34.574974532509813,-58.456296681291072 -34.575523381867519,-58.45671673990411 -34.57606053858629,-58.457804801923416 -34.575913116047822,-58.4583500660829 -34.575839260332934,-58.458922234578871 -34.575766811527316,-58.45821593344025 -34.574838720107742,-58.457665444908642 -34.574115358019483,-58.457444835669811 -34.574220846171116,-58.45674511499795 -34.574555335315459)));;1111;13_24_7;COMUNA 13;24;7;943;443;500;88,60%;402;402;100,00%;0;0,00%;367;18;4,90%;349;95,10%
MULTIPOLYGON (((-58.455377434623365 -34.571118282843834,-58.454425792200823 -34.571580847594156,-58.455144284464055 -34.57250234218985,-58.455956267907588 -34.573543701891609,-58.45674511499795 -34.574555335315459,-58.457444835669811 -34.574220846171116,-58.457665444908642 -34.574115358019483,-58.457262588014579 -34.573586022396853,-58.45686050228236 -34.573059713734395,-58.456050046341836 -34.57199878174238,-58.455377434623365 -34.571118282843834)));;1112;13_24_8;COMUNA 13;24;8;847;377;470;80,21%;393;393;100,00%;0;0,00%;339;3;0,88%;336;99,12%
MULTIPOLYGON (((-58.454912941045912 -34.575428438259429,-58.45564160271919 -34.576364296801202,-58.45671673990411 -34.57606053858629,-58.456296681291072 -34.575523381867519,-58.455867518762318 -34.574974532509813,-58.455997366415559 -34.574912776523526,-58.45674511499795 -34.574555335315459,-58.455956267907588 -34.573543701891609,-58.455144284464055 -34.57250234218985,-58.45499698423874 -34.57258501258223,-58.454318885714677 -34.572994069926303,-58.453376752043432 -34.573455077644439,-58.454184125461403 -34.574492152661428,-58.454912941045912 -34.575428438259429)));;1113;13_24_9;COMUNA 13;24;9;970;438;532;82,33%;447;447;100,00%;0;0,00%;381;54;14,17%;327;85,83%
MULTIPOLYGON (((-58.462522533334159 -34.574202155549401,-58.462355739852249 -34.574292652003223,-58.461261313628391 -34.574886119945909,-58.460178451476679 -34.575474859747558,-58.460821007060744 -34.576391107264989,-58.461878162654429 -34.575857575284928,-58.461975397198685 -34.575800742510253,-58.463189625913067 -34.575103671888222,-58.463355568645603 -34.575008385375881,-58.462903118866492 -34.574592805933023,-58.462522533334159 -34.574202155549401)));;1114;13_25_1;COMUNA 13;25;1;591;283;308;91,88%;289;289;100,00%;0;0,00%;262;13;4,96%;249;95,04%
MULTIPOLYGON (((-58.459866991577485 -34.575647184158804,-58.458922234578871 -34.575766811527316,-58.459791851108228 -34.576909418803986,-58.459899731264684 -34.576856038795505,-58.459903728144837 -34.577002946484903,-58.460102160507695 -34.57829554038608,-58.460224856101227 -34.57829526123389,-58.460546973025899 -34.577942928621667,-58.4616052644052 -34.576837262398648,-58.462247088424121 -34.576166674787565,-58.462376082057915 -34.576031880768262,-58.463189625913067 -34.575103671888222,-58.461975397198685 -34.575800742510253,-58.461878162654429 -34.575857575284928,-58.460821007060744 -34.576391107264989,-58.460178451476679 -34.575474859747558,-58.459866991577485 -34.575647184158804)));;1115;13_25_2;COMUNA 13;25;2;701;310;391;79,28%;348;348;100,00%;0;0,00%;279;2;0,72%;277;99,28%
MULTIPOLYGON (((-58.458922234578871 -34.575766811527316,-58.4583500660829 -34.575839260332934,-58.457804801923416 -34.575913116047822,-58.45671673990411 -34.57606053858629,-58.457592461145403 -34.57718041433926,-58.458693477664532 -34.577044745506697,-58.459791851108228 -34.576909418803986,-58.458922234578871 -34.575766811527316)));;1116;13_25_3;COMUNA 13;25;3;875;418;457;91,47%;477;477;100,00%;0;0,00%;392;2;0,51%;390;99,49%
MULTIPOLYGON (((-58.459899731264684 -34.576856038795505,-58.459791851108228 -34.576909418803986,-58.458693477664532 -34.577044745506697,-58.457592461145403 -34.57718041433926,-58.45671673990411 -34.57606053858629,-58.45564160271919 -34.576364296801202,-58.456398801565705 -34.577336914436842,-58.457340769977101 -34.578546728506808,-58.457743689168268 -34.578438008585508,-58.4585384469706 -34.578390008089656,-58.459695075936473 -34.578320109537614,-58.460102160507695 -34.57829554038608,-58.459903728144837 -34.577002946484903,-58.459899731264684 -34.576856038795505)));;1117;13_25_4;COMUNA 13;25;4;668;311;357;87,11%;319;319;100,00%;0;0,00%;269;2;0,74%;267;99,26%
MULTIPOLYGON (((-58.455289253283219 -34.577581369436018,-58.455970905006744 -34.578916253597939,-58.457161789057153 -34.578594961972946,-58.457340769977101 -34.578546728506808,-58.456398801565705 -34.577336914436842,-58.45564160271919 -34.576364296801202,-58.454787668986881 -34.576605592646672,-58.4550563372038 -34.577125138701433,-58.455289253283219 -34.577581369436018)));;1118;13_25_5;COMUNA 13;25;5;594;270;324;83,33%;239;239;100,00%;0;0,00%;221;0;0,00%;221;100,00%
MULTIPOLYGON (((-58.454241742519095 -34.578094069345561,-58.454315124550668 -34.578231122407956,-58.454862348554826 -34.579242679960181,-58.45539930125053 -34.579070452543647,-58.455970905006744 -34.578916253597939,-58.455289253283219 -34.577581369436018,-58.4550563372038 -34.577125138701433,-58.454787668986881 -34.576605592646672,-58.453720753946435 -34.577121949034392,-58.452010001214461 -34.577947761398221,-58.452528336078004 -34.578914888448445,-58.453327822343475 -34.578529584222629,-58.454241742519095 -34.578094069345561)));;1119;13_25_6;COMUNA 13;25;6;730;358;372;96,24%;309;308;99,68%;1;0,32%;274;19;6,93%;255;93,07%
MULTIPOLYGON (((-58.454241742519095 -34.578094069345561,-58.453327822343475 -34.578529584222629,-58.452528336078004 -34.578914888448445,-58.453020633374955 -34.57983334708463,-58.453533496065013 -34.579668872782513,-58.454862348554826 -34.579242679960181,-58.454315124550668 -34.578231122407956,-58.454241742519095 -34.578094069345561)));;1120;13_25_7;COMUNA 13;25;7;1156;510;646;78,95%;541;540;99,82%;1;0,19%;504;2;0,40%;502;99,60%
MULTIPOLYGON (((-58.452010001214461 -34.577947761398221,-58.45108798078148 -34.578392836669913,-58.450140149209496 -34.578850297174256,-58.449982445836611 -34.578926974191035,-58.450450299334584 -34.579698673963101,-58.45055500649287 -34.579866085766191,-58.450952471876256 -34.580501573632226,-58.451017614008009 -34.580475733740641,-58.452022320729483 -34.580153488428159,-58.452193049418604 -34.580098782658382,-58.453020633374955 -34.57983334708463,-58.452528336078004 -34.578914888448445,-58.452010001214461 -34.577947761398221)));;1121;13_25_8;COMUNA 13;25;8;783;352;431;81,67%;438;438;100,00%;0;0,00%;364;3;0,82%;361;99,18%
MULTIPOLYGON (((-58.453225823991744 -34.576216450903914,-58.451636775378773 -34.576902965904857,-58.451488528763576 -34.576974927240791,-58.452010001214461 -34.577947761398221,-58.453720753946435 -34.577121949034392,-58.454787668986881 -34.576605592646672,-58.45564160271919 -34.576364296801202,-58.454912941045912 -34.575428438259429,-58.454184125461403 -34.574492152661428,-58.452668921551982 -34.575302987472028,-58.453225823991744 -34.576216450903914)));;1122;13_26_1;COMUNA 13;26;1;853;413;440;93,86%;450;449;99,78%;1;0,22%;316;28;8,86%;288;91,14%
MULTIPOLYGON (((-58.449205803997152 -34.572715712554192,-58.448281367393349 -34.573102383968013,-58.448898616335896 -34.57426694160668,-58.449541077600692 -34.575477697764704,-58.450450897752816 -34.575038830185065,-58.449801019635423 -34.573826246879932,-58.449205803997152 -34.572715712554192)));;1123;13_26_10;COMUNA 13;26;10;938;420;518;81,08%;531;531;100,00%;0;0,00%;436;1;0,23%;435;99,77%
MULTIPOLYGON (((-58.447727981201766 -34.574838729352898,-58.448372219274169 -34.576041533683039,-58.449541077600692 -34.575477697764704,-58.448898616335896 -34.57426694160668,-58.448281367393349 -34.573102383968013,-58.447049709047363 -34.573615000643649,-58.44724487864606 -34.57393679979328,-58.447727981201766 -34.574838729352898)));;1124;13_26_11;COMUNA 13;26;11;645;292;353;82,72%;365;365;100,00%;0;0,00%;281;16;5,69%;265;94,31%
MULTIPOLYGON (((-58.451952336233916 -34.574143792724584,-58.452492114821077 -34.575012890087244,-58.452668921551982 -34.575302987472028,-58.454184125461403 -34.574492152661428,-58.453376752043432 -34.573455077644439,-58.45271394444385 -34.57260365078249,-58.452605492469729 -34.572464551395434,-58.451302250369558 -34.573096998951975,-58.451952336233916 -34.574143792724584)));;1125;13_26_2;COMUNA 13;26;2;811;351;460;76,30%;377;376;99,73%;1;0,27%;325;22;6,77%;303;93,23%
MULTIPOLYGON (((-58.450261357174817 -34.572265594119806,-58.449205803997152 -34.572715712554192,-58.449801019635423 -34.573826246879932,-58.45002887539497 -34.573714927969782,-58.450843224497078 -34.573319711225786,-58.451302250369558 -34.573096998951975,-58.452605492469729 -34.572464551395434,-58.452452860126478 -34.572268755635953,-58.451912055938543 -34.571570510039777,-58.451781531317849 -34.571617190583247,-58.450261357174817 -34.572265594119806)));;1126;13_26_3;COMUNA 13;26;3;771;343;428;80,14%;326;325;99,69%;1;0,31%;288;17;5,90%;271;94,10%
MULTIPOLYGON (((-58.451302250369558 -34.573096998951975,-58.450843224497078 -34.573319711225786,-58.45002887539497 -34.573714927969782,-58.449801019635423 -34.573826246879932,-58.450450897752816 -34.575038830185065,-58.450606890282977 -34.574963631279793,-58.451952336233916 -34.574143792724584,-58.451302250369558 -34.573096998951975)));;1127;13_26_4;COMUNA 13;26;4;967;445;522;85,25%;469;467;99,57%;2;0,43%;419;24;5,73%;395;94,27%
MULTIPOLYGON (((-58.451952336233916 -34.574143792724584,-58.450606890282977 -34.574963631279793,-58.450450897752816 -34.575038830185065,-58.450974303814128 -34.576015401819816,-58.451488528763576 -34.576974927240791,-58.451636775378773 -34.576902965904857,-58.453225823991744 -34.576216450903914,-58.452668921551982 -34.575302987472028,-58.452492114821077 -34.575012890087244,-58.451952336233916 -34.574143792724584)));;1128;13_26_5;COMUNA 13;26;5;751;346;405;85,43%;376;374;99,47%;2;0,53%;317;31;9,78%;286;90,22%
MULTIPOLYGON (((-58.450571710165647 -34.577419928736653,-58.45108798078148 -34.578392836669913,-58.452010001214461 -34.577947761398221,-58.451488528763576 -34.576974927240791,-58.450974303814128 -34.576015401819816,-58.450059792697324 -34.576455188275524,-58.450571710165647 -34.577419928736653)));;1129;13_26_6;COMUNA 13;26;6;785;329;456;72,15%;303;301;99,34%;2;0,66%;265;5;1,89%;260;98,11%
MULTIPOLYGON (((-58.450571710165647 -34.577419928736653,-58.449685281105403 -34.577850207629012,-58.449412538249689 -34.577983634546328,-58.449982445836611 -34.578926974191035,-58.450140149209496 -34.578850297174256,-58.45108798078148 -34.578392836669913,-58.450571710165647 -34.577419928736653)));;1130;13_26_7;COMUNA 13;26;7;491;216;275;78,55%;237;236;99,58%;1;0,42%;189;1;0,53%;188;99,47%
MULTIPOLYGON (((-58.450059792697324 -34.576455188275524,-58.448894075081554 -34.577015789851743,-58.449412538249689 -34.577983634546328,-58.449685281105403 -34.577850207629012,-58.450571710165647 -34.577419928736653,-58.450059792697324 -34.576455188275524)));;1131;13_26_8;COMUNA 13;26;8;467;214;253;84,58%;274;274;100,00%;0;0,00%;214;16;7,48%;198;92,52%
MULTIPOLYGON (((-58.449541077600692 -34.575477697764704,-58.448372219274169 -34.576041533683039,-58.448894075081554 -34.577015789851743,-58.450059792697324 -34.576455188275524,-58.450974303814128 -34.576015401819816,-58.450450897752816 -34.575038830185065,-58.449541077600692 -34.575477697764704)));;1132;13_26_9;COMUNA 13;26;9;515;237;278;85,25%;273;272;99,63%;1;0,37%;202;18;8,91%;184;91,09%
MULTIPOLYGON (((-58.450948004009902 -34.568686000539181,-58.450537868053296 -34.568920900153046,-58.450059359212425 -34.569193539435595,-58.450639885404804 -34.569935883854413,-58.451525555389111 -34.569423762858669,-58.450948004009902 -34.568686000539181)));;1133;13_27_1;COMUNA 13;27;1;422;183;239;76,57%;215;215;100,00%;0;0,00%;175;2;1,14%;173;98,86%
MULTIPOLYGON (((-58.449929972831939 -34.567381263965487,-58.449044406334956 -34.567853794378578,-58.450059359212425 -34.569193539435595,-58.450537868053296 -34.568920900153046,-58.450948004009902 -34.568686000539181,-58.449929972831939 -34.567381263965487)));;1134;13_27_2;COMUNA 13;27;2;856;359;497;72,23%;555;555;100,00%;0;0,00%;399;4;1,00%;395;99,00%
MULTIPOLYGON (((-58.449044406334956 -34.567853794378578,-58.448642701000402 -34.568068194749131,-58.448133203499722 -34.568328568892397,-58.449215234749872 -34.569674526299963,-58.450059359212425 -34.569193539435595,-58.449044406334956 -34.567853794378578)));;1135;13_27_3;COMUNA 13;27;3;1043;417;626;66,61%;598;597;99,83%;1;0,17%;440;5;1,14%;435;98,86%
MULTIPOLYGON (((-58.449796606986418 -34.570424480725812,-58.448863148025787 -34.570966725827418,-58.449394997627763 -34.571574275896445,-58.45017501290971 -34.571212230164946,-58.450340791069543 -34.571126468720124,-58.450512954777416 -34.57103739768484,-58.451193863409706 -34.570644348222473,-58.450639885404804 -34.569935883854413,-58.450059359212425 -34.569193539435595,-58.449215234749872 -34.569674526299963,-58.449796606986418 -34.570424480725812)));;1136;13_27_4;COMUNA 13;27;4;852;381;471;80,89%;547;546;99,82%;1;0,18%;387;15;3,88%;372;96,12%
MULTIPOLYGON (((-58.449215234749872 -34.569674526299963,-58.448225670777219 -34.570238381036106,-58.448863148025787 -34.570966725827418,-58.449796606986418 -34.570424480725812,-58.449215234749872 -34.569674526299963)));;1137;13_27_5;COMUNA 13;27;5;616;262;354;74,01%;393;393;100,00%;0;0,00%;311;1;0,32%;310;99,68%
MULTIPOLYGON (((-58.448133203499722 -34.568328568892397,-58.447042166583536 -34.568886134131382,-58.448225670777219 -34.570238381036106,-58.449215234749872 -34.569674526299963,-58.448133203499722 -34.568328568892397)));;1138;13_27_6;COMUNA 13;27;6;1120;473;647;73,11%;714;713;99,86%;1;0,14%;529;53;10,02%;476;89,98%
MULTIPOLYGON (((-58.448199254898093 -34.571352369604547,-58.448640093987215 -34.571923220362279,-58.448781691921724 -34.571858938053595,-58.449394997627763 -34.571574275896445,-58.448863148025787 -34.570966725827418,-58.448225670777219 -34.570238381036106,-58.447042166583536 -34.568886134131382,-58.446691114214261 -34.56906560343517,-58.446496898846704 -34.569160934061657,-58.44664083200027 -34.569333707054071,-58.447610060220157 -34.570589166711436,-58.448199254898093 -34.571352369604547)));;1139;13_27_7;COMUNA 13;27;7;1058;466;592;78,72%;699;697;99,71%;2;0,29%;497;53;10,66%;444;89,34%
MULTIPOLYGON (((-58.447610060220157 -34.570589166711436,-58.44669761879836 -34.571109072927676,-58.447230438465766 -34.571915091768027,-58.447560093868994 -34.572413746039921,-58.448640093987215 -34.571923220362279,-58.448199254898093 -34.571352369604547,-58.447610060220157 -34.570589166711436)));;1140;13_27_8;COMUNA 13;27;8;814;371;443;83,75%;433;433;100,00%;0;0,00%;368;22;5,98%;346;94,02%
MULTIPOLYGON (((-58.446496898846704 -34.569160934061657,-58.445704962124658 -34.569549786901874,-58.44669761879836 -34.571109072927676,-58.447610060220157 -34.570589166711436,-58.44664083200027 -34.569333707054071,-58.446496898846704 -34.569160934061657)));;1141;13_27_9;COMUNA 13;27;9;868;371;497;74,65%;536;536;100,00%;0;0,00%;407;0;0,00%;407;100,00%
MULTIPOLYGON (((-58.447560093868994 -34.572413746039921,-58.447230438465766 -34.571915091768027,-58.44669761879836 -34.571109072927676,-58.445829613874125 -34.571603625224483,-58.446332369377345 -34.572432461639266,-58.44658864490453 -34.57285490818753,-58.447560093868994 -34.572413746039921)));;1142;13_28_1;COMUNA 13;28;1;527;239;288;82,99%;358;358;100,00%;0;0,00%;268;80;29,85%;188;70,15%
MULTIPOLYGON (((-58.441943894933857 -34.571445273090589,-58.441410678658428 -34.57173913755603,-58.440744536232636 -34.572106218419982,-58.441703052501055 -34.573074034126606,-58.442611393786216 -34.572474372595593,-58.442792259802211 -34.572355946446933,-58.441943894933857 -34.571445273090589)));;1143;13_28_10;COMUNA 13;28;10;624;280;344;81,40%;358;358;100,00%;0;0,00%;273;0;0,00%;273;100,00%
MULTIPOLYGON (((-58.445704962124658 -34.569549786901874,-58.444885685987551 -34.569952081877865,-58.44537376446295 -34.570847965463805,-58.445698543329499 -34.571387470983673,-58.445829613874125 -34.571603625224483,-58.44669761879836 -34.571109072927676,-58.445704962124658 -34.569549786901874)));;1144;13_28_2;COMUNA 13;28;2;441;193;248;77,82%;274;273;99,64%;1;0,37%;213;16;7,51%;197;92,49%
MULTIPOLYGON (((-58.444349359763862 -34.571316216219763,-58.444894316867675 -34.572198306651224,-58.445829613874125 -34.571603625224483,-58.445698543329499 -34.571387470983673,-58.44537376446295 -34.570847965463805,-58.444885685987551 -34.569952081877865,-58.444110593429428 -34.570332686986241,-58.443827563254402 -34.570471663644504,-58.444349359763862 -34.571316216219763)));;1145;13_28_3;COMUNA 13;28;3;667;303;364;83,24%;379;379;100,00%;0;0,00%;318;19;5,97%;299;94,03%
MULTIPOLYGON (((-58.445829613874125 -34.571603625224483,-58.444894316867675 -34.572198306651224,-58.445411624014852 -34.573035459112795,-58.446332369377345 -34.572432461639266,-58.445829613874125 -34.571603625224483)));;1146;13_28_4;COMUNA 13;28;4;389;170;219;77,63%;272;272;100,00%;0;0,00%;201;16;7,96%;185;92,04%
MULTIPOLYGON (((-58.443446500878551 -34.574834044422893,-58.443658273288627 -34.575047716632085,-58.443658201815232 -34.575047748671402,-58.443682802429656 -34.575072612716085,-58.443971711852299 -34.57536428946743,-58.444320762954206 -34.575140107667401,-58.445001656879136 -34.574710049190337,-58.44512223466738 -34.574633866193366,-58.446023071504747 -34.574056221537937,-58.446022424426651 -34.574055131446187,-58.447049210050572 -34.573614178478074,-58.447020855049914 -34.573567459701316,-58.446942719626016 -34.57343864132546,-58.446914631794279 -34.573392297689793,-58.44658864490453 -34.57285490818753,-58.446332369377345 -34.572432461639266,-58.445411624014852 -34.573035459112795,-58.443139123598641 -34.574523771106051,-58.443446500878551 -34.574834044422893)));;1147;13_28_5;COMUNA 13;28;5;548;226;322;70,19%;280;279;99,64%;1;0,36%;217;8;3,69%;209;96,31%
MULTIPOLYGON (((-58.445411624014852 -34.573035459112795,-58.444894316867675 -34.572198306651224,-58.443490917103325 -34.573105879215447,-58.442574573659741 -34.573698503356255,-58.442420443427608 -34.573798200407694,-58.443139123598641 -34.574523771106051,-58.445411624014852 -34.573035459112795)));;1148;13_28_6;COMUNA 13;28;6;823;374;449;83,30%;461;461;100,00%;0;0,00%;356;5;1,40%;351;98,60%
MULTIPOLYGON (((-58.442792259802211 -34.572355946446933,-58.442611393786216 -34.572474372595593,-58.441703052501055 -34.573074034126606,-58.442420443427608 -34.573798200407694,-58.442574573659741 -34.573698503356255,-58.443490917103325 -34.573105879215447,-58.442792259802211 -34.572355946446933)));;1149;13_28_7;COMUNA 13;28;7;693;307;386;79,53%;401;401;100,00%;0;0,00%;329;1;0,30%;328;99,70%
MULTIPOLYGON (((-58.444349359763862 -34.571316216219763,-58.443338431163482 -34.571998413327606,-58.442792259802211 -34.572355946446933,-58.443490917103325 -34.573105879215447,-58.444894316867675 -34.572198306651224,-58.444349359763862 -34.571316216219763)));;1150;13_28_8;COMUNA 13;28;8;936;379;557;68,04%;577;577;100,00%;0;0,00%;451;1;0,22%;450;99,78%
MULTIPOLYGON (((-58.442544117595652 -34.571127120542712,-58.442203434160035 -34.57130228262379,-58.441943894933857 -34.571445273090589,-58.442792259802211 -34.572355946446933,-58.443338431163482 -34.571998413327606,-58.444349359763862 -34.571316216219763,-58.443827563254402 -34.570471663644504,-58.443639727442935 -34.570563821537462,-58.442956239600207 -34.570915277359113,-58.442544117595652 -34.571127120542712)));;1151;13_28_9;COMUNA 13;28;9;770;341;429;79,49%;582;582;100,00%;0;0,00%;393;6;1,53%;387;98,47%
MULTIPOLYGON (((-58.447977166569345 -34.577406896340214,-58.447238558497943 -34.577721959099541,-58.447735912892213 -34.578564943746791,-58.447857468253666 -34.578754614410563,-58.447930418737492 -34.578868571686051,-58.44846926209631 -34.579662964627758,-58.449087710287849 -34.580574622383708,-58.449441674739774 -34.581096373129171,-58.44959546270691 -34.58103976767309,-58.44999900785924 -34.580879733274266,-58.450952471876256 -34.580501573632226,-58.45055500649287 -34.579866085766191,-58.449660206566477 -34.580298194529625,-58.449108855841274 -34.579351897789628,-58.448557517610233 -34.578405598415209,-58.448449328423635 -34.578219873826157,-58.447977166569345 -34.577406896340214)));;1152;13_29_1;COMUNA 13;29;1;698;303;395;76,71%;314;313;99,68%;1;0,32%;274;43;15,69%;231;84,31%
MULTIPOLYGON (((-58.446411390047423 -34.580671763392736,-58.445953669723401 -34.580905161838196,-58.445290005783754 -34.581381638012303,-58.445169585491449 -34.581473103434156,-58.445551763214461 -34.582169242823632,-58.445980896320322 -34.581860557222875,-58.446214200558359 -34.581891646579798,-58.446790584909685 -34.58141684428513,-58.446484850042786 -34.580791285175437,-58.446411390047423 -34.580671763392736)));;1153;13_29_10;COMUNA 13;29;10;786;384;402;95,52%;292;292;100,00%;0;0,00%;258;2;0,78%;256;99,22%
MULTIPOLYGON (((-58.442919182424717 -34.57604027880609,-58.442727919983071 -34.576163140176291,-58.441878201723561 -34.576771967534071,-58.441814161515566 -34.57681787402025,-58.440888554087408 -34.577796415247619,-58.439938890629726 -34.578546907105483,-58.440533150801613 -34.579099856483182,-58.44154326642262 -34.58003979322622,-58.442282522700147 -34.580727694179728,-58.442509392713866 -34.580938797011157,-58.443431697101069 -34.581797009777205,-58.443779686104435 -34.582251519596156,-58.444448595179608 -34.583170814225561,-58.445786009801267 -34.582595983240964,-58.445551763214461 -34.582169242823632,-58.445169585491449 -34.581473103434156,-58.445290005783754 -34.581381638012303,-58.445953669723401 -34.580905161838196,-58.446411390047423 -34.580671763392736,-58.44594671575161 -34.579915753581815,-58.4463861426742 -34.579586503615268,-58.445504880261076 -34.578692894634571,-58.445383146298028 -34.578569491980552,-58.444615984797188 -34.577747585721774,-58.444522938788545 -34.577664399394507,-58.444385626035064 -34.5775416272337,-58.443694151343735 -34.576833674841936,-58.442919182424717 -34.57604027880609)));;1154;13_29_11;COMUNA 13;29;11;790;392;398;98,49%;508;508;100,00%;0;0,00%;327;3;0,92%;324;99,08%
MULTIPOLYGON (((-58.449108855841274 -34.579351897789628,-58.449660206566477 -34.580298194529625,-58.45055500649287 -34.579866085766191,-58.450450299334584 -34.579698673963101,-58.449982445836611 -34.578926974191035,-58.449412538249689 -34.577983634546328,-58.448995205076336 -34.578187822316877,-58.448557517610233 -34.578405598415209,-58.449108855841274 -34.579351897789628)));;1155;13_29_2;COMUNA 13;29;2;634;301;333;90,39%;341;341;100,00%;0;0,00%;281;37;13,17%;244;86,83%
MULTIPOLYGON (((-58.448372219274169 -34.576041533683039,-58.447417853492581 -34.576443899712075,-58.447977166569345 -34.577406896340214,-58.448449328423635 -34.578219873826157,-58.448557517610233 -34.578405598415209,-58.448995205076336 -34.578187822316877,-58.449412538249689 -34.577983634546328,-58.448894075081554 -34.577015789851743,-58.448372219274169 -34.576041533683039)));;1156;13_29_3;COMUNA 13;29;3;542;249;293;84,98%;315;315;100,00%;0;0,00%;247;4;1,62%;243;98,38%
MULTIPOLYGON (((-58.446733774393017 -34.575265875004028,-58.445881248423277 -34.575632184484533,-58.446207450478809 -34.575974144867708,-58.44667048192737 -34.576759028412468,-58.447238558497943 -34.577721959099541,-58.447977166569345 -34.577406896340214,-58.447417853492581 -34.576443899712075,-58.448372219274169 -34.576041533683039,-58.447727981201766 -34.574838729352898,-58.446733774393017 -34.575265875004028)));;1157;13_29_4;COMUNA 13;29;4;844;396;448;88,39%;440;439;99,77%;1;0,23%;382;24;6,28%;358;93,72%
MULTIPOLYGON (((-58.446023071504747 -34.574056221537937,-58.44512223466738 -34.574633866193366,-58.445001656879136 -34.574710049190337,-58.445881248423277 -34.575632184484533,-58.446733774393017 -34.575265875004028,-58.447727981201766 -34.574838729352898,-58.44724487864606 -34.57393679979328,-58.447049709047363 -34.573615000643649,-58.447049210050572 -34.573614178478074,-58.446022424426651 -34.574055131446187,-58.446023071504747 -34.574056221537937)));;1158;13_29_5;COMUNA 13;29;5;575;257;318;80,82%;347;346;99,71%;1;0,29%;280;24;8,57%;256;91,43%
MULTIPOLYGON (((-58.445001656879136 -34.574710049190337,-58.444320762954206 -34.575140107667401,-58.443971711852299 -34.57536428946743,-58.442919182424717 -34.57604027880609,-58.443694151343735 -34.576833674841936,-58.44385007628695 -34.576722497152666,-58.44472795929088 -34.576127674886891,-58.445741389982601 -34.577150679924529,-58.44667048192737 -34.576759028412468,-58.446207450478809 -34.575974144867708,-58.445881248423277 -34.575632184484533,-58.445001656879136 -34.574710049190337)));;1159;13_29_6;COMUNA 13;29;6;763;338;425;79,53%;418;418;100,00%;0;0,00%;330;2;0,61%;328;99,39%
MULTIPOLYGON (((-58.447483251072171 -34.580144485452287,-58.448100330502385 -34.581051429462292,-58.448393424505994 -34.581482256656123,-58.448459589734576 -34.5814578971885,-58.449192003025637 -34.581188250968545,-58.449441674739774 -34.581096373129171,-58.449087710287849 -34.580574622383708,-58.44846926209631 -34.579662964627758,-58.447930418737492 -34.578868571686051,-58.447857468253666 -34.578754614410563,-58.447735912892213 -34.578564943746791,-58.447238558497943 -34.577721959099541,-58.44667048192737 -34.576759028412468,-58.445741389982601 -34.577150679924529,-58.446282041642782 -34.578112906931935,-58.446819120226003 -34.579124358337644,-58.446885002086191 -34.579240005522379,-58.446965694860694 -34.579381571153704,-58.447421024622464 -34.580052924574254,-58.447483251072171 -34.580144485452287)));;1160;13_29_7;COMUNA 13;29;7;888;399;489;81,60%;432;432;100,00%;0;0,00%;355;20;5,63%;335;94,37%
MULTIPOLYGON (((-58.446411390047423 -34.580671763392736,-58.446484850042786 -34.580791285175437,-58.446790584909685 -34.58141684428513,-58.447092494096132 -34.582034444001316,-58.448279657689767 -34.581524146409642,-58.448393424505994 -34.581482256656123,-58.448100330502385 -34.581051429462292,-58.447483251072171 -34.580144485452287,-58.447421024622464 -34.580052924574254,-58.446965694860694 -34.579381571153704,-58.446885002086191 -34.579240005522379,-58.446819120226003 -34.579124358337644,-58.446282041642782 -34.578112906931935,-58.445741389982601 -34.577150679924529,-58.44472795929088 -34.576127674886891,-58.44385007628695 -34.576722497152666,-58.443694151343735 -34.576833674841936,-58.444385626035064 -34.5775416272337,-58.444522938788545 -34.577664399394507,-58.444615984797188 -34.577747585721774,-58.445383146298028 -34.578569491980552,-58.445504880261076 -34.578692894634571,-58.4463861426742 -34.579586503615268,-58.44594671575161 -34.579915753581815,-58.446411390047423 -34.580671763392736)));;1161;13_29_8;COMUNA 13;29;8;1103;517;586;88,23%;501;501;100,00%;0;0,00%;420;6;1,43%;414;98,57%
MULTIPOLYGON (((-58.447092494096132 -34.582034444001316,-58.446790584909685 -34.58141684428513,-58.446214200558359 -34.581891646579798,-58.445980896320322 -34.581860557222875,-58.445551763214461 -34.582169242823632,-58.445786009801267 -34.582595983240964,-58.447092494096132 -34.582034444001316)));;1162;13_29_9;COMUNA 13;29;9;571;276;295;93,56%;227;227;100,00%;0;0,00%;208;1;0,48%;207;99,52%
MULTIPOLYGON (((-58.463254144613686 -34.5464761221332,-58.462372112880779 -34.54603708816078,-58.461786354634143 -34.546834869262099,-58.461217183015698 -34.547609900105037,-58.462156763029931 -34.548080211647459,-58.461610482302127 -34.548878696065259,-58.462027379594723 -34.549087159515636,-58.462160893059931 -34.549154027175739,-58.462323498804814 -34.549234139480369,-58.462394315620223 -34.549270761105603,-58.462798789761493 -34.549468869281576,-58.463366937978684 -34.548693408753081,-58.463425241727492 -34.548613404679138,-58.46390060382496 -34.547905410027369,-58.464457069290809 -34.547071209186093,-58.463939400178639 -34.54681507672646,-58.463724230524626 -34.546708665260468,-58.463254144613686 -34.5464761221332)));;1163;13_3_1;COMUNA 13;3;1;833;375;458;81,88%;494;494;100,00%;0;0,00%;377;0;0,00%;377;100,00%
MULTIPOLYGON (((-58.454022905703113 -34.549518633765949,-58.453393237153797 -34.550052767206004,-58.453006326426348 -34.550504025690991,-58.45427792004898 -34.551164854909146,-58.454362196698149 -34.55107119437902,-58.455246658395275 -34.5501564907781,-58.45615340307549 -34.549218682159129,-58.456019350094735 -34.549149587166369,-58.455040472238373 -34.548644153959415,-58.454689510149258 -34.548948159734415,-58.454407240461393 -34.549192659350311,-58.454157487045926 -34.54940455342846,-58.454022905703113 -34.549518633765949)));;1164;13_3_10;COMUNA 13;3;10;972;454;518;87,64%;641;641;100,00%;0;0,00%;448;2;0,45%;446;99,55%
MULTIPOLYGON (((-58.463180970213941 -34.541584155067412,-58.463182070838769 -34.541582788933177,-58.463363769278338 -34.541369319400097,-58.463364436037374 -34.541368346926902,-58.463824073494038 -34.540697955864474,-58.464329512994752 -34.539880234746164,-58.464835283024456 -34.539062088864995,-58.465133055498015 -34.538580299423863,-58.465308874957323 -34.538295774969505,-58.465807902950736 -34.537488048033687,-58.466303006802661 -34.536686586978959,-58.46659795416565 -34.536209301124373,-58.466759891854529 -34.535924422783125,-58.466806949734043 -34.535841600261655,-58.466807124127889 -34.535841499867836,-58.467152287131547 -34.535256831378028,-58.467387044116002 -34.534847341111117,-58.46608410209717 -34.534271810261593,-58.463795635148315 -34.533260903939137,-58.46164824594053 -34.530800007881908,-58.458898456206803 -34.527620146516469,-58.458840166327676 -34.527622891305093,-58.458763326127801 -34.527619437975076,-58.458732096602915 -34.527615915660952,-58.458672955335302 -34.527627815731414,-58.458559692565416 -34.527667039266191,-58.458503784216887 -34.527691193500516,-58.45844404635578 -34.527719713992127,-58.458389074233885 -34.527738938381425,-58.45834193145668 -34.527745486332925,-58.458291130343873 -34.527737948920205,-58.458245776365928 -34.527710340255041,-58.458180765966468 -34.527675336109731,-58.458153451113667 -34.527665968428572,-58.458100013582786 -34.527632091487419,-58.458028876359172 -34.52759962236852,-58.457963014095164 -34.527583985243936,-58.457884131825232 -34.527578348073348,-58.457808398321177 -34.527568274135419,-58.457767553022435 -34.527567427379886,-58.457697860794525 -34.527564959633025,-58.457641528466453 -34.527561436009371,-58.457560943074 -34.527576574250773,-58.457467764190547 -34.527583331197597,-58.457368202935371 -34.527594313359188,-58.457292298334039 -34.527599028568893,-58.457236135499215 -34.527606068676533,-58.4571726558382 -34.52759324827521,-58.457112664859039 -34.527583597173759,-58.45702212457801 -34.52757978999049,-58.456939158611462 -34.527562954274217,-58.456868360370265 -34.527557809811121,-58.456803263828967 -34.527547524479111,-58.45674863312378 -34.527548437368331,-58.45668166349823 -34.527552448372909,-58.456596483198851 -34.527562655926445,-58.456530107953846 -34.527583780413124,-58.456479135316407 -34.527597722189803,-58.456435906463675 -34.527608988151862,-58.456364851187068 -34.52762687270917,-58.456309623687652 -34.527641870585299,-58.456247844044348 -34.527654825734416,-58.456188531724528 -34.527672922087,-58.456144280549438 -34.527698343531405,-58.456092031136059 -34.527715102120538,-58.456054416162068 -34.52775474995719,-58.455998076937647 -34.527836581971464,-58.455972971257211 -34.527870525956445,-58.455957141663504 -34.527894892503255,-58.455939184075099 -34.527926864945492,-58.455929821835937 -34.527949189490386,-58.455924118654785 -34.527971725515748,-58.455915180081973 -34.528016234293965,-58.455904456381511 -34.528037643222099,-58.455889136159371 -34.528076095001005,-58.455884453800437 -34.528102293236394,-58.45588121818637 -34.528126871752768,-58.455879938597228 -34.528165676443358,-58.455880532109987 -34.528192086250868,-58.45588452883193 -34.528225820558951,-58.455888781169463 -34.52825554059531,-58.455905029279734 -34.528317938992835,-58.455922555561131 -34.528359139213592,-58.455936933640302 -34.528396536249915,-58.455943057915064 -34.528428580447226,-58.455958880696123 -34.528490063273509,-58.455973769324444 -34.528528235019522,-58.455976320484289 -34.528549433404329,-58.455970872606507 -34.528571406035212,-58.455949595635325 -34.528609787063942,-58.455914362079284 -34.528659153779458,-58.455891725071623 -34.528678590112087,-58.455871556395699 -34.528691054398628,-58.455834792586231 -34.528721546821224,-58.455817346854133 -34.528735208494744,-58.455787221400747 -34.528754433107373,-58.455768584670224 -34.528763798716895,-58.455743821109429 -34.528772389288122,-58.455715738904971 -34.528779852847656,-58.45568416645402 -34.528803021211196,-58.455663827703397 -34.528813372671685,-58.455639829871942 -34.528823230934904,-58.455611492329979 -34.528830976159881,-58.45558034645461 -34.528840693144211,-58.455537030759871 -34.528863438228029,-58.455509884118342 -34.52887604289716,-58.455465121945885 -34.528896604662407,-58.45543235904298 -34.528908223016629,-58.455411850393631 -34.52891456013964,-58.455390065063405 -34.528923643798997,-58.455355940611817 -34.528935191625116,-58.455332538417494 -34.528944627307233,-58.455307349359906 -34.528952302225306,-58.455275607807785 -34.528961173982992,-58.455198252338462 -34.528998002083391,-58.455176807499079 -34.529005395500164,-58.455148895014439 -34.529016661946528,-58.455122769193004 -34.529031731504325,-58.455099111401495 -34.529043984167906,-58.455055369804064 -34.529068771409221,-58.455030094948405 -34.529083418443989,-58.454990437355249 -34.529114332984989,-58.454960481598057 -34.52913538848059,-58.45493920600606 -34.52915235980953,-58.454910270273935 -34.529185246934475,-58.454885590221451 -34.529208556381519,-58.454866867177131 -34.529228767459358,-58.454848229153839 -34.52924968280027,-58.45482295355076 -34.529271301970859,-58.45480840083026 -34.529284752407406,-58.45476389159785 -34.52932594876382,-58.454635129381693 -34.529445946320202,-58.454581087859118 -34.529500734206692,-58.454512068172484 -34.529566859659425,-58.454458280982998 -34.529629746503069,-58.454402963565762 -34.529676576079588,-58.454333944959629 -34.529729038776701,-58.454288841265502 -34.529753473517118,-58.454233865170465 -34.529789316576363,-58.454174804548387 -34.529823539526561,-58.454099064310562 -34.529863536210271,-58.454056767448392 -34.529899802637637,-58.454031404435405 -34.529939873259636,-58.454021187716144 -34.529988959486928,-58.453989102225101 -34.53002684641433,-58.453971397358302 -34.530071847391973,-58.453938375376403 -34.530113255540712,-58.453904930142095 -34.530133113280819,-58.453917266831027 -34.530155861780223,-58.453915985648869 -34.530200863928819,-58.453884578817409 -34.530257625055206,-58.453857002831739 -34.530300089964229,-58.45382525551878 -34.530356991901876,-58.453804146554674 -34.530402415161667,-58.453781590491289 -34.530451782169962,-58.453743884158165 -34.530528191662249,-58.453720735706611 -34.530546219028224,-58.453693326264762 -34.530620939035401,-58.453667450919603 -34.530673545373702,-58.453630342471499 -34.530727770671213,-58.453602936489105 -34.530769390419785,-58.453594507834993 -34.530805940903754,-58.453575271030019 -34.530849110627081,-58.453562587232483 -34.530887773571379,-58.453564879244674 -34.530939325599213,-58.453565724302159 -34.530993553707617,-58.453570987901422 -34.531107855550673,-58.45357455662721 -34.531157294890981,-58.453571827938411 -34.531208142280896,-58.453570035518979 -34.531257229089569,-58.453564158833935 -34.531302160456676,-58.453570364966303 -34.531357515779177,-58.453583806250371 -34.531396532802688,-58.453599801165829 -34.531429422950374,-58.453628645262789 -34.531468722819334,-58.453653660274981 -34.531505064504522,-58.453694164171665 -34.531532744926288,-58.453749302179759 -34.531587188297635,-58.453773127349955 -34.531609937647602,-58.453846730061834 -34.531681425420444,-58.453900081357219 -34.531734319220341,-58.453941774321699 -34.531785944492597,-58.45397529964341 -34.531820385217422,-58.45403494784032 -34.531878913488654,-58.454082599726888 -34.531912650924731,-58.454140802636381 -34.531958924913731,-58.454181051588428 -34.531986886858192,-58.454211088944824 -34.532012312743205,-58.454257377247238 -34.532067318673647,-58.454308006039518 -34.532118592305387,-58.454371825375333 -34.532168739999562,-58.454446029003527 -34.53219747885263,-58.454504914555088 -34.532228963248308,-58.454575967387299 -34.53228059026646,-58.454626768870966 -34.53230939787629,-58.454678166719802 -34.532331585458422,-58.454728967289789 -34.532370675223881,-58.4547807892001 -34.532408708643942,-58.454874394000029 -34.532457238202525,-58.454957617571594 -34.532497104631481,-58.45504858312804 -34.532560493777574,-58.455118615471541 -34.532611134449141,-58.455186434435731 -34.532671493733794,-58.455269910690511 -34.532744882746037,-58.455332368597119 -34.532805100770062,-58.455389806501827 -34.532856163079764,-58.455469115804227 -34.532899691075784,-58.455522471084201 -34.532927160367137,-58.45561062889648 -34.532994563207708,-58.455655133151403 -34.533030694325696,-58.455694190945962 -34.533067951931095,-58.455707804761275 -34.53309422161243,-58.455719375053661 -34.533134012968844,-58.455745833736835 -34.533223737211607,-58.45574778710256 -34.533271134025192,-58.455741229758267 -34.533326699770427,-58.455712375561696 -34.533388743433548,-58.455669481693953 -34.533427616126417,-58.455627011305573 -34.533489940687765,-58.455583520941417 -34.53353705315763,-58.455509816832055 -34.533618883855745,-58.455425474217414 -34.533709587551222,-58.455340536928695 -34.533786487655242,-58.455247089665647 -34.533860358862192,-58.45517508871653 -34.533922681456261,-58.455131257838474 -34.533965709032813,-58.455091425856381 -34.534017610518205,-58.455066146509701 -34.534065146488885,-58.455037633136364 -34.534114372475003,-58.455019841211296 -34.534177402623939,-58.455007666266646 -34.534236911823811,-58.455008766871003 -34.534299027620456,-58.455014972796612 -34.534369454005052,-58.45502637052946 -34.534433260671527,-58.455060573719301 -34.534516435912735,-58.455090355428055 -34.534558552515016,-58.455114860974355 -34.534599471540318,-58.455122600501042 -34.534651587253776,-58.455115448127906 -34.534693842403819,-58.455092125348216 -34.534747787261082,-58.45507186732214 -34.534789478182866,-58.45504131151818 -34.534835886996873,-58.454976966447646 -34.534923140743473,-58.454928282074306 -34.534988281692819,-58.454915852151359 -34.535042297632494,-58.45490912431778 -34.535093496894923,-58.454924862529225 -34.535154627652702,-58.454909878928063 -34.535214911340248,-58.45494068286694 -34.535248083939521,-58.455004932237379 -34.535279145863313,-58.455055141479832 -34.535291473563653,-58.455085097424039 -34.535292320546937,-58.45536047606717 -34.535434879594789,-58.455562415402383 -34.535538558607506,-58.455578157719316 -34.535558067522985,-58.455596027651062 -34.535577083578303,-58.455668872276014 -34.535615399526691,-58.455753546483059 -34.53565082863971,-58.455808690577136 -34.535680621952778,-58.4558561748225 -34.535718232095356,-58.455882725887008 -34.535730487700533,-58.455936254282449 -34.535745984391966,-58.455985866956361 -34.535774087094644,-58.456022885149892 -34.535793315415994,-58.456171893995467 -34.535873186529592,-58.456465743161161 -34.536023913470842,-58.456503527404351 -34.536044479778333,-58.456586329517847 -34.536088288907372,-58.45672240447179 -34.536157876505285,-58.456919752046524 -34.536255989384891,-58.456998810390147 -34.536294656959619,-58.457091570056463 -34.53633924089447,-58.457144758015716 -34.536364314971067,-58.457194967534441 -34.536387135259126,-58.457228752672677 -34.536401362823383,-58.457252921423063 -34.536411082687643,-58.457297259135693 -34.536429606687271,-58.457383040911843 -34.536469612402861,-58.457459461743341 -34.536503772301174,-58.457525585428286 -34.536532649767956,-58.457595794038376 -34.536563076740926,-58.457707957693223 -34.536612097851076,-58.457777060303727 -34.536638862523915,-58.457810079713347 -34.536653019469945,-58.457833312422025 -34.536663443441128,-58.457863183081592 -34.536676403005785,-58.457912456987458 -34.536696687625849,-58.45793313637499 -34.53671119618393,-58.457959858294679 -34.536722958360457,-58.457994835306515 -34.536734439145583,-58.458018238229059 -34.536745567347673,-58.458070490531675 -34.536771556521138,-58.458232864568267 -34.53684811559301,-58.45828894675342 -34.536872696293322,-58.458318476961722 -34.536889106606125,-58.458364346531596 -34.536917349054967,-58.458394898069272 -34.536932773421938,-58.45844178945724 -34.536950804112735,-58.458485446808943 -34.536970877026853,-58.458562719499042 -34.537006867336459,-58.458603823824028 -34.537026165435961,-58.458657012809773 -34.537048421812692,-58.458680926499241 -34.537060254163755,-58.458747562353288 -34.537074693660891,-58.458774964751917 -34.537098921075703,-58.458666184395568 -34.537159652575738,-58.45887722949476 -34.537331742756201,-58.459446457365139 -34.537795896594524,-58.459442664832935 -34.537798763456507,-58.458284174955189 -34.538597639032311,-58.457494283656708 -34.539004317733571,-58.454747017784882 -34.540325923620614,-58.453215200830599 -34.540792738115655,-58.453060214344006 -34.54083561536423,-58.452972465351422 -34.540858567255391,-58.452853225364208 -34.540889826806541,-58.452638660191539 -34.540954882864803,-58.452581380346587 -34.540972202907668,-58.452343748384713 -34.541053806623651,-58.452087475065014 -34.541152592180786,-58.451925930788001 -34.541220327764826,-58.451706508411874 -34.541319256617214,-58.451704125466392 -34.541319389307276,-58.450005390894724 -34.542239346960677,-58.449269631769504 -34.542651774511455,-58.449407587419444 -34.542758616684495,-58.450003212354915 -34.543591442806068,-58.450369272397801 -34.544064802462479,-58.450447922744132 -34.544164457141576,-58.450513950937285 -34.544244020436835,-58.450748565489071 -34.544527924380589,-58.450749608309096 -34.544529281190542,-58.45091528282866 -34.544744839121741,-58.452040202533453 -34.546119091993866,-58.452124018284813 -34.546284318341883,-58.452174988649318 -34.546384679589501,-58.452847198493956 -34.547255833013899,-58.453663417440239 -34.548313480964275,-58.453818641312694 -34.548567236622297,-58.453958126055618 -34.54875972047725,-58.454121185299549 -34.54898474255652,-58.454161083140811 -34.549197079211055,-58.454157487045926 -34.54940455342846,-58.454407240461393 -34.549192659350311,-58.454689510149258 -34.548948159734415,-58.455040472238373 -34.548644153959415,-58.455739920238763 -34.548038251971114,-58.456301207803939 -34.547551921833374,-58.456513497758991 -34.547367980472998,-58.456594192755489 -34.547281290320704,-58.457293615240658 -34.546719465877473,-58.458043502826598 -34.546117074016564,-58.458116618446688 -34.546057778210113,-58.458924288086749 -34.545402000223064,-58.4598965132801 -34.545888387428185,-58.460708482763103 -34.546294478870102,-58.460851046347663 -34.546366033781361,-58.461786354634143 -34.546834869262099,-58.462372112880779 -34.54603708816078,-58.461427277628353 -34.54556649635996,-58.460477346339552 -34.545093432214095,-58.459795439529977 -34.544718752258532,-58.460622235884472 -34.543950915770516,-58.461294283993617 -34.543326740722129,-58.46198317395762 -34.542686997887799,-58.462602008424611 -34.542112324599884,-58.463180970213941 -34.541584155067412)));;1165;13_3_2;COMUNA 13;3;2;654;312;342;91,23%;378;377;99,74%;1;0,27%;270;3;1,11%;267;98,89%
MULTIPOLYGON (((-58.460851046347663 -34.546366033781361,-58.460708482763103 -34.546294478870102,-58.4598965132801 -34.545888387428185,-58.459329288149576 -34.546664818152976,-58.458984300486648 -34.547137013460166,-58.458764945715899 -34.547455401830995,-58.459708936118275 -34.547927633860155,-58.46064144671378 -34.548394013018104,-58.461217183015698 -34.547609900105037,-58.461786354634143 -34.546834869262099,-58.460851046347663 -34.546366033781361)));;1166;13_3_3;COMUNA 13;3;3;781;363;418;86,84%;462;462;100,00%;0;0,00%;353;1;0,28%;352;99,72%
MULTIPOLYGON (((-58.456200725960159 -34.549243052021602,-58.456346865338276 -34.549318204064271,-58.457121995789123 -34.549715725255602,-58.457292073478278 -34.549501004588599,-58.457654275130231 -34.549009307005413,-58.457798473616258 -34.548813529083347,-58.458226894151039 -34.548230137951357,-58.458294565826833 -34.548138093846347,-58.458764945715899 -34.547455401830995,-58.458984300486648 -34.547137013460166,-58.459329288149576 -34.546664818152976,-58.4598965132801 -34.545888387428185,-58.458924288086749 -34.545402000223064,-58.458116618446688 -34.546057778210113,-58.458043502826598 -34.546117074016564,-58.457293615240658 -34.546719465877473,-58.456594192755489 -34.547281290320704,-58.456513497758991 -34.547367980472998,-58.456301207803939 -34.547551921833374,-58.455739920238763 -34.548038251971114,-58.455040472238373 -34.548644153959415,-58.456019350094735 -34.549149587166369,-58.45615340307549 -34.549218682159129,-58.456200725960159 -34.549243052021602)));;1167;13_3_4;COMUNA 13;3;4;1069;509;560;90,89%;754;754;100,00%;0;0,00%;433;3;0,69%;430;99,31%
MULTIPOLYGON (((-58.46064144671378 -34.548394013018104,-58.459708936118275 -34.547927633860155,-58.458764945715899 -34.547455401830995,-58.458294565826833 -34.548138093846347,-58.458226894151039 -34.548230137951357,-58.459148249775083 -34.54869378147302,-58.460077871787149 -34.549161502883102,-58.45976309589738 -34.549595600474888,-58.460996937804204 -34.550213258310393,-58.461078139292219 -34.550245655288883,-58.461438958633536 -34.54984641561591,-58.462027379594723 -34.549087159515636,-58.461610482302127 -34.548878696065259,-58.462156763029931 -34.548080211647459,-58.461217183015698 -34.547609900105037,-58.46064144671378 -34.548394013018104)));;1168;13_3_5;COMUNA 13;3;5;798;392;406;96,55%;446;446;100,00%;0;0,00%;312;1;0,32%;311;99,68%
MULTIPOLYGON (((-58.460111428158712 -34.551248431653732,-58.460399890957056 -34.551395909049546,-58.4604616862947 -34.551427953935622,-58.460538975854469 -34.551361191672314,-58.460658485538566 -34.551236680917633,-58.461031823299706 -34.55084906297899,-58.461124263479114 -34.550751101913512,-58.46120665932883 -34.550663915802303,-58.46167507012774 -34.55013002257683,-58.461773211813416 -34.550014595454577,-58.461862926525527 -34.549909098233591,-58.462086190930357 -34.549642819550215,-58.462394315620223 -34.549270761105603,-58.462323498804814 -34.549234139480369,-58.462160893059931 -34.549154027175739,-58.462027379594723 -34.549087159515636,-58.461438958633536 -34.54984641561591,-58.461078139292219 -34.550245655288883,-58.460996937804204 -34.550213258310393,-58.45976309589738 -34.549595600474888,-58.460077871787149 -34.549161502883102,-58.459148249775083 -34.54869378147302,-58.458226894151039 -34.548230137951357,-58.457798473616258 -34.548813529083347,-58.457654275130231 -34.549009307005413,-58.457292073478278 -34.549501004588599,-58.457121995789123 -34.549715725255602,-58.458051532219358 -34.550192265237129,-58.458973674150208 -34.550665065312387,-58.460111428158712 -34.551248431653732)));;1169;13_3_6;COMUNA 13;3;6;651;294;357;82,35%;382;382;100,00%;0;0,00%;271;0;0,00%;271;100,00%
MULTIPOLYGON (((-58.458973674150208 -34.550665065312387,-58.458051532219358 -34.550192265237129,-58.457295962541856 -34.55122453558441,-58.458212238119138 -34.551702059598917,-58.457829783331682 -34.552222818231442,-58.457405495408509 -34.552800528710705,-58.457592753828251 -34.552897512986661,-58.458117164830732 -34.553169166022649,-58.458159301935389 -34.553124235951309,-58.458178965487832 -34.553110926209108,-58.458150365813879 -34.553096135733519,-58.458685974608933 -34.552654307884616,-58.458769045308294 -34.552585781588668,-58.458925416010331 -34.552466766947802,-58.45901666843325 -34.552376483877971,-58.459131073512076 -34.552278877135713,-58.459200278360029 -34.552216974871904,-58.459148526811852 -34.552190000300854,-58.460111428158712 -34.551248431653732,-58.458973674150208 -34.550665065312387)));;1170;13_3_7;COMUNA 13;3;7;663;301;362;83,15%;357;357;100,00%;0;0,00%;290;14;4,83%;276;95,17%
MULTIPOLYGON (((-58.457295962541856 -34.55122453558441,-58.456363014955663 -34.550738270993165,-58.455457948829917 -34.551787917193238,-58.455741808637498 -34.551937799784291,-58.456489893153389 -34.552325745367675,-58.457277734347493 -34.552734322869419,-58.457405495408509 -34.552800528710705,-58.457829783331682 -34.552222818231442,-58.458212238119138 -34.551702059598917,-58.457295962541856 -34.55122453558441)));;1171;13_3_8;COMUNA 13;3;8;625;278;347;80,12%;361;361;100,00%;0;0,00%;278;3;1,08%;275;98,92%
MULTIPOLYGON (((-58.456200725960159 -34.549243052021602,-58.45615340307549 -34.549218682159129,-58.455246658395275 -34.5501564907781,-58.454362196698149 -34.55107119437902,-58.45427792004898 -34.551164854909146,-58.455457948829917 -34.551787917193238,-58.456363014955663 -34.550738270993165,-58.457295962541856 -34.55122453558441,-58.458051532219358 -34.550192265237129,-58.457121995789123 -34.549715725255602,-58.456346865338276 -34.549318204064271,-58.456200725960159 -34.549243052021602)));;1172;13_3_9;COMUNA 13;3;9;950;461;489;94,27%;416;416;100,00%;0;0,00%;354;15;4,24%;339;95,76%
MULTIPOLYGON (((-58.467061976186727 -34.548377191111229,-58.466122109937778 -34.547907973732343,-58.46552990591303 -34.548716336601572,-58.466470714164139 -34.549184572485792,-58.467559725858244 -34.549726601532214,-58.468189284851512 -34.548939988859246,-58.467061976186727 -34.548377191111229)));;1173;13_4_1;COMUNA 13;4;1;610;271;339;79,94%;424;424;100,00%;0;0,00%;291;2;0,69%;289;99,31%
MULTIPOLYGON (((-58.463636038420695 -34.553055299533824,-58.463475670792597 -34.552973113774414,-58.462679199572129 -34.554029854958408,-58.463310887957356 -34.554359023456982,-58.463542335199804 -34.554479943113421,-58.464519598296633 -34.553512282419689,-58.464279980614052 -34.553385378511742,-58.463636038420695 -34.553055299533824)));;1174;13_4_10;COMUNA 13;4;10;440;186;254;73,23%;316;315;99,68%;1;0,32%;237;1;0,42%;236;99,58%
MULTIPOLYGON (((-58.461763655364436 -34.552095396101436,-58.461245537958931 -34.551829815372322,-58.460377635109907 -34.552830481947758,-58.461313097885451 -34.553317983391139,-58.461924601925574 -34.55363666542943,-58.462257594394067 -34.553810196188138,-58.462679199572129 -34.554029854958408,-58.463475670792597 -34.552973113774414,-58.46270158647522 -34.55257626696082,-58.461763655364436 -34.552095396101436)));;1175;13_4_11;COMUNA 13;4;11;824;378;446;84,75%;398;398;100,00%;0;0,00%;370;58;15,68%;312;84,32%
MULTIPOLYGON (((-58.461313097885451 -34.553317983391139,-58.460377635109907 -34.552830481947758,-58.461245537958931 -34.551829815372322,-58.4604616862947 -34.551427953935622,-58.460399890957056 -34.551395909049546,-58.460111428158712 -34.551248431653732,-58.459148526811852 -34.552190000300854,-58.459200278360029 -34.552216974871904,-58.459131073512076 -34.552278877135713,-58.45901666843325 -34.552376483877971,-58.458925416010331 -34.552466766947802,-58.458769045308294 -34.552585781588668,-58.458685974608933 -34.552654307884616,-58.458150365813879 -34.553096135733519,-58.458178965487832 -34.553110926209108,-58.458159301935389 -34.553124235951309,-58.458117164830732 -34.553169166022649,-58.458261962456056 -34.553244582182195,-58.458262121111474 -34.553244245254866,-58.458533989312578 -34.553385176809506,-58.458754702028592 -34.553499485171237,-58.459472171307333 -34.553875650287956,-58.460409683310878 -34.554367172892221,-58.461313097885451 -34.553317983391139)));;1176;13_4_12;COMUNA 13;4;12;1400;632;768;82,29%;793;793;100,00%;0;0,00%;613;15;2,45%;598;97,55%
MULTIPOLYGON (((-58.461924601925574 -34.55363666542943,-58.461313097885451 -34.553317983391139,-58.460409683310878 -34.554367172892221,-58.461353845822138 -34.554862139194022,-58.462257594394067 -34.553810196188138,-58.461924601925574 -34.55363666542943)));;1177;13_4_13;COMUNA 13;4;13;707;305;402;75,87%;433;433;100,00%;0;0,00%;337;22;6,53%;315;93,47%
MULTIPOLYGON (((-58.462679199572129 -34.554029854958408,-58.462257594394067 -34.553810196188138,-58.461353845822138 -34.554862139194022,-58.462533043214712 -34.555480273340216,-58.463542335199804 -34.554479943113421,-58.463310887957356 -34.554359023456982,-58.462679199572129 -34.554029854958408)));;1178;13_4_14;COMUNA 13;4;14;758;319;439;72,67%;427;425;99,53%;2;0,47%;327;5;1,53%;322;98,47%
MULTIPOLYGON (((-58.465186765146399 -34.547432974071654,-58.464457069290809 -34.547071209186093,-58.46390060382496 -34.547905410027369,-58.463425241727492 -34.548613404679138,-58.463366937978684 -34.548693408753081,-58.464021059420062 -34.54902074266974,-58.464588597501674 -34.548247811736687,-58.46552990591303 -34.548716336601572,-58.466122109937778 -34.547907973732343,-58.465186765146399 -34.547432974071654)));;1179;13_4_2;COMUNA 13;4;2;777;344;433;79,45%;438;438;100,00%;0;0,00%;350;4;1,14%;346;98,86%
MULTIPOLYGON (((-58.467559725858244 -34.549726601532214,-58.466470714164139 -34.549184572485792,-58.46552990591303 -34.548716336601572,-58.464588597501674 -34.548247811736687,-58.464021059420062 -34.54902074266974,-58.464961862714901 -34.549491525485912,-58.465901570063238 -34.549961808064708,-58.466950922427216 -34.550486870885479,-58.467020884760032 -34.550399822130892,-58.467313414168196 -34.550034371896821,-58.467559725858244 -34.549726601532214)));;1180;13_4_3;COMUNA 13;4;3;679;341;338;100,89%;381;380;99,74%;1;0,26%;304;40;13,16%;264;86,84%
MULTIPOLYGON (((-58.466950922427216 -34.550486870885479,-58.465901570063238 -34.549961808064708,-58.464961862714901 -34.549491525485912,-58.464021059420062 -34.54902074266974,-58.463366937978684 -34.548693408753081,-58.462798789761493 -34.549468869281576,-58.463449935970033 -34.549798671122055,-58.464391681103237 -34.550269739968812,-58.465331819576562 -34.550739815588933,-58.466341767352482 -34.5512449539196,-58.46667737001038 -34.550827248021371,-58.466950922427216 -34.550486870885479)));;1181;13_4_4;COMUNA 13;4;4;995;446;549;81,24%;548;548;100,00%;0;0,00%;430;7;1,63%;423;98,37%
MULTIPOLYGON (((-58.466341767352482 -34.5512449539196,-58.465331819576562 -34.550739815588933,-58.464763505454009 -34.551515777983262,-58.464199096188388 -34.552286455651974,-58.465132872041394 -34.552749208444759,-58.465733026802241 -34.55200239997842,-58.466034419437548 -34.551627304349857,-58.466341767352482 -34.5512449539196)));;1182;13_4_5;COMUNA 13;4;5;758;336;422;79,62%;476;476;100,00%;0;0,00%;363;1;0,28%;362;99,72%
MULTIPOLYGON (((-58.465331819576562 -34.550739815588933,-58.464391681103237 -34.550269739968812,-58.463449935970033 -34.549798671122055,-58.462798789761493 -34.549468869281576,-58.462394315620223 -34.549270761105603,-58.462086190930357 -34.549642819550215,-58.461862926525527 -34.549909098233591,-58.461773211813416 -34.550014595454577,-58.461973236641249 -34.550115235295102,-58.462882461948212 -34.550571596566201,-58.463824127495201 -34.551044289524185,-58.464763505454009 -34.551515777983262,-58.465331819576562 -34.550739815588933)));;1183;13_4_6;COMUNA 13;4;6;879;382;497;76,86%;517;517;100,00%;0;0,00%;400;3;0,75%;397;99,25%
MULTIPOLYGON (((-58.463824127495201 -34.551044289524185,-58.462882461948212 -34.550571596566201,-58.462312168498052 -34.551348251833417,-58.462745082213956 -34.551565868152174,-58.463256308014117 -34.551819258899144,-58.464199096188388 -34.552286455651974,-58.464763505454009 -34.551515777983262,-58.463824127495201 -34.551044289524185)));;1184;13_4_7;COMUNA 13;4;7;730;351;379;92,61%;351;349;99,43%;2;0,57%;296;0;0,00%;296;100,00%
MULTIPOLYGON (((-58.461124263479114 -34.550751101913512,-58.461031823299706 -34.55084906297899,-58.460658485538566 -34.551236680917633,-58.460538975854469 -34.551361191672314,-58.4604616862947 -34.551427953935622,-58.461245537958931 -34.551829815372322,-58.461763655364436 -34.552095396101436,-58.46270158647522 -34.55257626696082,-58.463256308014117 -34.551819258899144,-58.462745082213956 -34.551565868152174,-58.462312168498052 -34.551348251833417,-58.462882461948212 -34.550571596566201,-58.461973236641249 -34.550115235295102,-58.461773211813416 -34.550014595454577,-58.46167507012774 -34.55013002257683,-58.46120665932883 -34.550663915802303,-58.461124263479114 -34.550751101913512)));;1185;13_4_8;COMUNA 13;4;8;624;280;344;81,40%;359;359;100,00%;0;0,00%;265;1;0,38%;264;99,62%
MULTIPOLYGON (((-58.465132872041394 -34.552749208444759,-58.464199096188388 -34.552286455651974,-58.463256308014117 -34.551819258899144,-58.46270158647522 -34.55257626696082,-58.463475670792597 -34.552973113774414,-58.463636038420695 -34.553055299533824,-58.464279980614052 -34.553385378511742,-58.464519598296633 -34.553512282419689,-58.465132872041394 -34.552749208444759)));;1186;13_4_9;COMUNA 13;4;9;714;331;383;86,42%;449;449;100,00%;0;0,00%;341;1;0,29%;340;99,71%
MULTIPOLYGON (((-58.472725536914766 -34.553054609816634,-58.472582641888714 -34.553241954031911,-58.472124591513406 -34.553851454878568,-58.472030631627092 -34.553976397407183,-58.471588147662047 -34.554558992337647,-58.472449464916309 -34.555016623597403,-58.472743006622416 -34.554637990934125,-58.472983692928523 -34.554322745192174,-58.473586166729007 -34.553533783514055,-58.474435942685624 -34.552420907066463,-58.473572851241194 -34.551943570560532,-58.472725536914766 -34.553054609816634)));;1187;13_5_1;COMUNA 13;5;1;744;360;384;93,75%;410;410;100,00%;0;0,00%;344;26;7,56%;318;92,44%
MULTIPOLYGON (((-58.471863552352936 -34.550998033219024,-58.471007640578918 -34.550524621772453,-58.470167200594709 -34.551629234319833,-58.470618440113668 -34.551881400653805,-58.471016905265962 -34.552103285826632,-58.471872237729833 -34.552579514159291,-58.472725536914766 -34.553054609816634,-58.473572851241194 -34.551943570560532,-58.472703555560251 -34.551462707133929,-58.471863552352936 -34.550998033219024)));;1188;13_5_2;COMUNA 13;5;2;1196;496;700;70,86%;501;495;98,80%;6;1,21%;403;2;0,50%;401;99,50%
MULTIPOLYGON (((-58.470157356515053 -34.550054232254965,-58.469302655753367 -34.549581442540521,-58.468372974881333 -34.549075761453061,-58.468189284851512 -34.548939988859246,-58.467559725858244 -34.549726601532214,-58.467313414168196 -34.550034371896821,-58.468461521083555 -34.550676043092345,-58.469316994766551 -34.551154120502517,-58.470167200594709 -34.551629234319833,-58.471007640578918 -34.550524621772453,-58.470157356515053 -34.550054232254965)));;1189;13_5_3;COMUNA 13;5;3;1189;539;650;82,92%;745;744;99,87%;1;0,13%;530;4;0,75%;526;99,25%
MULTIPOLYGON (((-58.470167200594709 -34.551629234319833,-58.469316994766551 -34.551154120502517,-58.468461521083555 -34.550676043092345,-58.467313414168196 -34.550034371896821,-58.467020884760032 -34.550399822130892,-58.466950922427216 -34.550486870885479,-58.46667737001038 -34.550827248021371,-58.467847954953513 -34.551479558463441,-58.468703943987116 -34.551956513271229,-58.469541811451144 -34.5524233921697,-58.470077410499599 -34.551747202982334,-58.470167200594709 -34.551629234319833)));;1190;13_5_4;COMUNA 13;5;4;1008;441;567;77,78%;602;602;100,00%;0;0,00%;478;2;0,42%;476;99,58%
MULTIPOLYGON (((-58.469541811451144 -34.5524233921697,-58.468958370567563 -34.55316007713725,-58.469830895555084 -34.553624487275663,-58.47050874776685 -34.553985377871811,-58.470703940987505 -34.554089102386044,-58.471588147662047 -34.554558992337647,-58.472030631627092 -34.553976397407183,-58.472124591513406 -34.553851454878568,-58.472582641888714 -34.553241954031911,-58.472725536914766 -34.553054609816634,-58.471872237729833 -34.552579514159291,-58.471016905265962 -34.552103285826632,-58.470618440113668 -34.551881400653805,-58.470167200594709 -34.551629234319833,-58.470077410499599 -34.551747202982334,-58.469541811451144 -34.5524233921697)));;1191;13_5_5;COMUNA 13;5;5;888;406;482;84,23%;434;434;100,00%;0;0,00%;359;16;4,46%;343;95,54%
MULTIPOLYGON (((-58.46667737001038 -34.550827248021371,-58.466341767352482 -34.5512449539196,-58.466034419437548 -34.551627304349857,-58.467250633730295 -34.552262012731347,-58.468122713651184 -34.552717138959409,-58.46830351500644 -34.552811430916798,-58.468958370567563 -34.55316007713725,-58.469541811451144 -34.5524233921697,-58.468703943987116 -34.551956513271229,-58.467847954953513 -34.551479558463441,-58.46667737001038 -34.550827248021371)));;1192;13_5_6;COMUNA 13;5;6;953;425;528;80,49%;542;542;100,00%;0;0,00%;437;4;0,92%;433;99,08%
MULTIPOLYGON (((-58.466034419437548 -34.551627304349857,-58.465733026802241 -34.55200239997842,-58.465132872041394 -34.552749208444759,-58.464519598296633 -34.553512282419689,-58.465253948037486 -34.553901371649289,-58.465616656664423 -34.554097921839535,-58.466232656011556 -34.553511329337823,-58.466351311400096 -34.553439914113142,-58.467250633730295 -34.552262012731347,-58.466034419437548 -34.551627304349857)));;1193;13_5_7;COMUNA 13;5;7;777;352;425;82,82%;438;438;100,00%;0;0,00%;327;4;1,22%;323;98,78%
MULTIPOLYGON (((-58.468122713651184 -34.552717138959409,-58.467250633730295 -34.552262012731347,-58.466351311400096 -34.553439914113142,-58.466232656011556 -34.553511329337823,-58.465616656664423 -34.554097921839535,-58.466193963616199 -34.554410878779684,-58.466383534579933 -34.55451799079119,-58.467225441424091 -34.553891314034715,-58.468122713651184 -34.552717138959409)));;1194;13_5_8;COMUNA 13;5;8;883;407;476;85,50%;550;550;100,00%;0;0,00%;417;0;0,00%;417;100,00%
MULTIPOLYGON (((-58.468958370567563 -34.55316007713725,-58.46830351500644 -34.552811430916798,-58.468122713651184 -34.552717138959409,-58.467225441424091 -34.553891314034715,-58.467550273918192 -34.554059055740581,-58.467851698557183 -34.554215177316379,-58.468767641404767 -34.554689734442007,-58.469364542101879 -34.554999013244945,-58.469672443456624 -34.555162595077476,-58.46977245225839 -34.555041950008395,-58.470606825519909 -34.55417502814749,-58.470703940987505 -34.554089102386044,-58.47050874776685 -34.553985377871811,-58.469830895555084 -34.553624487275663,-58.468958370567563 -34.55316007713725)));;1195;13_6_1;COMUNA 13;6;1;688;314;374;83,96%;325;325;100,00%;0;0,00%;283;0;0,00%;283;100,00%
MULTIPOLYGON (((-58.470602113673081 -34.555656575087809,-58.470491465007498 -34.555777996186983,-58.469880256632443 -34.556490883025035,-58.469083227284422 -34.557420406118759,-58.470068423522385 -34.557944388450288,-58.470872088108685 -34.557030140945152,-58.471555971285845 -34.556162941157005,-58.471849947313871 -34.555790085590999,-58.472449464916309 -34.555016623597403,-58.471588147662047 -34.554558992337647,-58.470703940987505 -34.554089102386044,-58.470606825519909 -34.55417502814749,-58.46977245225839 -34.555041950008395,-58.469672443456624 -34.555162595077476,-58.470602113673081 -34.555656575087809)));;1196;13_6_2;COMUNA 13;6;2;1061;479;582;82,30%;468;468;100,00%;0;0,00%;425;15;3,53%;410;96,47%
MULTIPOLYGON (((-58.469672443456624 -34.555162595077476,-58.469364542101879 -34.554999013244945,-58.468767641404767 -34.554689734442007,-58.468013933008244 -34.555438888324879,-58.46708801503479 -34.55635931917584,-58.467774049733087 -34.556723957061941,-58.468060927919211 -34.556876557369478,-58.469083227284422 -34.557420406118759,-58.469880256632443 -34.556490883025035,-58.470491465007498 -34.555777996186983,-58.470602113673081 -34.555656575087809,-58.469672443456624 -34.555162595077476)));;1197;13_6_3;COMUNA 13;6;3;932;429;503;85,29%;428;428;100,00%;0;0,00%;368;15;4,08%;353;95,92%
MULTIPOLYGON (((-58.467851698557183 -34.554215177316379,-58.467550273918192 -34.554059055740581,-58.467225441424091 -34.553891314034715,-58.466383534579933 -34.55451799079119,-58.465226242883098 -34.555369678890749,-58.466153335378607 -34.55586249557588,-58.467114072573239 -34.554930591085935,-58.468013933008244 -34.555438888324879,-58.468767641404767 -34.554689734442007,-58.467851698557183 -34.554215177316379)));;1198;13_6_4;COMUNA 13;6;4;904;411;493;83,37%;530;530;100,00%;0;0,00%;419;18;4,30%;401;95,70%
MULTIPOLYGON (((-58.466383534579933 -34.55451799079119,-58.466193963616199 -34.554410878779684,-58.465616656664423 -34.554097921839535,-58.465253948037486 -34.553901371649289,-58.464519598296633 -34.553512282419689,-58.463542335199804 -34.554479943113421,-58.464135639943727 -34.554789951773245,-58.464615905155682 -34.555045238548878,-58.465226242883098 -34.555369678890749,-58.466383534579933 -34.55451799079119)));;1199;13_6_5;COMUNA 13;6;5;939;412;527;78,18%;559;559;100,00%;0;0,00%;454;10;2,20%;444;97,80%
MULTIPOLYGON (((-58.465226242883098 -34.555369678890749,-58.464615905155682 -34.555045238548878,-58.464135639943727 -34.554789951773245,-58.463542335199804 -34.554479943113421,-58.462533043214712 -34.555480273340216,-58.462837528000456 -34.555614011874759,-58.463412791955861 -34.555914939087387,-58.463732346999748 -34.556082127519964,-58.46434200777145 -34.556401079024909,-58.465226242883098 -34.555369678890749)));;1200;13_6_6;COMUNA 13;6;6;864;364;500;72,80%;443;436;98,42%;7;1,61%;368;0;0,00%;368;100,00%
MULTIPOLYGON (((-58.466153335378607 -34.55586249557588,-58.465226242883098 -34.555369678890749,-58.46434200777145 -34.556401079024909,-58.465275235303636 -34.556889254113187,-58.46621783767629 -34.557382351560058,-58.46708801503479 -34.55635931917584,-58.468013933008244 -34.555438888324879,-58.467114072573239 -34.554930591085935,-58.466153335378607 -34.55586249557588)));;1201;13_6_7;COMUNA 13;6;7;977;445;532;83,65%;497;497;100,00%;0;0,00%;425;34;8,00%;391;92,00%
MULTIPOLYGON (((-58.470068423522385 -34.557944388450288,-58.469083227284422 -34.557420406118759,-58.468060927919211 -34.556876557369478,-58.467774049733087 -34.556723957061941,-58.46708801503479 -34.55635931917584,-58.46621783767629 -34.557382351560058,-58.467181137208343 -34.557886286492625,-58.467758135014208 -34.558188108588944,-58.468219531832951 -34.558427676891654,-58.46918421726712 -34.558928497138304,-58.469649646190582 -34.558420772567139,-58.470068423522385 -34.557944388450288)));;1202;13_6_8;COMUNA 13;6;8;794;354;440;80,45%;387;387;100,00%;0;0,00%;339;18;5,31%;321;94,69%
MULTIPOLYGON (((-58.468219531832951 -34.558427676891654,-58.467758135014208 -34.558188108588944,-58.467181137208343 -34.557886286492625,-58.466504511698062 -34.558672542164032,-58.466374700967933 -34.55882332759009,-58.465826256190752 -34.559462737865807,-58.466843466280437 -34.560032310647955,-58.467738612412965 -34.560533496653719,-58.468464868960076 -34.559724132419198,-58.468929965391283 -34.559205846817015,-58.46918421726712 -34.558928497138304,-58.468219531832951 -34.558427676891654)));;1203;13_7_1;COMUNA 13;7;1;779;335;444;75,45%;341;340;99,71%;1;0,29%;271;8;2,95%;263;97,05%
MULTIPOLYGON (((-58.46621783767629 -34.557382351560058,-58.465275235303636 -34.556889254113187,-58.464616390718099 -34.557659582859273,-58.465549549207317 -34.558160221103094,-58.466504511698062 -34.558672542164032,-58.467181137208343 -34.557886286492625,-58.46621783767629 -34.557382351560058)));;1204;13_7_2;COMUNA 13;7;2;586;268;318;84,28%;273;272;99,63%;1;0,37%;221;1;0,45%;220;99,55%
MULTIPOLYGON (((-58.463412791955861 -34.555914939087387,-58.462837528000456 -34.555614011874759,-58.462533043214712 -34.555480273340216,-58.46187588760214 -34.55618276748902,-58.462769941199824 -34.556664975286182,-58.463690393904194 -34.557161331858815,-58.464220640235439 -34.557447325291349,-58.464616390718099 -34.557659582859273,-58.465275235303636 -34.556889254113187,-58.46434200777145 -34.556401079024909,-58.463732346999748 -34.556082127519964,-58.463412791955861 -34.555914939087387)));;1205;13_7_3;COMUNA 13;7;3;1016;447;569;78,56%;567;566;99,82%;1;0,18%;457;2;0,44%;455;99,56%
MULTIPOLYGON (((-58.463690393904194 -34.557161331858815,-58.462769941199824 -34.556664975286182,-58.46187588760214 -34.55618276748902,-58.461649966520568 -34.556424819025182,-58.461221189565244 -34.556884201663514,-58.462140613863809 -34.557399021430449,-58.463050089800035 -34.557908341052702,-58.463690393904194 -34.557161331858815)));;1206;13_7_4;COMUNA 13;7;4;753;344;409;84,11%;508;508;100,00%;0;0,00%;344;1;0,29%;343;99,71%
MULTIPOLYGON (((-58.461221189565244 -34.556884201663514,-58.46077819170695 -34.557358794495677,-58.460564692863464 -34.557587533709615,-58.461511445723843 -34.558132993818198,-58.462412583421283 -34.558652107220858,-58.463050089800035 -34.557908341052702,-58.462140613863809 -34.557399021430449,-58.461221189565244 -34.556884201663514)));;1207;13_7_5;COMUNA 13;7;5;1048;438;610;71,80%;664;664;100,00%;0;0,00%;476;1;0,21%;475;99,79%
MULTIPOLYGON (((-58.464616390718099 -34.557659582859273,-58.464220640235439 -34.557447325291349,-58.463690393904194 -34.557161331858815,-58.463050089800035 -34.557908341052702,-58.462412583421283 -34.558652107220858,-58.463320287094945 -34.559175016883039,-58.463965365430298 -34.558420822954751,-58.464616390718099 -34.557659582859273)));;1208;13_7_6;COMUNA 13;7;6;829;372;457;81,40%;480;480;100,00%;0;0,00%;381;1;0,26%;380;99,74%
MULTIPOLYGON (((-58.465549549207317 -34.558160221103094,-58.464616390718099 -34.557659582859273,-58.463965365430298 -34.558420822954751,-58.463320287094945 -34.559175016883039,-58.464014586346792 -34.559574958960326,-58.46422553341246 -34.559696370417001,-58.464882354840775 -34.558934283881293,-58.465549549207317 -34.558160221103094)));;1209;13_7_7;COMUNA 13;7;7;805;382;423;90,31%;418;418;100,00%;0;0,00%;346;2;0,58%;344;99,42%
MULTIPOLYGON (((-58.466504511698062 -34.558672542164032,-58.465549549207317 -34.558160221103094,-58.464882354840775 -34.558934283881293,-58.46422553341246 -34.559696370417001,-58.465162884713415 -34.560236027231355,-58.465826256190752 -34.559462737865807,-58.466374700967933 -34.55882332759009,-58.466504511698062 -34.558672542164032)));;1210;13_7_8;COMUNA 13;7;8;776;346;430;80,47%;417;416;99,76%;1;0,24%;309;1;0,32%;308;99,68%
MULTIPOLYGON (((-58.466843466280437 -34.560032310647955,-58.465826256190752 -34.559462737865807,-58.465162884713415 -34.560236027231355,-58.466171076545521 -34.560816451281035,-58.467037197982933 -34.561315107862242,-58.467738612412965 -34.560533496653719,-58.466843466280437 -34.560032310647955)));;1211;13_7_9;COMUNA 13;7;9;818;360;458;78,60%;434;433;99,77%;1;0,23%;373;3;0,80%;370;99,20%
MULTIPOLYGON (((-58.462533043214712 -34.555480273340216,-58.461353845822138 -34.554862139194022,-58.460532646615221 -34.55581815695647,-58.461649966520568 -34.556424819025182,-58.46187588760214 -34.55618276748902,-58.462533043214712 -34.555480273340216)));;1212;13_8_1;COMUNA 13;8;1;640;268;372;72,04%;406;406;100,00%;0;0,00%;314;3;0,96%;311;99,04%
MULTIPOLYGON (((-58.461649966520568 -34.556424819025182,-58.460532646615221 -34.55581815695647,-58.459724793678824 -34.556758464432335,-58.46077819170695 -34.557358794495677,-58.461221189565244 -34.556884201663514,-58.461649966520568 -34.556424819025182)));;1213;13_8_10;COMUNA 13;8;10;650;289;361;80,06%;382;382;100,00%;0;0,00%;292;1;0,34%;291;99,66%
MULTIPOLYGON (((-58.461353845822138 -34.554862139194022,-58.460409683310878 -34.554367172892221,-58.459597416529895 -34.555310367122225,-58.460532646615221 -34.55581815695647,-58.461353845822138 -34.554862139194022)));;1214;13_8_2;COMUNA 13;8;2;563;248;315;78,73%;388;387;99,74%;1;0,26%;275;1;0,36%;274;99,64%
MULTIPOLYGON (((-58.458670965168565 -34.554807288898019,-58.457885320366358 -34.555710048165814,-58.458802838097299 -34.556232992051484,-58.459597416529895 -34.555310367122225,-58.460409683310878 -34.554367172892221,-58.459472171307333 -34.553875650287956,-58.458791504683639 -34.554668765349199,-58.458670965168565 -34.554807288898019)));;1215;13_8_3;COMUNA 13;8;3;929;427;502;85,06%;516;516;100,00%;0;0,00%;411;1;0,24%;410;99,76%
MULTIPOLYGON (((-58.457743673940612 -34.554300893557873,-58.45697513437635 -34.555191252804192,-58.457885320366358 -34.555710048165814,-58.458670965168565 -34.554807288898019,-58.458791504683639 -34.554668765349199,-58.459472171307333 -34.553875650287956,-58.458754702028592 -34.553499485171237,-58.458533989312578 -34.553385176809506,-58.458262121111474 -34.553244245254866,-58.458261962456056 -34.553244582182195,-58.458228494650378 -34.553315655764209,-58.457819556759688 -34.553626217762556,-58.457768141420345 -34.553664456890274,-58.457581632563773 -34.553805934586215,-58.457366180391517 -34.553969876552806,-58.457269733241581 -34.554041636157883,-58.457743673940612 -34.554300893557873)));;1216;13_8_4;COMUNA 13;8;4;879;411;468;87,82%;476;476;100,00%;0;0,00%;388;3;0,77%;385;99,23%
MULTIPOLYGON (((-58.457743673940612 -34.554300893557873,-58.457269733241581 -34.554041636157883,-58.457193886334409 -34.554098114225475,-58.456896373103191 -34.55429487003277,-58.456639463568663 -34.554464583638513,-58.456389533326487 -34.554629930662706,-58.456203106675154 -34.554751194041899,-58.455780611479987 -34.55501603476452,-58.455316063187141 -34.555551954862651,-58.454502110212253 -34.556493495114061,-58.455391268095312 -34.557025970135939,-58.456206748699202 -34.556081395812967,-58.456345001433476 -34.555921325371621,-58.45697513437635 -34.555191252804192,-58.457743673940612 -34.554300893557873)));;1217;13_8_5;COMUNA 13;8;5;955;439;516;85,08%;656;655;99,85%;1;0,15%;452;5;1,11%;447;98,89%
MULTIPOLYGON (((-58.457885320366358 -34.555710048165814,-58.45697513437635 -34.555191252804192,-58.456345001433476 -34.555921325371621,-58.456206748699202 -34.556081395812967,-58.457100169324839 -34.556612943117884,-58.457241571008772 -34.556449843512837,-58.457885320366358 -34.555710048165814)));;1218;13_8_6;COMUNA 13;8;6;676;317;359;88,30%;355;355;100,00%;0;0,00%;295;1;0,34%;294;99,66%
MULTIPOLYGON (((-58.458802838097299 -34.556232992051484,-58.457885320366358 -34.555710048165814,-58.457241571008772 -34.556449843512837,-58.457100169324839 -34.556612943117884,-58.458008923227013 -34.557153639774477,-58.458154069757036 -34.556986313726888,-58.458802838097299 -34.556232992051484)));;1219;13_8_7;COMUNA 13;8;7;808;354;454;77,97%;413;413;100,00%;0;0,00%;364;3;0,82%;361;99,18%
MULTIPOLYGON (((-58.459724793678824 -34.556758464432335,-58.458802838097299 -34.556232992051484,-58.458154069757036 -34.556986313726888,-58.458008923227013 -34.557153639774477,-58.458919561594534 -34.557695386063777,-58.459727467230444 -34.558175993531449,-58.459914654792058 -34.558287129728811,-58.459958921840801 -34.558236494639544,-58.460564692863464 -34.557587533709615,-58.46077819170695 -34.557358794495677,-58.459724793678824 -34.556758464432335)));;1220;13_8_8;COMUNA 13;8;8;993;428;565;75,75%;513;513;100,00%;0;0,00%;439;11;2,51%;428;97,49%
MULTIPOLYGON (((-58.460532646615221 -34.55581815695647,-58.459597416529895 -34.555310367122225,-58.458802838097299 -34.556232992051484,-58.459724793678824 -34.556758464432335,-58.460532646615221 -34.55581815695647)));;1221;13_8_9;COMUNA 13;8;9;708;309;399;77,44%;440;440;100,00%;0;0,00%;326;3;0,92%;323;99,08%
MULTIPOLYGON (((-58.457100169324839 -34.556612943117884,-58.456206748699202 -34.556081395812967,-58.455391268095312 -34.557025970135939,-58.455689784584145 -34.557204728146239,-58.456281969722298 -34.557556325945988,-58.457100169324839 -34.556612943117884)));;1222;13_9_1;COMUNA 13;9;1;673;307;366;83,88%;353;353;100,00%;0;0,00%;287;4;1,39%;283;98,61%
MULTIPOLYGON (((-58.458296315818657 -34.560157095873166,-58.457304957210418 -34.559568367669009,-58.456386903163363 -34.559023087833921,-58.455581782853876 -34.559950972617003,-58.45573747320762 -34.560043802664758,-58.456505375190723 -34.56049583615065,-58.457506869426503 -34.5610852754467,-58.458296315818657 -34.560157095873166)));;1223;13_9_10;COMUNA 13;9;10;537;219;318;68,87%;336;335;99,70%;1;0,30%;239;25;10,46%;214;89,54%
MULTIPOLYGON (((-58.458008923227013 -34.557153639774477,-58.457100169324839 -34.556612943117884,-58.456281969722298 -34.557556325945988,-58.457191069141039 -34.558096253941933,-58.458105798456472 -34.558639344490459,-58.458919561594534 -34.557695386063777,-58.458008923227013 -34.557153639774477)));;1224;13_9_2;COMUNA 13;9;2;699;304;395;76,96%;434;434;100,00%;0;0,00%;303;3;0,99%;300;99,01%
MULTIPOLYGON (((-58.459914654792058 -34.558287129728811,-58.459727467230444 -34.558175993531449,-58.458919561594534 -34.557695386063777,-58.458105798456472 -34.558639344490459,-58.458935755773275 -34.559132212023918,-58.459095874837658 -34.559226869006324,-58.459243236219628 -34.559056231777866,-58.459914654792058 -34.558287129728811)));;1225;13_9_3;COMUNA 13;9;3;506;213;293;72,70%;354;354;100,00%;0;0,00%;247;3;1,21%;244;98,79%
MULTIPOLYGON (((-58.459095874837658 -34.559226869006324,-58.458935755773275 -34.559132212023918,-58.458105798456472 -34.558639344490459,-58.457304957210418 -34.559568367669009,-58.458296315818657 -34.560157095873166,-58.458532473774802 -34.55987934521189,-58.459095874837658 -34.559226869006324)));;1226;13_9_4;COMUNA 13;9;4;572;246;326;75,46%;401;401;100,00%;0;0,00%;293;2;0,68%;291;99,32%
MULTIPOLYGON (((-58.458105798456472 -34.558639344490459,-58.457191069141039 -34.558096253941933,-58.456281969722298 -34.557556325945988,-58.455477969099114 -34.558483294792971,-58.456386903163363 -34.559023087833921,-58.457304957210418 -34.559568367669009,-58.458105798456472 -34.558639344490459)));;1227;13_9_5;COMUNA 13;9;5;1175;502;673;74,59%;620;619;99,84%;1;0,16%;488;4;0,82%;484;99,18%
MULTIPOLYGON (((-58.456281969722298 -34.557556325945988,-58.455689784584145 -34.557204728146239,-58.455391268095312 -34.557025970135939,-58.454502110212253 -34.556493495114061,-58.454011311801985 -34.557061163020684,-58.453697758977384 -34.557426016007632,-58.45458896497238 -34.557955327784981,-58.455477969099114 -34.558483294792971,-58.456281969722298 -34.557556325945988)));;1228;13_9_6;COMUNA 13;9;6;685;311;374;83,16%;430;430;100,00%;0;0,00%;320;1;0,31%;319;99,69%
MULTIPOLYGON (((-58.45458896497238 -34.557955327784981,-58.453697758977384 -34.557426016007632,-58.452902499094307 -34.558351348764788,-58.453734635684562 -34.558848477394179,-58.453789538666776 -34.558881229369007,-58.45458896497238 -34.557955327784981)));;1229;13_9_7;COMUNA 13;9;7;677;318;359;88,58%;364;363;99,73%;1;0,28%;296;2;0,68%;294;99,32%
MULTIPOLYGON (((-58.455477969099114 -34.558483294792971,-58.45458896497238 -34.557955327784981,-58.453789538666776 -34.558881229369007,-58.454525412965644 -34.559320807701575,-58.454676844870363 -34.55941110350075,-58.455332559207307 -34.558650899304524,-58.455477969099114 -34.558483294792971)));;1230;13_9_8;COMUNA 13;9;8;788;337;451;74,72%;429;429;100,00%;0;0,00%;344;1;0,29%;343;99,71%
MULTIPOLYGON (((-58.456386903163363 -34.559023087833921,-58.455477969099114 -34.558483294792971,-58.455332559207307 -34.558650899304524,-58.454676844870363 -34.55941110350075,-58.455581782853876 -34.559950972617003,-58.456386903163363 -34.559023087833921)));;1231;13_9_9;COMUNA 13;9;9;868;357;511;69,86%;431;431;100,00%;0;0,00%;363;0;0,00%;363;100,00%
MULTIPOLYGON (((-58.448386076597927 -34.5672225646436,-58.447531661753594 -34.567699665407439,-58.448133203499722 -34.568328568892397,-58.448642701000402 -34.568068194749131,-58.449044406334956 -34.567853794378578,-58.448386076597927 -34.5672225646436)));;1232;14_1_1;COMUNA 14;1;1;429;186;243;76,54%;304;304;100,00%;0;0,00%;210;0;0,00%;210;100,00%
MULTIPOLYGON (((-58.440382543306853 -34.565333604984041,-58.440325491500772 -34.565381202269464,-58.439500957812477 -34.56606945889348,-58.439471239269295 -34.566094243062444,-58.439413845791407 -34.566142191978791,-58.440601011090912 -34.56720140269023,-58.441516389202206 -34.566496604541307,-58.440382543306853 -34.565333604984041)));;1233;14_1_10;COMUNA 14;1;10;1210;531;679;78,20%;561;561;100,00%;0;0,00%;462;2;0,43%;460;99,57%
MULTIPOLYGON (((-58.447531661753594 -34.567699665407439,-58.446505414430092 -34.568272868424089,-58.447042166583536 -34.568886134131382,-58.448133203499722 -34.568328568892397,-58.447531661753594 -34.567699665407439)));;1234;14_1_2;COMUNA 14;1;2;562;244;318;76,73%;333;333;100,00%;0;0,00%;255;27;10,59%;228;89,41%
MULTIPOLYGON (((-58.447531661753594 -34.567699665407439,-58.447037462876828 -34.567182960718263,-58.446831647783803 -34.566967783883818,-58.446104685489424 -34.567814977753578,-58.446154393349403 -34.567871747539584,-58.445682001648741 -34.568165709495794,-58.445622571844531 -34.568190209305932,-58.446496898846704 -34.569160934061657,-58.446691114214261 -34.56906560343517,-58.447042166583536 -34.568886134131382,-58.446505414430092 -34.568272868424089,-58.447531661753594 -34.567699665407439)));;1235;14_1_3;COMUNA 14;1;3;862;375;487;77,00%;495;495;100,00%;0;0,00%;400;2;0,50%;398;99,50%
MULTIPOLYGON (((-58.446426194497747 -34.565874231863162,-58.446064504640773 -34.565661920261967,-58.445519973301607 -34.565340422254309,-58.444725142637211 -34.566269433140839,-58.445129772250198 -34.566729864337375,-58.445422908396928 -34.567051610395218,-58.44577094664529 -34.567433718107452,-58.446104685489424 -34.567814977753578,-58.446831647783803 -34.566967783883818,-58.447037462876828 -34.567182960718263,-58.447531661753594 -34.567699665407439,-58.448386076597927 -34.5672225646436,-58.447854500050511 -34.566712830969216,-58.447795763521057 -34.566678315258542,-58.447319743993567 -34.566398877772961,-58.446426194497747 -34.565874231863162)));;1236;14_1_4;COMUNA 14;1;4;944;424;520;81,54%;455;455;100,00%;0;0,00%;362;1;0,28%;361;99,72%
MULTIPOLYGON (((-58.446104685489424 -34.567814977753578,-58.44577094664529 -34.567433718107452,-58.445422908396928 -34.567051610395218,-58.444443778816868 -34.568200532121864,-58.445704962124658 -34.569549786901874,-58.446496898846704 -34.569160934061657,-58.445622571844531 -34.568190209305932,-58.445682001648741 -34.568165709495794,-58.446154393349403 -34.567871747539584,-58.446104685489424 -34.567814977753578)));;1237;14_1_5;COMUNA 14;1;5;1356;612;744;82,26%;774;774;100,00%;0;0,00%;585;29;4,96%;556;95,04%
MULTIPOLYGON (((-58.443713614030777 -34.568750092537812,-58.444885685987551 -34.569952081877865,-58.445704962124658 -34.569549786901874,-58.444443778816868 -34.568200532121864,-58.444282824887239 -34.568028387771577,-58.443743544087127 -34.567416729245757,-58.442980511675948 -34.567998183038107,-58.443713614030777 -34.568750092537812)));;1238;14_1_6;COMUNA 14;1;6;1000;455;545;83,49%;562;562;100,00%;0;0,00%;446;0;0,00%;446;100,00%
MULTIPOLYGON (((-58.442980511675948 -34.567998183038107,-58.442190726010907 -34.568619770102082,-58.442965132578152 -34.569310702392777,-58.444110593429428 -34.570332686986241,-58.444885685987551 -34.569952081877865,-58.443713614030777 -34.568750092537812,-58.442980511675948 -34.567998183038107)));;1239;14_1_7;COMUNA 14;1;7;849;371;478;77,62%;472;472;100,00%;0;0,00%;367;3;0,82%;364;99,18%
MULTIPOLYGON (((-58.444612402011984 -34.564804563329773,-58.443646194434237 -34.564234039056707,-58.442353161985466 -34.565840098349568,-58.441516389202206 -34.566496604541307,-58.440601011090912 -34.56720140269023,-58.442190726010907 -34.568619770102082,-58.442980511675948 -34.567998183038107,-58.443743544087127 -34.567416729245757,-58.444282824887239 -34.568028387771577,-58.444443778816868 -34.568200532121864,-58.445422908396928 -34.567051610395218,-58.445129772250198 -34.566729864337375,-58.444725142637211 -34.566269433140839,-58.445519973301607 -34.565340422254309,-58.444612402011984 -34.564804563329773)));;1240;14_1_8;COMUNA 14;1;8;952;415;537;77,28%;392;390;99,49%;2;0,51%;299;0;0,00%;299;100,00%
MULTIPOLYGON (((-58.441267856141415 -34.564609224650461,-58.441132385424275 -34.564707655839968,-58.440382543306853 -34.565333604984041,-58.441516389202206 -34.566496604541307,-58.442353161985466 -34.565840098349568,-58.441267856141415 -34.564609224650461)));;1241;14_1_9;COMUNA 14;1;9;1012;439;573;76,61%;465;465;100,00%;0;0,00%;398;0;0,00%;398;100,00%
MULTIPOLYGON (((-58.434858497864759 -34.562089157581006,-58.434957857598199 -34.561792195139205,-58.433875685818904 -34.561568483763672,-58.433270455483566 -34.5614621374461,-58.432426769755978 -34.561386082697148,-58.431809254130258 -34.561360645191435,-58.431194907416391 -34.56140770729219,-58.431083716465196 -34.561157377623168,-58.431012427681225 -34.561189447422272,-58.430952148808871 -34.561209855208958,-58.430890679123664 -34.561227586479731,-58.430828103813248 -34.561242500403665,-58.430764678242724 -34.561254667471566,-58.430700572729428 -34.561263946875421,-58.430635957483275 -34.561270479510256,-58.430571002849327 -34.561274054143027,-58.430505879064846 -34.561274741243778,-58.430440841495724 -34.561272611305419,-58.430375975304521 -34.561267593924931,-58.430311621012997 -34.561259689192958,-58.430214408623364 -34.561247690998798,-58.430126476007764 -34.561233864135872,-58.430039310708459 -34.561217149961983,-58.429952997835144 -34.561197618927281,-58.42986762246926 -34.561175411907804,-58.429783440059701 -34.561150388122989,-58.429700450558279 -34.561122688426629,-58.42961873907246 -34.561092383269852,-58.429538646150696 -34.56105940232203,-58.429460086614192 -34.561023886414432,-58.429383315825497 -34.560985906045424,-58.429308418917415 -34.560945461241538,-58.429199053975097 -34.560882822847873,-58.429126541634361 -34.560840406666969,-58.429054455235566 -34.560797427154625,-58.428982965064421 -34.560753813932955,-58.428911985936466 -34.560709707830767,-58.428841517909234 -34.560664967997589,-58.428771560954907 -34.560619664859985,-58.42870220020211 -34.560573798442505,-58.428633350523235 -34.560527368722411,-58.42856509701808 -34.560480446150038,-58.428497354616532 -34.560432889851178,-58.428430208389365 -34.560384840701879,-58.428145567071851 -34.560115382204955,-58.428003970874933 -34.559980195142245,-58.427914111992649 -34.559894391076803,-58.427747419448323 -34.55972229349392,-58.427539806832357 -34.559489969928649,-58.427354913420672 -34.559283146685246,-58.427287896049961 -34.559336509946256,-58.427073729428344 -34.55950701868273,-58.423902350039356 -34.562017009361888,-58.423789575346035 -34.562152683732428,-58.423546764797344 -34.562447862768593,-58.423373060217358 -34.56267518118247,-58.423372257326903 -34.562675611661334,-58.423459046346935 -34.562452309569906,-58.423132549386352 -34.562322127985574,-58.422118647415004 -34.562683923922798,-58.421310963314319 -34.562964228592307,-58.42114321778984 -34.563041498977547,-58.42090000860798 -34.563193887489653,-58.420710491665012 -34.563394958117883,-58.420618223394378 -34.563536834034231,-58.420296651244158 -34.564103156240442,-58.420054505217806 -34.564665350204294,-58.419886426076772 -34.564969705071633,-58.418571378217599 -34.56393204430676,-58.417957991875546 -34.563441835665451,-58.417802178326617 -34.563316281645442,-58.417394793598298 -34.562997035433597,-58.417009237036702 -34.562692847703779,-58.416802017588665 -34.562334539849424,-58.416635456980032 -34.562470245854655,-58.416419904721721 -34.562640513998382,-58.416189101212296 -34.56282299437364,-58.416044821812584 -34.562908101889256,-58.415832517747226 -34.563039786970315,-58.415630094680218 -34.563159925682143,-58.415455513861708 -34.563271130775895,-58.415311763868146 -34.563357839462981,-58.415111551966284 -34.563479245828056,-58.415038656965024 -34.563519289585095,-58.414909212614468 -34.563598186131635,-58.414730037524812 -34.563701219005559,-58.414663018148637 -34.563737884414302,-58.414490656013776 -34.563835637691533,-58.41426175013433 -34.563961045579447,-58.413939088741735 -34.564129093562151,-58.413589264731456 -34.564304383603577,-58.413525569903463 -34.564331894388182,-58.413276057856322 -34.564459686586005,-58.413077386247451 -34.564558342733896,-58.412928702590555 -34.564630468482619,-58.412739313711349 -34.564722226149307,-58.41262545678871 -34.564780703201578,-58.412466459257033 -34.564872895458436,-58.412339400799652 -34.564940662992633,-58.411564884698365 -34.56532606219433,-58.410919790704583 -34.565668481363801,-58.41076411575672 -34.565751094913189,-58.410202215353948 -34.566054459411575,-58.40934343682509 -34.566509811232372,-58.408671762103793 -34.566853051933762,-58.407859817717835 -34.567268060098904,-58.407645243044826 -34.567062461605147,-58.407535744047927 -34.566957478021251,-58.407479853530461 -34.566892590769001,-58.407440807739988 -34.566845810497703,-58.407398527259794 -34.566798465343432,-58.407349096010421 -34.566750412676008,-58.407297194756119 -34.566704119507492,-58.407243078760146 -34.566659797227516,-58.407186577800644 -34.56661737533021,-58.407128032367154 -34.566576924392876,-58.407067442317789 -34.566538655689399,-58.407006254460413 -34.566503274132941,-58.406941062675614 -34.566471904976737,-58.406887698497883 -34.566449626097487,-58.406832970650456 -34.566429670615996,-58.406777134437334 -34.566412179498577,-58.406720189948743 -34.566397011892569,-58.40666239244063 -34.566384379190438,-58.406603912176017 -34.566374281469216,-58.406537853821753 -34.566365940874157,-58.406407515806187 -34.566362852540145,-58.406240049126083 -34.566374958832895,-58.406178492185397 -34.56638246588787,-58.406117955124003 -34.566392508706549,-58.406058097448586 -34.566405016706817,-58.405999004240343 -34.566420060354758,-58.405941016126036 -34.566437498958663,-58.405884133101353 -34.566457332520038,-58.405828440296283 -34.566479561080087,-58.405774278291219 -34.566504114373636,-58.40571892192704 -34.566532258791632,-58.40561153114799 -34.566585872932301,-58.405311157112266 -34.56673982332422,-58.405081298086301 -34.566857889216678,-58.404647129158263 -34.567078679066405,-58.404500304259535 -34.567154316678177,-58.404448610482596 -34.567178659280302,-58.404395640440235 -34.567201874441238,-58.404323680729192 -34.567231630080599,-58.404269946523215 -34.567251816520489,-58.404202759159297 -34.567274602237958,-58.404144344304719 -34.567292180632158,-58.404064728612362 -34.56731291796892,-58.403993033892547 -34.567328729271239,-58.403935645380862 -34.567339476775757,-58.403846669957595 -34.567352814776193,-58.403757271017724 -34.567363053780866,-58.403667789061103 -34.567370264379143,-58.403598485619909 -34.567375301489172,-58.403151437545816 -34.567142398051836,-58.403023870514176 -34.566595762638769,-58.402753070697358 -34.566934870102656,-58.402718389751506 -34.566978305664556,-58.402677147484958 -34.56702997778585,-58.402598312646873 -34.567148535712086,-58.402481914535699 -34.567292850830746,-58.402369427553772 -34.567443646922754,-58.402330404664539 -34.567486587245476,-58.40227263703207 -34.567550223403522,-58.401799822657878 -34.568097969982929,-58.401305889543551 -34.568528163758977,-58.400485320204098 -34.569135943628147,-58.400125652295358 -34.56935079656683,-58.399987793181424 -34.569611394216118,-58.39977541232799 -34.569976672363374,-58.39966869462372 -34.570255643397388,-58.399659577773797 -34.570490648792372,-58.399721523743793 -34.570762382577293,-58.399916627016971 -34.571034184878187,-58.40028615733506 -34.571452068333663,-58.400377859943283 -34.5715557815968,-58.400533426245637 -34.571761855651403,-58.400555285489276 -34.571790882107294,-58.401757406607345 -34.573127754478612,-58.401776602322343 -34.573154964475542,-58.401827550037957 -34.573226405822965,-58.401898957179995 -34.57332658979589,-58.402039363735376 -34.57352529557977,-58.402140959851472 -34.57363194068575,-58.402515582619444 -34.574011236783143,-58.402644715081934 -34.574138719636728,-58.402647090942608 -34.574140968282322,-58.402783986729936 -34.574276397942022,-58.40344185739027 -34.573467107266353,-58.403576575612028 -34.573311743448869,-58.40364499946881 -34.573233111253245,-58.404306546884769 -34.572377618393418,-58.404806687797318 -34.571723039898934,-58.404960275893401 -34.571582195689274,-58.405127649518121 -34.571628152895684,-58.406079188968263 -34.572294101099843,-58.40608529153436 -34.572380709956811,-58.4061847458687 -34.572620273036428,-58.406351265342906 -34.572858976608373,-58.406690735768628 -34.57330987193248,-58.407329000045827 -34.574077268147668,-58.407418310639294 -34.574210694568428,-58.407606365207911 -34.574505228692672,-58.407812027601047 -34.57482716595802,-58.407995552784072 -34.575021622764531,-58.408215069389861 -34.575254265986857,-58.408324402756683 -34.575370094279016,-58.408449308900373 -34.575499380665526,-58.408543341266949 -34.575577946862779,-58.408772935770379 -34.575767281847945,-58.408852846621031 -34.57582767178387,-58.408941779232208 -34.575893629255411,-58.409004077758546 -34.575935066872866,-58.409078970610508 -34.575987425944419,-58.409152670820674 -34.576040911254452,-58.409225263578655 -34.576095452416929,-58.409296918992709 -34.576151331210184,-58.409349510126688 -34.576194877167261,-58.409389334930204 -34.576230248168343,-58.409427796789039 -34.576266674943881,-58.409464895747782 -34.576304087069687,-58.409500546706639 -34.576342414084365,-58.409534749664815 -34.576381655989188,-58.409567419521977 -34.576421742322836,-58.409598556276933 -34.576462673086468,-58.409628244983111 -34.576504589169261,-58.409667712792697 -34.576566228632565,-58.409698074634804 -34.576620892004769,-58.409724434012645 -34.576676680439796,-58.409746705730093 -34.576733664328749,-58.409768886574746 -34.576799733062323,-58.409781031722424 -34.576847909365519,-58.409955671370874 -34.577239691532853,-58.410724659417703 -34.576896837993587,-58.410939113868864 -34.576799882795108,-58.411747018325471 -34.576434784825693,-58.413158832731071 -34.575796747557447,-58.414502748997712 -34.575189302190104,-58.414688578590486 -34.575106414169632,-58.414623608385469 -34.57496927011897,-58.414676912691341 -34.5748125943269,-58.414795413371827 -34.574695171126088,-58.414986362226927 -34.574591086572283,-58.415180238930205 -34.574577781354598,-58.41551758660291 -34.574553474563949,-58.415997170979374 -34.574441048591481,-58.416259969639761 -34.574351426741877,-58.417463003460952 -34.573767276213637,-58.41794919924034 -34.573537938619275,-58.418173262296087 -34.573432241405911,-58.419204476704195 -34.572971466792694,-58.419500068399252 -34.572839383021211,-58.42002218621807 -34.572602584730582,-58.420548133269591 -34.572364024880009,-58.421741296394345 -34.571822788152268,-58.422117440590867 -34.571652202237253,-58.422515088428646 -34.571471803735633,-58.422608508041307 -34.571429434809829,-58.422614640407993 -34.571426641522777,-58.422694981207563 -34.571390198525236,-58.422998645506219 -34.571267545913877,-58.423244744054266 -34.57116818481272,-58.423409093312166 -34.571101756091707,-58.423523286058291 -34.57105566404978,-58.423602482292274 -34.571018927296691,-58.423602549974795 -34.571018966286665,-58.423606275203795 -34.571024063033491,-58.423769825313542 -34.570949563838226,-58.423760704208391 -34.570945594432352,-58.423887077287354 -34.570886758906127,-58.424103460821975 -34.570786330231464,-58.424199347247992 -34.570741851552924,-58.424374178753141 -34.570649649074717,-58.424402451522504 -34.570634727727501,-58.425889227124401 -34.569850432953885,-58.426196991309688 -34.569673827593107,-58.429719836190493 -34.567652348004756,-58.430174985963575 -34.567391191120329,-58.430678840681544 -34.567102086344384,-58.43122697579426 -34.566775876598925,-58.432245318908571 -34.566169840738382,-58.43331013966214 -34.565536200669762,-58.433798308394302 -34.565245670634418,-58.434409512868648 -34.564888333276215,-58.435489795031273 -34.564254184656328,-58.436476744192014 -34.563660923698947,-58.436667388700478 -34.563546311537024,-58.436878808497255 -34.563419238129974,-58.438045233374162 -34.562976783577213,-58.438175917625571 -34.562946456439356,-58.438922305915106 -34.562773286538437,-58.439525652154934 -34.562673398116949,-58.439927995694177 -34.562606780724138,-58.440857916200322 -34.562438703722506,-58.441344541606227 -34.56235075773052,-58.441220115310507 -34.56218177534366,-58.441164038222965 -34.562098731534668,-58.440965922212186 -34.562136326406666,-58.440816180229504 -34.562165001620606,-58.440657916398976 -34.562194682198836,-58.440510000505618 -34.562222350280138,-58.440376694927323 -34.562241964163029,-58.440228780482457 -34.562263589385026,-58.440090605077948 -34.562284209145332,-58.439947560044928 -34.56230533138492,-58.43981973285662 -34.562322931507381,-58.439666340298494 -34.562343547934361,-58.439550687256599 -34.562358632355242,-58.439402165538858 -34.56237371039839,-58.439246947879859 -34.562390297604267,-58.439088078229744 -34.56240638036325,-58.43893286059118 -34.562422463626476,-58.438786164685531 -34.56243754127545,-58.438658947468696 -34.562449097783102,-58.438525034601625 -34.562461156375669,-58.438361295685134 -34.562475726594705,-58.438221904176935 -34.562489294391909,-58.438091034579323 -34.562501353118456,-58.43795955775564 -34.562508376149687,-58.437834776383767 -34.562515400403214,-58.437695388039593 -34.562517889649541,-58.437570607994516 -34.562520381744577,-58.437425132534806 -34.562523876515627,-58.437279048843152 -34.562525860357077,-58.437125052619145 -34.562526835280011,-58.436978968760407 -34.562529322305529,-58.436820711302076 -34.562531806576281,-58.435948912522093 -34.562542176837063,-58.435410487681594 -34.562543751291685,-58.435319155949458 -34.562468371146714,-58.435319180204345 -34.562468363146429,-58.434944710717218 -34.56215974373341,-58.434858497864759 -34.562089157581006)));;1242;14_10_1;COMUNA 14;10;1;25;17;8;212,50%;21;20;95,24%;1;5,00%;6;0;0,00%;6;100,00%
MULTIPOLYGON (((-58.417394793598298 -34.562997035433597,-58.417802178326617 -34.563316281645442,-58.417957991875546 -34.563441835665451,-58.418571378217599 -34.56393204430676,-58.419886426076772 -34.564969705071633,-58.420054505217806 -34.564665350204294,-58.420296651244158 -34.564103156240442,-58.420618223394378 -34.563536834034231,-58.420710491665012 -34.563394958117883,-58.42090000860798 -34.563193887489653,-58.42114321778984 -34.563041498977547,-58.421310963314319 -34.562964228592307,-58.422118647415004 -34.562683923922798,-58.423132549386352 -34.562322127985574,-58.423459046346935 -34.562452309569906,-58.423372257326903 -34.562675611661334,-58.423372937521712 -34.562675341747564,-58.423546764797344 -34.562447862768593,-58.423789575346035 -34.562152683732428,-58.423902350039356 -34.562017009361888,-58.427073729428344 -34.55950701868273,-58.427287896049961 -34.559336509946256,-58.427354913420672 -34.559283146685246,-58.427539806832357 -34.559489969928649,-58.427747419448323 -34.55972229349392,-58.427914111992649 -34.559894391076803,-58.428003970874933 -34.559980195142245,-58.428145567071851 -34.560115382204955,-58.428430208389365 -34.560384840701879,-58.428497354616532 -34.560432889851178,-58.42856509701808 -34.560480446150038,-58.428633350523235 -34.560527368722411,-58.42870220020211 -34.560573798442505,-58.428771560954907 -34.560619664859985,-58.428841517909234 -34.560664967997589,-58.428911985936466 -34.560709707830767,-58.428982965064421 -34.560753813932955,-58.429054455235566 -34.560797427154625,-58.429126541634361 -34.560840406666969,-58.429199053975097 -34.560882822847873,-58.429308418917415 -34.560945461241538,-58.429383315825497 -34.560985906045424,-58.429460086614192 -34.561023886414432,-58.429538646150696 -34.56105940232203,-58.42961873907246 -34.561092383269852,-58.429700450558279 -34.561122688426629,-58.429783440059701 -34.561150388122989,-58.42986762246926 -34.561175411907804,-58.429952997835144 -34.561197618927281,-58.430039310708459 -34.561217149961983,-58.430126476007764 -34.561233864135872,-58.430214408623364 -34.561247690998798,-58.430311621012997 -34.561259689192958,-58.430375975304521 -34.561267593924931,-58.430440841495724 -34.561272611305419,-58.430505879064846 -34.561274741243778,-58.430571002849327 -34.561274054143027,-58.430635957483275 -34.561270479510256,-58.430700572729428 -34.561263946875421,-58.430764678242724 -34.561254667471566,-58.430828103813248 -34.561242500403665,-58.430890679123664 -34.561227586479731,-58.430952148808871 -34.561209855208958,-58.431012427681225 -34.561189447422272,-58.431083716465196 -34.561157377623168,-58.431194907416391 -34.56140770729219,-58.431809254130258 -34.561360645191435,-58.432426769755978 -34.561386082697148,-58.433270455483566 -34.5614621374461,-58.433875685818904 -34.561568483763672,-58.434957857598199 -34.561792195139205,-58.43502757516498 -34.561802281833252,-58.435124447865114 -34.561815825482178,-58.435275290428379 -34.561836001203197,-58.435385783699168 -34.561850181534716,-58.435496277168035 -34.561863868786531,-58.435570166611555 -34.561872688438072,-58.435668657692091 -34.56188390796747,-58.435743654081151 -34.561892023502338,-58.435818820947553 -34.561899505197616,-58.435935615100774 -34.561910165134961,-58.43602525398228 -34.561917720300634,-58.436115915441682 -34.561922106467875,-58.436217388617948 -34.561925649805517,-58.436300303983948 -34.561927921385099,-58.436362703490438 -34.561929132099067,-58.436444682971079 -34.561929713162542,-58.436550158731727 -34.561928538564231,-58.436617837301426 -34.561926440271812,-58.436678961054227 -34.561923847565239,-58.436779160199109 -34.561918093975542,-58.436891363297825 -34.561910018794634,-58.437025020005898 -34.561898638017681,-58.437105043901177 -34.561891330551013,-58.437203371270101 -34.561881843659975,-58.437277010493666 -34.561874323469929,-58.437657467889558 -34.56182721690304,-58.437980214090913 -34.561756786579728,-58.438248137285093 -34.56168380910983,-58.438473495449436 -34.561610822611748,-58.438686596094378 -34.561532762637491,-58.438924134085909 -34.561434565307621,-58.439240770354225 -34.561286028377097,-58.439469118694589 -34.5611676864713,-58.439694493811345 -34.5610242016066,-58.439892368957224 -34.560890711635267,-58.440166452935919 -34.560684274417717,-58.440327890361843 -34.560555847651571,-58.440489244166642 -34.560419885104992,-58.440653664053002 -34.560276316920913,-58.440845513569172 -34.560059721979549,-58.440958260444667 -34.559913679216294,-58.441031338943326 -34.559762558660907,-58.441128780414765 -34.559546016888902,-58.441208005549541 -34.559324401175253,-58.441259802721085 -34.559168206069351,-58.441299420786649 -34.559034756306652,-58.441332895472847 -34.558956660059998,-58.441385539511202 -34.558815888269898,-58.441375938519052 -34.558744263646119,-58.441337505242153 -34.558573052022467,-58.441250917442588 -34.558298376555967,-58.441164403031877 -34.558071449665945,-58.441058552244748 -34.557896282184906,-58.44091422532756 -34.557721107747554,-58.440692955450984 -34.557510143021709,-58.440442828375424 -34.557303046045519,-58.440158991061836 -34.557103970864169,-58.439835138784062 -34.556933691653562,-58.439539199093197 -34.556797573358146,-58.439148778370857 -34.556641083116709,-58.438811725980052 -34.556504955114441,-58.438490751331642 -34.556409394592606,-58.438343159406124 -34.556365490003586,-58.437986351737457 -34.556259850119368,-58.437698837639132 -34.556147251251588,-58.437500959301502 -34.556034670237914,-58.437330916846825 -34.555922024262877,-58.437099094965191 -34.555745488960689,-58.436869918012 -34.555552333296859,-58.436687212587849 -34.555380244405711,-58.436536667459023 -34.555261826553966,-58.436243408450288 -34.55502907667784,-58.435982221964395 -34.554859434587748,-58.435717112328845 -34.554716412003337,-58.435455914848831 -34.554586770607095,-58.435335401743906 -34.55452688176242,-58.435181695211142 -34.554455083368239,-58.43410985399661 -34.553956976872357,-58.434653547934566 -34.553593585673084,-58.434634961228959 -34.553323647544296,-58.434212381017659 -34.552938249625491,-58.432640999837695 -34.552029161552582,-58.432332249079224 -34.551857668786127,-58.432035584136329 -34.551692587017214,-58.431940847155211 -34.551640282926265,-58.431827477777823 -34.551577764839628,-58.431629223409878 -34.551450541180415,-58.431627038931616 -34.551449208554644,-58.431353807133007 -34.551276148549675,-58.431089087102933 -34.551140701458131,-58.430879990554921 -34.55106831880034,-58.430560901136637 -34.551017810356427,-58.430040485013848 -34.55096443297888,-58.4297876247388 -34.550938520028993,-58.429571949965592 -34.550916308800588,-58.429168861736734 -34.550874354398694,-58.428699473134884 -34.551165834211332,-58.428462621519522 -34.551292745734806,-58.428134865433414 -34.551412236387598,-58.426901681539753 -34.551970216714203,-58.426698554231969 -34.552046005560896,-58.42657488590639 -34.551825606750043,-58.42624612264828 -34.551901428035578,-58.426151285050608 -34.551935204061401,-58.426127552184973 -34.551899984061997,-58.426038502001909 -34.551935240675093,-58.425691664339062 -34.552074719946795,-58.424263460099894 -34.549266895044596,-58.424248316353207 -34.54925167830033,-58.424225507944755 -34.549245544069585,-58.424202268767665 -34.54925067782937,-58.424186089911551 -34.549265250871258,-58.424182165561852 -34.549284757584395,-58.42419169024604 -34.549302930449045,-58.424211602466407 -34.54931392315445,-58.425046462528037 -34.550933624875491,-58.425569069541964 -34.551934535414873,-58.425563347120274 -34.551978268087247,-58.425569032906303 -34.552017003998159,-58.425573951340624 -34.552058627132382,-58.425572230089152 -34.552101093356733,-58.425559781122665 -34.552149542509639,-58.425428420132853 -34.552198025845826,-58.4245382667104 -34.552512413262569,-58.424233476990914 -34.552644154676571,-58.422776200115031 -34.553047930815715,-58.422728169202777 -34.552918049976164,-58.422214236471675 -34.553045351293846,-58.422256992014404 -34.553169385246406,-58.421272962130494 -34.553414982119492,-58.420390147651801 -34.553636309277017,-58.420178935687034 -34.553688914375073,-58.420008586437334 -34.553732025923793,-58.419871609979054 -34.553764444229422,-58.419772772174369 -34.553788143001576,-58.419717010693027 -34.55380199725915,-58.419669166803381 -34.55381324852867,-58.419599443671558 -34.553830478247704,-58.419480258830049 -34.553859803659371,-58.419379632744935 -34.553884487440442,-58.41928207166103 -34.553907834138947,-58.419231501867046 -34.55392274640694,-58.419172844285349 -34.553940050246787,-58.419072559343881 -34.553963114103503,-58.41893558026409 -34.553999123070319,-58.418779958741887 -34.554036533693797,-58.418633190006268 -34.554073383908047,-58.418496210631432 -34.554109251529525,-58.418390647096444 -34.554133580577812,-58.418245580674501 -34.55417000838861,-58.41811694506751 -34.554201793927611,-58.418007719495776 -34.554229079188907,-58.417898748311622 -34.554258054663833,-58.4177715612471 -34.554286600785126,-58.417631261484445 -34.554322325361284,-58.417508754896893 -34.554352774431422,-58.417383694109724 -34.554384067539516,-58.417233261308041 -34.554425703659632,-58.417093471774905 -34.554461498232563,-58.416948912946424 -34.55450158682909,-58.416824616085009 -34.554536048808721,-58.416724326954245 -34.554564251812245,-58.416578828553803 -34.554609551121601,-58.416425327434276 -34.554656819145421,-58.416297112205093 -34.554695434221109,-58.416158423780367 -34.554739538378541,-58.416009772534402 -34.554789695183047,-58.415849457315055 -34.554843509469869,-58.415679181039252 -34.554900066314019,-58.415550364588185 -34.554946920184634,-58.415417631208697 -34.554995814748757,-58.415293751603514 -34.555042599833762,-58.415165954864726 -34.555091777743044,-58.415033475795681 -34.555141728373371,-58.414896141359662 -34.555197311018098,-58.414771919462254 -34.555246208210136,-58.414627091171283 -34.555306506133974,-58.414503718678972 -34.555358009139013,-58.414386388612442 -34.555411486330868,-58.414251177046808 -34.555474534215854,-58.414124729539935 -34.555543430773923,-58.414021272374896 -34.555599730161219,-58.413884775609169 -34.55567608759042,-58.413789148620388 -34.555733798424832,-58.413670450392907 -34.555796148019716,-58.413563501562834 -34.555854135831957,-58.413462427378072 -34.555909942721371,-58.413360674483116 -34.555961664559632,-58.413251000027429 -34.556021763766921,-58.413130513564063 -34.556083830406386,-58.413031396695551 -34.556139567305522,-58.412946244826138 -34.556187140430346,-58.412837761633732 -34.556247028472178,-58.412760953980332 -34.556290731459121,-58.412672990443454 -34.556342106231391,-58.412582812186351 -34.556395804079827,-58.412520479923572 -34.556431836450884,-58.412447841183038 -34.556478569259028,-58.412354342970723 -34.556531983867949,-58.412277787370257 -34.556580334750585,-58.412184711490532 -34.556638820055348,-58.412104492331231 -34.556692169539097,-58.412024869664492 -34.556744321979885,-58.411952997348379 -34.556789646294575,-58.411872778453279 -34.55684208009032,-58.411810441477492 -34.556884802537752,-58.411753129435233 -34.556923160655124,-58.411679637004177 -34.55697249839757,-58.411422025019824 -34.557152891597539,-58.411145246083464 -34.55735398131722,-58.411022987172124 -34.557248220626434,-58.410740766107679 -34.557300920134544,-58.410643523669961 -34.557212424008348,-58.410673502968194 -34.557187646933734,-58.410632238955081 -34.55715326159158,-58.410080437134233 -34.556651100892076,-58.410039305046844 -34.556678337913723,-58.410005358749508 -34.556649448719732,-58.409975240834562 -34.556624082455834,-58.409950651462992 -34.556605901997209,-58.409927251436301 -34.556591525036872,-58.409899254278429 -34.556577850341299,-58.409875000090778 -34.556568121099467,-58.40984997894703 -34.556559729609624,-58.409824361049502 -34.556552746370748,-58.409798231387306 -34.556547382696451,-58.409771675216724 -34.55654342734622,-58.409744862605841 -34.556541162096416,-58.40971787881093 -34.556540375706717,-58.409690894033744 -34.556541138676621,-58.409664163689271 -34.556543380691345,-58.409637517394117 -34.55654731295418,-58.409611380945321 -34.556552653947442,-58.409585754207392 -34.556559614948547,-58.409560722437242 -34.556567984717766,-58.409536455926549 -34.556577692903851,-58.409513124832714 -34.556588880432855,-58.409490814413402 -34.556601336065263,-58.409469524623162 -34.556615130227357,-58.409449511013072 -34.556629981328207,-58.409430688369206 -34.556646030182684,-58.40941339727749 -34.556663136088567,-58.409397552703972 -34.556681158157907,-58.409383239773135 -34.556700096428408,-58.409370628823673 -34.556719810123589,-58.409359634777267 -34.556740228781052,-58.409350342893838 -34.556761141161338,-58.409343008547047 -34.556782547376407,-58.409337291286398 -34.556804376852092,-58.409333616824185 -34.556826488923242,-58.409331729879163 -34.556848742627032,-58.409331715577039 -34.556871138000723,-58.409333574144178 -34.556893322915826,-58.4093373055371 -34.556915367797934,-58.409342994926561 -34.556937202258396,-58.409350472155246 -34.556958685371171,-58.409359652189991 -34.556979676247273,-58.4093706202462 -34.557000034072153,-58.409383291200491 -34.557019758808153,-58.409397835437431 -34.557038639251971,-58.409411531579963 -34.55705258952338,-58.409468616441664 -34.557105433716025,-58.40943165453961 -34.557133447031767,-58.40945028599743 -34.557150427757755,-58.410025143472573 -34.557672813393239,-58.410056313627855 -34.557650008906009,-58.410154577054932 -34.557739139764358,-58.41006190210657 -34.557967560853008,-58.410171138112105 -34.558070992842865,-58.410084604187702 -34.558144691298395,-58.410004630513846 -34.558209307607008,-58.409925507617459 -34.558274487635899,-58.409846386869383 -34.558336075902673,-58.409757042116041 -34.558411533548345,-58.40966292845166 -34.558489665232791,-58.409594108623857 -34.558549567591243,-58.409510213588739 -34.558621717415789,-58.409430491339698 -34.558691122400099,-58.409358945028629 -34.55875433344216,-58.409273941682748 -34.558828454537085,-58.409178799942538 -34.558915388605079,-58.40907803753548 -34.559005630136895,-58.408963817219544 -34.559107838029945,-58.40888358088921 -34.559180974986766,-58.408812200047016 -34.559250312811386,-58.408762625810972 -34.559297546561268,-58.408708109978875 -34.559351257269221,-58.408640988241324 -34.559415878353683,-58.408595329602306 -34.559463184193682,-58.408533316081964 -34.559526610244575,-58.408477947814433 -34.559581658557519,-58.408412185001907 -34.559650505658517,-58.408324614723682 -34.559742090510269,-58.408255698829571 -34.55981572506748,-58.408153304185163 -34.559925473009237,-58.40806172953468 -34.560021351845691,-58.407955840092029 -34.560137295514011,-58.407891692913452 -34.560207551566073,-58.40783810946558 -34.560265628687887,-58.40776910582354 -34.560341939100184,-58.407693543453561 -34.560423950997738,-58.40762505124485 -34.560498853043313,-58.407559200020245 -34.560570516661087,-58.407495734596097 -34.560638660037334,-58.407448113106874 -34.560691387327772,-58.407394869692901 -34.560749253126993,-58.407322882395597 -34.56083063257767,-58.407245528925429 -34.560916446364963,-58.407169622667567 -34.561001979057529,-58.407082046844337 -34.561097718108513,-58.407005713061906 -34.561185574548851,-58.406921201916653 -34.56128068104838,-58.406843164185169 -34.561370085970516,-58.406764784026457 -34.561462096434227,-58.406708044639409 -34.561527002891118,-58.406637331332249 -34.561610776983471,-58.406599759565701 -34.561655198319968,-58.406452545621022 -34.561819715363484,-58.406340256031953 -34.561951852547679,-58.406265281857223 -34.562041047227211,-58.406173269925077 -34.562147488258582,-58.406100338366734 -34.562236895056508,-58.406032007818069 -34.56232017691292,-58.405955839395112 -34.562411976591669,-58.405877797801011 -34.562503986626545,-58.405797964226096 -34.562601981955552,-58.405695382873944 -34.562726094528642,-58.405605667883478 -34.562832677043303,-58.405515865894706 -34.562941653921456,-58.405420184786614 -34.563057740963821,-58.405334300355733 -34.563163761664924,-58.405249015447978 -34.563264218959638,-58.405177275938911 -34.563350456595622,-58.405097779217243 -34.563451409488103,-58.404937595454591 -34.56365028624662,-58.404880165579897 -34.563724628538509,-58.404854518548511 -34.563757153035318,-58.404717847231979 -34.563685747024415,-58.404587652569134 -34.56384984728885,-58.403664927905091 -34.563347340160355,-58.403732755242316 -34.56325786194455,-58.403396194340083 -34.563072761165081,-58.403323683505477 -34.563163786282935,-58.402345663440556 -34.562628001320199,-58.400778544135925 -34.561652877534399,-58.400134936413806 -34.561239925419535,-58.40009446566377 -34.561286103910909,-58.400664131533453 -34.561651551788188,-58.402212354311146 -34.562621526608261,-58.403285255167347 -34.563212150006372,-58.403218534389744 -34.56330120595927,-58.403559862654475 -34.563487013787892,-58.403631947211217 -34.563396903861715,-58.404548204000271 -34.563896872831819,-58.404419199927474 -34.564061818585351,-58.40455570021237 -34.564134844634602,-58.404031973870111 -34.56485680893288,-58.403297896311457 -34.564709898211753,-58.403276872404184 -34.564704606057717,-58.403254231538398 -34.564698538430761,-58.403229548053922 -34.564691695122626,-58.40319354464711 -34.564681113733819,-58.403138050543923 -34.564664114094121,-58.403093451925166 -34.564649162092785,-58.403067408263936 -34.56463964191375,-58.403034896777349 -34.564627019840451,-58.403008088148006 -34.564615809059724,-58.402967579243999 -34.564596210920321,-58.402935668500326 -34.564576898679505,-58.402906823484251 -34.564556249844927,-58.40287764047563 -34.56453207955623,-58.402850841584545 -34.564507347024268,-58.402827617446285 -34.564483743049692,-58.402812135435134 -34.564466974155224,-58.402790274693103 -34.564441610201413,-58.402776325426011 -34.564424349075054,-58.402743920679221 -34.564381796082188,-58.402719087594647 -34.56434635978983,-58.402698848564967 -34.564315221713976,-58.402679807264704 -34.564275914849858,-58.40266238804066 -34.564230270473111,-58.402650488324362 -34.564204207135333,-58.402635267871553 -34.564178987270111,-58.402612985550888 -34.564148129876386,-58.40259095468938 -34.564122765801898,-58.402563731522207 -34.564096413206812,-58.402521870709919 -34.564063151678525,-58.402492600214167 -34.56404264338601,-58.402467242381832 -34.564026855534649,-58.402445287331496 -34.564014520213775,-58.402415927369802 -34.5640000684634,-58.402317458502679 -34.563960863144324,-58.402245115957847 -34.563934276875628,-58.40214681398939 -34.563899930870285,-58.402097364692501 -34.563883285882078,-58.402058468793022 -34.563870660377944,-58.402025104756824 -34.563860361656985,-58.402002720116734 -34.563853589668213,-58.401951651690503 -34.563839267861965,-58.401903305383449 -34.563827834841206,-58.401829507746434 -34.563812374852169,-58.401794779915171 -34.563804469859953,-58.401764138496134 -34.563796426046331,-58.401701154746746 -34.563778013500027,-58.401680386929357 -34.563772228218909,-58.401618336828797 -34.56375768950668,-58.40150776771118 -34.563735238780879,-58.401417540934887 -34.563718361793725,-58.401367999832154 -34.56371115349949,-58.401193324768933 -34.563691768993969,-58.40111254055271 -34.5636845448511,-58.401059506727698 -34.563680574249069,-58.401029456040959 -34.563679713964575,-58.400991742403448 -34.563680399163601,-58.400959561512124 -34.563682143533832,-58.400935297716444 -34.563684032752654,-58.400886088082203 -34.563689148917639,-58.400834663257562 -34.563696658412013,-58.400798988220281 -34.563703471615277,-58.400735383607511 -34.563719073840019,-58.400679525757603 -34.563734891244337,-58.400628605290464 -34.563750992836098,-58.400587135475213 -34.563765620276868,-58.400504535172985 -34.563796424652963,-58.40045148530217 -34.563813933598531,-58.400410783234513 -34.563826378175904,-58.400381747511908 -34.56383432145465,-58.400322741392962 -34.563847813042145,-58.400282979154738 -34.563855680390503,-58.400226444237369 -34.563865933615482,-58.400117377225016 -34.563884188418449,-58.400063398005571 -34.56389204840626,-58.399992817251835 -34.563901097079686,-58.399946671105738 -34.563907622952009,-58.399861103910453 -34.563921030234305,-58.399835390666794 -34.563925735513784,-58.399792307583041 -34.563934446099729,-58.399760633113608 -34.563941824465708,-58.399627547553948 -34.563974996680344,-58.399583525422948 -34.56398708713791,-58.399541800073187 -34.564001502813824,-58.399517871193446 -34.564010645764562,-58.399477165693682 -34.564027315566491,-58.399420705558441 -34.564050949327417,-58.399395584062141 -34.564061077594779,-58.399338530630409 -34.564081189728135,-58.399312131713536 -34.564091880720326,-58.399288115085412 -34.56410440401077,-58.39923819917513 -34.564142267064213,-58.399166983907136 -34.564201669258139,-58.399014929733589 -34.564324975739922,-58.398947718091442 -34.564380788185268,-58.398920544455528 -34.564402465086111,-58.398875057376145 -34.564437302000613,-58.398787748144848 -34.56450127322087,-58.398749077451043 -34.564528366836939,-58.398675484823279 -34.564578612162805,-58.39865385128121 -34.56459162955651,-58.39861526957791 -34.564613582105537,-58.398593379756313 -34.564627726163977,-58.39857063519986 -34.564646306584031,-58.398548312562831 -34.564669746589857,-58.398533570088496 -34.564688753761445,-58.398518654800114 -34.564711070844801,-58.398498100100383 -34.564760287550151,-58.398487271736037 -34.564781832096791,-58.398426596469399 -34.564861169847603,-58.398390807145901 -34.564904955738619,-58.398375810443973 -34.564922342967044,-58.398354090765842 -34.564936487071456,-58.398331525832873 -34.564942743056307,-58.398286143545846 -34.564951381470905,-58.398260766081016 -34.564961720644845,-58.398232482474917 -34.564987129362414,-58.398201383496783 -34.565020283404522,-58.398170108952151 -34.565060268631171,-58.398125879955231 -34.565118698511029,-58.39810440583453 -34.565145448886781,-58.39808208097223 -34.56517142412649,-58.398057028851433 -34.565201271327076,-58.398038534933775 -34.565227248587085,-58.39802455135225 -34.565255411427998,-58.398014568622102 -34.565284069366562,-58.398005177179343 -34.565318713795229,-58.397994071016051 -34.565368921376098,-58.397985618745274 -34.565400045019601,-58.397972905236209 -34.565437082155036,-58.397947055084501 -34.565507846192801,-58.39793826372383 -34.565537068160758,-58.397935092015643 -34.565565166299542,-58.397939389419406 -34.565622424606019,-58.39793971302808 -34.565644256718826,-58.397935351252933 -34.565670030180485,-58.39791454242998 -34.565716852173743,-58.397906098833708 -34.565736707716084,-58.397885758104316 -34.565838532357319,-58.397874212961987 -34.56590571226269,-58.397864131686894 -34.565951483557434,-58.39785900383449 -34.565977045331337,-58.39785677188631 -34.566000848002822,-58.39786116341093 -34.566046486131995,-58.397865738379878 -34.566075151785782,-58.397876503681246 -34.566135300974608,-58.397888027443138 -34.566205451001203,-58.397904546371066 -34.566311379886727,-58.397910396957585 -34.566341877280479,-58.397921939725862 -34.566387589625741,-58.397934084341472 -34.566425696323279,-58.397958227407329 -34.566470851943926,-58.397966813119801 -34.566487406514561,-58.397975649327044 -34.566510299521994,-58.397996034974483 -34.566570383370774,-58.398013187951364 -34.566627366776032,-58.398020740520529 -34.56665885102327,-58.398027438481542 -34.566694560353405,-58.398033374709968 -34.566724494379919,-58.39804441300592 -34.566762177924758,-58.398052911123983 -34.566781972019974,-58.398062602162561 -34.566800428659711,-58.39807569651051 -34.566821563273223,-58.398094746733427 -34.566847278701587,-58.398123412858936 -34.566878562836557,-58.398142129646963 -34.566895122752641,-58.398173356369341 -34.566917957157543,-58.398194374635516 -34.566930856150719,-58.398221097246626 -34.56694333559976,-58.398260333825938 -34.566956878033338,-58.398283055783629 -34.566968510249673,-58.39831190314689 -34.56698570931524,-58.398338451834327 -34.567002977587627,-58.39837154917138 -34.567028982079755,-58.398385841211088 -34.567042722602352,-58.398465890064877 -34.567124458445299,-58.398559127936487 -34.567215356493115,-58.398585668856398 -34.567242906844463,-58.398624284518625 -34.567289267163076,-58.398644696797227 -34.567315476197919,-58.398667406327888 -34.567343517499772,-58.398738261650152 -34.567424614507345,-58.398771179415093 -34.56746315455149,-58.398796780873084 -34.56749478904846,-58.398810389773296 -34.567511416612177,-58.398835397899482 -34.567539670361732,-58.39887240288796 -34.56757736740898,-58.398907877412363 -34.567612528323636,-58.398978400337207 -34.567683554154961,-58.399027740732826 -34.567733511645834,-58.399064489790391 -34.567772124032963,-58.399108808694592 -34.567820247807298,-58.399168097885223 -34.567886267457396,-58.399205100928953 -34.567926922275625,-58.399262011181548 -34.567986743189742,-58.399316711569377 -34.568041844414886,-58.399406974361249 -34.568129148552799,-58.399500383104133 -34.568222088298619,-58.399548705693967 -34.568267819512727,-58.399572270392241 -34.568291565123801,-58.399595407136601 -34.568318338809242,-58.399624412479362 -34.568352791911551,-58.399647890917635 -34.568378086826037,-58.399671030367152 -34.568401339218909,-58.399691107960692 -34.568420575768585,-58.399711866758004 -34.568439671815234,-58.399745966130851 -34.568493001573046,-58.399764590347743 -34.568520336303031,-58.399798439787901 -34.56856648250713,-58.399828889064473 -34.568605654817638,-58.399875245182365 -34.568663005108171,-58.399934278050729 -34.568731841269077,-58.400002329449372 -34.568808710549305,-58.400031932723159 -34.568840980666309,-58.400084250989259 -34.568895235210526,-58.400100926027335 -34.568910878241432,-58.400126536081892 -34.568932300747946,-58.40015504037089 -34.568954288136574,-58.400175294544184 -34.568965425753888,-58.40019342020279 -34.568976703129088,-58.400204221010029 -34.568992131860938,-58.400222246423724 -34.569023621321591,-58.400189023582833 -34.569049732202842,-58.400165086103542 -34.569068523571858,-58.400141233855656 -34.56908717412864,-58.400117296460429 -34.569105824637049,-58.400093273970526 -34.569124404671498,-58.400069251522766 -34.569142914275602,-58.40004531430678 -34.569161283067473,-58.40002120685952 -34.569179581341636,-58.399997099507438 -34.569197738759868,-58.399962173948857 -34.569223637427186,-58.39956098323097 -34.568807215410523,-58.39952720969363 -34.568773323232833,-58.399465106733359 -34.568711739120339,-58.399366170623736 -34.568609570735738,-58.398919555094139 -34.568151501474439,-58.398655333460894 -34.567877478021302,-58.398429392858247 -34.56764446184112,-58.398354957796904 -34.567568785541205,-58.398183288924741 -34.567395377543946,-58.398059854047176 -34.567271292769419,-58.397989247662444 -34.56719956210307,-58.397852290839857 -34.567057581844026,-58.397603219981633 -34.566796522426877,-58.397574044481161 -34.566763688534451,-58.397525640795998 -34.566715280312302,-58.397504457200689 -34.566696254087773,-58.397487782046269 -34.566681948783462,-58.397448644003191 -34.56665157443431,-58.397420649926218 -34.566632262852139,-58.397389588334043 -34.566616400477045,-58.397366268234087 -34.566607866500377,-58.397339542221516 -34.566600034951783,-58.397312558992397 -34.566594527304524,-58.397289574645548 -34.566592120520681,-58.397252966904979 -34.566592171325695,-58.397225977557262 -34.566594480898203,-58.397204095429231 -34.566597849589023,-58.39715036533137 -34.566611131189354,-58.39708982060985 -34.56662933889595,-58.397043155062654 -34.56664459616259,-58.397003811927583 -34.566658730542535,-58.396978774377821 -34.566668999203984,-58.396950669273203 -34.56668271706274,-58.396890112472605 -34.566716136593904,-58.396778546777362 -34.566766501130722,-58.396687506347128 -34.566806735379146,-58.396568020454701 -34.566860194166004,-58.396537275771955 -34.566874262627117,-58.396516833630919 -34.566886716877598,-58.396492552618682 -34.56690902862681,-58.396449695070736 -34.566953021376058,-58.396317537658227 -34.567096124826818,-58.396259425293529 -34.567159617102263,-58.396238889277797 -34.567182916796504,-58.396215114429779 -34.567210862812743,-58.396199774807805 -34.567230151071129,-58.396168838062728 -34.567271333188692,-58.396056081452755 -34.567425715015524,-58.396006986004522 -34.567497944863021,-58.395935386874136 -34.567605093478392,-58.395868647596188 -34.567703089383585,-58.395847935938235 -34.567732797642499,-58.395830975970931 -34.567755324542624,-58.395781700214101 -34.567733324756212,-58.395746922220127 -34.567786688284642,-58.395794666069854 -34.567808053414993,-58.395751536990439 -34.567871131098187,-58.395684884057935 -34.567967084603637,-58.395595815347306 -34.568094083435092,-58.395405995787911 -34.568370047237394,-58.395249324987958 -34.568606379450088,-58.395234825555107 -34.56863890805591,-58.395221680610895 -34.568680944861889,-58.395215530771367 -34.568705731266398,-58.395211684274791 -34.568724744046399,-58.395205612452258 -34.568758333690738,-58.395202694313348 -34.568787417841378,-58.39520436830346 -34.56882298368415,-58.395208753574025 -34.568874748908669,-58.39521253959412 -34.568930598484762,-58.395212098491591 -34.568949683572271,-58.395189349387458 -34.568971502922047,-58.39509025227153 -34.569074339843702,-58.395018081074589 -34.569148880534037,-58.394946423540276 -34.569219759335994,-58.394925546732402 -34.569242283930464,-58.394886478181093 -34.569230853290328,-58.39485968055412 -34.569205626045331,-58.394839428348838 -34.569192867759774,-58.394769811418918 -34.569162123488987,-58.394741808069035 -34.569153938535912,-58.39471328885989 -34.569151950739638,-58.39468161592194 -34.56915446841623,-58.394651130765887 -34.569162057388091,-58.394630690366292 -34.569171342167657,-58.394609650445368 -34.569184992994948,-58.394586392538685 -34.569204065350206,-58.394561852915622 -34.569228841456955,-58.392937828290663 -34.571979583144909,-58.392787192516657 -34.572234716766197,-58.393177984498116 -34.572213568830882,-58.39392474488298 -34.572262346678258,-58.394191302682707 -34.572281159339866,-58.394323517465011 -34.57229045921801,-58.394451138344486 -34.572295319575659,-58.394820293937975 -34.572309399247757,-58.395205818732627 -34.572190664289522,-58.398350990520612 -34.570397919775019,-58.39879730864503 -34.570143495398156,-58.398978210908126 -34.570052318432047,-58.399339758784386 -34.569870033983122,-58.400125652295358 -34.56935079656683,-58.400485320204098 -34.569135943628147,-58.401305889543551 -34.568528163758977,-58.401799822657878 -34.568097969982929,-58.40227263703207 -34.567550223403522,-58.402330404664539 -34.567486587245476,-58.402369427553772 -34.567443646922754,-58.402481914535699 -34.567292850830746,-58.402598312646873 -34.567148535712086,-58.402677147484958 -34.56702997778585,-58.402718389751506 -34.566978305664556,-58.402753070697358 -34.566934870102656,-58.403023870514176 -34.566595762638769,-58.403151437545816 -34.567142398051836,-58.403598485619909 -34.567375301489172,-58.403667789061103 -34.567370264379143,-58.403757271017724 -34.567363053780866,-58.403846669957595 -34.567352814776193,-58.403935645380862 -34.567339476775757,-58.403993033892547 -34.567328729271239,-58.404064728612362 -34.56731291796892,-58.404144344304719 -34.567292180632158,-58.404202759159297 -34.567274602237958,-58.404269946523215 -34.567251816520489,-58.404323680729192 -34.567231630080599,-58.404395640440235 -34.567201874441238,-58.404448610482596 -34.567178659280302,-58.404500304259535 -34.567154316678177,-58.404647129158263 -34.567078679066405,-58.405081298086301 -34.566857889216678,-58.405311157112266 -34.56673982332422,-58.40561153114799 -34.566585872932301,-58.40571892192704 -34.566532258791632,-58.405774278291219 -34.566504114373636,-58.405828440296283 -34.566479561080087,-58.405884133101353 -34.566457332520038,-58.405941016126036 -34.566437498958663,-58.405999004240343 -34.566420060354758,-58.406058097448586 -34.566405016706817,-58.406117955124003 -34.566392508706549,-58.406178492185397 -34.56638246588787,-58.406240049126083 -34.566374958832895,-58.406407515806187 -34.566362852540145,-58.406537853821753 -34.566365940874157,-58.406603912176017 -34.566374281469216,-58.40666239244063 -34.566384379190438,-58.406720189948743 -34.566397011892569,-58.406777134437334 -34.566412179498577,-58.406832970650456 -34.566429670615996,-58.406887698497883 -34.566449626097487,-58.406941062675614 -34.566471904976737,-58.407006254460413 -34.566503274132941,-58.407067442317789 -34.566538655689399,-58.407128032367154 -34.566576924392876,-58.407186577800644 -34.56661737533021,-58.407243078760146 -34.566659797227516,-58.407297194756119 -34.566704119507492,-58.407349096010421 -34.566750412676008,-58.407398527259794 -34.566798465343432,-58.407440807739988 -34.566845810497703,-58.407479853530461 -34.566892590769001,-58.407535744047927 -34.566957478021251;"58.407645243044826 -34.567062461605147,-58.407859817717835 -34.567268060098904,-58.408671762103793 -34.566853051933762,-58.40934343682509 -34.566509811232372,-58.410202215353948 -34.566054459411575,-58.41076411575672 -34.565751094913189,-58.410919790704583 -34.565668481363801,-58.411564884698365 -34.56532606219433,-58.412339400799652 -34.564940662992633,-58.412466459257033 -34.564872895458436,-58.41262545678871 -34.564780703201578,-58.412739313711349 -34.564722226149307,-58.412928702590555 -34.564630468482619,-58.413077386247451 -34.564558342733896,-58.413276057856322 -34.564459686586005,-58.413525569903463 -34.564331894388182,-58.413589264731456 -34.564304383603577,-58.413939088741735 -34.564129093562151,-58.41426175013433 -34.563961045579447,-58.414490656013776 -34.563835637691533,-58.414663018148637 -34.563737884414302,-58.414730037524812 -34.563701219005559,-58.414909212614468 -34.563598186131635,-58.415038656965024 -34.563519289585095,-58.415111551966284 -34.563479245828056,-58.415311763868146 -34.563357839462981,-58.415455513861708 -34.563271130775895,-58.415630094680218 -34.563159925682143,-58.415832517747226 -34.563039786970315,-58.416044821812584 -34.562908101889256,-58.416189101212296 -34.56282299437364,-58.416419904721721 -34.562640513998382,-58.416635456980032 -34.562470245854655,-58.416802017588665 -34.562334539849424,-58.417009237036702 -34.562692847703779,-58.417394793598298 -34.562997035433597)))""";1243;14_10_2;COMUNA 14;10;2;0;0;0;0,00%;0;0;0,00%;0;0,00%;0;0;0,00%;0;0,00%
MULTIPOLYGON (((-58.424276826705565 -34.574805711592759,-58.423529322132204 -34.575068090764375,-58.424254655172618 -34.576360136516428,-58.423529874610388 -34.576794572268838,-58.424351027230188 -34.577682194236147,-58.424695696922882 -34.578054852860625,-58.425252448352026 -34.578663501094155,-58.425950975348321 -34.578310529629412,-58.426202438915325 -34.57824877150847,-58.426531222955234 -34.578167950499449,-58.426781493500549 -34.578106472532191,-58.426717432877943 -34.577980532897662,-58.426656264969353 -34.577860228120144,-58.42571469251061 -34.576008812252567,-58.425248600692157 -34.575092222934565,-58.424987454152294 -34.574556204313524,-58.424409926001047 -34.574758920445788,-58.424408952422318 -34.574757088861176,-58.424406848634504 -34.574759986611475,-58.424276719299165 -34.574805504417597,-58.424276826705565 -34.574805711592759)));;1244;14_11_1;COMUNA 14;11;1;1047;484;563;85,97%;404;402;99,50%;2;0,50%;284;4;1,41%;280;98,59%
MULTIPOLYGON (((-58.424255685276556 -34.579162789905794,-58.425097844834589 -34.578690763253817,-58.425252448352026 -34.578663501094155,-58.424695696922882 -34.578054852860625,-58.424351027230188 -34.577682194236147,-58.42341560749837 -34.578248962755779,-58.423736191688732 -34.578594220789491,-58.424255685276556 -34.579162789905794)));;1245;14_11_10;COMUNA 14;11;10;444;210;234;89,74%;315;313;99,37%;2;0,64%;208;1;0,48%;207;99,52%
MULTIPOLYGON (((-58.423403223914228 -34.579642607958988,-58.424127894752665 -34.579251392415017,-58.424255685276556 -34.579162789905794,-58.423736191688732 -34.578594220789491,-58.42341560749837 -34.578248962755779,-58.422528211807844 -34.578786583718262,-58.422570836485313 -34.578856882363006,-58.422669209813151 -34.578796630460275,-58.422964131600473 -34.579209490522672,-58.422843869442588 -34.579281778268509,-58.42312056078007 -34.579718787900866,-58.423346528280952 -34.579568220897976,-58.423403223914228 -34.579642607958988)));;1246;14_11_11;COMUNA 14;11;11;526;233;293;79,52%;467;467;100,00%;0;0,00%;316;5;1,58%;311;98,42%
MULTIPOLYGON (((-58.420585735628507 -34.580793215067821,-58.420725900264458 -34.580712640749518,-58.420947277360092 -34.580669046104134,-58.421284384527219 -34.580674199871098,-58.421465092122396 -34.580738927101542,-58.421597040913824 -34.580844788772623,-58.422323429993149 -34.580359198616421,-58.423403223914228 -34.579642607958988,-58.423346528280952 -34.579568220897976,-58.42312056078007 -34.579718787900866,-58.422843869442588 -34.579281778268509,-58.422964131600473 -34.579209490522672,-58.422669209813151 -34.578796630460275,-58.422570836485313 -34.578856882363006,-58.422528211807844 -34.578786583718262,-58.42341560749837 -34.578248962755779,-58.422872399067501 -34.577663973491767,-58.42258841513803 -34.5773588677026,-58.421212340370332 -34.575904191599946,-58.420988712198273 -34.575985949824464,-58.420872469976601 -34.576027813222339,-58.420224662357548 -34.576260979635279,-58.420025322848645 -34.576294784771854,-58.419719768603699 -34.576240590775306,-58.418349490220585 -34.575864028380934,-58.418196862471731 -34.576278004370188,-58.41801004669923 -34.576614288303205,-58.417737252420388 -34.576914904989415,-58.417269307933765 -34.577348767846196,-58.420220385907776 -34.580416849641963,-58.420585735628507 -34.580793215067821)));;1247;14_11_12;COMUNA 14;11;12;727;344;383;89,82%;514;513;99,81%;1;0,19%;362;3;0,83%;359;99,17%
MULTIPOLYGON (((-58.418349490220585 -34.575864028380934,-58.419719768603699 -34.576240590775306,-58.420025322848645 -34.576294784771854,-58.420224662357548 -34.576260979635279,-58.420872469976601 -34.576027813222339,-58.420988712198273 -34.575985949824464,-58.421212340370332 -34.575904191599946,-58.420585036332533 -34.574991262128073,-58.41942725654264 -34.575500667469925,-58.418826138660386 -34.574702390936181,-58.420024278354653 -34.574173356621657,-58.419204476704195 -34.572971466792694,-58.418173262296087 -34.573432241405911,-58.41794919924034 -34.573537938619275,-58.417463003460952 -34.573767276213637,-58.416259969639761 -34.574351426741877,-58.415997170979374 -34.574441048591481,-58.41551758660291 -34.574553474563949,-58.415180238930205 -34.574577781354598,-58.414986362226927 -34.574591086572283,-58.414795413371827 -34.574695171126088,-58.414676912691341 -34.5748125943269,-58.414623608385469 -34.57496927011897,-58.414688578590486 -34.575106414169632,-58.41491941038673 -34.575238693435324,-58.415573562635132 -34.575543115531929,-58.417269307933765 -34.577348767846196,-58.417737252420388 -34.576914904989415,-58.41801004669923 -34.576614288303205,-58.418196862471731 -34.576278004370188,-58.418349490220585 -34.575864028380934)));;1248;14_11_13;COMUNA 14;11;13;776;344;432;79,63%;673;673;100,00%;0;0,00%;399;2;0,50%;397;99,50%
MULTIPOLYGON (((-58.420024278354653 -34.574173356621657,-58.418826138660386 -34.574702390936181,-58.41942725654264 -34.575500667469925,-58.420585036332533 -34.574991262128073,-58.420198093643407 -34.574428146393565,-58.420024278354653 -34.574173356621657)));;1249;14_11_14;COMUNA 14;11;14;523;238;285;83,51%;333;333;100,00%;0;0,00%;231;2;0,87%;229;99,13%
MULTIPOLYGON (((-58.42291162426757 -34.573967633014732,-58.423529322132204 -34.575068090764375,-58.424276826705565 -34.574805711592759,-58.424276719299165 -34.574805504417597,-58.424406848634504 -34.574759986611475,-58.424408952422318 -34.574757088861176,-58.424409926001047 -34.574758920445788,-58.424987454152294 -34.574556204313524,-58.424853479616687 -34.574281221594511,-58.423244744054266 -34.57116818481272,-58.422998645506219 -34.571267545913877,-58.422694981207563 -34.571390198525236,-58.422614640407993 -34.571426641522777,-58.422608508041307 -34.571429434809829,-58.422515088428646 -34.571471803735633,-58.422117440590867 -34.571652202237253,-58.421741296394345 -34.571822788152268,-58.422430646129854 -34.573110819075183,-58.42291162426757 -34.573967633014732)));;1250;14_11_2;COMUNA 14;11;2;955;469;486;96,50%;760;760;100,00%;0;0,00%;468;4;0,85%;464;99,15%
MULTIPOLYGON (((-58.421741296394345 -34.571822788152268,-58.420548133269591 -34.572364024880009,-58.421256807541866 -34.573629110260178,-58.422430646129854 -34.573110819075183,-58.421741296394345 -34.571822788152268)));;1251;14_11_3;COMUNA 14;11;3;507;225;282;79,79%;334;334;100,00%;0;0,00%;237;1;0,42%;236;99,58%
MULTIPOLYGON (((-58.420548133269591 -34.572364024880009,-58.42002218621807 -34.572602584730582,-58.419500068399252 -34.572839383021211,-58.419204476704195 -34.572971466792694,-58.420024278354653 -34.574173356621657,-58.420816103322345 -34.573823756860222,-58.421256807541866 -34.573629110260178,-58.420548133269591 -34.572364024880009)));;1252;14_11_4;COMUNA 14;11;4;710;300;410;73,17%;387;387;100,00%;0;0,00%;279;0;0,00%;279;100,00%
MULTIPOLYGON (((-58.421256807541866 -34.573629110260178,-58.420816103322345 -34.573823756860222,-58.420024278354653 -34.574173356621657,-58.420198093643407 -34.574428146393565,-58.420585036332533 -34.574991262128073,-58.421734456236997 -34.574485575503914,-58.42291162426757 -34.573967633014732,-58.422430646129854 -34.573110819075183,-58.421256807541866 -34.573629110260178)));;1253;14_11_5;COMUNA 14;11;5;799;375;424;88,44%;553;553;100,00%;0;0,00%;379;1;0,26%;378;99,74%
MULTIPOLYGON (((-58.42291162426757 -34.573967633014732,-58.421734456236997 -34.574485575503914,-58.420585036332533 -34.574991262128073,-58.421212340370332 -34.575904191599946,-58.422128138317355 -34.575569344437255,-58.422302882629509 -34.575507005391579,-58.423255711425846 -34.575167091356697,-58.423529322132204 -34.575068090764375,-58.42291162426757 -34.573967633014732)));;1254;14_11_6;COMUNA 14;11;6;911;435;476;91,39%;504;504;100,00%;0;0,00%;353;3;0,85%;350;99,15%
MULTIPOLYGON (((-58.423529322132204 -34.575068090764375,-58.423255711425846 -34.575167091356697,-58.422302882629509 -34.575507005391579,-58.423529874610388 -34.576794572268838,-58.424254655172618 -34.576360136516428,-58.423529322132204 -34.575068090764375)));;1255;14_11_7;COMUNA 14;11;7;561;259;302;85,76%;428;426;99,53%;2;0,47%;267;18;6,74%;249;93,26%
MULTIPOLYGON (((-58.422302882629509 -34.575507005391579,-58.422128138317355 -34.575569344437255,-58.421212340370332 -34.575904191599946,-58.42258841513803 -34.5773588677026,-58.423529874610388 -34.576794572268838,-58.422302882629509 -34.575507005391579)));;1256;14_11_8;COMUNA 14;11;8;1045;479;566;84,63%;746;745;99,87%;1;0,13%;529;1;0,19%;528;99,81%
MULTIPOLYGON (((-58.423529874610388 -34.576794572268838,-58.42258841513803 -34.5773588677026,-58.422872399067501 -34.577663973491767,-58.42341560749837 -34.578248962755779,-58.424351027230188 -34.577682194236147,-58.423529874610388 -34.576794572268838)));;1257;14_11_9;COMUNA 14;11;9;694;322;372;86,56%;607;607;100,00%;0;0,00%;412;20;4,85%;392;95,15%
MULTIPOLYGON (((-58.427995677405953 -34.581787188060297,-58.428311945158214 -34.581527548544393,-58.428527360446928 -34.581350700327832,-58.428760406575556 -34.581159348987129,-58.428826674617831 -34.581104928524205,-58.429010061146009 -34.580954409668514,-58.42892170987664 -34.580872269172175,-58.428477836954514 -34.580438324721115,-58.428064971670835 -34.579982203408647,-58.427843008410925 -34.579737059606813,-58.426531222955234 -34.578167950499449,-58.426202438915325 -34.57824877150847,-58.425950975348321 -34.578310529629412,-58.425252448352026 -34.578663501094155,-58.425097844834589 -34.578690763253817,-58.424255685276556 -34.579162789905794,-58.424377374284084 -34.579291182986964,-58.424569191299135 -34.579500155436918,-58.425334029105386 -34.580352680926211,-58.426193702674183 -34.579729464474092,-58.427072082992012 -34.58073251215022,-58.427995677405953 -34.581787188060297)));;1258;14_12_1;COMUNA 14;12;1;434;187;247;75,71%;315;315;100,00%;0;0,00%;230;15;6,52%;215;93,48%
MULTIPOLYGON (((-58.423756720939863 -34.581495967590122,-58.422899310885576 -34.582117406786473,-58.424019468854453 -34.583016184158048,-58.424672287975454 -34.582528200231408,-58.424869393705301 -34.582379029992843,-58.423756720939863 -34.581495967590122)));;1259;14_12_10;COMUNA 14;12;10;743;341;402;84,83%;604;604;100,00%;0;0,00%;352;2;0,57%;350;99,43%
MULTIPOLYGON (((-58.421597040913824 -34.580844788772623,-58.421661969082919 -34.580960705608128,-58.421733555052555 -34.58118205290755,-58.422899310885576 -34.582117406786473,-58.423756720939863 -34.581495967590122,-58.422602279704215 -34.580579781246094,-58.422323429993149 -34.580359198616421,-58.421597040913824 -34.580844788772623)));;1260;14_12_11;COMUNA 14;12;11;606;285;321;88,79%;357;355;99,44%;2;0,56%;274;22;8,03%;252;91,97%
MULTIPOLYGON (((-58.426193702674183 -34.579729464474092,-58.425334029105386 -34.580352680926211,-58.426235310047154 -34.581357431740109,-58.427072082992012 -34.58073251215022,-58.426193702674183 -34.579729464474092)));;1261;14_12_2;COMUNA 14;12;2;841;381;460;82,83%;526;524;99,62%;2;0,38%;382;48;12,57%;334;87,43%
MULTIPOLYGON (((-58.427072082992012 -34.58073251215022,-58.426235310047154 -34.581357431740109,-58.425436854816013 -34.581953694076084,-58.426394074345559 -34.583013744486315,-58.427180784782735 -34.582411275137346,-58.427995677405953 -34.581787188060297,-58.427072082992012 -34.58073251215022)));;1262;14_12_3;COMUNA 14;12;3;633;312;321;97,20%;559;559;100,00%;0;0,00%;329;10;3,04%;319;96,96%
MULTIPOLYGON (((-58.425334029105386 -34.580352680926211,-58.424524767569451 -34.580939285799246,-58.425304172031431 -34.581806675602095,-58.425436854816013 -34.581953694076084,-58.426235310047154 -34.581357431740109,-58.425334029105386 -34.580352680926211)));;1263;14_12_4;COMUNA 14;12;4;767;290;477;60,80%;463;460;99,35%;3;0,65%;344;66;19,19%;278;80,81%
MULTIPOLYGON (((-58.423611701708538 -34.579880009212673,-58.424396173361188 -34.580796140993421,-58.424524767569451 -34.580939285799246,-58.425334029105386 -34.580352680926211,-58.424569191299135 -34.579500155436918,-58.424377374284084 -34.579291182986964,-58.424255685276556 -34.579162789905794,-58.424127894752665 -34.579251392415017,-58.423403223914228 -34.579642607958988,-58.423611701708538 -34.579880009212673)));;1264;14_12_5;COMUNA 14;12;5;829;353;476;74,16%;501;500;99,80%;1;0,20%;380;6;1,58%;374;98,42%
MULTIPOLYGON (((-58.423611701708538 -34.579880009212673,-58.423403223914228 -34.579642607958988,-58.422323429993149 -34.580359198616421,-58.422602279704215 -34.580579781246094,-58.423756720939863 -34.581495967590122,-58.424524767569451 -34.580939285799246,-58.424396173361188 -34.580796140993421,-58.423611701708538 -34.579880009212673)));;1265;14_12_6;COMUNA 14;12;6;551;228;323;70,59%;357;356;99,72%;1;0,28%;264;6;2,27%;258;97,73%
MULTIPOLYGON (((-58.424524767569451 -34.580939285799246,-58.423756720939863 -34.581495967590122,-58.424869393705301 -34.582379029992843,-58.425024590532921 -34.582261608373912,-58.425436854816013 -34.581953694076084,-58.425304172031431 -34.581806675602095,-58.424524767569451 -34.580939285799246)));;1266;14_12_7;COMUNA 14;12;7;324;149;175;85,14%;187;186;99,47%;1;0,54%;145;2;1,38%;143;98,62%
MULTIPOLYGON (((-58.425436854816013 -34.581953694076084,-58.425024590532921 -34.582261608373912,-58.424869393705301 -34.582379029992843,-58.426025246655769 -34.583296251445603,-58.426394074345559 -34.583013744486315,-58.425436854816013 -34.581953694076084)));;1267;14_12_8;COMUNA 14;12;8;332;145;187;77,54%;281;281;100,00%;0;0,00%;188;0;0,00%;188;100,00%
MULTIPOLYGON (((-58.424869393705301 -34.582379029992843,-58.424672287975454 -34.582528200231408,-58.424019468854453 -34.583016184158048,-58.425177614993608 -34.583945386589647,-58.426025246655769 -34.583296251445603,-58.424869393705301 -34.582379029992843)));;1268;14_12_9;COMUNA 14;12;9;671;313;358;87,43%;399;394;98,75%;5;1,27%;327;74;22,63%;253;77,37%
MULTIPOLYGON (((-58.43786582180654 -34.587739415756197,-58.437917521829817 -34.587704143152621,-58.437918058462401 -34.587703777249736,-58.436700788031651 -34.586807451170969,-58.436666616171827 -34.58678229619575,-58.435701361232439 -34.586070930891019,-58.434753234344917 -34.585372167943348,-58.434364234361034 -34.585680400648613,-58.434238511638711 -34.585785727788902,-58.434037496518094 -34.585937799600948,-58.433665952283206 -34.586233357578408,-58.433511965309904 -34.586355839405151,-58.433511609909594 -34.586356072219374,-58.433307863824545 -34.586517579163569,-58.432902073240847 -34.586838197970451,-58.433946185934737 -34.58749530596107,-58.434112629093171 -34.587600067597407,-58.434869504277501 -34.588074909558841,-58.436195035655849 -34.58890657608341,-58.436274627618339 -34.589000681625429,-58.437124392853306 -34.589612013914063,-58.438051432688709 -34.588990067067968,-58.438123319433693 -34.588941840193613,-58.438249887619811 -34.588856862204963,-58.438251316177706 -34.588855926553563,-58.438261413155168 -34.588848868077399,-58.438275318079505 -34.588839329646859,-58.438288934532871 -34.588829934275232,-58.438303358742978 -34.588819966590705,-58.438318013718195 -34.588809903538404,-58.438332380222271 -34.588799983544945,-58.438345881278572 -34.588790635849939,-58.438360190063058 -34.588780811253798,-58.438373748812197 -34.58877141586111,-58.438387480641467 -34.588761925089237,-58.438398385312908 -34.588754437407879,-58.438412866640654 -34.588746330258445,-58.438425501972375 -34.588738461270488,-58.438498057721922 -34.588690004459565,-58.438498470381028 -34.588690004541398,-58.438513199169641 -34.588683902935919,-58.438526526841557 -34.588675557013914,-58.438533389209098 -34.588671257682599,-58.438541066118219 -34.588666448033102,-58.438554393812147 -34.58865800669588,-58.438568586903394 -34.588649136173657,-58.438582779991641 -34.588640265649744,-58.438595184551104 -34.588632396598477,-58.43860903146836 -34.588623716827414,-58.438614342268707 -34.588620375880893,-58.438271548748617 -34.588459033658388,-58.438081932003982 -34.588368217257639,-58.43786582180654 -34.587739415756197)));;1269;14_13_1;COMUNA 14;13;1;697;319;378;84,39%;299;299;100,00%;0;0,00%;267;36;13,48%;231;86,52%
MULTIPOLYGON (((-58.435310818557852 -34.590821879938801,-58.436036696170994 -34.590341810285196,-58.436173915655843 -34.590249723836827,-58.436061453676764 -34.590148920669726,-58.435261410464349 -34.589575128936971,-58.435134129597145 -34.589484885375114,-58.43397642145225 -34.588717193251277,-58.433084261840143 -34.589358836732771,-58.434366528611221 -34.590210513234439,-58.433432972487175 -34.590841585685716,-58.434363212859914 -34.591448660343744,-58.435310818557852 -34.590821879938801)));;1270;14_13_10;COMUNA 14;13;10;735;326;409;79,71%;366;364;99,45%;2;0,55%;294;9;3,06%;285;96,94%
MULTIPOLYGON (((-58.432185217812545 -34.588761689906846,-58.431207891718003 -34.58938949496838,-58.431713178771354 -34.589719214962443,-58.432169345280869 -34.590016947461237,-58.433432972487175 -34.590841585685716,-58.434366528611221 -34.590210513234439,-58.433084261840143 -34.589358836732771,-58.43397642145225 -34.588717193251277,-58.433129480957597 -34.588155489531644,-58.432185217812545 -34.588761689906846)));;1271;14_13_11;COMUNA 14;13;11;621;262;359;72,98%;324;323;99,69%;1;0,31%;260;38;14,62%;222;85,38%
MULTIPOLYGON (((-58.431713178771354 -34.589719214962443,-58.431207891718003 -34.58938949496838,-58.430250653268644 -34.590004339213323,-58.430768457303635 -34.590337305979013,-58.431272898809077 -34.59066160477348,-58.432516523497291 -34.591461105404477,-58.433445575289454 -34.59205839758171,-58.434132633784301 -34.591601077426027,-58.434363212859914 -34.591448660343744,-58.433432972487175 -34.590841585685716,-58.432169345280869 -34.590016947461237,-58.431713178771354 -34.589719214962443)));;1272;14_13_12;COMUNA 14;13;12;559;248;311;79,74%;320;320;100,00%;0;0,00%;247;4;1,62%;243;98,38%
MULTIPOLYGON (((-58.433511965309904 -34.586355839405151,-58.433665952283206 -34.586233357578408,-58.434037496518094 -34.585937799600948,-58.434238511638711 -34.585785727788902,-58.434364234361034 -34.585680400648613,-58.434753234344917 -34.585372167943348,-58.433816871397283 -34.584682062663923,-58.432930069349794 -34.584028442591581,-58.431670590829867 -34.583100133094931,-58.430689417296108 -34.582376962648375,-58.430166404101968 -34.581991456360939,-58.43004127747772 -34.581879657769463,-58.429110073656133 -34.581047328403606,-58.429010061146009 -34.580954409668514,-58.428826674617831 -34.581104928524205,-58.428760406575556 -34.581159348987129,-58.428527360446928 -34.581350700327832,-58.428311945158214 -34.581527548544393,-58.427995677405953 -34.581787188060297,-58.427180784782735 -34.582411275137346,-58.427276363410833 -34.582517786170854,-58.428098706122235 -34.583436651356934,-58.428352595995413 -34.583720255816544,-58.428619509889529 -34.58401844143399,-58.42871492183086 -34.584125092118327,-58.429396176743751 -34.584882916484489,-58.430173433895114 -34.584273664608986,-58.431160944693708 -34.585399603501344,-58.431835415768539 -34.586168539561648,-58.432902073240847 -34.586838197970451,-58.433307863824545 -34.586517579163569,-58.433511609909594 -34.586356072219374,-58.433511965309904 -34.586355839405151)));;1273;14_13_2;COMUNA 14;13;2;676;331;345;95,94%;446;445;99,78%;1;0,22%;313;51;16,29%;262;83,71%
MULTIPOLYGON (((-58.427180784782735 -34.582411275137346,-58.426394074345559 -34.583013744486315,-58.426025246655769 -34.583296251445603,-58.427151672284694 -34.584190142442985,-58.42732901811582 -34.584047874209979,-58.428098706122235 -34.583436651356934,-58.427276363410833 -34.582517786170854,-58.427180784782735 -34.582411275137346)));;1274;14_13_3;COMUNA 14;13;3;749;357;392;91,07%;591;591;100,00%;0;0,00%;406;20;4,93%;386;95,07%
MULTIPOLYGON (((-58.427151672284694 -34.584190142442985,-58.426313654914075 -34.584856824107661,-58.426989999945114 -34.585310704323589,-58.427997000075884 -34.585979683957511,-58.428845658853291 -34.585314472742105,-58.429396176743751 -34.584882916484489,-58.42871492183086 -34.584125092118327,-58.428619509889529 -34.58401844143399,-58.428352595995413 -34.583720255816544,-58.428098706122235 -34.583436651356934,-58.42732901811582 -34.584047874209979,-58.427151672284694 -34.584190142442985)));;1275;14_13_4;COMUNA 14;13;4;595;275;320;85,94%;316;315;99,68%;1;0,32%;242;33;13,64%;209;86,36%
MULTIPOLYGON (((-58.430348115869279 -34.585941807153205,-58.431071959845326 -34.586746959089496,-58.431213865132413 -34.58664762556316,-58.431835415768539 -34.586168539561648,-58.431160944693708 -34.585399603501344,-58.430173433895114 -34.584273664608986,-58.429396176743751 -34.584882916484489,-58.428845658853291 -34.585314472742105,-58.427997000075884 -34.585979683957511,-58.429146527175718 -34.586743346200215,-58.430070612017893 -34.586126881634684,-58.430348115869279 -34.585941807153205)));;1276;14_13_5;COMUNA 14;13;5;723;332;391;84,91%;435;432;99,31%;3;0,69%;301;1;0,33%;300;99,67%
MULTIPOLYGON (((-58.429148898226252 -34.588047554410586,-58.430123084151262 -34.587392017262843,-58.430822986017581 -34.586921056287579,-58.431071959845326 -34.586746959089496,-58.430348115869279 -34.585941807153205,-58.430070612017893 -34.586126881634684,-58.429146527175718 -34.586743346200215,-58.428157181693528 -34.587403237705992,-58.427369016059039 -34.587928948768059,-58.427204703248215 -34.588039398494097,-58.427692770679457 -34.588354904266417,-58.428201529320752 -34.588683865166622,-58.42871250551152 -34.58901416262885,-58.429062495007848 -34.589240465844391,-58.429228168386992 -34.589346994533273,-58.429952801619415 -34.588872378390306,-58.429790470108017 -34.588464365575732,-58.429660639819559 -34.588380031334218,-58.429148898226252 -34.588047554410586)));;1277;14_13_6;COMUNA 14;13;6;584;281;303;92,74%;408;407;99,75%;1;0,25%;278;3;1,08%;275;98,92%
MULTIPOLYGON (((-58.430530771712789 -34.587662651348786,-58.430529341777046 -34.587661854219355,-58.430123084151262 -34.587392017262843,-58.429148898226252 -34.588047554410586,-58.429660639819559 -34.588380031334218,-58.429790470108017 -34.588464365575732,-58.429952801619415 -34.588872378390306,-58.429228168386992 -34.589346994533273,-58.429733534432856 -34.589671863396184,-58.430250653268644 -34.590004339213323,-58.431207891718003 -34.58938949496838,-58.432185217812545 -34.588761689906846,-58.431793933324911 -34.588501862702699,-58.431643669168956 -34.588402031813715,-58.431162145185851 -34.588082177157901,-58.430530771712789 -34.587662651348786)));;1278;14_13_7;COMUNA 14;13;7;385;170;215;79,07%;192;188;97,92%;4;2,13%;147;12;8,16%;135;91,84%
MULTIPOLYGON (((-58.431835415768539 -34.586168539561648,-58.431213865132413 -34.58664762556316,-58.431071959845326 -34.586746959089496,-58.430822986017581 -34.586921056287579,-58.430123084151262 -34.587392017262843,-58.430529341777046 -34.587661854219355,-58.430530771712789 -34.587662651348786,-58.431162145185851 -34.588082177157901,-58.431643669168956 -34.588402031813715,-58.431793933324911 -34.588501862702699,-58.432185217812545 -34.588761689906846,-58.433129480957597 -34.588155489531644,-58.433946185934737 -34.58749530596107,-58.432902073240847 -34.586838197970451,-58.431835415768539 -34.586168539561648)));;1279;14_13_8;COMUNA 14;13;8;662;308;354;87,01%;352;350;99,43%;2;0,57%;275;30;10,91%;245;89,09%
MULTIPOLYGON (((-58.435261410464349 -34.589575128936971,-58.436061453676764 -34.590148920669726,-58.436173915655843 -34.590249723836827,-58.437124392853306 -34.589612013914063,-58.436274627618339 -34.589000681625429,-58.436195035655849 -34.58890657608341,-58.434869504277501 -34.588074909558841,-58.434112629093171 -34.587600067597407,-58.433946185934737 -34.58749530596107,-58.433129480957597 -34.588155489531644,-58.43397642145225 -34.588717193251277,-58.435134129597145 -34.589484885375114,-58.435261410464349 -34.589575128936971)));;1280;14_13_9;COMUNA 14;13;9;769;332;437;75,97%;432;431;99,77%;1;0,23%;337;12;3,56%;325;96,44%
MULTIPOLYGON (((-58.426025246655769 -34.583296251445603,-58.425177614993608 -34.583945386589647,-58.426313654914075 -34.584856824107661,-58.427151672284694 -34.584190142442985,-58.426025246655769 -34.583296251445603)));;1281;14_14_1;COMUNA 14;14;1;878;390;488;79,92%;613;611;99,67%;2;0,33%;460;15;3,26%;445;96,74%
MULTIPOLYGON (((-58.42123571183609 -34.586963952066881,-58.420387068624052 -34.587613757432251,-58.420167278204531 -34.587788195100408,-58.421488403444606 -34.588614174510298,-58.422569253556311 -34.587818657656179,-58.42123571183609 -34.586963952066881)));;1282;14_14_10;COMUNA 14;14;10;684;298;386;77,20%;465;463;99,57%;2;0,43%;349;4;1,15%;345;98,85%
MULTIPOLYGON (((-58.420167278204531 -34.587788195100408,-58.419369124594454 -34.588421601769426,-58.420295089395346 -34.588976667579466,-58.421488403444606 -34.588614174510298,-58.420167278204531 -34.587788195100408)));;1283;14_14_11;COMUNA 14;14;11;833;352;481;73,18%;529;529;100,00%;0;0,00%;411;2;0,49%;409;99,51%
MULTIPOLYGON (((-58.425177614993608 -34.583945386589647,-58.424231754609401 -34.584669699187145,-58.425382433087783 -34.585597629420789,-58.426313654914075 -34.584856824107661,-58.425177614993608 -34.583945386589647)));;1284;14_14_2;COMUNA 14;14;2;596;271;325;83,38%;435;435;100,00%;0;0,00%;290;17;5,86%;273;94,14%
MULTIPOLYGON (((-58.424231754609401 -34.584669699187145,-58.42325895960272 -34.585414630302758,-58.423389796503926 -34.585507774890708,-58.424334263839484 -34.586183595820629,-58.424505458241384 -34.586294287803518,-58.424696868803117 -34.586143003394731,-58.425382433087783 -34.585597629420789,-58.424231754609401 -34.584669699187145)));;1285;14_14_3;COMUNA 14;14;3;726;328;398;82,41%;541;541;100,00%;0;0,00%;358;4;1,12%;354;98,88%
MULTIPOLYGON (((-58.426989999945114 -34.585310704323589,-58.426313654914075 -34.584856824107661,-58.425382433087783 -34.585597629420789,-58.424696868803117 -34.586143003394731,-58.424505458241384 -34.586294287803518,-58.425187686507826 -34.586735362322337,-58.42606363656887 -34.586042994728629,-58.426989999945114 -34.585310704323589)));;1286;14_14_4;COMUNA 14;14;4;417;195;222;87,84%;252;250;99,21%;2;0,80%;194;15;7,73%;179;92,27%
MULTIPOLYGON (((-58.427997000075884 -34.585979683957511,-58.426989999945114 -34.585310704323589,-58.42606363656887 -34.586042994728629,-58.425187686507826 -34.586735362322337,-58.42619886865473 -34.587389075616152,-58.427076603555207 -34.586701138158773,-58.427997000075884 -34.585979683957511)));;1287;14_14_5;COMUNA 14;14;5;416;194;222;87,39%;241;241;100,00%;0;0,00%;197;33;16,75%;164;83,25%
MULTIPOLYGON (((-58.427076603555207 -34.586701138158773,-58.42619886865473 -34.587389075616152,-58.427204703248215 -34.588039398494097,-58.427369016059039 -34.587928948768059,-58.428157181693528 -34.587403237705992,-58.429146527175718 -34.586743346200215,-58.427997000075884 -34.585979683957511,-58.427076603555207 -34.586701138158773)));;1288;14_14_6;COMUNA 14;14;6;467;218;249;87,55%;271;270;99,63%;1;0,37%;202;2;0,99%;200;99,01%
MULTIPOLYGON (((-58.425187686507826 -34.586735362322337,-58.424505458241384 -34.586294287803518,-58.423602147752078 -34.587008256009277,-58.424281481656969 -34.587449616316775,-58.424612212624581 -34.587664446947024,-58.425284062116148 -34.588108827584755,-58.426199906975995 -34.58871462221682,-58.427204703248215 -34.588039398494097,-58.42619886865473 -34.587389075616152,-58.425187686507826 -34.586735362322337)));;1289;14_14_7;COMUNA 14;14;7;523;254;269;94,42%;276;275;99,64%;1;0,36%;210;0;0,00%;210;100,00%
MULTIPOLYGON (((-58.42325895960272 -34.585414630302758,-58.422288873156511 -34.586157512127812,-58.422495308574803 -34.586289134934006,-58.423602147752078 -34.587008256009277,-58.424505458241384 -34.586294287803518,-58.424334263839484 -34.586183595820629,-58.423389796503926 -34.585507774890708,-58.42325895960272 -34.585414630302758)));;1290;14_14_8;COMUNA 14;14;8;942;408;534;76,40%;607;607;100,00%;0;0,00%;462;5;1,08%;457;98,92%
MULTIPOLYGON (((-58.422288873156511 -34.586157512127812,-58.42123571183609 -34.586963952066881,-58.422569253556311 -34.587818657656179,-58.423503672025198 -34.587086044466105,-58.423602147752078 -34.587008256009277,-58.422495308574803 -34.586289134934006,-58.422288873156511 -34.586157512127812)));;1291;14_14_9;COMUNA 14;14;9;982;445;537;82,87%;712;712;100,00%;0;0,00%;483;5;1,04%;478;98,96%
MULTIPOLYGON (((-58.424019468854453 -34.583016184158048,-58.423065610025645 -34.58372928765197,-58.424231754609401 -34.584669699187145,-58.425177614993608 -34.583945386589647,-58.424019468854453 -34.583016184158048)));;1292;14_15_1;COMUNA 14;15;1;704;302;402;75,12%;418;415;99,28%;3;0,72%;319;3;0,94%;316;99,06%
MULTIPOLYGON (((-58.422899310885576 -34.582117406786473,-58.421934304664042 -34.582816905800946,-58.423065610025645 -34.58372928765197,-58.424019468854453 -34.583016184158048,-58.422899310885576 -34.582117406786473)));;1293;14_15_2;COMUNA 14;15;2;749;324;425;76,24%;527;527;100,00%;0;0,00%;351;12;3,42%;339;96,58%
MULTIPOLYGON (((-58.421733555052555 -34.58118205290755,-58.420751444165575 -34.58186287419376,-58.421934304664042 -34.582816905800946,-58.422899310885576 -34.582117406786473,-58.421733555052555 -34.58118205290755)));;1294;14_15_3;COMUNA 14;15;3;679;280;399;70,18%;489;488;99,80%;1;0,20%;350;0;0,00%;350;100,00%
MULTIPOLYGON (((-58.420751444165575 -34.58186287419376,-58.420206378483826 -34.582240729381084,-58.420052458114625 -34.582346525120848,-58.421232750615374 -34.583325352302261,-58.421934304664042 -34.582816905800946,-58.420751444165575 -34.58186287419376)));;1295;14_15_4;COMUNA 14;15;4;814;331;483;68,53%;511;510;99,80%;1;0,20%;379;8;2,11%;371;97,89%
MULTIPOLYGON (((-58.421934304664042 -34.582816905800946,-58.421232750615374 -34.583325352302261,-58.422357914293279 -34.58425830277006,-58.423065610025645 -34.58372928765197,-58.421934304664042 -34.582816905800946)));;1296;14_15_5;COMUNA 14;15;5;915;394;521;75,62%;607;606;99,84%;1;0,17%;443;6;1,35%;437;98,65%
MULTIPOLYGON (((-58.423065610025645 -34.58372928765197,-58.422357914293279 -34.58425830277006,-58.422006277010965 -34.584522844721619,-58.42325895960272 -34.585414630302758,-58.424231754609401 -34.584669699187145,-58.423065610025645 -34.58372928765197)));;1297;14_15_6;COMUNA 14;15;6;943;424;519;81,70%;571;570;99,82%;1;0,18%;440;76;17,27%;364;82,73%
MULTIPOLYGON (((-58.421232750615374 -34.583325352302261,-58.420411079871592 -34.583920939828715,-58.421777389096803 -34.584692563846325,-58.422006277010965 -34.584522844721619,-58.422357914293279 -34.58425830277006,-58.421232750615374 -34.583325352302261)));;1298;14_15_7;COMUNA 14;15;7;637;272;365;74,52%;489;489;100,00%;0;0,00%;348;2;0,57%;346;99,43%
MULTIPOLYGON (((-58.421232750615374 -34.583325352302261,-58.420052458114625 -34.582346525120848,-58.418256492593102 -34.583581498432636,-58.419648856120695 -34.584473301544229,-58.420411079871592 -34.583920939828715,-58.421232750615374 -34.583325352302261)));;1299;14_15_8;COMUNA 14;15;8;1904;831;1073;77,45%;1156;1155;99,91%;1;0,09%;886;4;0,45%;882;99,55%
MULTIPOLYGON (((-58.420436284239493 -34.58091320667706,-58.420585735628507 -34.580793215067821,-58.420220385907776 -34.580416849641963,-58.417269307933765 -34.577348767846196,-58.415573562635132 -34.575543115531929,-58.41491941038673 -34.575238693435324,-58.414688578590486 -34.575106414169632,-58.414502748997712 -34.575189302190104,-58.413158832731071 -34.575796747557447,-58.413976590956821 -34.577042762951123,-58.414356768021534 -34.577621882060257,-58.41467331683473 -34.578104139878818,-58.414719862293339 -34.578183301820353,-58.414806028488357 -34.578306383575139,-58.415432504328479 -34.579260892940297,-58.415969409954968 -34.580078880150744,-58.414470451659994 -34.580545076954238,-58.415225581086581 -34.581684645437505,-58.41695077235407 -34.581573891247245,-58.419732271769533 -34.58139531727744,-58.420116559689873 -34.581370499607196,-58.420144827326588 -34.581240685518019,-58.420230189067055 -34.581106344257755,-58.420307396677238 -34.581032467051351,-58.420436284239493 -34.58091320667706)));;1300;14_16_1;COMUNA 14;16;1;1306;575;731;78,66%;737;737;100,00%;0;0,00%;591;4;0,68%;587;99,32%
MULTIPOLYGON (((-58.415432504328479 -34.579260892940297,-58.413930660742409 -34.579730462486914,-58.414470451659994 -34.580545076954238,-58.415969409954968 -34.580078880150744,-58.415432504328479 -34.579260892940297)));;1301;14_16_2;COMUNA 14;16;2;790;353;437;80,78%;556;556;100,00%;0;0,00%;331;4;1,21%;327;98,79%
MULTIPOLYGON (((-58.414806028488357 -34.578306383575139,-58.414719862293339 -34.578183301820353,-58.413248904330125 -34.578701067045692,-58.413338646839605 -34.578837018318133,-58.413930660742409 -34.579730462486914,-58.415432504328479 -34.579260892940297,-58.414806028488357 -34.578306383575139)));;1302;14_16_3;COMUNA 14;16;3;1101;515;586;87,88%;747;747;100,00%;0;0,00%;524;2;0,38%;522;99,62%
MULTIPOLYGON (((-58.413976590956821 -34.577042762951123,-58.412532953221543 -34.577621005229204,-58.412967485518038 -34.578276844281142,-58.413248904330125 -34.578701067045692,-58.414719862293339 -34.578183301820353,-58.41467331683473 -34.578104139878818,-58.414356768021534 -34.577621882060257,-58.413976590956821 -34.577042762951123)));;1303;14_16_4;COMUNA 14;16;4;945;457;488;93,65%;611;611;100,00%;0;0,00%;397;1;0,25%;396;99,75%
MULTIPOLYGON (((-58.413158832731071 -34.575796747557447,-58.411747018325471 -34.576434784825693,-58.412532953221543 -34.577621005229204,-58.413976590956821 -34.577042762951123,-58.413158832731071 -34.575796747557447)));;1304;14_16_5;COMUNA 14;16;5;929;424;505;83,96%;521;521;100,00%;0;0,00%;374;3;0,80%;371;99,20%
MULTIPOLYGON (((-58.411747018325471 -34.576434784825693,-58.410939113868864 -34.576799882795108,-58.411704711296899 -34.577952647727564,-58.412532953221543 -34.577621005229204,-58.411747018325471 -34.576434784825693)));;1305;14_16_6;COMUNA 14;16;6;299;135;164;82,32%;180;179;99,44%;1;0,56%;122;0;0,00%;122;100,00%
MULTIPOLYGON (((-58.412532953221543 -34.577621005229204,-58.411704711296899 -34.577952647727564,-58.412404797377917 -34.579006787246968,-58.413248904330125 -34.578701067045692,-58.412967485518038 -34.578276844281142,-58.412532953221543 -34.577621005229204)));;1306;14_16_7;COMUNA 14;16;7;721;320;401;79,80%;429;429;100,00%;0;0,00%;324;4;1,23%;320;98,77%
MULTIPOLYGON (((-58.414470451659994 -34.580545076954238,-58.413605100317326 -34.580814179712327,-58.414225887706543 -34.581748832618771,-58.415225581086581 -34.581684645437505,-58.414470451659994 -34.580545076954238)));;1307;14_17_1;COMUNA 14;17;1;809;373;436;85,55%;454;454;100,00%;0;0,00%;352;1;0,28%;351;99,72%
MULTIPOLYGON (((-58.41306514489402 -34.580001110750032,-58.413605100317326 -34.580814179712327,-58.414470451659994 -34.580545076954238,-58.413930660742409 -34.579730462486914,-58.413338646839605 -34.578837018318133,-58.413248904330125 -34.578701067045692,-58.412404797377917 -34.579006787246968,-58.412494744872276 -34.579142250222944,-58.41306514489402 -34.580001110750032)));;1308;14_17_2;COMUNA 14;17;2;900;390;510;76,47%;559;558;99,82%;1;0,18%;390;3;0,77%;387;99,23%
MULTIPOLYGON (((-58.412326948864731 -34.58121170350983,-58.412705908101287 -34.581846322109641,-58.414225887706543 -34.581748832618771,-58.413605100317326 -34.580814179712327,-58.41306514489402 -34.580001110750032,-58.411834012885791 -34.580385971973648,-58.412326948864731 -34.58121170350983)));;1309;14_17_3;COMUNA 14;17;3;820;348;472;73,73%;440;439;99,77%;1;0,23%;338;1;0,30%;337;99,70%
MULTIPOLYGON (((-58.412404797377917 -34.579006787246968,-58.411318085521913 -34.57940461896321,-58.411227682006846 -34.579370265258149,-58.411340576197581 -34.57955953387404,-58.411834012885791 -34.580385971973648,-58.41306514489402 -34.580001110750032,-58.412494744872276 -34.579142250222944,-58.412404797377917 -34.579006787246968)));;1310;14_17_4;COMUNA 14;17;4;420;189;231;81,82%;371;371;100,00%;0;0,00%;208;1;0,48%;207;99,52%
MULTIPOLYGON (((-58.411227682006846 -34.579370265258149,-58.411318085521913 -34.57940461896321,-58.412404797377917 -34.579006787246968,-58.411704711296899 -34.577952647727564,-58.411244299603176 -34.578137039681501,-58.41063697161227 -34.578381017691584,-58.411227682006846 -34.579370265258149)));;1311;14_17_5;COMUNA 14;17;5;729;333;396;84,09%;511;511;100,00%;0;0,00%;328;6;1,83%;322;98,17%
MULTIPOLYGON (((-58.410939113868864 -34.576799882795108,-58.410724659417703 -34.576896837993587,-58.409955671370874 -34.577239691532853,-58.409863688764482 -34.577280709809756,-58.408616549082922 -34.57783673617898,-58.409268149878002 -34.578930801207413,-58.41063697161227 -34.578381017691584,-58.411244299603176 -34.578137039681501,-58.411704711296899 -34.577952647727564,-58.410939113868864 -34.576799882795108)));;1312;14_17_6;COMUNA 14;17;6;675;272;403;67,49%;383;383;100,00%;0;0,00%;274;4;1,46%;270;98,54%
MULTIPOLYGON (((-58.41063697161227 -34.578381017691584,-58.409268149878002 -34.578930801207413,-58.409831988512714 -34.579877353680189,-58.410397370964525 -34.58082650981062,-58.410826087499018 -34.580701053774568,-58.411834012885791 -34.580385971973648,-58.411340576197581 -34.57955953387404,-58.411227682006846 -34.579370265258149,-58.41063697161227 -34.578381017691584)));;1313;14_17_7;COMUNA 14;17;7;762;327;435;75,17%;435;435;100,00%;0;0,00%;316;3;0,95%;313;99,05%
MULTIPOLYGON (((-58.411834012885791 -34.580385971973648,-58.410826087499018 -34.580701053774568,-58.410397370964525 -34.58082650981062,-58.411096070750851 -34.581977981469635,-58.412705908101287 -34.581846322109641,-58.412326948864731 -34.58121170350983,-58.411834012885791 -34.580385971973648)));;1314;14_17_8;COMUNA 14;17;8;1335;572;763;74,97%;818;818;100,00%;0;0,00%;623;1;0,16%;622;99,84%
MULTIPOLYGON (((-58.416063943881248 -34.583854564770554,-58.414996174457166 -34.584539954730559,-58.415631690528208 -34.584952260512743,-58.415951157589191 -34.58515196888407,-58.416402209186458 -34.584852973720096,-58.416733834165818 -34.584625836291494,-58.41711239381452 -34.584366601506687,-58.417687043557855 -34.583973066327324,-58.418256492593102 -34.583581498432636,-58.420052458114625 -34.582346525120848,-58.420206378483826 -34.582240729381084,-58.420751444165575 -34.58186287419376,-58.421733555052555 -34.58118205290755,-58.421661969082919 -34.580960705608128,-58.421597040913824 -34.580844788772623,-58.421465092122396 -34.580738927101542,-58.421284384527219 -34.580674199871098,-58.420947277360092 -34.580669046104134,-58.420725900264458 -34.580712640749518,-58.420585735628507 -34.580793215067821,-58.420436284239493 -34.58091320667706,-58.420307396677238 -34.581032467051351,-58.420230189067055 -34.581106344257755,-58.420144827326588 -34.581240685518019,-58.420116559689873 -34.581370499607196,-58.419732271769533 -34.58139531727744,-58.41695077235407 -34.581573891247245,-58.415225581086581 -34.581684645437505,-58.414225887706543 -34.581748832618771,-58.414842140863271 -34.582447696118422,-58.41552545366288 -34.583234543720664,-58.416063943881248 -34.583854564770554)));;1315;14_18_1;COMUNA 14;18;1;741;327;414;78,99%;518;518;100,00%;0;0,00%;355;9;2,54%;346;97,46%
MULTIPOLYGON (((-58.416063943881248 -34.583854564770554,-58.41552545366288 -34.583234543720664,-58.414275970232723 -34.584072680222036,-58.414996174457166 -34.584539954730559,-58.416063943881248 -34.583854564770554)));;1316;14_18_2;COMUNA 14;18;2;741;305;436;69,95%;411;411;100,00%;0;0,00%;314;0;0,00%;314;100,00%
MULTIPOLYGON (((-58.414842140863271 -34.582447696118422,-58.41411363369334 -34.582965387296845,-58.413376598772018 -34.583489127218726,-58.414275970232723 -34.584072680222036,-58.41552545366288 -34.583234543720664,-58.414842140863271 -34.582447696118422)));;1317;14_18_3;COMUNA 14;18;3;1081;468;613;76,35%;587;587;100,00%;0;0,00%;476;4;0,84%;472;99,16%
MULTIPOLYGON (((-58.414225887706543 -34.581748832618771,-58.412705908101287 -34.581846322109641,-58.412806794755284 -34.582015243585772,-58.41411363369334 -34.582965387296845,-58.414842140863271 -34.582447696118422,-58.414225887706543 -34.581748832618771)));;1318;14_18_4;COMUNA 14;18;4;900;387;513;75,44%;514;514;100,00%;0;0,00%;391;2;0,51%;389;99,49%
MULTIPOLYGON (((-58.412705908101287 -34.581846322109641,-58.411096070750851 -34.581977981469635,-58.412105021672794 -34.582664065878497,-58.413376598772018 -34.583489127218726,-58.41411363369334 -34.582965387296845,-58.412806794755284 -34.582015243585772,-58.412705908101287 -34.581846322109641)));;1319;14_18_5;COMUNA 14;18;5;996;437;559;78,18%;716;716;100,00%;0;0,00%;466;5;1,07%;461;98,93%
MULTIPOLYGON (((-58.413376598772018 -34.583489127218726,-58.412569274231394 -34.584062835831084,-58.413403242170872 -34.584657988520455,-58.414275970232723 -34.584072680222036,-58.413376598772018 -34.583489127218726)));;1320;14_18_6;COMUNA 14;18;6;828;360;468;76,92%;454;454;100,00%;0;0,00%;354;8;2,26%;346;97,74%
MULTIPOLYGON (((-58.414996174457166 -34.584539954730559,-58.414275970232723 -34.584072680222036,-58.413403242170872 -34.584657988520455,-58.414070391015883 -34.585134120605879,-58.414996174457166 -34.584539954730559)));;1321;14_18_7;COMUNA 14;18;7;606;276;330;83,64%;381;381;100,00%;0;0,00%;282;3;1,06%;279;98,94%
MULTIPOLYGON (((-58.414996174457166 -34.584539954730559,-58.414070391015883 -34.585134120605879,-58.414989073789336 -34.585789650650263,-58.415178612369857 -34.585664156125326,-58.415951157589191 -34.58515196888407,-58.415631690528208 -34.584952260512743,-58.414996174457166 -34.584539954730559)));;1322;14_18_8;COMUNA 14;18;8;912;356;556;64,03%;678;678;100,00%;0;0,00%;489;0;0,00%;489;100,00%
MULTIPOLYGON (((-58.420411079871592 -34.583920939828715,-58.419648856120695 -34.584473301544229,-58.41992704295734 -34.58465150521009,-58.420956295015102 -34.585307803785867,-58.421084327842117 -34.585212632370194,-58.421777389096803 -34.584692563846325,-58.420411079871592 -34.583920939828715)));;1323;14_19_1;COMUNA 14;19;1;542;235;307;76,55%;363;363;100,00%;0;0,00%;276;1;0,36%;275;99,64%
MULTIPOLYGON (((-58.422006277010965 -34.584522844721619,-58.421777389096803 -34.584692563846325,-58.421084327842117 -34.585212632370194,-58.420956295015102 -34.585307803785867,-58.422288873156511 -34.586157512127812,-58.42325895960272 -34.585414630302758,-58.422006277010965 -34.584522844721619)));;1324;14_19_2;COMUNA 14;19;2;969;419;550;76,18%;758;758;100,00%;0;0,00%;529;3;0,57%;526;99,43%
MULTIPOLYGON (((-58.420956295015102 -34.585307803785867,-58.419885339847923 -34.58610352143706,-58.420234700944242 -34.586322314327383,-58.42123571183609 -34.586963952066881,-58.422288873156511 -34.586157512127812,-58.420956295015102 -34.585307803785867)));;1325;14_19_3;COMUNA 14;19;3;1060;463;597;77,55%;757;757;100,00%;0;0,00%;546;3;0,55%;543;99,45%
MULTIPOLYGON (((-58.419648856120695 -34.584473301544229,-58.418698191847646 -34.585162286354112,-58.418551587355857 -34.585268082784879,-58.419885339847923 -34.58610352143706,-58.420956295015102 -34.585307803785867,-58.41992704295734 -34.58465150521009,-58.419648856120695 -34.584473301544229)));;1326;14_19_4;COMUNA 14;19;4;1224;526;698;75,36%;902;901;99,89%;1;0,11%;628;4;0,64%;624;99,36%
MULTIPOLYGON (((-58.418256492593102 -34.583581498432636,-58.417687043557855 -34.583973066327324,-58.41711239381452 -34.584366601506687,-58.418551587355857 -34.585268082784879,-58.418698191847646 -34.585162286354112,-58.419648856120695 -34.584473301544229,-58.418256492593102 -34.583581498432636)));;1327;14_19_5;COMUNA 14;19;5;1426;605;821;73,69%;829;829;100,00%;0;0,00%;652;2;0,31%;650;99,69%
MULTIPOLYGON (((-58.442621864402781 -34.56362617194339,-58.442535270813607 -34.563689047779995,-58.441267856141415 -34.564609224650461,-58.442353161985466 -34.565840098349568,-58.443646194434237 -34.564234039056707,-58.442621864402781 -34.56362617194339)));;1328;14_2_1;COMUNA 14;2;1;1172;508;664;76,51%;635;635;100,00%;0;0,00%;505;3;0,59%;502;99,41%
MULTIPOLYGON (((-58.437415317863923 -34.564498200954652,-58.436275439126213 -34.565180172712111,-58.437019400208733 -34.566057060153234,-58.437173689805256 -34.565967370265412,-58.437792297455744 -34.565590791361267,-58.438300717226582 -34.565284260831525,-58.438457559414097 -34.565189710450348,-58.438489660081281 -34.565170349770902,-58.437607750894919 -34.56438316515667,-58.437575309798206 -34.564402525536693,-58.437415317863923 -34.564498200954652)));;1329;14_2_10;COMUNA 14;2;10;1135;521;614;84,85%;627;627;100,00%;0;0,00%;474;2;0,42%;472;99,58%
MULTIPOLYGON (((-58.442535270813607 -34.563689047779995,-58.441969305838441 -34.563053009299409,-58.440599075072434 -34.563899919144099,-58.441267856141415 -34.564609224650461,-58.442535270813607 -34.563689047779995)));;1330;14_2_2;COMUNA 14;2;2;540;246;294;83,67%;429;429;100,00%;0;0,00%;271;0;0,00%;271;100,00%
MULTIPOLYGON (((-58.441344541606227 -34.56235075773052,-58.440857916200322 -34.562438703722506,-58.439848705491414 -34.563042489486598,-58.440599075072434 -34.563899919144099,-58.441969305838441 -34.563053009299409,-58.441497306168969 -34.562522482135975,-58.441344849831871 -34.562351104211452,-58.441344541606227 -34.56235075773052)));;1331;14_2_3;COMUNA 14;2;3;866;372;494;75,30%;447;447;100,00%;0;0,00%;349;0;0,00%;349;100,00%
MULTIPOLYGON (((-58.439848705491414 -34.563042489486598,-58.43880950888105 -34.563664219522252,-58.439566258358269 -34.564521374985297,-58.440067938597096 -34.564218920449242,-58.440599075072434 -34.563899919144099,-58.439848705491414 -34.563042489486598)));;1332;14_2_4;COMUNA 14;2;4;658;283;375;75,47%;441;441;100,00%;0;0,00%;320;4;1,25%;316;98,75%
MULTIPOLYGON (((-58.440599075072434 -34.563899919144099,-58.440067938597096 -34.564218920449242,-58.439566258358269 -34.564521374985297,-58.440325491500772 -34.565381202269464,-58.440382543306853 -34.565333604984041,-58.441132385424275 -34.564707655839968,-58.441267856141415 -34.564609224650461,-58.440599075072434 -34.563899919144099)));;1333;14_2_5;COMUNA 14;2;5;720;310;410;75,61%;445;445;100,00%;0;0,00%;340;0;0,00%;340;100,00%
MULTIPOLYGON (((-58.439566258358269 -34.564521374985297,-58.438489660081281 -34.565170349770902,-58.439500957812477 -34.56606945889348,-58.440325491500772 -34.565381202269464,-58.439566258358269 -34.564521374985297)));;1334;14_2_6;COMUNA 14;2;6;673;298;375;79,47%;448;448;100,00%;0;0,00%;268;2;0,75%;266;99,25%
MULTIPOLYGON (((-58.43880950888105 -34.563664219522252,-58.437607750894919 -34.56438316515667,-58.438489660081281 -34.565170349770902,-58.439566258358269 -34.564521374985297,-58.43880950888105 -34.563664219522252)));;1335;14_2_7;COMUNA 14;2;7;704;309;395;78,23%;422;422;100,00%;0;0,00%;317;2;0,63%;315;99,37%
MULTIPOLYGON (((-58.439525652154934 -34.562673398116949,-58.438922305915106 -34.562773286538437,-58.438175917625571 -34.562946456439356,-58.438045233374162 -34.562976783577213,-58.436878808497255 -34.563419238129974,-58.436667388700478 -34.563546311537024,-58.437607750894919 -34.56438316515667,-58.43880950888105 -34.563664219522252,-58.439848705491414 -34.563042489486598,-58.440857916200322 -34.562438703722506,-58.439927995694177 -34.562606780724138,-58.439525652154934 -34.562673398116949)));;1336;14_2_8;COMUNA 14;2;8;932;390;542;71,96%;536;536;100,00%;0;0,00%;402;2;0,50%;400;99,50%
MULTIPOLYGON (((-58.436667388700478 -34.563546311537024,-58.436476744192014 -34.563660923698947,-58.435489795031273 -34.564254184656328,-58.436275439126213 -34.565180172712111,-58.437415317863923 -34.564498200954652,-58.437575309798206 -34.564402525536693,-58.437607750894919 -34.56438316515667,-58.436667388700478 -34.563546311537024)));;1337;14_2_9;COMUNA 14;2;9;909;398;511;77,89%;486;486;100,00%;0;0,00%;380;2;0,53%;378;99,47%
MULTIPOLYGON (((-58.419885339847923 -34.58610352143706,-58.418783014928358 -34.586922669945764,-58.419472716833695 -34.587353919493509,-58.420167278204531 -34.587788195100408,-58.420387068624052 -34.587613757432251,-58.42123571183609 -34.586963952066881,-58.420234700944242 -34.586322314327383,-58.419885339847923 -34.58610352143706)));;1338;14_20_1;COMUNA 14;20;1;1265;577;688;83,87%;734;734;100,00%;0;0,00%;604;9;1,49%;595;98,51%
MULTIPOLYGON (((-58.418551587355857 -34.585268082784879,-58.41743053204813 -34.586077000730789,-58.418783014928358 -34.586922669945764,-58.419885339847923 -34.58610352143706,-58.418551587355857 -34.585268082784879)));;1339;14_20_2;COMUNA 14;20;2;1306;550;756;72,75%;956;956;100,00%;0;0,00%;661;2;0,30%;659;99,70%
MULTIPOLYGON (((-58.41711239381452 -34.584366601506687,-58.416733834165818 -34.584625836291494,-58.416402209186458 -34.584852973720096,-58.415951157589191 -34.58515196888407,-58.41743053204813 -34.586077000730789,-58.418551587355857 -34.585268082784879,-58.41711239381452 -34.584366601506687)));;1340;14_20_3;COMUNA 14;20;3;957;398;559;71,20%;635;635;100,00%;0;0,00%;470;3;0,64%;467;99,36%
MULTIPOLYGON (((-58.415951157589191 -34.58515196888407,-58.415178612369857 -34.585664156125326,-58.414989073789336 -34.585789650650263,-58.416535546288628 -34.586722818380451,-58.41743053204813 -34.586077000730789,-58.415951157589191 -34.58515196888407)));;1341;14_20_4;COMUNA 14;20;4;800;336;464;72,41%;448;448;100,00%;0;0,00%;374;2;0,53%;372;99,47%
MULTIPOLYGON (((-58.41743053204813 -34.586077000730789,-58.416535546288628 -34.586722818380451,-58.417922951772958 -34.587554636444445,-58.418568851333887 -34.5870817540468,-58.418783014928358 -34.586922669945764,-58.41743053204813 -34.586077000730789)));;1342;14_20_5;COMUNA 14;20;5;765;339;426;79,58%;503;503;100,00%;0;0,00%;375;4;1,07%;371;98,93%
MULTIPOLYGON (((-58.419472716833695 -34.587353919493509,-58.418783014928358 -34.586922669945764,-58.418568851333887 -34.5870817540468,-58.417922951772958 -34.587554636444445,-58.418659399739028 -34.587996048939218,-58.419472716833695 -34.587353919493509)));;1343;14_20_6;COMUNA 14;20;6;507;221;286;77,27%;407;407;100,00%;0;0,00%;275;1;0,36%;274;99,64%
MULTIPOLYGON (((-58.420167278204531 -34.587788195100408,-58.419472716833695 -34.587353919493509,-58.418659399739028 -34.587996048939218,-58.41877568615584 -34.588065811960675,-58.419369124594454 -34.588421601769426,-58.420167278204531 -34.587788195100408)));;1344;14_20_7;COMUNA 14;20;7;320;133;187;71,12%;220;220;100,00%;0;0,00%;168;6;3,57%;162;96,43%
MULTIPOLYGON (((-58.430253604280935 -34.591394606619367,-58.429164355036903 -34.592178005185119,-58.430321641414153 -34.592944826883141,-58.431219440560653 -34.593539733106347,-58.432358668529012 -34.592781681922091,-58.433445575289454 -34.59205839758171,-58.432516523497291 -34.591461105404477,-58.431272898809077 -34.59066160477348,-58.430253604280935 -34.591394606619367)));;1345;14_21_1;COMUNA 14;21;1;950;412;538;76,58%;573;567;98,95%;6;1,06%;399;30;7,52%;369;92,48%
MULTIPOLYGON (((-58.426082817019257 -34.592789467594116,-58.426993095762008 -34.59340131073364,-58.427222114922969 -34.593555115973736,-58.427591909921141 -34.593298240976843,-58.428056005111827 -34.592971388894981,-58.427782714260395 -34.592789050293497,-58.426864856315845 -34.592179112241077,-58.42588988643061 -34.591531120337748,-58.425131687023132 -34.592150209588631,-58.426082817019257 -34.592789467594116)));;1346;14_21_10;COMUNA 14;21;10;545;248;297;83,50%;330;329;99,70%;1;0,30%;252;33;13,10%;219;86,90%
MULTIPOLYGON (((-58.428056005111827 -34.592971388894981,-58.427591909921141 -34.593298240976843,-58.427222114922969 -34.593555115973736,-58.428189113008344 -34.594204362430489,-58.428853113438258 -34.594650199677396,-58.429169070241493 -34.594855294928706,-58.429348808142571 -34.594745410303688,-58.430059495633415 -34.594302345659997,-58.430282249452482 -34.594163385499115,-58.431219440560653 -34.593539733106347,-58.430321641414153 -34.592944826883141,-58.429164355036903 -34.592178005185119,-58.428301510674707 -34.59279849377463,-58.428056005111827 -34.592971388894981)));;1347;14_21_11;COMUNA 14;21;11;705;324;381;85,04%;350;350;100,00%;0;0,00%;284;23;8,10%;261;91,90%
MULTIPOLYGON (((-58.429185306424102 -34.590688656052158,-58.428033396990052 -34.591428574960794,-58.426864856315845 -34.592179112241077,-58.427782714260395 -34.592789050293497,-58.428056005111827 -34.592971388894981,-58.428301510674707 -34.59279849377463,-58.429164355036903 -34.592178005185119,-58.430253604280935 -34.591394606619367,-58.431272898809077 -34.59066160477348,-58.430768457303635 -34.590337305979013,-58.430250653268644 -34.590004339213323,-58.429185306424102 -34.590688656052158)));;1348;14_21_2;COMUNA 14;21;2;681;301;380;79,21%;370;369;99,73%;1;0,27%;303;17;5,61%;286;94,39%
MULTIPOLYGON (((-58.427046336815756 -34.590774532202637,-58.42588988643061 -34.591531120337748,-58.426864856315845 -34.592179112241077,-58.428033396990052 -34.591428574960794,-58.429185306424102 -34.590688656052158,-58.430250653268644 -34.590004339213323,-58.429733534432856 -34.589671863396184,-58.429228168386992 -34.589346994533273,-58.428186667021912 -34.590028421826815,-58.427046336815756 -34.590774532202637)));;1349;14_21_3;COMUNA 14;21;3;332;136;196;69,39%;222;220;99,10%;2;0,91%;145;1;0,69%;144;99,31%
MULTIPOLYGON (((-58.427046336815756 -34.590774532202637,-58.426052566627575 -34.590115901733604,-58.425076860056961 -34.589469381836921,-58.423938715136885 -34.590234197051515,-58.424908035884577 -34.590878540803956,-58.425742688730722 -34.59143332549251,-58.42588988643061 -34.591531120337748,-58.427046336815756 -34.590774532202637)));;1350;14_21_4;COMUNA 14;21;4;529;246;283;86,93%;340;340;100,00%;0;0,00%;254;0;0,00%;254;100,00%
MULTIPOLYGON (((-58.428186667021912 -34.590028421826815,-58.429228168386992 -34.589346994533273,-58.429062495007848 -34.589240465844391,-58.42871250551152 -34.58901416262885,-58.428201529320752 -34.588683865166622,-58.427692770679457 -34.588354904266417,-58.427204703248215 -34.588039398494097,-58.426199906975995 -34.58871462221682,-58.425076860056961 -34.589469381836921,-58.426052566627575 -34.590115901733604,-58.427046336815756 -34.590774532202637,-58.428186667021912 -34.590028421826815)));;1351;14_21_5;COMUNA 14;21;5;409;173;236;73,31%;251;249;99,20%;2;0,80%;158;7;4,43%;151;95,57%
MULTIPOLYGON (((-58.425284062116148 -34.588108827584755,-58.424612212624581 -34.587664446947024,-58.424281481656969 -34.587449616316775,-58.423602147752078 -34.587008256009277,-58.423503672025198 -34.587086044466105,-58.422569253556311 -34.587818657656179,-58.423084119494312 -34.588148627873807,-58.42325250564101 -34.588260306622914,-58.424250998995014 -34.588922060282286,-58.423204370590739 -34.589745984382951,-58.423938715136885 -34.590234197051515,-58.425076860056961 -34.589469381836921,-58.426199906975995 -34.58871462221682,-58.425284062116148 -34.588108827584755)));;1352;14_21_6;COMUNA 14;21;6;559;266;293;90,78%;345;345;100,00%;0;0,00%;246;17;6,91%;229;93,09%
MULTIPOLYGON (((-58.42325250564101 -34.588260306622914,-58.423084119494312 -34.588148627873807,-58.422569253556311 -34.587818657656179,-58.421488403444606 -34.588614174510298,-58.420295089395346 -34.588976667579466,-58.421430492136814 -34.589657224870194,-58.422248659485675 -34.589363613816751,-58.422495829021337 -34.589274959549016,-58.422207664403082 -34.589083377737957,-58.42325250564101 -34.588260306622914)));;1353;14_21_7;COMUNA 14;21;7;696;316;380;83,16%;400;400;100,00%;0;0,00%;309;28;9,06%;281;90,94%
MULTIPOLYGON (((-58.422248659485675 -34.589363613816751,-58.421430492136814 -34.589657224870194,-58.422367432377797 -34.59028967601656,-58.42244626343502 -34.590342732326313,-58.423204370590739 -34.589745984382951,-58.424250998995014 -34.588922060282286,-58.42325250564101 -34.588260306622914,-58.422207664403082 -34.589083377737957,-58.422495829021337 -34.589274959549016,-58.422248659485675 -34.589363613816751)));;1354;14_21_8;COMUNA 14;21;8;687;286;401;71,32%;425;424;99,76%;1;0,24%;323;1;0,31%;322;99,69%
MULTIPOLYGON (((-58.423938715136885 -34.590234197051515,-58.423204370590739 -34.589745984382951,-58.42244626343502 -34.590342732326313,-58.423173114305172 -34.590832003462317,-58.424156138763529 -34.591493682192748,-58.424901483776509 -34.591995414071306,-58.425131687023132 -34.592150209588631,-58.42588988643061 -34.591531120337748,-58.425742688730722 -34.59143332549251,-58.424908035884577 -34.590878540803956,-58.423938715136885 -34.590234197051515)));;1355;14_21_9;COMUNA 14;21;9;568;283;285;99,30%;340;340;100,00%;0;0,00%;266;64;24,06%;202;75,94%
MULTIPOLYGON (((-58.426082817019257 -34.592789467594116,-58.425198695905273 -34.593504086421291,-58.426073039702011 -34.594110854682619,-58.426246717880133 -34.594231826924144,-58.427371125991407 -34.595015005186411,-58.428088929447696 -34.595515019140421,-58.429169070241493 -34.594855294928706,-58.428853113438258 -34.594650199677396,-58.428189113008344 -34.594204362430489,-58.427222114922969 -34.593555115973736,-58.426993095762008 -34.59340131073364,-58.426082817019257 -34.592789467594116)));;1356;14_22_1;COMUNA 14;22;1;857;371;486;76,34%;486;485;99,79%;1;0,21%;368;2;0,54%;366;99,46%
MULTIPOLYGON (((-58.421299838663877 -34.595365786286045,-58.421514776394261 -34.596431604729275,-58.422962011697379 -34.596362926982778,-58.423149636476538 -34.596347635228646,-58.423120089043167 -34.596158252089161,-58.42301012394698 -34.5953006477488,-58.422868173566236 -34.594194220184967,-58.42105789271848 -34.594163755544571,-58.421092976757599 -34.594340253302327,-58.421299838663877 -34.595365786286045)));;1357;14_22_10;COMUNA 14;22;10;672;291;381;76,38%;430;430;100,00%;0;0,00%;336;10;2,98%;326;97,02%
MULTIPOLYGON (((-58.426082817019257 -34.592789467594116,-58.425131687023132 -34.592150209588631,-58.424901483776509 -34.591995414071306,-58.424156138763529 -34.591493682192748,-58.423173114305172 -34.590832003462317,-58.422506399903774 -34.591373356502913,-58.422543305711415 -34.5916613378172,-58.422681090094102 -34.592735510055853,-58.423318176111607 -34.592199146825287,-58.424286309974882 -34.592870960803602,-58.425198695905273 -34.593504086421291,-58.426082817019257 -34.592789467594116)));;1358;14_22_2;COMUNA 14;22;2;875;421;454;92,73%;494;493;99,80%;1;0,20%;407;55;13,51%;352;86,49%
MULTIPOLYGON (((-58.421430492136814 -34.589657224870194,-58.420242248078665 -34.590067537877793,-58.422454939469048 -34.591599968248438,-58.422543305711415 -34.5916613378172,-58.422506399903774 -34.591373356502913,-58.423173114305172 -34.590832003462317,-58.42244626343502 -34.590342732326313,-58.422367432377797 -34.59028967601656,-58.421430492136814 -34.589657224870194)));;1359;14_22_3;COMUNA 14;22;3;494;212;282;75,18%;312;309;99,04%;3;0,97%;233;0;0,00%;233;100,00%
MULTIPOLYGON (((-58.420242248078665 -34.590067537877793,-58.419073245307423 -34.590790041681331,-58.419022133481349 -34.590821573948688,-58.419143864981692 -34.591561928528485,-58.420543370720637 -34.591578054428489,-58.422454939469048 -34.591599968248438,-58.420242248078665 -34.590067537877793)));;1360;14_22_4;COMUNA 14;22;4;576;257;319;80,56%;323;321;99,38%;2;0,62%;240;1;0,42%;239;99,58%
MULTIPOLYGON (((-58.42078215179923 -34.592778184123723,-58.42105789271848 -34.594163755544571,-58.422868173566236 -34.594194220184967,-58.422856040678148 -34.594099282923302,-58.422687538345336 -34.592785514142705,-58.422681090094102 -34.592735510055853,-58.422543305711415 -34.5916613378172,-58.422454939469048 -34.591599968248438,-58.420543370720637 -34.591578054428489,-58.42078215179923 -34.592778184123723)));;1361;14_22_5;COMUNA 14;22;5;926;449;477;94,13%;510;510;100,00%;0;0,00%;423;72;17,02%;351;82,98%
MULTIPOLYGON (((-58.422856040678148 -34.594099282923302,-58.422868173566236 -34.594194220184967,-58.42301012394698 -34.5953006477488,-58.423635796465561 -34.594805196472898,-58.424418662107271 -34.594144503187309,-58.42469486446624 -34.593911340928443,-58.425198695905273 -34.593504086421291,-58.424286309974882 -34.592870960803602,-58.423318176111607 -34.592199146825287,-58.422681090094102 -34.592735510055853,-58.422687538345336 -34.592785514142705,-58.422856040678148 -34.594099282923302)));;1362;14_22_6;COMUNA 14;22;6;1058;482;576;83,68%;457;457;100,00%;0;0,00%;415;2;0,48%;413;99,52%
MULTIPOLYGON (((-58.424418662107271 -34.594144503187309,-58.423635796465561 -34.594805196472898,-58.42301012394698 -34.5953006477488,-58.423120089043167 -34.596158252089161,-58.423149636476538 -34.596347635228646,-58.423311029518224 -34.596334447479741,-58.424046685051451 -34.59625805426424,-58.424205567433376 -34.596159692756856,-58.424749653599434 -34.595530928402724,-58.425340734643363 -34.594860028243922,-58.426246717880133 -34.594231826924144,-58.426073039702011 -34.594110854682619,-58.425198695905273 -34.593504086421291,-58.42469486446624 -34.593911340928443,-58.424418662107271 -34.594144503187309)));;1363;14_22_7;COMUNA 14;22;7;760;343;417;82,25%;369;367;99,46%;2;0,54%;322;13;4,04%;309;95,96%
MULTIPOLYGON (((-58.426246717880133 -34.594231826924144,-58.425340734643363 -34.594860028243922,-58.424749653599434 -34.595530928402724,-58.424205567433376 -34.596159692756856,-58.424643392517744 -34.596787141358647,-58.424842979796452 -34.597061861977465,-58.426024078358139 -34.596614036279803,-58.426240186158154 -34.596511843547994,-58.426950248335388 -34.596210492618049,-58.427023849584934 -34.596165582832882,-58.428088929447696 -34.595515019140421,-58.427371125991407 -34.595015005186411,-58.426246717880133 -34.594231826924144)));;1364;14_22_8;COMUNA 14;22;8;767;339;428;79,21%;411;411;100,00%;0;0,00%;340;2;0,59%;338;99,41%
MULTIPOLYGON (((-58.421777551428157 -34.597734912628006,-58.422837355446475 -34.597711535687559,-58.422933791295009 -34.597717771067103,-58.423367161030654 -34.597748680950346,-58.423537943011517 -34.597631993061718,-58.424842979796452 -34.597061861977465,-58.424643392517744 -34.596787141358647,-58.424205567433376 -34.596159692756856,-58.424046685051451 -34.59625805426424,-58.423311029518224 -34.596334447479741,-58.423149636476538 -34.596347635228646,-58.422962011697379 -34.596362926982778,-58.421514776394261 -34.596431604729275,-58.421777551428157 -34.597734912628006)));;1365;14_22_9;COMUNA 14;22;9;1375;613;762;80,45%;747;744;99,60%;3;0,40%;500;1;0,20%;499;99,80%
MULTIPOLYGON (((-58.419342935432411 -34.592772610651984,-58.419567565103463 -34.594138729880342,-58.42105789271848 -34.594163755544571,-58.42078215179923 -34.592778184123723,-58.420543370720637 -34.591578054428489,-58.419143864981692 -34.591561928528485,-58.419022133481349 -34.590821573948688,-58.417864269173172 -34.591537238803028,-58.418056494569768 -34.592773273619621,-58.419139571615581 -34.592771833976741,-58.419342935432411 -34.592772610651984)));;1366;14_23_1;COMUNA 14;23;1;599;283;316;89,56%;362;362;100,00%;0;0,00%;281;8;2,85%;273;97,15%
MULTIPOLYGON (((-58.418724713247222 -34.596564087051767,-58.416996419756117 -34.596646060822764,-58.417262939568552 -34.597825642604192,-58.417465637445098 -34.597820717718825,-58.418940815057759 -34.597789282579058,-58.420162705218736 -34.597763164318359,-58.42013872603065 -34.597522442431718,-58.419963379718709 -34.596505299494417,-58.418724713247222 -34.596564087051767)));;1367;14_23_10;COMUNA 14;23;10;750;350;400;87,50%;540;540;100,00%;0;0,00%;378;1;0,26%;377;99,74%
MULTIPOLYGON (((-58.416996419756117 -34.596646060822764,-58.416864070126252 -34.596652349455361,-58.41551783498565 -34.596712965487129,-58.416000506878511 -34.597854744604206,-58.416159087386397 -34.597852481157041,-58.417262939568552 -34.597825642604192,-58.416996419756117 -34.596646060822764)));;1368;14_23_11;COMUNA 14;23;11;890;386;504;76,59%;656;655;99,85%;1;0,15%;462;2;0,43%;460;99,57%
MULTIPOLYGON (((-58.417864269173172 -34.591537238803028,-58.417022181386471 -34.592057580925392,-58.416924377826476 -34.592129941506201,-58.416358426106171 -34.592548195131513,-58.416100620625173 -34.592743949753206,-58.418056494569768 -34.592773273619621,-58.417864269173172 -34.591537238803028)));;1369;14_23_2;COMUNA 14;23;2;468;198;270;73,33%;289;289;100,00%;0;0,00%;218;7;3,21%;211;96,79%
MULTIPOLYGON (((-58.418056494569768 -34.592773273619621,-58.416100620625173 -34.592743949753206,-58.416418037416747 -34.59408588385871,-58.416591255929006 -34.594088555166969,-58.41829329319097 -34.594117215667971,-58.419567565103463 -34.594138729880342,-58.419342935432411 -34.592772610651984,-58.419139571615581 -34.592771833976741,-58.418056494569768 -34.592773273619621)));;1370;14_23_3;COMUNA 14;23;3;547;254;293;86,69%;284;284;100,00%;0;0,00%;243;2;0,82%;241;99,18%
MULTIPOLYGON (((-58.416100620625173 -34.592743949753206,-58.415867009987359 -34.592921332105504,-58.415266365394707 -34.593377385676398,-58.414393664345937 -34.594054041743938,-58.416418037416747 -34.59408588385871,-58.416100620625173 -34.592743949753206)));;1371;14_23_4;COMUNA 14;23;4;726;325;401;81,05%;463;463;100,00%;0;0,00%;368;2;0,54%;366;99,46%
MULTIPOLYGON (((-58.416418037416747 -34.59408588385871,-58.414393664345937 -34.594054041743938,-58.414626010903085 -34.594603591629081,-58.415046402615381 -34.59559795024807,-58.416746219279553 -34.595538388591287,-58.416418037416747 -34.59408588385871)));;1372;14_23_5;COMUNA 14;23;5;1023;469;554;84,66%;745;745;100,00%;0;0,00%;516;5;0,97%;511;99,03%
MULTIPOLYGON (((-58.41829329319097 -34.594117215667971,-58.416591255929006 -34.594088555166969,-58.416418037416747 -34.59408588385871,-58.416746219279553 -34.595538388591287,-58.416976932221893 -34.595530305922701,-58.418531967759392 -34.595471087607208,-58.418408681151476 -34.594772071971825,-58.41829329319097 -34.594117215667971)));;1373;14_23_6;COMUNA 14;23;6;443;210;233;90,13%;274;274;100,00%;0;0,00%;212;3;1,42%;209;98,58%
MULTIPOLYGON (((-58.419567565103463 -34.594138729880342,-58.41829329319097 -34.594117215667971,-58.418408681151476 -34.594772071971825,-58.418531967759392 -34.595471087607208,-58.419778873174273 -34.595423643357961,-58.421299838663877 -34.595365786286045,-58.421092976757599 -34.594340253302327,-58.42105789271848 -34.594163755544571,-58.419567565103463 -34.594138729880342)));;1374;14_23_7;COMUNA 14;23;7;694;329;365;90,14%;382;382;100,00%;0;0,00%;341;26;7,62%;315;92,38%
MULTIPOLYGON (((-58.421299838663877 -34.595365786286045,-58.419778873174273 -34.595423643357961,-58.418531967759392 -34.595471087607208,-58.418724713247222 -34.596564087051767,-58.419963379718709 -34.596505299494417,-58.42013872603065 -34.597522442431718,-58.420162705218736 -34.597763164318359,-58.420432684322542 -34.597757412836387,-58.421777551428157 -34.597734912628006,-58.421514776394261 -34.596431604729275,-58.421299838663877 -34.595365786286045)));;1375;14_23_8;COMUNA 14;23;8;1095;514;581;88,47%;552;551;99,82%;1;0,18%;482;80;16,60%;402;83,40%
MULTIPOLYGON (((-58.418531967759392 -34.595471087607208,-58.416976932221893 -34.595530305922701,-58.416746219279553 -34.595538388591287,-58.415046402615381 -34.59559795024807,-58.41551783498565 -34.596712965487129,-58.416864070126252 -34.596652349455361,-58.416996419756117 -34.596646060822764,-58.418724713247222 -34.596564087051767,-58.418531967759392 -34.595471087607208)));;1376;14_23_9;COMUNA 14;23;9;954;448;506;88,54%;620;620;100,00%;0;0,00%;492;2;0,41%;490;99,59%
MULTIPOLYGON (((-58.417270460216685 -34.590738114247159,-58.41696734802975 -34.59033016790665,-58.415944906497472 -34.59114333393471,-58.416924377826476 -34.592129941506201,-58.417022181386471 -34.592057580925392,-58.417864269173172 -34.591537238803028,-58.417270460216685 -34.590738114247159)));;1377;14_24_1;COMUNA 14;24;1;673;296;377;78,51%;434;433;99,77%;1;0,23%;301;3;1,00%;298;99,00%
MULTIPOLYGON (((-58.41665408780063 -34.589799043030695,-58.416447440700203 -34.589743047161868,-58.415344706642337 -34.590538712299576,-58.415944906497472 -34.59114333393471,-58.41696734802975 -34.59033016790665,-58.416611565181462 -34.589851282585329,-58.41665408780063 -34.589799043030695)));;1378;14_24_2;COMUNA 14;24;2;462;204;258;79,07%;315;315;100,00%;0;0,00%;232;3;1,29%;229;98,71%
MULTIPOLYGON (((-58.414721365910843 -34.589910767772182,-58.413912443851039 -34.590504555234645,-58.414057637793697 -34.590653140225996,-58.414524202326156 -34.5911306682017,-58.415344706642337 -34.590538712299576,-58.416447440700203 -34.589743047161868,-58.415732822967286 -34.589600360525409,-58.415750073223897 -34.589155644730781,-58.414721365910843 -34.589910767772182)));;1379;14_24_3;COMUNA 14;24;3;514;217;297;73,06%;355;355;100,00%;0;0,00%;269;0;0,00%;269;100,00%
MULTIPOLYGON (((-58.415344706642337 -34.590538712299576,-58.414524202326156 -34.5911306682017,-58.415152651637229 -34.591773757048628,-58.415295955478832 -34.591659442074167,-58.415944906497472 -34.59114333393471,-58.415344706642337 -34.590538712299576)));;1380;14_24_4;COMUNA 14;24;4;394;169;225;75,11%;271;271;100,00%;0;0,00%;210;9;4,29%;201;95,71%
MULTIPOLYGON (((-58.415944906497472 -34.59114333393471,-58.415295955478832 -34.591659442074167,-58.415152651637229 -34.591773757048628,-58.416100620625173 -34.592743949753206,-58.416358426106171 -34.592548195131513,-58.416924377826476 -34.592129941506201,-58.415944906497472 -34.59114333393471)));;1381;14_24_5;COMUNA 14;24;5;807;356;451;78,94%;589;589;100,00%;0;0,00%;436;5;1,15%;431;98,85%
MULTIPOLYGON (((-58.415152651637229 -34.591773757048628,-58.414377764808656 -34.592391646121328,-58.415266365394707 -34.593377385676398,-58.415867009987359 -34.592921332105504,-58.416100620625173 -34.592743949753206,-58.415152651637229 -34.591773757048628)));;1382;14_24_6;COMUNA 14;24;6;714;304;410;74,15%;442;442;100,00%;0;0,00%;343;22;6,41%;321;93,59%
MULTIPOLYGON (((-58.414524202326156 -34.5911306682017,-58.413746710290106 -34.591691578218956,-58.414377764808656 -34.592391646121328,-58.415152651637229 -34.591773757048628,-58.414524202326156 -34.5911306682017)));;1383;14_24_7;COMUNA 14;24;7;690;286;404;70,79%;443;443;100,00%;0;0,00%;331;4;1,21%;327;98,79%
MULTIPOLYGON (((-58.413746710290106 -34.591691578218956,-58.413646008722374 -34.591764216714388,-58.412877875766874 -34.592319702145154,-58.413523033025463 -34.59307316253367,-58.414377764808656 -34.592391646121328,-58.413746710290106 -34.591691578218956)));;1384;14_24_8;COMUNA 14;24;8;527;232;295;78,64%;372;372;100,00%;0;0,00%;267;0;0,00%;267;100,00%
MULTIPOLYGON (((-58.414377764808656 -34.592391646121328,-58.413523033025463 -34.59307316253367,-58.414393664345937 -34.594054041743938,-58.415266365394707 -34.593377385676398,-58.414377764808656 -34.592391646121328)));;1385;14_24_9;COMUNA 14;24;9;720;329;391;84,14%;457;457;100,00%;0;0,00%;348;3;0,86%;345;99,14%
MULTIPOLYGON (((-58.416535546288628 -34.586722818380451,-58.415879248712784 -34.587196319880952,-58.415661674022893 -34.587353003099295,-58.417066793589619 -34.588185119338782,-58.417277811643856 -34.588026881838417,-58.417922951772958 -34.587554636444445,-58.416535546288628 -34.586722818380451)));;1386;14_25_1;COMUNA 14;25;1;849;377;472;79,87%;519;516;99,42%;3;0,58%;383;2;0,52%;381;99,48%
MULTIPOLYGON (((-58.418659399739028 -34.587996048939218,-58.417922951772958 -34.587554636444445,-58.417277811643856 -34.588026881838417,-58.417066793589619 -34.588185119338782,-58.417913999073711 -34.588686791332556,-58.41877568615584 -34.588065811960675,-58.418659399739028 -34.587996048939218)));;1387;14_25_2;COMUNA 14;25;2;443;192;251;76,49%;309;308;99,68%;1;0,32%;216;0;0,00%;216;100,00%
MULTIPOLYGON (((-58.415855285748123 -34.589078358124141,-58.415750073223897 -34.589155644730781,-58.415732822967286 -34.589600360525409,-58.416447440700203 -34.589743047161868,-58.41665408780063 -34.589799043030695,-58.416811991801552 -34.589605362378023,-58.417025881126541 -34.589342967338318,-58.417058092220373 -34.589303470767341,-58.417913999073711 -34.588686791332556,-58.417066793589619 -34.588185119338782,-58.416808834299168 -34.588378410657846,-58.415855285748123 -34.589078358124141)));;1388;14_25_3;COMUNA 14;25;3;781;336;445;75,51%;517;515;99,61%;2;0,39%;353;1;0,28%;352;99,72%
MULTIPOLYGON (((-58.416811991801552 -34.589605362378023,-58.41665408780063 -34.589799043030695,-58.416611565181462 -34.589851282585329,-58.41696734802975 -34.59033016790665,-58.417862063830547 -34.589618640538625,-58.418091403312665 -34.589600202717598,-58.418296727194807 -34.589583727639642,-58.419043933923838 -34.589356734615208,-58.41855570930894 -34.589067181214737,-58.419369124594454 -34.588421601769426,-58.41877568615584 -34.588065811960675,-58.417913999073711 -34.588686791332556,-58.417058092220373 -34.589303470767341,-58.417025881126541 -34.589342967338318,-58.416811991801552 -34.589605362378023)));;1389;14_25_4;COMUNA 14;25;4;524;229;295;77,63%;403;402;99,75%;1;0,25%;285;1;0,35%;284;99,65%
MULTIPOLYGON (((-58.420295089395346 -34.588976667579466,-58.419369124594454 -34.588421601769426,-58.41855570930894 -34.589067181214737,-58.419043933923838 -34.589356734615208,-58.420295089395346 -34.588976667579466)));;1390;14_25_5;COMUNA 14;25;5;466;200;266;75,19%;298;298;100,00%;0;0,00%;239;6;2,51%;233;97,49%
MULTIPOLYGON (((-58.420295089395346 -34.588976667579466,-58.419043933923838 -34.589356734615208,-58.420242248078665 -34.590067537877793,-58.421430492136814 -34.589657224870194,-58.420295089395346 -34.588976667579466)));;1391;14_25_6;COMUNA 14;25;6;460;212;248;85,48%;400;400;100,00%;0;0,00%;277;15;5,42%;262;94,58%
MULTIPOLYGON (((-58.419043933923838 -34.589356734615208,-58.418296727194807 -34.589583727639642,-58.418091403312665 -34.589600202717598,-58.41837300874311 -34.589941516130871,-58.419073245307423 -34.590790041681331,-58.420242248078665 -34.590067537877793,-58.419043933923838 -34.589356734615208)));;1392;14_25_7;COMUNA 14;25;7;721;332;389;85,35%;498;498;100,00%;0;0,00%;373;71;19,03%;302;80,97%
MULTIPOLYGON (((-58.41837300874311 -34.589941516130871,-58.417270460216685 -34.590738114247159,-58.417864269173172 -34.591537238803028,-58.419022133481349 -34.590821573948688,-58.419073245307423 -34.590790041681331,-58.41837300874311 -34.589941516130871)));;1393;14_25_8;COMUNA 14;25;8;715;314;401;78,30%;453;453;100,00%;0;0,00%;355;3;0,85%;352;99,15%
MULTIPOLYGON (((-58.418091403312665 -34.589600202717598,-58.417862063830547 -34.589618640538625,-58.41696734802975 -34.59033016790665,-58.417270460216685 -34.590738114247159,-58.41837300874311 -34.589941516130871,-58.418091403312665 -34.589600202717598)));;1394;14_25_9;COMUNA 14;25;9;675;279;396;70,45%;543;543;100,00%;0;0,00%;405;5;1,23%;400;98,77%
MULTIPOLYGON (((-58.414989073789336 -34.585789650650263,-58.414060795050879 -34.58640423871072,-58.415163512775479 -34.587058079884059,-58.415661674022893 -34.587353003099295,-58.415879248712784 -34.587196319880952,-58.416535546288628 -34.586722818380451,-58.414989073789336 -34.585789650650263)));;1395;14_26_1;COMUNA 14;26;1;1046;432;614;70,36%;731;731;100,00%;0;0,00%;526;1;0,19%;525;99,81%
MULTIPOLYGON (((-58.414060795050879 -34.58640423871072,-58.4131550775842 -34.587003898623884,-58.413377649811288 -34.587186883477322,-58.414116354930307 -34.587799950937239,-58.415163512775479 -34.587058079884059,-58.414060795050879 -34.58640423871072)));;1396;14_26_2;COMUNA 14;26;2;728;322;406;79,31%;467;467;100,00%;0;0,00%;357;1;0,28%;356;99,72%
MULTIPOLYGON (((-58.415661674022893 -34.587353003099295,-58.415163512775479 -34.587058079884059,-58.414116354930307 -34.587799950937239,-58.414541674948254 -34.588152880169346,-58.414807127459362 -34.58796839974876,-58.415661674022893 -34.587353003099295)));;1397;14_26_3;COMUNA 14;26;3;411;183;228;80,26%;255;255;100,00%;0;0,00%;184;2;1,09%;182;98,91%
MULTIPOLYGON (((-58.415661674022893 -34.587353003099295,-58.414807127459362 -34.58796839974876,-58.414541674948254 -34.588152880169346,-58.415750073223897 -34.589155644730781,-58.415855285748123 -34.589078358124141,-58.416808834299168 -34.588378410657846,-58.417066793589619 -34.588185119338782,-58.415661674022893 -34.587353003099295)));;1398;14_26_4;COMUNA 14;26;4;1732;732;1000;73,20%;1032;1032;100,00%;0;0,00%;850;5;0,59%;845;99,41%
MULTIPOLYGON (((-58.414541674948254 -34.588152880169346,-58.414395828911523 -34.588254235053149,-58.41359547834719 -34.588776542238293,-58.414721365910843 -34.589910767772182,-58.415750073223897 -34.589155644730781,-58.414541674948254 -34.588152880169346)));;1399;14_26_5;COMUNA 14;26;5;944;435;509;85,46%;609;609;100,00%;0;0,00%;458;2;0,44%;456;99,56%
MULTIPOLYGON (((-58.4131550775842 -34.587003898623884,-58.412359071350558 -34.587530918073021,-58.41359547834719 -34.588776542238293,-58.414395828911523 -34.588254235053149,-58.414541674948254 -34.588152880169346,-58.414116354930307 -34.587799950937239,-58.413377649811288 -34.587186883477322,-58.4131550775842 -34.587003898623884)));;1400;14_26_6;COMUNA 14;26;6;939;406;533;76,17%;521;521;100,00%;0;0,00%;387;4;1,03%;383;98,97%
MULTIPOLYGON (((-58.412359071350558 -34.587530918073021,-58.412184858449152 -34.587646273268305,-58.41173369167565 -34.587944970945792,-58.411542267579414 -34.588073276293173,-58.412757889562421 -34.589322984787074,-58.41359547834719 -34.588776542238293,-58.412359071350558 -34.587530918073021)));;1401;14_26_7;COMUNA 14;26;7;1170;508;662;76,74%;781;781;100,00%;0;0,00%;532;3;0,56%;529;99,44%
MULTIPOLYGON (((-58.41359547834719 -34.588776542238293,-58.412757889562421 -34.589322984787074,-58.413912443851039 -34.590504555234645,-58.414721365910843 -34.589910767772182,-58.41359547834719 -34.588776542238293)));;1402;14_27_1;COMUNA 14;27;1;1230;537;693;77,49%;855;855;100,00%;0;0,00%;616;4;0,65%;612;99,35%
MULTIPOLYGON (((-58.412757889562421 -34.589322984787074,-58.412264804240309 -34.589644766694448,-58.412036150397633 -34.589793973714755,-58.413170983340052 -34.591052869907642,-58.413482292019751 -34.590820240136942,-58.413912443851039 -34.590504555234645,-58.412757889562421 -34.589322984787074)));;1403;14_27_2;COMUNA 14;27;2;1125;471;654;72,02%;865;865;100,00%;0;0,00%;570;29;5,09%;541;94,91%
MULTIPOLYGON (((-58.411542267579414 -34.588073276293173,-58.411392501379588 -34.588173780839874,-58.411045945318229 -34.588401038141775,-58.412264804240309 -34.589644766694448,-58.412757889562421 -34.589322984787074,-58.411542267579414 -34.588073276293173)));;1404;14_27_3;COMUNA 14;27;3;587;248;339;73,16%;447;447;100,00%;0;0,00%;284;1;0,35%;283;99,65%
MULTIPOLYGON (((-58.411045945318229 -34.588401038141775,-58.410081049957441 -34.589057131095537,-58.411188829187509 -34.590346810058932,-58.412036150397633 -34.589793973714755,-58.412264804240309 -34.589644766694448,-58.411045945318229 -34.588401038141775)));;1405;14_27_4;COMUNA 14;27;4;791;321;470;68,30%;676;675;99,85%;1;0,15%;396;2;0,51%;394;99,49%
MULTIPOLYGON (((-58.412036150397633 -34.589793973714755,-58.411188829187509 -34.590346810058932,-58.412327020599243 -34.591676351999482,-58.412985083417112 -34.591191673066277,-58.413170983340052 -34.591052869907642,-58.412036150397633 -34.589793973714755)));;1406;14_27_5;COMUNA 14;27;5;923;389;534;72,85%;701;700;99,86%;1;0,14%;487;3;0,62%;484;99,38%
MULTIPOLYGON (((-58.4133098718358 -34.591207016816774,-58.413170983340052 -34.591052869907642,-58.412985083417112 -34.591191673066277,-58.412327020599243 -34.591676351999482,-58.412390845500376 -34.591750888318508,-58.412462925218733 -34.591835076270648,-58.412877875766874 -34.592319702145154,-58.413646008722374 -34.591764216714388,-58.413746710290106 -34.591691578218956,-58.4133098718358 -34.591207016816774)));;1407;14_27_6;COMUNA 14;27;6;419;175;244;71,72%;317;317;100,00%;0;0,00%;212;2;0,94%;210;99,06%
MULTIPOLYGON (((-58.414057637793697 -34.590653140225996,-58.413912443851039 -34.590504555234645,-58.413482292019751 -34.590820240136942,-58.413170983340052 -34.591052869907642,-58.4133098718358 -34.591207016816774,-58.413746710290106 -34.591691578218956,-58.414524202326156 -34.5911306682017,-58.414057637793697 -34.590653140225996)));;1408;14_27_7;COMUNA 14;27;7;433;200;233;85,84%;311;311;100,00%;0;0,00%;217;2;0,92%;215;99,08%
MULTIPOLYGON (((-58.414070391015883 -34.585134120605879,-58.413296395953381 -34.585630872190634,-58.413158220535855 -34.58572567918209,-58.414060795050879 -34.58640423871072,-58.414989073789336 -34.585789650650263,-58.414070391015883 -34.585134120605879)));;1409;14_28_1;COMUNA 14;28;1;630;269;361;74,52%;361;361;100,00%;0;0,00%;299;2;0,67%;297;99,33%
MULTIPOLYGON (((-58.410963707269836 -34.585203761571442,-58.409932110870727 -34.58555368624404,-58.410564864364041 -34.586543927841618,-58.410721868993818 -34.586439835671349,-58.41168757119911 -34.58579909042507,-58.410963707269836 -34.585203761571442)));;1410;14_28_10;COMUNA 14;28;10;843;379;464;81,68%;583;583;100,00%;0;0,00%;381;0;0,00%;381;100,00%
MULTIPOLYGON (((-58.409932110870727 -34.58555368624404,-58.408038247127045 -34.586149144470831,-58.408136083069081 -34.586288841786434,-58.408316698126171 -34.586545904619399,-58.409028704891838 -34.587559288825922,-58.410564864364041 -34.586543927841618,-58.409932110870727 -34.58555368624404)));;1411;14_28_11;COMUNA 14;28;11;980;446;534;83,52%;493;493;100,00%;0;0,00%;392;2;0,51%;390;99,49%
MULTIPOLYGON (((-58.411542267579414 -34.588073276293173,-58.410992096432608 -34.587212305578802,-58.410564864364041 -34.586543927841618,-58.409028704891838 -34.587559288825922,-58.409497827064001 -34.588227126691763,-58.410081049957441 -34.589057131095537,-58.411045945318229 -34.588401038141775,-58.411392501379588 -34.588173780839874,-58.411542267579414 -34.588073276293173)));;1412;14_28_12;COMUNA 14;28;12;578;233;345;67,54%;429;429;100,00%;0;0,00%;270;1;0,37%;269;99,63%
MULTIPOLYGON (((-58.414070391015883 -34.585134120605879,-58.413403242170872 -34.584657988520455,-58.413024246906922 -34.584912211401651,-58.412520707436514 -34.58524631477696,-58.413158220535855 -34.58572567918209,-58.413296395953381 -34.585630872190634,-58.414070391015883 -34.585134120605879)));;1413;14_28_2;COMUNA 14;28;2;617;270;347;77,81%;355;355;100,00%;0;0,00%;266;3;1,13%;263;98,87%
MULTIPOLYGON (((-58.412569274231394 -34.584062835831084,-58.411735018689328 -34.584655683510711,-58.412520707436514 -34.58524631477696,-58.413024246906922 -34.584912211401651,-58.413403242170872 -34.584657988520455,-58.412569274231394 -34.584062835831084)));;1414;14_28_3;COMUNA 14;28;3;676;283;393;72,01%;369;369;100,00%;0;0,00%;288;1;0,35%;287;99,65%
MULTIPOLYGON (((-58.411735018689328 -34.584655683510711,-58.410963707269836 -34.585203761571442,-58.41168757119911 -34.58579909042507,-58.412520707436514 -34.58524631477696,-58.411735018689328 -34.584655683510711)));;1415;14_28_4;COMUNA 14;28;4;693;287;406;70,69%;395;395;100,00%;0;0,00%;314;2;0,64%;312;99,36%
MULTIPOLYGON (((-58.413158220535855 -34.58572567918209,-58.412520707436514 -34.58524631477696,-58.41168757119911 -34.58579909042507,-58.41213900308599 -34.586168518588913,-58.412309226968326 -34.586308383380526,-58.413158220535855 -34.58572567918209)));;1416;14_28_5;COMUNA 14;28;5;555;259;296;87,50%;300;300;100,00%;0;0,00%;228;0;0,00%;228;100,00%
MULTIPOLYGON (((-58.413158220535855 -34.58572567918209,-58.412309226968326 -34.586308383380526,-58.4131550775842 -34.587003898623884,-58.414060795050879 -34.58640423871072,-58.413158220535855 -34.58572567918209)));;1417;14_28_6;COMUNA 14;28;6;936;390;546;71,43%;552;552;100,00%;0;0,00%;413;2;0,48%;411;99,52%
MULTIPOLYGON (((-58.412309226968326 -34.586308383380526,-58.411621657903339 -34.586780229308971,-58.412184858449152 -34.587646273268305,-58.412359071350558 -34.587530918073021,-58.4131550775842 -34.587003898623884,-58.412309226968326 -34.586308383380526)));;1418;14_28_7;COMUNA 14;28;7;740;312;428;72,90%;585;585;100,00%;0;0,00%;374;1;0,27%;373;99,73%
MULTIPOLYGON (((-58.411621657903339 -34.586780229308971,-58.410992096432608 -34.587212305578802,-58.411542267579414 -34.588073276293173,-58.41173369167565 -34.587944970945792,-58.412184858449152 -34.587646273268305,-58.411621657903339 -34.586780229308971)));;1419;14_28_8;COMUNA 14;28;8;525;200;325;61,54%;475;475;100,00%;0;0,00%;302;0;0,00%;302;100,00%
MULTIPOLYGON (((-58.412309226968326 -34.586308383380526,-58.41213900308599 -34.586168518588913,-58.41168757119911 -34.58579909042507,-58.410721868993818 -34.586439835671349,-58.410564864364041 -34.586543927841618,-58.410992096432608 -34.587212305578802,-58.411621657903339 -34.586780229308971,-58.412309226968326 -34.586308383380526)));;1420;14_28_9;COMUNA 14;28;9;579;253;326;77,61%;383;383;100,00%;0;0,00%;263;1;0,38%;262;99,62%
MULTIPOLYGON (((-58.409831988512714 -34.579877353680189,-58.408429018764267 -34.580386688631044,-58.408244373623596 -34.580453721843519,-58.408665944485378 -34.581372397859056,-58.408885077960583 -34.58130347774425,-58.409465063017912 -34.581116752543487,-58.409736318000853 -34.581029402152886,-58.409817140801621 -34.581003379784086,-58.410059694050751 -34.580925312392417,-58.410397370964525 -34.58082650981062,-58.409831988512714 -34.579877353680189)));;1421;14_29_1;COMUNA 14;29;1;545;239;306;78,10%;407;407;100,00%;0;0,00%;277;1;0,36%;276;99,64%
MULTIPOLYGON (((-58.411435376060687 -34.583253669783687,-58.410714516670581 -34.58388839083883,-58.411735018689328 -34.584655683510711,-58.412569274231394 -34.584062835831084,-58.411435376060687 -34.583253669783687)));;1422;14_29_10;COMUNA 14;29;10;787;331;456;72,59%;502;502;100,00%;0;0,00%;366;2;0,55%;364;99,45%
MULTIPOLYGON (((-58.412105021672794 -34.582664065878497,-58.411435376060687 -34.583253669783687,-58.412569274231394 -34.584062835831084,-58.413376598772018 -34.583489127218726,-58.412105021672794 -34.582664065878497)));;1423;14_29_11;COMUNA 14;29;11;640;270;370;72,97%;432;432;100,00%;0;0,00%;281;2;0,71%;279;99,29%
MULTIPOLYGON (((-58.408244373623596 -34.580453721843519,-58.407664630207144 -34.580664245175157,-58.407278218511934 -34.580804005687583,-58.406233614391411 -34.581181852363862,-58.406636068382596 -34.582010663575829,-58.40768550302753 -34.581680704984748,-58.408665944485378 -34.581372397859056,-58.408244373623596 -34.580453721843519)));;1424;14_29_2;COMUNA 14;29;2;924;381;543;70,17%;395;394;99,75%;1;0,25%;280;8;2,86%;272;97,14%
MULTIPOLYGON (((-58.406233614391411 -34.581181852363862,-58.405184146047937 -34.581561518840658,-58.405584155278277 -34.582341809193842,-58.405778254600733 -34.582280348048258,-58.406636068382596 -34.582010663575829,-58.406233614391411 -34.581181852363862)));;1425;14_29_3;COMUNA 14;29;3;517;239;278;85,97%;453;453;100,00%;0;0,00%;270;0;0,00%;270;100,00%
MULTIPOLYGON (((-58.406636068382596 -34.582010663575829,-58.405778254600733 -34.582280348048258,-58.405584155278277 -34.582341809193842,-58.406019292873019 -34.58319056796541,-58.406172382963348 -34.583459241503078,-58.406908913428353 -34.583247881608742,-58.407194143153347 -34.583159979887355,-58.406636068382596 -34.582010663575829)));;1426;14_29_4;COMUNA 14;29;4;750;323;427;75,64%;527;527;100,00%;0;0,00%;358;1;0,28%;357;99,72%
MULTIPOLYGON (((-58.40768550302753 -34.581680704984748,-58.406636068382596 -34.582010663575829,-58.407194143153347 -34.583159979887355,-58.408221442224651 -34.582843246667032,-58.40768550302753 -34.581680704984748)));;1427;14_29_5;COMUNA 14;29;5;474;185;289;64,01%;494;494;100,00%;0;0,00%;280;2;0,71%;278;99,29%
MULTIPOLYGON (((-58.408665944485378 -34.581372397859056,-58.40768550302753 -34.581680704984748,-58.408221442224651 -34.582843246667032,-58.409202317328756 -34.582540851226589,-58.408665944485378 -34.581372397859056)));;1428;14_29_6;COMUNA 14;29;6;826;357;469;76,12%;679;678;99,85%;1;0,15%;448;3;0,67%;445;99,33%
MULTIPOLYGON (((-58.410397370964525 -34.58082650981062,-58.410059694050751 -34.580925312392417,-58.409817140801621 -34.581003379784086,-58.409736318000853 -34.581029402152886,-58.409465063017912 -34.581116752543487,-58.408885077960583 -34.58130347774425,-58.408665944485378 -34.581372397859056,-58.409202317328756 -34.582540851226589,-58.409929814265688 -34.582316581248833,-58.410188891502081 -34.582236689701027,-58.411096070750851 -34.581977981469635,-58.410397370964525 -34.58082650981062)));;1429;14_29_7;COMUNA 14;29;7;838;371;467;79,44%;617;617;100,00%;0;0,00%;379;6;1,58%;373;98,42%
MULTIPOLYGON (((-58.410188891502081 -34.582236689701027,-58.410246145140327 -34.582405036525273,-58.410465596530614 -34.582561540088605,-58.411435376060687 -34.583253669783687,-58.412105021672794 -34.582664065878497,-58.411096070750851 -34.581977981469635,-58.410188891502081 -34.582236689701027)));;1430;14_29_8;COMUNA 14;29;8;609;261;348;75,00%;376;375;99,73%;1;0,27%;267;2;0,75%;265;99,25%
MULTIPOLYGON (((-58.410963707269836 -34.585203761571442,-58.411735018689328 -34.584655683510711,-58.410714516670581 -34.58388839083883,-58.411435376060687 -34.583253669783687,-58.410465596530614 -34.582561540088605,-58.410246145140327 -34.582405036525273,-58.410188891502081 -34.582236689701027,-58.409929814265688 -34.582316581248833,-58.409202317328756 -34.582540851226589,-58.408221442224651 -34.582843246667032,-58.407194143153347 -34.583159979887355,-58.406908913428353 -34.583247881608742,-58.406172382963348 -34.583459241503078,-58.406398224353566 -34.583808515090148,-58.407091807139686 -34.584798450869428,-58.407625723100381 -34.585560484472026,-58.408038247127045 -34.586149144470831,-58.409932110870727 -34.58555368624404,-58.410963707269836 -34.585203761571442)));;1431;14_29_9;COMUNA 14;29;9;724;317;407;77,89%;457;456;99,78%;1;0,22%;336;7;2,08%;329;97,92%
MULTIPOLYGON (((-58.438489660081281 -34.565170349770902,-58.438457559414097 -34.565189710450348,-58.438300717226582 -34.565284260831525,-58.437792297455744 -34.565590791361267,-58.437173689805256 -34.565967370265412,-58.437019400208733 -34.566057060153234,-58.437742356079518 -34.56690914882882,-58.438098265164868 -34.567328535175299,-58.438310735734284 -34.567126949282297,-58.439261420687842 -34.566269421911102,-58.439338740283318 -34.566204926860635,-58.439413845791407 -34.566142191978791,-58.439471239269295 -34.566094243062444,-58.439500957812477 -34.56606945889348,-58.438489660081281 -34.565170349770902)));;1432;14_3_1;COMUNA 14;3;1;1619;719;900;79,89%;1018;1018;100,00%;0;0,00%;758;4;0,53%;754;99,47%
MULTIPOLYGON (((-58.434839983568928 -34.56731832759192,-58.434532331196451 -34.567495729526719,-58.43376153369848 -34.567941272894949,-58.43449894262681 -34.568802820966297,-58.435575016065329 -34.568174516364451,-58.434839983568928 -34.56731832759192)));;1433;14_3_10;COMUNA 14;3;10;631;260;371;70,08%;441;441;100,00%;0;0,00%;308;2;0,65%;306;99,35%
MULTIPOLYGON (((-58.434098328331942 -34.566454385907562,-58.433023629344724 -34.56707922715173,-58.43376153369848 -34.567941272894949,-58.434532331196451 -34.567495729526719,-58.434839983568928 -34.56731832759192,-58.434098328331942 -34.566454385907562)));;1434;14_3_11;COMUNA 14;3;11;708;308;400;77,00%;464;464;100,00%;0;0,00%;347;2;0,58%;345;99,42%
MULTIPOLYGON (((-58.43331013966214 -34.565536200669762,-58.432245318908571 -34.566169840738382,-58.433023629344724 -34.56707922715173,-58.434098328331942 -34.566454385907562,-58.43331013966214 -34.565536200669762)));;1435;14_3_12;COMUNA 14;3;12;677;302;375;80,53%;454;454;100,00%;0;0,00%;305;1;0,33%;304;99,67%
MULTIPOLYGON (((-58.437742356079518 -34.56690914882882,-58.437019400208733 -34.566057060153234,-58.436118008470046 -34.566581326812525,-58.435938427281258 -34.566684883661416,-58.436664782540333 -34.567538317461327,-58.436157708548897 -34.567834347937378,-58.437018972243052 -34.568833800987179,-58.437069730550604 -34.568778527563971,-58.437353025265161 -34.568347018660575,-58.437506595990762 -34.56811316703233,-58.437879321456641 -34.567536316829155,-58.438098265164868 -34.567328535175299,-58.437742356079518 -34.56690914882882)));;1436;14_3_2;COMUNA 14;3;2;498;235;263;89,35%;366;366;100,00%;0;0,00%;226;2;0,88%;224;99,12%
MULTIPOLYGON (((-58.436275439126213 -34.565180172712111,-58.435773740164507 -34.56548021713521,-58.435198045270667 -34.565814962667808,-58.435938427281258 -34.566684883661416,-58.436118008470046 -34.566581326812525,-58.437019400208733 -34.566057060153234,-58.436275439126213 -34.565180172712111)));;1437;14_3_3;COMUNA 14;3;3;426;188;238;78,99%;354;354;100,00%;0;0,00%;226;1;0,44%;225;99,56%
MULTIPOLYGON (((-58.435489795031273 -34.564254184656328,-58.434409512868648 -34.564888333276215,-58.435198045270667 -34.565814962667808,-58.435773740164507 -34.56548021713521,-58.436275439126213 -34.565180172712111,-58.435489795031273 -34.564254184656328)));;1438;14_3_4;COMUNA 14;3;4;781;347;434;79,95%;415;415;100,00%;0;0,00%;297;1;0,34%;296;99,66%
MULTIPOLYGON (((-58.434409512868648 -34.564888333276215,-58.433798308394302 -34.565245670634418,-58.43331013966214 -34.565536200669762,-58.434098328331942 -34.566454385907562,-58.435198045270667 -34.565814962667808,-58.434409512868648 -34.564888333276215)));;1439;14_3_5;COMUNA 14;3;5;862;368;494;74,49%;564;564;100,00%;0;0,00%;407;23;5,65%;384;94,35%
MULTIPOLYGON (((-58.435198045270667 -34.565814962667808,-58.434098328331942 -34.566454385907562,-58.434839983568928 -34.56731832759192,-58.435938427281258 -34.566684883661416,-58.435198045270667 -34.565814962667808)));;1440;14_3_6;COMUNA 14;3;6;410;190;220;86,36%;229;229;100,00%;0;0,00%;164;0;0,00%;164;100,00%
MULTIPOLYGON (((-58.435938427281258 -34.566684883661416,-58.434839983568928 -34.56731832759192,-58.435575016065329 -34.568174516364451,-58.436157708548897 -34.567834347937378,-58.436664782540333 -34.567538317461327,-58.435938427281258 -34.566684883661416)));;1441;14_3_7;COMUNA 14;3;7;638;279;359;77,72%;384;384;100,00%;0;0,00%;297;0;0,00%;297;100,00%
MULTIPOLYGON (((-58.436157708548897 -34.567834347937378,-58.435575016065329 -34.568174516364451,-58.436315935877822 -34.569037603575204,-58.435238153976009 -34.569666407212736,-58.435729040974678 -34.57023985130639,-58.436565465763977 -34.569328162807729,-58.436724640756253 -34.569154668132001,-58.437018972243052 -34.568833800987179,-58.436157708548897 -34.567834347937378)));;1442;14_3_8;COMUNA 14;3;8;839;359;480;74,79%;585;585;100,00%;0;0,00%;430;0;0,00%;430;100,00%
MULTIPOLYGON (((-58.435575016065329 -34.568174516364451,-58.43449894262681 -34.568802820966297,-58.435238153976009 -34.569666407212736,-58.436315935877822 -34.569037603575204,-58.435575016065329 -34.568174516364451)));;1443;14_3_9;COMUNA 14;3;9;893;352;541;65,06%;618;618;100,00%;0;0,00%;456;0;0,00%;456;100,00%
MULTIPOLYGON (((-58.408616549082922 -34.57783673617898,-58.407907163346522 -34.578153052741563,-58.407684015337111 -34.578252533986905,-58.407035747874318 -34.578583521491105,-58.406925849381359 -34.57867277081894,-58.407703334226689 -34.57955935767459,-58.409268149878002 -34.578930801207413,-58.408616549082922 -34.57783673617898)));;1444;14_30_1;COMUNA 14;30;1;811;366;445;82,25%;515;515;100,00%;0;0,00%;327;18;5,50%;309;94,50%
MULTIPOLYGON (((-58.409268149878002 -34.578930801207413,-58.407703334226689 -34.57955935767459,-58.408429018764267 -34.580386688631044,-58.409831988512714 -34.579877353680189,-58.409268149878002 -34.578930801207413)));;1445;14_30_2;COMUNA 14;30;2;976;423;553;76,49%;626;626;100,00%;0;0,00%;429;1;0,23%;428;99,77%
MULTIPOLYGON (((-58.406925849381359 -34.57867277081894,-58.4068647662003 -34.578722322422237,-58.406323874207317 -34.579161458277625,-58.406827639651496 -34.579871508137444,-58.407064374483454 -34.580346424685793,-58.407278218511934 -34.580804005687583,-58.407664630207144 -34.580664245175157,-58.408244373623596 -34.580453721843519,-58.408429018764267 -34.580386688631044,-58.407703334226689 -34.57955935767459,-58.406925849381359 -34.57867277081894)));;1446;14_30_3;COMUNA 14;30;3;840;378;462;81,82%;626;626;100,00%;0;0,00%;407;4;0,98%;403;99,02%
MULTIPOLYGON (((-58.406323874207317 -34.579161458277625,-58.405831622662582 -34.579561035265868,-58.405566070654338 -34.579776624427964,-58.405809230905206 -34.580307886782862,-58.406233614391411 -34.581181852363862,-58.407278218511934 -34.580804005687583,-58.407064374483454 -34.580346424685793,-58.406827639651496 -34.579871508137444,-58.406323874207317 -34.579161458277625)));;1447;14_30_4;COMUNA 14;30;4;574;272;302;90,07%;539;539;100,00%;0;0,00%;305;1;0,33%;304;99,67%
MULTIPOLYGON (((-58.404644685341253 -34.580515375194445,-58.40367371056454 -34.581289892962999,-58.403670208542572 -34.581292686381794,-58.404167885089116 -34.58192907902049,-58.405184146047937 -34.581561518840658,-58.406233614391411 -34.581181852363862,-58.405809230905206 -34.580307886782862,-58.405566070654338 -34.579776624427964,-58.405297535454736 -34.579994606066428,-58.404688816656339 -34.580480183453673,-58.404644685341253 -34.580515375194445)));;1448;14_30_5;COMUNA 14;30;5;952;410;542;75,65%;534;534;100,00%;0;0,00%;378;2;0,53%;376;99,47%
MULTIPOLYGON (((-58.405184146047937 -34.581561518840658,-58.404167885089116 -34.58192907902049,-58.404707766516111 -34.582619224226967,-58.405584155278277 -34.582341809193842,-58.405184146047937 -34.581561518840658)));;1449;14_30_6;COMUNA 14;30;6;476;201;275;73,09%;317;317;100,00%;0;0,00%;233;0;0,00%;233;100,00%
MULTIPOLYGON (((-58.405584155278277 -34.582341809193842,-58.404707766516111 -34.582619224226967,-58.405359872729868 -34.583452946744231,-58.406172382963348 -34.583459241503078,-58.406019292873019 -34.58319056796541,-58.405584155278277 -34.582341809193842)));;1450;14_30_7;COMUNA 14;30;7;383;166;217;76,50%;314;314;100,00%;0;0,00%;204;1;0,49%;203;99,51%
MULTIPOLYGON (((-58.403670208542572 -34.581292686381794,-58.403537641511093 -34.581398401202172,-58.403312321410517 -34.581471960160584,-58.402487250980869 -34.58173726769558,-58.403803825548039 -34.583198533427186,-58.404026664812399 -34.583442594395876,-58.405359872729868 -34.583452946744231,-58.404707766516111 -34.582619224226967,-58.404167885089116 -34.58192907902049,-58.403670208542572 -34.581292686381794)));;1451;14_30_8;COMUNA 14;30;8;1632;717;915;78,36%;889;889;100,00%;0;0,00%;675;3;0,44%;672;99,56%
MULTIPOLYGON (((-58.402487250980869 -34.58173726769558,-58.40175997716355 -34.581972798163179,-58.401653780082675 -34.582006160513458,-58.401531475917956 -34.582045607944991,-58.402043926335487 -34.583427187904427,-58.404026664812399 -34.583442594395876,-58.403803825548039 -34.583198533427186,-58.402487250980869 -34.58173726769558)));;1452;14_30_9;COMUNA 14;30;9;1280;540;740;72,97%;807;807;100,00%;0;0,00%;579;2;0,35%;577;99,65%
MULTIPOLYGON (((-58.407995552784072 -34.575021622764531,-58.407812027601047 -34.57482716595802,-58.407606365207911 -34.574505228692672,-58.407418310639294 -34.574210694568428,-58.407329000045827 -34.574077268147668,-58.406690735768628 -34.57330987193248,-58.406351265342906 -34.572858976608373,-58.4061847458687 -34.572620273036428,-58.40608529153436 -34.572380709956811,-58.406079188968263 -34.572294101099843,-58.405127649518121 -34.571628152895684,-58.404960275893401 -34.571582195689274,-58.404806687797318 -34.571723039898934,-58.404306546884769 -34.572377618393418,-58.40364499946881 -34.573233111253245,-58.403576575612028 -34.573311743448869,-58.40344185739027 -34.573467107266353,-58.402783986729936 -34.574276397942022,-58.403792146350376 -34.575372780055744,-58.40429538427793 -34.575921495709927,-58.404872223176895 -34.57655024749679,-58.405801067354673 -34.575793821184249,-58.406631445292874 -34.575200447994497,-58.406996520118078 -34.575610702876908,-58.407515594329965 -34.576194202667629,-58.406631614211229 -34.576724244645618,-58.40705055308905 -34.577193540556813,-58.407907163346522 -34.578153052741563,-58.408616549082922 -34.57783673617898,-58.409863688764482 -34.577280709809756,-58.409955671370874 -34.577239691532853,-58.409781031722424 -34.576847909365519,-58.409768886574746 -34.576799733062323,-58.409746705730093 -34.576733664328749,-58.409724434012645 -34.576676680439796,-58.409698074634804 -34.576620892004769,-58.409667712792697 -34.576566228632565,-58.409628244983111 -34.576504589169261,-58.409598556276933 -34.576462673086468,-58.409567419521977 -34.576421742322836,-58.409534749664815 -34.576381655989188,-58.409500546706639 -34.576342414084365,-58.409464895747782 -34.576304087069687,-58.409427796789039 -34.576266674943881,-58.409389334930204 -34.576230248168343,-58.409349510126688 -34.576194877167261,-58.409296918992709 -34.576151331210184,-58.409225263578655 -34.576095452416929,-58.409152670820674 -34.576040911254452,-58.409078970610508 -34.575987425944419,-58.409004077758546 -34.575935066872866,-58.408941779232208 -34.575893629255411,-58.408852846621031 -34.57582767178387,-58.408772935770379 -34.575767281847945,-58.408543341266949 -34.575577946862779,-58.408449308900373 -34.575499380665526,-58.408324402756683 -34.575370094279016,-58.408215069389861 -34.575254265986857,-58.407995552784072 -34.575021622764531)));;1453;14_31_1;COMUNA 14;31;1;721;371;350;106,00%;407;406;99,75%;1;0,25%;217;2;0,92%;215;99,08%
MULTIPOLYGON (((-58.40320745166111 -34.581177121524341,-58.403207618094406 -34.581172911395818,-58.403109404783493 -34.580761793307936,-58.403013040484112 -34.579963861165773,-58.402998568434626 -34.57984046869192,-58.402911599388318 -34.579173426600867,-58.402894493418138 -34.579042567709408,-58.402761260238172 -34.578656500373512,-58.402632320294103 -34.578222193532142,-58.402048647501701 -34.578569243318952,-58.401414114987787 -34.578946618140733,-58.400670107055063 -34.579398796312972,-58.400264594857369 -34.579622072015169,-58.400216426331262 -34.579648011873651,-58.400155520834879 -34.579681432770478,-58.399865899453147 -34.57984058639407,-58.39858828462399 -34.580471638265699,-58.398109317234791 -34.580702099490452,-58.39936160293162 -34.582715021637327,-58.399572293829252 -34.582677664471014,-58.40020085697968 -34.582474881046231,-58.401531475917956 -34.582045607944991,-58.401653780082675 -34.582006160513458,-58.40175997716355 -34.581972798163179,-58.402487250980869 -34.58173726769558,-58.403312321410517 -34.581471960160584,-58.403537641511093 -34.581398401202172,-58.403670208542572 -34.581292686381794,-58.40367371056454 -34.581289892962999,-58.40320745166111 -34.581177121524341)));;1454;14_31_10;COMUNA 14;31;10;545;237;308;76,95%;280;280;100,00%;0;0,00%;195;2;1,03%;193;98,97%
MULTIPOLYGON (((-58.401531475917956 -34.582045607944991,-58.40020085697968 -34.582474881046231,-58.400606604701764 -34.583039054910778,-58.401215409716244 -34.583881439781408,-58.401345927466444 -34.583792769448948,-58.40194310773196 -34.583426363078139,-58.402043926335487 -34.583427187904427,-58.401531475917956 -34.582045607944991)));;1455;14_31_11;COMUNA 14;31;11;391;160;231;69,26%;326;326;100,00%;0;0,00%;214;1;0,47%;213;99,53%
MULTIPOLYGON (((-58.39993899380196 -34.583641836671205,-58.400543718374358 -34.584471827838954,-58.401126636988991 -34.583941820026993,-58.401215409716244 -34.583881439781408,-58.400606604701764 -34.583039054910778,-58.40020085697968 -34.582474881046231,-58.399572293829252 -34.582677664471014,-58.39936160293162 -34.582715021637327,-58.399274993061546 -34.582730399826893,-58.39993899380196 -34.583641836671205)));;1456;14_31_12;COMUNA 14;31;12;575;217;358;60,61%;383;383;100,00%;0;0,00%;260;1;0,38%;259;99,62%
MULTIPOLYGON (((-58.406996520118078 -34.575610702876908,-58.406631445292874 -34.575200447994497,-58.405801067354673 -34.575793821184249,-58.404872223176895 -34.57655024749679,-58.405058549030024 -34.57675344275053,-58.406106245679801 -34.576135667593675,-58.406631614211229 -34.576724244645618,-58.407515594329965 -34.576194202667629,-58.406996520118078 -34.575610702876908)));;1457;14_31_2;COMUNA 14;31;2;837;393;444;88,51%;439;439;100,00%;0;0,00%;327;2;0,61%;325;99,39%
MULTIPOLYGON (((-58.406631614211229 -34.576724244645618,-58.406106245679801 -34.576135667593675,-58.405058549030024 -34.57675344275053,-58.405298902270843 -34.577015468416441,-58.406025501441292 -34.577807531249583,-58.40705055308905 -34.577193540556813,-58.406631614211229 -34.576724244645618)));;1458;14_31_3;COMUNA 14;31;3;616;278;338;82,25%;413;413;100,00%;0;0,00%;279;1;0,36%;278;99,64%
MULTIPOLYGON (((-58.40705055308905 -34.577193540556813,-58.406025501441292 -34.577807531249583,-58.4068647662003 -34.578722322422237,-58.406925849381359 -34.57867277081894,-58.407035747874318 -34.578583521491105,-58.407684015337111 -34.578252533986905,-58.407907163346522 -34.578153052741563,-58.40705055308905 -34.577193540556813)));;1459;14_31_4;COMUNA 14;31;4;646;274;372;73,66%;346;346;100,00%;0;0,00%;250;0;0,00%;250;100,00%
MULTIPOLYGON (((-58.406025501441292 -34.577807531249583,-58.404668737113383 -34.578620237533848,-58.405831622662582 -34.579561035265868,-58.406323874207317 -34.579161458277625,-58.4068647662003 -34.578722322422237,-58.406025501441292 -34.577807531249583)));;1460;14_31_5;COMUNA 14;31;5;607;275;332;82,83%;319;319;100,00%;0;0,00%;251;1;0,40%;250;99,60%
MULTIPOLYGON (((-58.404230917225753 -34.57703489191217,-58.403437545146637 -34.577624181868984,-58.404668737113383 -34.578620237533848,-58.406025501441292 -34.577807531249583,-58.405298902270843 -34.577015468416441,-58.405058549030024 -34.57675344275053,-58.404872223176895 -34.57655024749679,-58.404756616957577 -34.576644421981641,-58.404230917225753 -34.57703489191217)));;1461;14_31_6;COMUNA 14;31;6;1220;551;669;82,36%;610;609;99,84%;1;0,16%;406;0;0,00%;406;100,00%
MULTIPOLYGON (((-58.402911599388318 -34.579173426600867,-58.402998568434626 -34.57984046869192,-58.403013040484112 -34.579963861165773,-58.403109404783493 -34.580761793307936,-58.403207618094406 -34.581172911395818,-58.40320745166111 -34.581177121524341,-58.40367371056454 -34.581289892962999,-58.404644685341253 -34.580515375194445,-58.404688816656339 -34.580480183453673,-58.405297535454736 -34.579994606066428,-58.405566070654338 -34.579776624427964,-58.405831622662582 -34.579561035265868,-58.404668737113383 -34.578620237533848,-58.403437545146637 -34.577624181868984,-58.402632320294103 -34.578222193532142,-58.402761260238172 -34.578656500373512,-58.402894493418138 -34.579042567709408,-58.402911599388318 -34.579173426600867)));;1462;14_31_7;COMUNA 14;31;7;897;391;506;77,27%;420;418;99,52%;2;0,48%;315;2;0,63%;313;99,37%
MULTIPOLYGON (((-58.398771721976033 -34.577616517094235,-58.398771410698203 -34.577616686083942,-58.399263535807087 -34.578309506965319,-58.399901626549081 -34.579207761623152,-58.399971373773248 -34.579305407176626,-58.400036621305638 -34.579272340726078,-58.400135955371383 -34.579429510883571,-58.400264594857369 -34.579622072015169,-58.400670107055063 -34.579398796312972,-58.401414114987787 -34.578946618140733,-58.402048647501701 -34.578569243318952,-58.402632320294103 -34.578222193532142,-58.403437545146637 -34.577624181868984,-58.404230917225753 -34.57703489191217,-58.404756616957577 -34.576644421981641,-58.404872223176895 -34.57655024749679,-58.40429538427793 -34.575921495709927,-58.403792146350376 -34.575372780055744,-58.402783986729936 -34.574276397942022,-58.402647090942608 -34.574140968282322,-58.402617889850305 -34.574161144782586,-58.402549845201484 -34.574241379242714,-58.402321281215379 -34.574514754269849,-58.402096205750752 -34.574783324123089,-58.401845280751964 -34.575089400632734,-58.401655027521898 -34.575315205199708,-58.401236692484034 -34.57566107572265,-58.401167837015969 -34.575717500959044,-58.401144992895674 -34.575737694030288,-58.400849700585418 -34.575932248494809,-58.400601963421224 -34.576093502148957,-58.40035876052572 -34.576243524704331,-58.400123713498537 -34.576382318045674,-58.399929427076223 -34.576494921783819,-58.399780891587518 -34.57656748476964,-58.399528653636096 -34.576689044304352,-58.399265546482169 -34.576815839689488,-58.398982509416214 -34.576956852449378,-58.39876196075587 -34.577073933766826,-58.398583073815182 -34.577171566205926,-58.398482766741324 -34.577237365340594,-58.398771721976033 -34.577616517094235)));;1463;14_31_8;COMUNA 14;31;8;738;340;398;85,43%;525;525;100,00%;0;0,00%;269;2;0,74%;267;99,26%
MULTIPOLYGON (((-58.400155520834879 -34.579681432770478,-58.400216426331262 -34.579648011873651,-58.400264594857369 -34.579622072015169,-58.400135955371383 -34.579429510883571,-58.400036621305638 -34.579272340726078,-58.399971373773248 -34.579305407176626,-58.399901626549081 -34.579207761623152,-58.399263535807087 -34.578309506965319,-58.398771410698203 -34.577616686083942,-58.398771721976033 -34.577616517094235,-58.398482766741324 -34.577237365340594,-58.398429081780904 -34.577272581363722,-58.398128796098099 -34.57746974757162,-58.398060838616402 -34.577515535654051,-58.39720552006888 -34.578079925897889,-58.397147078344524 -34.578120058653496,-58.396559474961528 -34.578506408493944,-58.396582320808555 -34.578542213279036,-58.396662668030601 -34.578669655392147,-58.396755753462905 -34.5788173907358,-58.396771433382035 -34.578839308521616,-58.396913346414607 -34.579041310874288,-58.397960044224654 -34.580492223006459,-58.398109317234791 -34.580702099490452,-58.39858828462399 -34.580471638265699,-58.399865899453147 -34.57984058639407,-58.400155520834879 -34.579681432770478)));;1464;14_31_9;COMUNA 14;31;9;649;292;357;81,79%;338;338;100,00%;0;0,00%;225;0;0,00%;225;100,00%
MULTIPOLYGON (((-58.442965132578152 -34.569310702392777,-58.442822334846419 -34.569407443981852,-58.441757670210478 -34.569848763964742,-58.442956239600207 -34.570915277359113,-58.443639727442935 -34.570563821537462,-58.443827563254402 -34.570471663644504,-58.444110593429428 -34.570332686986241,-58.442965132578152 -34.569310702392777)));;1465;14_4_1;COMUNA 14;4;1;880;374;506;73,91%;526;526;100,00%;0;0,00%;413;3;0,73%;410;99,27%
MULTIPOLYGON (((-58.429014704670834 -34.577253622778109,-58.42929789906028 -34.577248911670935,-58.429307173056081 -34.577265957178085,-58.430105413946023 -34.57703313498569,-58.431407760948133 -34.57665493875615,-58.431468669047725 -34.576575232687397,-58.431709235404078 -34.576485008508726,-58.432202078688 -34.576338950353367,-58.432343242994598 -34.576274128803732,-58.432841243861617 -34.576027796026139,-58.432417362510122 -34.575360490845462,-58.432352685335047 -34.575273499268363,-58.432313277661116 -34.575236234365313,-58.432264501215776 -34.575207418175836,-58.432209931329602 -34.575188882645477,-58.431899797947715 -34.575073799909468,-58.431832798705429 -34.575051669371675,-58.43176716277469 -34.575026862972734,-58.431703060393808 -34.574999521609115,-58.431640661852605 -34.574969645326505,-58.431580052297583 -34.574937234149218,-58.431521401938703 -34.57490249939989,-58.431464795920967 -34.574865441103142,-58.431310815074063 -34.57475321374487,-58.431055470662642 -34.574983157570081,-58.429161036289351 -34.57669920313306,-58.428499406935785 -34.577253056927375,-58.429014704670834 -34.577253622778109)));;1466;14_4_10;COMUNA 14;4;10;1482;645;837;77,06%;870;869;99,89%;1;0,12%;697;5;0,72%;692;99,28%
MULTIPOLYGON (((-58.43962618028236 -34.567951959310349,-58.44024598939918 -34.568503507345369,-58.441225682393096 -34.569375341180901,-58.441757670210478 -34.569848763964742,-58.442822334846419 -34.569407443981852,-58.442965132578152 -34.569310702392777,-58.442190726010907 -34.568619770102082,-58.440601011090912 -34.56720140269023,-58.439413845791407 -34.566142191978791,-58.439338740283318 -34.566204926860635,-58.439261420687842 -34.566269421911102,-58.438310735734284 -34.567126949282297,-58.438098265164868 -34.567328535175299,-58.438122853791221 -34.567380795931214,-58.438165837122561 -34.567414327167846,-58.438213759788276 -34.567442859161744,-58.438265855733825 -34.567465828348944,-58.438321188548258 -34.567482952834759,-58.438378736703015 -34.56749388028323,-58.438437563781683 -34.567498328802735,-58.438503798928316 -34.567498271523476,-58.438565434845223 -34.567504903731944,-58.438625536512781 -34.56751787391152,-58.438683252653099 -34.567536970620125,-58.43873756171552 -34.567561982383751,-58.438787612497457 -34.567592416060862,-58.438868391817103 -34.567641518506079,-58.438950704448359 -34.567687874597105,-58.439034890807427 -34.567731906950556,-58.439120865814438 -34.56777340426931,-58.439208629444458 -34.567812436975295,-58.439297926325239 -34.567848864164503,-58.439388671314923 -34.567882685817331,-58.439480864406768 -34.567913901930631,-58.43962618028236 -34.567951959310349)));;1467;14_4_2;COMUNA 14;4;2;610;282;328;85,98%;274;273;99,64%;1;0,37%;220;1;0,45%;219;99,55%
MULTIPOLYGON (((-58.44024598939918 -34.568503507345369,-58.43962618028236 -34.567951959310349,-58.439480864406768 -34.567913901930631,-58.439388671314923 -34.567882685817331,-58.439297926325239 -34.567848864164503,-58.439208629444458 -34.567812436975295,-58.439120865814438 -34.56777340426931,-58.439034890807427 -34.567731906950556,-58.438950704448359 -34.567687874597105,-58.438868391817103 -34.567641518506079,-58.438787612497457 -34.567592416060862,-58.43873756171552 -34.567561982383751,-58.438683252653099 -34.567536970620125,-58.438625536512781 -34.56751787391152,-58.438565434845223 -34.567504903731944,-58.438503798928316 -34.567498271523476,-58.438437563781683 -34.567498328802735,-58.438378736703015 -34.56749388028323,-58.438321188548258 -34.567482952834759,-58.438265855733825 -34.567465828348944,-58.438213759788276 -34.567442859161744,-58.438165837122561 -34.567414327167846,-58.438122853791221 -34.567380795931214,-58.438098265164868 -34.567328535175299,-58.437879321456641 -34.567536316829155,-58.437506595990762 -34.56811316703233,-58.437353025265161 -34.568347018660575,-58.438317777878375 -34.568959354444651,-58.439222779089327 -34.569568854045407,-58.440161161467564 -34.570200889231664,-58.440867000542688 -34.57067624929936,-58.440991073680493 -34.570574154346417,-58.441662561666298 -34.569888185936954,-58.441757670210478 -34.569848763964742,-58.441225682393096 -34.569375341180901,-58.44024598939918 -34.568503507345369)));;1468;14_4_3;COMUNA 14;4;3;585;262;323;81,11%;314;312;99,36%;2;0,64%;218;2;0,92%;216;99,08%
MULTIPOLYGON (((-58.441757670210478 -34.569848763964742,-58.441662561666298 -34.569888185936954,-58.440991073680493 -34.570574154346417,-58.440867000542688 -34.57067624929936,-58.441834605577803 -34.571327925467671,-58.441943894933857 -34.571445273090589,-58.442203434160035 -34.57130228262379,-58.442544117595652 -34.571127120542712,-58.442956239600207 -34.570915277359113,-58.441757670210478 -34.569848763964742)));;1469;14_4_4;COMUNA 14;4;4;651;289;362;79,83%;386;386;100,00%;0;0,00%;293;2;0,68%;291;99,32%
MULTIPOLYGON (((-58.440867000542688 -34.57067624929936,-58.440161161467564 -34.570200889231664,-58.439222779089327 -34.569568854045407,-58.438317777878375 -34.568959354444651,-58.437353025265161 -34.568347018660575,-58.437069730550604 -34.568778527563971,-58.437018972243052 -34.568833800987179,-58.436724640756253 -34.569154668132001,-58.439506141017766 -34.570704520670468,-58.440214386821083 -34.571096994037219,-58.441410678658428 -34.57173913755603,-58.441943894933857 -34.571445273090589,-58.441834605577803 -34.571327925467671,-58.440867000542688 -34.57067624929936)));;1470;14_4_5;COMUNA 14;4;5;862;377;485;77,73%;477;476;99,79%;1;0,21%;384;16;4,17%;368;95,83%
MULTIPOLYGON (((-58.432091403870082 -34.57405042436281,-58.431988092657356 -34.574143430539841,-58.431754129799572 -34.574354084633761,-58.432324939777786 -34.574306690780766,-58.432839383411526 -34.5742639989924,-58.433912031645136 -34.57417981647253,-58.434428241196713 -34.574449103499539,-58.436308166045549 -34.573419551005358,-58.437711611917358 -34.57263629176532,-58.43808262953781 -34.572429175182897,-58.439003409983144 -34.573065722661575,-58.439659945386182 -34.572703931463479,-58.440744536232636 -34.572106218419982,-58.441410678658428 -34.57173913755603,-58.440214386821083 -34.571096994037219,-58.439506141017766 -34.570704520670468,-58.436724640756253 -34.569154668132001,-58.436565465763977 -34.569328162807729,-58.435729040974678 -34.57023985130639,-58.435263680750808 -34.570747093432793,-58.434917727797213 -34.571109706864554,-58.434078638897681 -34.571989128268207,-58.433430658035356 -34.572668229065279,-58.433325556054982 -34.572778349374779,-58.433100531260223 -34.573014150168397,-58.432528168706099 -34.573614035640794,-58.432237129369653 -34.57391918762476,-58.432091403870082 -34.57405042436281)));;1471;14_4_6;COMUNA 14;4;6;1303;619;684;90,50%;656;649;98,93%;7;1,08%;454;5;1,10%;449;98,90%
MULTIPOLYGON (((-58.43808262953781 -34.572429175182897,-58.437711611917358 -34.57263629176532,-58.436308166045549 -34.573419551005358,-58.436580729600252 -34.573606448587846,-58.43676109905897 -34.573751563656685,-58.436933967836595 -34.573925340065252,-58.437115244858866 -34.574105763975126,-58.438450757762162 -34.573370204597069,-58.439003409983144 -34.573065722661575,-58.43808262953781 -34.572429175182897)));;1472;14_4_7;COMUNA 14;4;7;929;397;532;74,62%;604;603;99,83%;1;0,17%;432;1;0,23%;431;99,77%
MULTIPOLYGON (((-58.433912031645136 -34.57417981647253,-58.432839383411526 -34.5742639989924,-58.432324939777786 -34.574306690780766,-58.431754129799572 -34.574354084633761,-58.431581318469725 -34.57450968111538,-58.431456287494228 -34.574622259591862,-58.431575304861965 -34.574653629356675,-58.431726135198559 -34.574537395180869,-58.431960673237889 -34.574616190208204,-58.431970942762256 -34.574705069806377,-58.432084676443296 -34.574750522848731,-58.432074490359355 -34.574665939238685,-58.432300093355629 -34.574733111158793,-58.432307724988739 -34.574818820921493,-58.432741654056542 -34.574937876901522,-58.433008806294822 -34.575009846635105,-58.433142467667295 -34.575046007366815,-58.434153017195925 -34.574578904114915,-58.434428241196713 -34.574449103499539,-58.433912031645136 -34.57417981647253)));;1473;14_4_8;COMUNA 14;4;8;1123;490;633;77,41%;600;599;99,83%;1;0,17%;482;7;1,45%;475;98,55%
MULTIPOLYGON (((-58.431355955857775 -34.574712589817466,-58.431310815074063 -34.57475321374487,-58.431464795920967 -34.574865441103142,-58.431521401938703 -34.57490249939989,-58.431580052297583 -34.574937234149218,-58.431640661852605 -34.574969645326505,-58.431703060393808 -34.574999521609115,-58.43176716277469 -34.575026862972734,-58.431832798705429 -34.575051669371675,-58.431899797947715 -34.575073799909468,-58.432209931329602 -34.575188882645477,-58.432264501215776 -34.575207418175836,-58.432313277661116 -34.575236234365313,-58.432352685335047 -34.575273499268363,-58.432417362510122 -34.575360490845462,-58.432841243861617 -34.576027796026139,-58.433922199386764 -34.575558257630412,-58.434139882577242 -34.575462505684712,-58.434139913259379 -34.575462429621027,-58.434141901538595 -34.575461412882383,-58.434331608841511 -34.575377653370666,-58.434335377745228 -34.575375996292017,-58.434335291643372 -34.575376022662915,-58.435347705435987 -34.574927854443615,-58.437115244858866 -34.574105763975126,-58.436933967836595 -34.573925340065252,-58.43676109905897 -34.573751563656685,-58.436580729600252 -34.573606448587846,-58.436308166045549 -34.573419551005358,-58.434428241196713 -34.574449103499539,-58.434153017195925 -34.574578904114915,-58.433142467667295 -34.575046007366815,-58.433008806294822 -34.575009846635105,-58.432741654056542 -34.574937876901522,-58.432307724988739 -34.574818820921493,-58.432300093355629 -34.574733111158793,-58.432074490359355 -34.574665939238685,-58.432084676443296 -34.574750522848731,-58.431970942762256 -34.574705069806377,-58.431960673237889 -34.574616190208204,-58.431726135198559 -34.574537395180869,-58.431575304861965 -34.574653629356675,-58.431456287494228 -34.574622259591862,-58.431456229005001 -34.574622171921774,-58.43145425678005 -34.574624169033974,-58.431356730230249 -34.57471194555972,-58.431355937034951 -34.574712562672914,-58.431355955857775 -34.574712589817466)));;1474;14_4_9;COMUNA 14;4;9;802;373;429;86,95%;588;587;99,83%;1;0,17%;433;1;0,23%;432;99,77%
MULTIPOLYGON (((-58.438450757762162 -34.573370204597069,-58.437115244858866 -34.574105763975126,-58.438382320970284 -34.575359782620801,-58.439208457708268 -34.574779919815327,-58.439597804378892 -34.574509067125021,-58.438450757762162 -34.573370204597069)));;1475;14_5_10;COMUNA 14;5;10;1268;550;718;76,60%;660;660;100,00%;0;0,00%;546;2;0,37%;544;99,63%
MULTIPOLYGON (((-58.440744536232636 -34.572106218419982,-58.439659945386182 -34.572703931463479,-58.440684589413713 -34.573752968180301,-58.44087014650421 -34.573623841069669,-58.441703052501055 -34.573074034126606,-58.440744536232636 -34.572106218419982)));;1476;14_5_4;COMUNA 14;5;4;554;240;314;76,43%;369;368;99,73%;1;0,27%;284;4;1,41%;280;98,59%
MULTIPOLYGON (((-58.439659945386182 -34.572703931463479,-58.439003409983144 -34.573065722661575,-58.438450757762162 -34.573370204597069,-58.439597804378892 -34.574509067125021,-58.440684589413713 -34.573752968180301,-58.439659945386182 -34.572703931463479)));;1477;14_5_5;COMUNA 14;5;5;1046;441;605;72,89%;644;642;99,69%;2;0,31%;507;2;0,39%;505;99,61%
MULTIPOLYGON (((-58.441383673928343 -34.574468615681312,-58.440684589413713 -34.573752968180301,-58.439597804378892 -34.574509067125021,-58.440274164579243 -34.575180559786794,-58.440849315996367 -34.574814169680842,-58.441383673928343 -34.574468615681312)));;1478;14_5_6;COMUNA 14;5;6;631;280;351;79,77%;387;387;100,00%;0;0,00%;277;2;0,72%;275;99,28%
MULTIPOLYGON (((-58.438382320970284 -34.575359782620801,-58.437365564759979 -34.576051518787068,-58.437171551997011 -34.576026394593796,-58.436674848873665 -34.575943187597296,-58.436904939516722 -34.576114370428868,-58.437378154055246 -34.576164894180543,-58.437687900263604 -34.576190029526515,-58.437863975738175 -34.576197741860611,-58.437954481797512 -34.576204521091448,-58.43809505362568 -34.576207648231268,-58.438498805399945 -34.576211461503846,-58.438650871701768 -34.576214590282042,-58.438651010722097 -34.576214575591088,-58.438656264638965 -34.57621112804808,-58.438882003513669 -34.576067310266865,-58.438890792246738 -34.576061717251349,-58.438890851111232 -34.576061743547847,-58.439060289452719 -34.576054452227858,-58.439152263135895 -34.575989467259603,-58.43921525200502 -34.576051805972007,-58.439482780481192 -34.576028405456974,-58.439566138777863 -34.576019406818773,-58.439659374262199 -34.576008508499697,-58.439722382805378 -34.576000773570954,-58.439811872404796 -34.575988113792363,-58.439867132854609 -34.575980306910239,-58.439936357485522 -34.575970248991759,-58.439963178958948 -34.575965887609165,-58.440034447475021 -34.57595413980345,-58.44008502510961 -34.575945838974391,-58.440139604660558 -34.575936905034517,-58.440160721255197 -34.575933387660051,-58.440184222119058 -34.575928955190129,-58.44030513228099 -34.575906300418893,-58.440425276027995 -34.575883856664468,-58.440515277380349 -34.575866970932495,-58.440536308910012 -34.575863030924481,-58.440561768112744 -34.575858317035333,-58.440679101852268 -34.575836365499775,-58.440723719854461 -34.575825950565168,-58.440770980515055 -34.575803282049705,-58.440881842548755 -34.575783864474666,-58.440274164579243 -34.575180559786794,-58.439597804378892 -34.574509067125021,-58.439208457708268 -34.574779919815327,-58.438382320970284 -34.575359782620801)));;1479;14_5_7;COMUNA 14;5;7;553;258;295;87,46%;283;281;99,29%;2;0,71%;236;18;7,63%;218;92,37%
MULTIPOLYGON (((-58.439221092199844 -34.576175333439416,-58.439105123128996 -34.576185874903423,-58.438836490894083 -34.576196245655133,-58.438801745857837 -34.576218211615959,-58.438651010722097 -34.576214575591088,-58.438650871701768 -34.576214590282042,-58.438498805399945 -34.576211461503846,-58.43809505362568 -34.576207648231268,-58.437954481797512 -34.576204521091448,-58.437863975738175 -34.576197741860611,-58.437687900263604 -34.576190029526515,-58.437378154055246 -34.576164894180543,-58.436904939516722 -34.576114370428868,-58.437082164450175 -34.576260047704501,-58.437225172065489 -34.576372828871527,-58.437753197808938 -34.576786476491584,-58.438430624285012 -34.577317128347147,-58.438746015830496 -34.57756529966629,-58.439146110329816 -34.577880249899728,-58.439806947402296 -34.578424060388201,-58.439938890629726 -34.578546907105483,-58.440888554087408 -34.577796415247619,-58.441814161515566 -34.57681787402025,-58.441878201723561 -34.576771967534071,-58.441667337451605 -34.576562897471817,-58.441051490034013 -34.575952282081964,-58.441051357985629 -34.575952151041029,-58.441265878076081 -34.575804837436777,-58.441255446408675 -34.575807804932992,-58.440983988462349 -34.575885295429245,-58.44088061634983 -34.575914714858563,-58.440809091262715 -34.575931392898269,-58.440757916777351 -34.575943215195679,-58.44070188887995 -34.575955811277659,-58.440656760091834 -34.575965662707709,-58.440596645170018 -34.575978610130711,-58.440548621431326 -34.575988601847499,-58.440445166202423 -34.57600935855455,-58.440236212877089 -34.576048124734484,-58.440192276605551 -34.576055722595768,-58.440127308937058 -34.576066485701659,-58.44004880282256 -34.576079288601122,-58.439983324368932 -34.576089628982459,-58.439945263518347 -34.576095255933822,-58.439895196931268 -34.576102500417562,-58.439842661085216 -34.576110026120425,-58.439789103753981 -34.576116636077337,-58.439739633457812 -34.576122753800988,-58.439698933269341 -34.576127816774928,-58.439661809237421 -34.576132457857256,-58.43953434518582 -34.576145392026326,-58.439441365376148 -34.576154811362663,-58.439355537854567 -34.576163457315637,-58.439331952288661 -34.576165917695356,-58.439221092199844 -34.576175333439416)));;1480;14_5_8;COMUNA 14;5;8;456;222;234;94,87%;231;230;99,57%;1;0,43%;190;13;6,84%;177;93,16%
MULTIPOLYGON (((-58.437365564759979 -34.576051518787068,-58.438382320970284 -34.575359782620801,-58.437115244858866 -34.574105763975126,-58.435347705435987 -34.574927854443615,-58.436050648272115 -34.575446764316389,-58.436674848873665 -34.575943187597296,-58.437171551997011 -34.576026394593796,-58.437365564759979 -34.576051518787068)));;1481;14_5_9;COMUNA 14;5;9;1213;582;631;92,23%;601;601;100,00%;0;0,00%;502;3;0,60%;499;99,40%
MULTIPOLYGON (((-58.435347705435987 -34.574927854443615,-58.434335291643372 -34.575376022662915,-58.434335377745228 -34.575375996292017,-58.434331608841511 -34.575377653370666,-58.434141901538595 -34.575461412882383,-58.434139913259379 -34.575462429621027,-58.434139882577242 -34.575462505684712,-58.434299887444176 -34.575604771131047,-58.435027898098994 -34.576246852254329,-58.435830836901836 -34.576946075193135,-58.436018103174838 -34.577109433003749,-58.436647408272833 -34.577658606101522,-58.437753197808938 -34.576786476491584,-58.437225172065489 -34.576372828871527,-58.437082164450175 -34.576260047704501,-58.436904939516722 -34.576114370428868,-58.436674848873665 -34.575943187597296,-58.436050648272115 -34.575446764316389,-58.435347705435987 -34.574927854443615)));;1482;14_6_1;COMUNA 14;6;1;991;468;523;89,48%;700;699;99,86%;1;0,14%;512;2;0,39%;510;99,61%
MULTIPOLYGON (((-58.431637642718854 -34.576677181507165,-58.431575137749036 -34.57670111025503,-58.431407760948133 -34.57665493875615,-58.430105413946023 -34.57703313498569,-58.430974454597823 -34.577791776093001,-58.432015988521528 -34.577007643223325,-58.431637642718854 -34.576677181507165)));;1483;14_6_10;COMUNA 14;6;10;395;172;223;77,13%;284;284;100,00%;0;0,00%;213;4;1,88%;209;98,12%
MULTIPOLYGON (((-58.438746015830496 -34.57756529966629,-58.438430624285012 -34.577317128347147,-58.437753197808938 -34.576786476491584,-58.436647408272833 -34.577658606101522,-58.437578910787842 -34.578471441063009,-58.437831899907913 -34.578692135901306,-58.438225687044081 -34.579035891828433,-58.438741377650182 -34.579486365045014,-58.438836423342167 -34.579412014367477,-58.439809014239188 -34.578649563168383,-58.439938890629726 -34.578546907105483,-58.439806947402296 -34.578424060388201,-58.439146110329816 -34.577880249899728,-58.438746015830496 -34.57756529966629)));;1484;14_6_2;COMUNA 14;6;2;821;397;424;93,63%;588;588;100,00%;0;0,00%;401;19;4,74%;382;95,26%
MULTIPOLYGON (((-58.438225687044081 -34.579035891828433,-58.437831899907913 -34.578692135901306,-58.437578910787842 -34.578471441063009,-58.436647408272833 -34.577658606101522,-58.435628550767376 -34.578466939389152,-58.434704297165382 -34.579200212241922,-58.434610865951228 -34.579274207947712,-58.43552985321692 -34.580076843758299,-58.436142918949905 -34.580610733254268,-58.436690529742293 -34.581090589373837,-58.436944334901028 -34.580892254695357,-58.437716219001921 -34.580288446413505,-58.438741377650182 -34.579486365045014,-58.438225687044081 -34.579035891828433)));;1485;14_6_3;COMUNA 14;6;3;943;453;490;92,45%;440;438;99,55%;2;0,46%;380;53;13,95%;327;86,05%
MULTIPOLYGON (((-58.435002140376426 -34.577920367511268,-58.433987776090206 -34.578729955741402,-58.434610865951228 -34.579274207947712,-58.434704297165382 -34.579200212241922,-58.435628550767376 -34.578466939389152,-58.436647408272833 -34.577658606101522,-58.436018103174838 -34.577109433003749,-58.435830836901836 -34.576946075193135,-58.435027898098994 -34.576246852254329,-58.43400308427109 -34.577048621239442,-58.435002140376426 -34.577920367511268)));;1486;14_6_4;COMUNA 14;6;4;722;354;368;96,20%;499;498;99,80%;1;0,20%;361;9;2,49%;352;97,51%
MULTIPOLYGON (((-58.433922199386764 -34.575558257630412,-58.432841243861617 -34.576027796026139,-58.43400308427109 -34.577048621239442,-58.435027898098994 -34.576246852254329,-58.434299887444176 -34.575604771131047,-58.434139882577242 -34.575462505684712,-58.433922199386764 -34.575558257630412)));;1487;14_6_5;COMUNA 14;6;5;794;333;461;72,23%;461;461;100,00%;0;0,00%;387;20;5,17%;367;94,83%
MULTIPOLYGON (((-58.432343242994598 -34.576274128803732,-58.432202078688 -34.576338950353367,-58.431709235404078 -34.576485008508726,-58.431468669047725 -34.576575232687397,-58.431407760948133 -34.57665493875615,-58.431575137749036 -34.57670111025503,-58.431637642718854 -34.576677181507165,-58.432015988521528 -34.577007643223325,-58.432979528325454 -34.577849325433569,-58.43400308427109 -34.577048621239442,-58.432841243861617 -34.576027796026139,-58.432343242994598 -34.576274128803732)));;1488;14_6_6;COMUNA 14;6;6;1127;522;605;86,28%;604;604;100,00%;0;0,00%;511;70;13,70%;441;86,30%
MULTIPOLYGON (((-58.43400308427109 -34.577048621239442,-58.432979528325454 -34.577849325433569,-58.433987776090206 -34.578729955741402,-58.435002140376426 -34.577920367511268,-58.43400308427109 -34.577048621239442)));;1489;14_6_7;COMUNA 14;6;7;788;334;454;73,57%;454;454;100,00%;0;0,00%;359;3;0,84%;356;99,16%
MULTIPOLYGON (((-58.432979528325454 -34.577849325433569,-58.43195688962134 -34.578649316910059,-58.432975180706066 -34.579538197775747,-58.433987776090206 -34.578729955741402,-58.432979528325454 -34.577849325433569)));;1490;14_6_8;COMUNA 14;6;8;530;249;281;88,61%;324;324;100,00%;0;0,00%;253;2;0,79%;251;99,21%
MULTIPOLYGON (((-58.432015988521528 -34.577007643223325,-58.430974454597823 -34.577791776093001,-58.43195688962134 -34.578649316910059,-58.432979528325454 -34.577849325433569,-58.432015988521528 -34.577007643223325)));;1491;14_6_9;COMUNA 14;6;9;784;357;427;83,61%;524;524;100,00%;0;0,00%;402;21;5,22%;381;94,78%
MULTIPOLYGON (((-58.441449981302853 -34.585247104079173,-58.440378383591408 -34.585994407989006,-58.439278319437761 -34.586761556893606,-58.438510323691759 -34.587297062555116,-58.438325584188057 -34.587425904243162,-58.437918058462401 -34.587703777249736,-58.437917521829817 -34.587704143152621,-58.43786582180654 -34.587739415756197,-58.438081932003982 -34.588368217257639,-58.438271548748617 -34.588459033658388,-58.438614342268707 -34.588620375880893,-58.439389070312068 -34.588108322618254,-58.440156549311396 -34.587601122404742,-58.441089248187268 -34.586984646493349,-58.441397561441391 -34.586780255804022,-58.442425204672894 -34.586098713066995,-58.44347727388044 -34.585400967604635,-58.444585789851651 -34.584665755062176,-58.444785675749735 -34.584513524823564,-58.444399798995633 -34.583191793696543,-58.443607256610271 -34.583742610391326,-58.442522326338306 -34.584499227385344,-58.441449981302853 -34.585247104079173)));;1492;14_7_1;COMUNA 14;7;1;879;422;457;92,34%;478;478;100,00%;0;0,00%;375;50;13,33%;325;86,67%
MULTIPOLYGON (((-58.443779686104435 -34.582251519596156,-58.443431697101069 -34.581797009777205,-58.442323699918958 -34.582614398758217,-58.441267207402433 -34.583393686467211,-58.44021572012506 -34.584169303727954,-58.441449981302853 -34.585247104079173,-58.442522326338306 -34.584499227385344,-58.443607256610271 -34.583742610391326,-58.444399798995633 -34.583191793696543,-58.444448595179608 -34.583170814225561,-58.443779686104435 -34.582251519596156)));;1493;14_7_2;COMUNA 14;7;2;918;442;476;92,86%;579;579;100,00%;0;0,00%;411;21;5,11%;390;94,89%
MULTIPOLYGON (((-58.441267207402433 -34.583393686467211,-58.442323699918958 -34.582614398758217,-58.443431697101069 -34.581797009777205,-58.442509392713866 -34.580938797011157,-58.441375930326984 -34.581786808356817,-58.440404854155517 -34.580938923701112,-58.439664919875746 -34.581523317535634,-58.439383609693444 -34.581743977466616,-58.438358939908483 -34.582547683810198,-58.439281659832119 -34.583353531271683,-58.44021572012506 -34.584169303727954,-58.441267207402433 -34.583393686467211)));;1494;14_7_3;COMUNA 14;7;3;815;397;418;94,98%;403;400;99,26%;3;0,75%;289;8;2,77%;281;97,23%
MULTIPOLYGON (((-58.440404854155517 -34.580938923701112,-58.441375930326984 -34.581786808356817,-58.442509392713866 -34.580938797011157,-58.442282522700147 -34.580727694179728,-58.44154326642262 -34.58003979322622,-58.440533150801613 -34.579099856483182,-58.440304905649342 -34.579291160831005,-58.439511830752657 -34.579955970018112,-58.439392511010084 -34.580054965494497,-58.440404854155517 -34.580938923701112)));;1495;14_7_4;COMUNA 14;7;4;1021;487;534;91,20%;577;577;100,00%;0;0,00%;402;3;0,75%;399;99,25%
MULTIPOLYGON (((-58.437399292625685 -34.58170956676738,-58.438358939908483 -34.582547683810198,-58.439383609693444 -34.581743977466616,-58.439664919875746 -34.581523317535634,-58.440404854155517 -34.580938923701112,-58.439392511010084 -34.580054965494497,-58.439511830752657 -34.579955970018112,-58.440304905649342 -34.579291160831005,-58.440533150801613 -34.579099856483182,-58.439938890629726 -34.578546907105483,-58.439809014239188 -34.578649563168383,-58.438836423342167 -34.579412014367477,-58.438741377650182 -34.579486365045014,-58.437716219001921 -34.580288446413505,-58.436944334901028 -34.580892254695357,-58.436690529742293 -34.581090589373837,-58.437399292625685 -34.58170956676738)));;1496;14_7_5;COMUNA 14;7;5;745;359;386;93,01%;424;423;99,76%;1;0,24%;260;13;5,00%;247;95,00%
MULTIPOLYGON (((-58.435405825096339 -34.583363641988143,-58.436309030776194 -34.584153380025171,-58.437188587384156 -34.584922330843646,-58.438239860764263 -34.584133218043817,-58.43733944584362 -34.583347368267169,-58.436406614434858 -34.582533264171801,-58.437399292625685 -34.58170956676738,-58.436690529742293 -34.581090589373837,-58.435668568551513 -34.581889062307141,-58.434639177770045 -34.582693299751504,-58.435405825096339 -34.583363641988143)));;1497;14_7_6;COMUNA 14;7;6;727;316;411;76,89%;378;377;99,74%;1;0,27%;301;11;3,65%;290;96,35%
MULTIPOLYGON (((-58.438239860764263 -34.584133218043817,-58.439168556466342 -34.584943645003406,-58.440328663932078 -34.585956087469917,-58.440378383591408 -34.585994407989006,-58.441449981302853 -34.585247104079173,-58.44021572012506 -34.584169303727954,-58.439281659832119 -34.583353531271683,-58.438358939908483 -34.582547683810198,-58.437399292625685 -34.58170956676738,-58.436406614434858 -34.582533264171801,-58.43733944584362 -34.583347368267169,-58.438239860764263 -34.584133218043817)));;1498;14_7_7;COMUNA 14;7;7;661;309;352;87,78%;344;341;99,13%;3;0,88%;240;3;1,25%;237;98,75%
MULTIPOLYGON (((-58.439168556466342 -34.584943645003406,-58.438239860764263 -34.584133218043817,-58.437188587384156 -34.584922330843646,-58.4363807209809 -34.585528803729616,-58.436257302319028 -34.585627372611377,-58.437169480694457 -34.586420556783125,-58.438325584188057 -34.587425904243162,-58.438510323691759 -34.587297062555116,-58.439278319437761 -34.586761556893606,-58.440378383591408 -34.585994407989006,-58.440328663932078 -34.585956087469917,-58.439168556466342 -34.584943645003406)));;1499;14_7_8;COMUNA 14;7;8;586;254;332;76,51%;369;367;99,46%;2;0,54%;239;7;2,93%;232;97,07%
MULTIPOLYGON (((-58.433816871397283 -34.584682062663923,-58.434753234344917 -34.585372167943348,-58.435701361232439 -34.586070930891019,-58.436666616171827 -34.58678229619575,-58.436700788031651 -34.586807451170969,-58.437918058462401 -34.587703777249736,-58.438325584188057 -34.587425904243162,-58.437169480694457 -34.586420556783125,-58.436257302319028 -34.585627372611377,-58.4363807209809 -34.585528803729616,-58.437188587384156 -34.584922330843646,-58.436309030776194 -34.584153380025171,-58.435405825096339 -34.583363641988143,-58.434639177770045 -34.582693299751504,-58.433714957734637 -34.583415296529822,-58.432930069349794 -34.584028442591581,-58.433816871397283 -34.584682062663923)));;1500;14_7_9;COMUNA 14;7;9;616;280;336;83,33%;405;404;99,75%;1;0,25%;275;17;6,18%;258;93,82%
MULTIPOLYGON (((-58.432557519400774 -34.582405326778172,-58.431652154345088 -34.581615278515507,-58.430689417296108 -34.582376962648375,-58.431670590829867 -34.583100133094931,-58.432930069349794 -34.584028442591581,-58.433714957734637 -34.583415296529822,-58.434639177770045 -34.582693299751504,-58.435668568551513 -34.581889062307141,-58.436690529742293 -34.581090589373837,-58.436142918949905 -34.580610733254268,-58.43552985321692 -34.580076843758299,-58.43450874433622 -34.580876786237582,-58.433481824116576 -34.581681296326991,-58.432557519400774 -34.582405326778172)));;1501;14_8_1;COMUNA 14;8;1;843;427;416;102,64%;490;489;99,80%;1;0,20%;366;6;1,64%;360;98,36%
MULTIPOLYGON (((-58.434610865951228 -34.579274207947712,-58.433987776090206 -34.578729955741402,-58.432975180706066 -34.579538197775747,-58.43195864778572 -34.580349458600033,-58.432573053881576 -34.580886605906279,-58.433481824116576 -34.581681296326991,-58.43450874433622 -34.580876786237582,-58.43552985321692 -34.580076843758299,-58.434610865951228 -34.579274207947712)));;1502;14_8_2;COMUNA 14;8;2;592;287;305;94,10%;412;412;100,00%;0;0,00%;290;5;1,72%;285;98,28%
MULTIPOLYGON (((-58.43195688962134 -34.578649316910059,-58.430931590979178 -34.57945134135435,-58.43195864778572 -34.580349458600033,-58.432975180706066 -34.579538197775747,-58.43195688962134 -34.578649316910059)));;1503;14_8_3;COMUNA 14;8;3;356;166;190;87,37%;227;226;99,56%;1;0,44%;169;10;5,92%;159;94,08%
MULTIPOLYGON (((-58.430974454597823 -34.577791776093001,-58.429931708677543 -34.578576885599958,-58.430931590979178 -34.57945134135435,-58.43195688962134 -34.578649316910059,-58.430974454597823 -34.577791776093001)));;1504;14_8_4;COMUNA 14;8;4;455;203;252;80,56%;316;316;100,00%;0;0,00%;245;30;12,24%;215;87,76%
MULTIPOLYGON (((-58.430105413946023 -34.57703313498569,-58.429307173056081 -34.577265957178085,-58.428683736463988 -34.577485512563186,-58.429931708677543 -34.578576885599958,-58.430974454597823 -34.577791776093001,-58.430105413946023 -34.57703313498569)));;1505;14_8_5;COMUNA 14;8;5;987;429;558;76,88%;645;644;99,84%;1;0,16%;482;4;0,83%;478;99,17%
MULTIPOLYGON (((-58.427403909163239 -34.577907772537358,-58.428986210866007 -34.579288700077463,-58.429931708677543 -34.578576885599958,-58.428683736463988 -34.577485512563186,-58.429307173056081 -34.577265957178085,-58.42929789906028 -34.577248911670935,-58.429014704670834 -34.577253622778109,-58.428499406935785 -34.577253056927375,-58.427846850543496 -34.577468022218028,-58.426656264969353 -34.577860228120144,-58.426717432877943 -34.577980532897662,-58.426781493500549 -34.578106472532191,-58.427403909163239 -34.577907772537358)));;1506;14_8_6;COMUNA 14;8;6;927;398;529;75,24%;629;629;100,00%;0;0,00%;469;33;7,04%;436;92,96%
MULTIPOLYGON (((-58.427403909163239 -34.577907772537358,-58.426781493500549 -34.578106472532191,-58.426531222955234 -34.578167950499449,-58.427843008410925 -34.579737059606813,-58.428064971670835 -34.579982203408647,-58.428986210866007 -34.579288700077463,-58.427403909163239 -34.577907772537358)));;1507;14_8_7;COMUNA 14;8;7;632;297;335;88,66%;391;391;100,00%;0;0,00%;301;5;1,66%;296;98,34%
MULTIPOLYGON (((-58.429931708677543 -34.578576885599958,-58.428986210866007 -34.579288700077463,-58.428064971670835 -34.579982203408647,-58.428477836954514 -34.580438324721115,-58.42892170987664 -34.580872269172175,-58.429010061146009 -34.580954409668514,-58.430003967457758 -34.580176971654737,-58.430931590979178 -34.57945134135435,-58.429931708677543 -34.578576885599958)));;1508;14_8_8;COMUNA 14;8;8;696;319;377;84,62%;388;388;100,00%;0;0,00%;306;23;7,52%;283;92,48%
MULTIPOLYGON (((-58.43195864778572 -34.580349458600033,-58.430931590979178 -34.57945134135435,-58.430003967457758 -34.580176971654737,-58.429010061146009 -34.580954409668514,-58.429110073656133 -34.581047328403606,-58.43004127747772 -34.581879657769463,-58.430166404101968 -34.581991456360939,-58.430689417296108 -34.582376962648375,-58.431652154345088 -34.581615278515507,-58.432557519400774 -34.582405326778172,-58.433481824116576 -34.581681296326991,-58.432573053881576 -34.580886605906279,-58.43195864778572 -34.580349458600033)));;1509;14_8_9;COMUNA 14;8;9;1177;570;607;93,90%;780;779;99,87%;1;0,13%;476;7;1,47%;469;98,53%
MULTIPOLYGON (((-58.43420071929858 -34.570271618123932,-58.433143853985612 -34.570888153967765,-58.434078638897681 -34.571989128268207,-58.434917727797213 -34.571109706864554,-58.435263680750808 -34.570747093432793,-58.435729040974678 -34.57023985130639,-58.435238153976009 -34.569666407212736,-58.43420071929858 -34.570271618123932)));;1510;14_9_1;COMUNA 14;9;1;1190;582;608;95,72%;731;731;100,00%;0;0,00%;491;5;1,02%;486;98,98%
MULTIPOLYGON (((-58.433143853985612 -34.570888153967765,-58.43298120552911 -34.570983048143709,-58.432310425464586 -34.571375223816453,-58.433055683034496 -34.57223551441907,-58.433430658035356 -34.572668229065279,-58.434078638897681 -34.571989128268207,-58.433143853985612 -34.570888153967765)));;1511;14_9_10;COMUNA 14;9;10;912;408;504;80,95%;633;633;100,00%;0;0,00%;462;2;0,43%;460;99,57%
MULTIPOLYGON (((-58.432177580127117 -34.571452870066892,-58.431167095796958 -34.572043765354998,-58.431911326480325 -34.572902372370002,-58.432528168706099 -34.573614035640794,-58.433100531260223 -34.573014150168397,-58.433325556054982 -34.572778349374779,-58.433430658035356 -34.572668229065279,-58.433055683034496 -34.57223551441907,-58.432310425464586 -34.571375223816453,-58.432177580127117 -34.571452870066892)));;1512;14_9_11;COMUNA 14;9;11;767;334;433;77,14%;591;591;100,00%;0;0,00%;395;1;0,25%;394;99,75%
MULTIPOLYGON (((-58.423908295040349 -34.571030785932088,-58.423940061976658 -34.571008823246828,-58.42390201659564 -34.570983810084925,-58.423866167782499 -34.57099548932937,-58.423769825313542 -34.570949563838226,-58.423606275203795 -34.571024063033491,-58.423602549974795 -34.571018966286665,-58.423602482292274 -34.571018927296691,-58.423523286058291 -34.57105566404978,-58.423409093312166 -34.571101756091707,-58.423244744054266 -34.57116818481272,-58.424853479616687 -34.574281221594511,-58.424987454152294 -34.574556204313524,-58.425248600692157 -34.575092222934565,-58.42571469251061 -34.576008812252567,-58.426656264969353 -34.577860228120144,-58.427846850543496 -34.577468022218028,-58.428499406935785 -34.577253056927375,-58.429161036289351 -34.57669920313306,-58.431055470662642 -34.574983157570081,-58.431310815074063 -34.57475321374487,-58.431355955857775 -34.574712589817466,-58.431355937034951 -34.574712562672914,-58.431356730230249 -34.57471194555972,-58.43145425678005 -34.574624169033974,-58.431456229005001 -34.574622171921774,-58.431456287494228 -34.574622259591862,-58.431581318469725 -34.57450968111538,-58.431754129799572 -34.574354084633761,-58.431988092657356 -34.574143430539841,-58.432091403870082 -34.57405042436281,-58.432237129369653 -34.57391918762476,-58.432528168706099 -34.573614035640794,-58.431911326480325 -34.572902372370002,-58.431167095796958 -34.572043765354998,-58.430126620928654 -34.572652180178927,-58.429525901167764 -34.573003441870227,-58.428692941297079 -34.573490486966172,-58.427959118466703 -34.573136602333406,-58.427506993795937 -34.57292054902944,-58.427328678295318 -34.572831878646184,-58.427034137138541 -34.572687162377882,-58.426201957882633 -34.572260488744298,-58.424420665260605 -34.57120482839791,-58.424189065855821 -34.571067003148833,-58.424138166995029 -34.571036422385369,-58.42403179818595 -34.571102377490497,-58.423908295040349 -34.571030785932088)));;1513;14_9_12;COMUNA 14;9;12;1035;533;502;106,18%;511;510;99,80%;1;0,20%;418;4;0,96%;414;99,04%
MULTIPOLYGON (((-58.431430720375737 -34.570594122949437,-58.431565523612669 -34.57051542161647,-58.430914672557236 -34.569764094675627,-58.431173671830742 -34.569508869102918,-58.431311475135757 -34.569372208554,-58.431521577244965 -34.569157296522498,-58.431526397477754 -34.569109626511725,-58.431205041302441 -34.568728068698398,-58.431124693518548 -34.568672622999934,-58.43083003529491 -34.568453170699335,-58.430785855179444 -34.568438721909835,-58.430764406380817 -34.568424349478768,-58.430741171160655 -34.56840624401962,-58.430716060638964 -34.568394194665998,-58.430697846762612 -34.56838052732666,-58.430677081134 -34.568360802713848,-58.430379101757623 -34.568149447386915,-58.43031628957057 -34.568102949844231,-58.430303100414761 -34.568085199093417,-58.430099260238471 -34.567931757866781,-58.429719836190486 -34.567652348004756,-58.426196991309688 -34.569673827593093,-58.425889227124387 -34.569850432953885,-58.424402451522504 -34.570634727727501,-58.424374178753126 -34.570649649074717,-58.424199347247992 -34.570741851552924,-58.424103460821961 -34.570786330231449,-58.423887077287333 -34.570886758906127,-58.423760704208419 -34.570945594432331,-58.423769825313542 -34.570949563838226,-58.423866167782499 -34.570995489329356,-58.423902016595626 -34.570983810084918,-58.42394006197663 -34.571008823246828,-58.423908295040334 -34.571030785932074,-58.42403179818595 -34.571102377490497,-58.424138166995014 -34.571036422385362,-58.424189065855821 -34.571067003148826,-58.424420665260591 -34.571204828397903,-58.426201957882633 -34.572260488744277,-58.427034137138527 -34.572687162377882,-58.427328678295318 -34.572831878646177,-58.42750699379593 -34.57292054902944,-58.427959118466681 -34.573136602333406,-58.428692941297079 -34.573490486966158,-58.429525901167764 -34.573003441870227,-58.430126620928654 -34.572652180178927,-58.429378154331694 -34.571792363862812,-58.430421348619596 -34.57118332222035,-58.431430720375737 -34.570594122949437)));;1514;14_9_13;COMUNA 14;9;13;683;305;378;80,69%;529;526;99,43%;3;0,57%;349;2;0,57%;347;99,43%
MULTIPOLYGON (((-58.433462024076739 -34.569408237082683,-58.43420071929858 -34.570271618123932,-58.435238153976009 -34.569666407212736,-58.43449894262681 -34.568802820966297,-58.43376153369848 -34.567941272894949,-58.433458304541141 -34.568116560384105,-58.433019765345115 -34.568369986705079,-58.432720706037884 -34.568541681657287,-58.433462024076739 -34.569408237082683)));;1515;14_9_2;COMUNA 14;9;2;876;392;484;80,99%;423;423;100,00%;0;0,00%;303;2;0,66%;301;99,34%
MULTIPOLYGON (((-58.432720706037884 -34.568541681657287,-58.432548950768378 -34.568640235188973,-58.431674494071544 -34.569157503317527,-58.432409251544094 -34.570022866144789,-58.433143853985612 -34.570888153967765,-58.43420071929858 -34.570271618123932,-58.433462024076739 -34.569408237082683,-58.432720706037884 -34.568541681657287)));;1516;14_9_3;COMUNA 14;9;3;1102;522;580;90,00%;734;734;100,00%;0;0,00%;525;6;1,14%;519;98,86%
MULTIPOLYGON (((-58.433458304541141 -34.568116560384105,-58.432367187347722 -34.567460913465247,-58.430939071080104 -34.568291220243289,-58.431380050735029 -34.568810652520561,-58.431674494071544 -34.569157503317527,-58.432548950768378 -34.568640235188973,-58.432720706037884 -34.568541681657287,-58.433019765345115 -34.568369986705079,-58.433458304541141 -34.568116560384105)));;1517;14_9_4;COMUNA 14;9;4;1217;551;666;82,73%;766;766;100,00%;0;0,00%;537;4;0,74%;533;99,26%
MULTIPOLYGON (((-58.433023629344724 -34.56707922715173,-58.432367187347722 -34.567460913465247,-58.433458304541141 -34.568116560384105,-58.43376153369848 -34.567941272894949,-58.433023629344724 -34.56707922715173)));;1518;14_9_5;COMUNA 14;9;5;398;173;225;76,89%;255;255;100,00%;0;0,00%;198;2;1,01%;196;98,99%
MULTIPOLYGON (((-58.432245318908571 -34.566169840738382,-58.43122697579426 -34.566775876598925,-58.432367187347722 -34.567460913465247,-58.433023629344724 -34.56707922715173,-58.432245318908571 -34.566169840738382)));;1519;14_9_6;COMUNA 14;9;6;694;320;374;85,56%;427;427;100,00%;0;0,00%;296;1;0,34%;295;99,66%
MULTIPOLYGON (((-58.43122697579426 -34.566775876598925,-58.430678840681544 -34.567102086344384,-58.430174985963575 -34.567391191120329,-58.430939071080104 -34.568291220243289,-58.432367187347722 -34.567460913465247,-58.43122697579426 -34.566775876598925)));;1520;14_9_7;COMUNA 14;9;7;654;284;370;76,76%;378;378;100,00%;0;0,00%;264;0;0,00%;264;100,00%
MULTIPOLYGON (((-58.431674494071558 -34.569157503317513,-58.431380050735001 -34.568810652520561,-58.430939071080104 -34.568291220243268,-58.430174985963575 -34.567391191120301,-58.429719836190486 -34.567652348004756,-58.430099260238471 -34.567931757866781,-58.430303100414761 -34.568085199093417,-58.43031628957057 -34.568102949844231,-58.430379101757623 -34.568149447386915,-58.430677081134 -34.568360802713848,-58.430697846762612 -34.56838052732666,-58.430716060638964 -34.568394194665998,-58.430741171160655 -34.56840624401962,-58.430764406380817 -34.568424349478768,-58.430785855179444 -34.568438721909835,-58.43083003529491 -34.568453170699335,-58.431124693518548 -34.568672622999934,-58.431205041302441 -34.568728068698398,-58.431526397477754 -34.569109626511725,-58.431521577244965 -34.569157296522498,-58.431311475135757 -34.569372208554,-58.431173671830742 -34.569508869102918,-58.430914672557236 -34.569764094675627,-58.431565523612669 -34.57051542161647,-58.43240925154408 -34.570022866144789,-58.431674494071558 -34.569157503317513)));;1521;14_9_8;COMUNA 14;9;8;784;364;420;86,67%;555;555;100,00%;0;0,00%;391;3;0,77%;388;99,23%
MULTIPOLYGON (((-58.430421348619596 -34.571183322220357,-58.429378154331708 -34.571792363862812,-58.430126620928654 -34.572652180178927,-58.431167095796958 -34.572043765354998,-58.432177580127117 -34.571452870066892,-58.432310425464586 -34.571375223816453,-58.43298120552911 -34.570983048143709,-58.433143853985612 -34.570888153967765,-58.432409251544094 -34.570022866144789,-58.43156552361269 -34.57051542161647,-58.431430720375751 -34.570594122949437,-58.430421348619596 -34.571183322220357)));;1522;14_9_9;COMUNA 14;9;9;793;361;432;83,56%;579;579;100,00%;0;0,00%;363;8;2,20%;355;97,80%
MULTIPOLYGON (((-58.500170114399573 -34.593026612416509,-58.501497560817171 -34.593844187534224,-58.502141914788588 -34.594243362842576,-58.503083537468683 -34.594382215249922,-58.503471839545547 -34.593953548200965,-58.503311346736744 -34.593856133102356,-58.502141986320559 -34.593133389622757,-58.501928169404664 -34.593001199810445,-58.500817099464669 -34.59231525721588,-58.499487298018579 -34.591494153924103,-58.49820249841391 -34.590700911372963,-58.497554823776852 -34.591415844792358,-58.498840479237153 -34.59220768530777,-58.500170114399573 -34.593026612416509)));;1523;15_1_1;COMUNA 15;1;1;1023;485;538;90,15%;527;527;100,00%;0;0,00%;417;5;1,20%;412;98,80%
MULTIPOLYGON (((-58.48961662700853 -34.586500121344677,-58.489513796888112 -34.586613810557225,-58.488994362662865 -34.587182890256479,-58.488895531451917 -34.587291155319882,-58.48836894001338 -34.587874248481384,-58.487699410880651 -34.588615684902862,-58.487590276063493 -34.588736486709522,-58.487028508075511 -34.589359653150439,-58.486695308181829 -34.58972924095346,-58.486329159453575 -34.590135314539204,-58.487458819598366 -34.590832371909372,-58.488162762737915 -34.590058815938647,-58.488836046730228 -34.589318925702656,-58.489412955372053 -34.588684902121237,-58.489508552423537 -34.588579172686956,-58.490132949199015 -34.587888301911086,-58.490751206737393 -34.587204190112715,-58.491413377158914 -34.586471471266414,-58.490850301212831 -34.586116447195579,-58.49028569696226 -34.585760434894887,-58.48961662700853 -34.586500121344677)));;1524;15_1_10;COMUNA 15;1;10;939;441;498;88,55%;396;396;100,00%;0;0,00%;340;29;8,53%;311;91,47%
MULTIPOLYGON (((-58.487443572160736 -34.586222682670439,-58.486893983042854 -34.586797252759524,-58.486802725930261 -34.586897134012979,-58.486941298645988 -34.586985560849925,-58.488241437496328 -34.587795398813611,-58.48836894001338 -34.587874248481384,-58.488895531451917 -34.587291155319882,-58.488994362662865 -34.587182890256479,-58.489513796888112 -34.586613810557225,-58.48961662700853 -34.586500121344677,-58.49028569696226 -34.585760434894887,-58.489559528778308 -34.58530255006675,-58.488968873558733 -34.584930057809075,-58.488793593920711 -34.58481818943666,-58.488193967031165 -34.585438200579986,-58.488086367296376 -34.585550621948819,-58.487443572160736 -34.586222682670439)));;1525;15_1_11;COMUNA 15;1;11;587;295;292;101,03%;272;272;100,00%;0;0,00%;220;3;1,36%;217;98,64%
MULTIPOLYGON (((-58.486111474517926 -34.587633213802626,-58.485561273070431 -34.588215876796269,-58.485434341776894 -34.588350553813484,-58.485078233943618 -34.588728592572238,-58.484710459604173 -34.589118956811745,-58.483650516479635 -34.589491059688854,-58.482501495837816 -34.589893239450028,-58.482012132621833 -34.590064451472031,-58.481861585128037 -34.590117153363792,-58.481457793884005 -34.590245812781617,-58.481288425993803 -34.590299784512446,-58.481182239890153 -34.590328675032218,-58.480870919180738 -34.590413373049358,-58.479544899255849 -34.59075125280679,-58.478082960903492 -34.591123714188257,-58.47782494036062 -34.591189382853749,-58.47672839114869 -34.591468750285649,-58.476726926217808 -34.59146625920323,-58.47596234833663 -34.591659213459131,-58.47587969084816 -34.591678753428326,-58.475875807780305 -34.591685966614421,-58.475950011400514 -34.59187138847453,-58.476016295398274 -34.592056459021634,-58.476123590379295 -34.592354961446368,-58.476148949459372 -34.592426740832032,-58.476306667361591 -34.592430174189424,-58.476541967128604 -34.592437119833875,-58.47710718057963 -34.592453322664007,-58.477728685122585 -34.592467966599799,-58.478338864392711 -34.592487256893406,-58.47896403161085 -34.59250344342523,-58.479589284558593 -34.592521246524825,-58.480283857884096 -34.592535867312698,-58.480895911770602 -34.592555144550367,-58.481534280244787 -34.592572865302692,-58.482106989716733 -34.592589043817924,-58.482713423429956 -34.592606763476276,-58.483448280404133 -34.592626852814782,-58.484134424954419 -34.592643777154379,-58.484879672395273 -34.592664560300875,-58.485621087968255 -34.592685339615855,-58.486325032265071 -34.592703022972209,-58.487472157950599 -34.592734275620842,-58.488664250446107 -34.592768747491654,-58.489396300667252 -34.592791055218768,-58.490459203346084 -34.592818776917881,-58.490701487575329 -34.592822735807552,-58.490629602668342 -34.592778375722034,-58.490561624475554 -34.592736426382253,-58.489737359549132 -34.592232577773096,-58.488797861254845 -34.591658182070276,-58.488593949765466 -34.591532445867351,-58.487458819598366 -34.590832371909372,-58.486329159453575 -34.590135314539204,-58.486695308181829 -34.58972924095346,-58.487028508075511 -34.589359653150439,-58.487590276063493 -34.588736486709522,-58.487699410880651 -34.588615684902862,-58.48836894001338 -34.587874248481384,-58.488241437496328 -34.587795398813611,-58.486941298645988 -34.586985560849925,-58.486802725930261 -34.586897134012979,-58.48669597528756 -34.587014061186778,-58.486440502016521 -34.587284685468362,-58.486111474517926 -34.587633213802626)));;1526;15_1_12;COMUNA 15;1;12;737;357;380;93,95%;334;334;100,00%;0;0,00%;283;2;0,71%;281;99,29%
MULTIPOLYGON (((-58.496936164570251 -34.592098793461012,-58.496313153963449 -34.592786529040069,-58.495838589887455 -34.593310411876658,-58.495812541887453 -34.59333915247327,-58.495720051231444 -34.593429187732234,-58.49565186771472 -34.593495261367117,-58.495930094844255 -34.593504092241254,-58.497468754474653 -34.593729129731123,-58.497958124905487 -34.593800823130202,-58.499288099321134 -34.593995650554589,-58.500231843218792 -34.594133820085588,-58.501117420413621 -34.594263549603944,-58.502403973569045 -34.594451948010054,-58.502506346387072 -34.59446910713595,-58.502876875202681 -34.594697918069137,-58.503181207085568 -34.594582220964853,-58.503543782400641 -34.594450117761816,-58.503543789060693 -34.594450092905667,-58.503083537468683 -34.594382215249922,-58.502141914788588 -34.594243362842576,-58.501497560817171 -34.593844187534224,-58.500170114399573 -34.593026612416509,-58.498840479237153 -34.59220768530777,-58.497554823776852 -34.591415844792358,-58.496936164570251 -34.592098793461012)));;1527;15_1_2;COMUNA 15;1;2;946;425;521;81,57%;412;411;99,76%;1;0,24%;344;4;1,16%;340;98,84%
MULTIPOLYGON (((-58.495800956866219 -34.591399008482099,-58.495179049228796 -34.592086808477667,-58.495362443525011 -34.592200214724748,-58.496313153963449 -34.592786529040069,-58.496936164570251 -34.592098793461012,-58.497554823776852 -34.591415844792358,-58.49820249841391 -34.590700911372963,-58.497066361691346 -34.589999448063971,-58.49592794422454 -34.589296495779728,-58.495283070703351 -34.590010148890933,-58.494663893191408 -34.590695269524247,-58.495584343644104 -34.591265470189498,-58.495800956866219 -34.591399008482099)));;1528;15_1_3;COMUNA 15;1;3;691;309;382;80,89%;339;338;99,71%;1;0,30%;268;0;0,00%;268;100,00%
MULTIPOLYGON (((-58.494041896417151 -34.5913834863807,-58.493372559584401 -34.59212410834062,-58.492708318482272 -34.592859020839256,-58.494276643678504 -34.593085183339447,-58.495132136078851 -34.593208555398974,-58.495225137501265 -34.593221981881214,-58.495838589887455 -34.593310411876658,-58.496313153963449 -34.592786529040069,-58.495362443525011 -34.592200214724748,-58.495179049228796 -34.592086808477667,-58.495800956866219 -34.591399008482099,-58.495584343644104 -34.591265470189498,-58.494663893191408 -34.590695269524247,-58.494041896417151 -34.5913834863807)));;1529;15_1_4;COMUNA 15;1;4;644;297;347;85,59%;276;275;99,64%;1;0,36%;237;1;0,42%;236;99,58%
MULTIPOLYGON (((-58.489298569685708 -34.590759305843321,-58.488593949765466 -34.591532445867351,-58.488797861254845 -34.591658182070276,-58.489737359549132 -34.592232577773096,-58.490561624475554 -34.592736426382253,-58.490629602668342 -34.592778375722034,-58.490959766533933 -34.592797572379268,-58.490992948868154 -34.592800513858691,-58.492645455829376 -34.59282044320846,-58.492708318482272 -34.592859020839256,-58.493372559584401 -34.59212410834062,-58.493231417339182 -34.592037379735274,-58.492240190283084 -34.591420416126056,-58.49209087291684 -34.591327490740248,-58.491102560563533 -34.590717700497038,-58.489972190137138 -34.590020184030799,-58.489298569685708 -34.590759305843321)));;1530;15_1_5;COMUNA 15;1;5;782;364;418;87,08%;308;306;99,35%;2;0,65%;268;3;1,12%;265;98,88%
MULTIPOLYGON (((-58.491771566334165 -34.589979062802819,-58.490636941024526 -34.58927725747489,-58.490069490844398 -34.589913467844461,-58.489972190137138 -34.590020184030799,-58.491102560563533 -34.590717700497038,-58.49209087291684 -34.591327490740248,-58.492240190283084 -34.591420416126056,-58.493231417339182 -34.592037379735274,-58.493372559584401 -34.59212410834062,-58.494041896417151 -34.5913834863807,-58.492907658776986 -34.590681843087538,-58.493530255556365 -34.58999299795196,-58.492961782933193 -34.589640802214312,-58.492395614880984 -34.589290082178699,-58.491771566334165 -34.589979062802819)));;1531;15_1_6;COMUNA 15;1;6;740;366;374;97,86%;279;279;100,00%;0;0,00%;257;1;0,39%;256;99,61%
MULTIPOLYGON (((-58.494663893191408 -34.590695269524247,-58.495283070703351 -34.590010148890933,-58.49592794422454 -34.589296495779728,-58.495592342581055 -34.589089254443849,-58.49536116995769 -34.588945789650168,-58.494794400100673 -34.588594165335927,-58.494225335240046 -34.588241060027983,-58.493579944828262 -34.588955972055039,-58.492961782933193 -34.589640802214312,-58.493530255556365 -34.58999299795196,-58.492907658776986 -34.590681843087538,-58.494041896417151 -34.5913834863807,-58.494663893191408 -34.590695269524247)));;1532;15_1_7;COMUNA 15;1;7;699;327;372;87,90%;343;343;100,00%;0;0,00%;290;0;0,00%;290;100,00%
MULTIPOLYGON (((-58.491261845071904 -34.588587718969173,-58.49074675261366 -34.589154128763006,-58.490636941024526 -34.58927725747489,-58.491771566334165 -34.589979062802819,-58.492395614880984 -34.589290082178699,-58.492961782933193 -34.589640802214312,-58.493579944828262 -34.588955972055039,-58.494225335240046 -34.588241060027983,-58.4938905082861 -34.588033320796093,-58.493663514281408 -34.587890203818986,-58.492540139654842 -34.587181933951598,-58.492384962376661 -34.587352471638511,-58.491882398281994 -34.587905150340667,-58.491261845071904 -34.588587718969173)));;1533;15_1_8;COMUNA 15;1;8;716;330;386;85,49%;316;315;99,68%;1;0,32%;276;1;0,36%;275;99,64%
MULTIPOLYGON (((-58.491970155028916 -34.586822479981151,-58.491413377158914 -34.586471471266414,-58.490751206737393 -34.587204190112715,-58.490132949199015 -34.587888301911086,-58.489508552423537 -34.588579172686956,-58.489412955372053 -34.588684902121237,-58.488836046730228 -34.589318925702656,-58.488162762737915 -34.590058815938647,-58.487458819598366 -34.590832371909372,-58.488593949765466 -34.591532445867351,-58.489298569685708 -34.590759305843321,-58.489972190137138 -34.590020184030799,-58.490069490844398 -34.589913467844461,-58.490636941024526 -34.58927725747489,-58.49074675261366 -34.589154128763006,-58.491261845071904 -34.588587718969173,-58.491882398281994 -34.587905150340667,-58.492384962376661 -34.587352471638511,-58.492540139654842 -34.587181933951598,-58.491970155028916 -34.586822479981151)));;1534;15_1_9;COMUNA 15;1;9;988;472;516;91,47%;395;394;99,75%;1;0,25%;342;2;0,58%;340;99,42%
MULTIPOLYGON (((-58.460527720930415 -34.578294633170451,-58.460224856101227 -34.57829526123389,-58.460102160507695 -34.57829554038608,-58.459695075936473 -34.578320109537614,-58.4585384469706 -34.578390008089656,-58.458901874585692 -34.579745569531958,-58.459169535657416 -34.58076336637145,-58.460530636677682 -34.580772130909779,-58.460529303035443 -34.57966680322383,-58.460527720930415 -34.578294633170451)));;1535;15_10_1;COMUNA 15;10;1;719;336;383;87,73%;404;404;100,00%;0;0,00%;348;16;4,60%;332;95,40%
MULTIPOLYGON (((-58.44999900785924 -34.580879733274266,-58.44959546270691 -34.58103976767309,-58.449441674739774 -34.581096373129171,-58.449192003025637 -34.581188250968545,-58.449810337716606 -34.582407804849126,-58.450286358766263 -34.583346695640849,-58.451211500310698 -34.582925642158997,-58.450705486025193 -34.582073516111514,-58.451063645529622 -34.581939742442039,-58.451434832448854 -34.581801109565866,-58.451712177942774 -34.581703243479211,-58.451522163298307 -34.581409763381544,-58.451476873255089 -34.581339897178474,-58.450952471876256 -34.580501573632226,-58.44999900785924 -34.580879733274266)));;1536;15_10_10;COMUNA 15;10;10;582;270;312;86,54%;342;342;100,00%;0;0,00%;257;65;25,29%;192;74,71%
MULTIPOLYGON (((-58.451282957104802 -34.585304901213682,-58.452346153986497 -34.584836455803355,-58.45174638497457 -34.58382643255198,-58.451211500310698 -34.582925642158997,-58.450286358766263 -34.583346695640849,-58.450473041606607 -34.583714969035604,-58.450771329392694 -34.584300374645146,-58.449744571124171 -34.584799445304718,-58.44955364473045 -34.584887597501869,-58.449882176695773 -34.585917111000946,-58.450089880155481 -34.585830579823771,-58.451282957104802 -34.585304901213682)));;1537;15_10_11;COMUNA 15;10;11;656;285;371;76,82%;317;316;99,68%;1;0,32%;253;2;0,79%;251;99,21%
MULTIPOLYGON (((-58.45343147963829 -34.584358143218211,-58.452346153986497 -34.584836455803355,-58.451282957104802 -34.585304901213682,-58.451809750717267 -34.586339146343413,-58.452972755708011 -34.585891620763483,-58.453515465076805 -34.585676583641302,-58.453964872751307 -34.585181737321349,-58.45343147963829 -34.584358143218211)));;1538;15_10_12;COMUNA 15;10;12;782;363;419;86,63%;396;396;100,00%;0;0,00%;338;21;6,21%;317;93,79%
MULTIPOLYGON (((-58.450212674281907 -34.586953595757073,-58.450303151589885 -34.587239250339785,-58.450526071589039 -34.587936061476242,-58.450767081658753 -34.588689491536186,-58.450767134374281 -34.588689656330516,-58.450767466042272 -34.588690693159741,-58.450768122278028 -34.588689975332507,-58.450768247237889 -34.588689838644456,-58.451236835349235 -34.588177266785081,-58.452205961204712 -34.587117240749514,-58.452375698348213 -34.586931613910934,-58.453110167508186 -34.586122908642288,-58.453515465076805 -34.585676583641302,-58.452972755708011 -34.585891620763483,-58.451809750717267 -34.586339146343413,-58.451282957104802 -34.585304901213682,-58.450089880155481 -34.585830579823771,-58.449882176695773 -34.585917111000946,-58.450191395597464 -34.586886478184837,-58.450212674281907 -34.586953595757073)));;1539;15_10_13;COMUNA 15;10;13;1059;457;602;75,91%;446;445;99,78%;1;0,22%;364;32;8,79%;332;91,21%
MULTIPOLYGON (((-58.458901874585692 -34.579745569531958,-58.4585384469706 -34.578390008089656,-58.457743689168268 -34.578438008585508,-58.457340769977101 -34.578546728506808,-58.457161789057153 -34.578594961972946,-58.45762669983035 -34.579812145683427,-58.457982734138497 -34.580755720322863,-58.458404247765998 -34.581869866530901,-58.458454138773497 -34.582002901941188,-58.458782351073118 -34.582868934536812,-58.458831561873453 -34.58300626570059,-58.460533219759213 -34.582950249129098,-58.460531970983538 -34.581853232042135,-58.460530636677682 -34.580772130909779,-58.459169535657416 -34.58076336637145,-58.458901874585692 -34.579745569531958)));;1540;15_10_2;COMUNA 15;10;2;1107;579;528;109,66%;408;407;99,75%;1;0,25%;341;3;0,88%;338;99,12%
MULTIPOLYGON (((-58.455580635856997 -34.580401575058374,-58.456153698597177 -34.581299109162067,-58.456706340020688 -34.582163328208729,-58.458404247765998 -34.581869866530901,-58.457982734138497 -34.580755720322863,-58.45762669983035 -34.579812145683427,-58.457161789057153 -34.578594961972946,-58.455970905006744 -34.578916253597939,-58.45539930125053 -34.579070452543647,-58.454862348554826 -34.579242679960181,-58.454982044922367 -34.579464034852748,-58.455580635856997 -34.580401575058374)));;1541;15_10_3;COMUNA 15;10;3;1097;503;594;84,68%;471;470;99,79%;1;0,21%;409;19;4,65%;390;95,35%
MULTIPOLYGON (((-58.456153698597177 -34.581299109162067,-58.454818862335451 -34.581695173420826,-58.453466897707408 -34.582096221966111,-58.454017728473595 -34.582959959957137,-58.454584661870754 -34.583848908713669,-58.454828074877597 -34.584230630432351,-58.454913980872661 -34.584365359765641,-58.45620807832664 -34.58388288049067,-58.457495604008336 -34.583402992915829,-58.458831561873453 -34.58300626570059,-58.458782351073118 -34.582868934536812,-58.458454138773497 -34.582002901941188,-58.458404247765998 -34.581869866530901,-58.456706340020688 -34.582163328208729,-58.456153698597177 -34.581299109162067)));;1542;15_10_4;COMUNA 15;10;4;799;383;416;92,07%;432;432;100,00%;0;0,00%;337;20;5,93%;317;94,07%
MULTIPOLYGON (((-58.454862348554826 -34.579242679960181,-58.453533496065013 -34.579668872782513,-58.45427348074238 -34.580835383068148,-58.454818862335451 -34.581695173420826,-58.456153698597177 -34.581299109162067,-58.455580635856997 -34.580401575058374,-58.454982044922367 -34.579464034852748,-58.454862348554826 -34.579242679960181)));;1543;15_10_5;COMUNA 15;10;5;725;319;406;78,57%;339;338;99,71%;1;0,30%;277;6;2,17%;271;97,83%
MULTIPOLYGON (((-58.452947918263646 -34.581282556413178,-58.453466897707408 -34.582096221966111,-58.454818862335451 -34.581695173420826,-58.45427348074238 -34.580835383068148,-58.453533496065013 -34.579668872782513,-58.453020633374955 -34.57983334708463,-58.452193049418604 -34.580098782658382,-58.452947918263646 -34.581282556413178)));;1544;15_10_6;COMUNA 15;10;6;485;216;269;80,30%;281;281;100,00%;0;0,00%;216;14;6,48%;202;93,52%
MULTIPOLYGON (((-58.452193049418604 -34.580098782658382,-58.452022320729483 -34.580153488428159,-58.451017614008009 -34.580475733740641,-58.450952471876256 -34.580501573632226,-58.451476873255089 -34.581339897178474,-58.451522163298307 -34.581409763381544,-58.451712177942774 -34.581703243479211,-58.452209525469094 -34.582471347114165,-58.453466897707408 -34.582096221966111,-58.452947918263646 -34.581282556413178,-58.452193049418604 -34.580098782658382)));;1545;15_10_7;COMUNA 15;10;7;846;386;460;83,91%;508;508;100,00%;0;0,00%;402;20;4,98%;382;95,02%
MULTIPOLYGON (((-58.453466897707408 -34.582096221966111,-58.452209525469094 -34.582471347114165,-58.452766136497395 -34.583330795245345,-58.45343147963829 -34.584358143218211,-58.453964872751307 -34.585181737321349,-58.454184081613654 -34.584940334514798,-58.454828074877597 -34.584230630432351,-58.454584661870754 -34.583848908713669,-58.454017728473595 -34.582959959957137,-58.453466897707408 -34.582096221966111)));;1546;15_10_8;COMUNA 15;10;8;720;316;404;78,22%;358;358;100,00%;0;0,00%;324;20;6,17%;304;93,83%
MULTIPOLYGON (((-58.451211500310698 -34.582925642158997,-58.45174638497457 -34.58382643255198,-58.452346153986497 -34.584836455803355,-58.45343147963829 -34.584358143218211,-58.452766136497395 -34.583330795245345,-58.452209525469094 -34.582471347114165,-58.451712177942774 -34.581703243479211,-58.451434832448854 -34.581801109565866,-58.451063645529622 -34.581939742442039,-58.450705486025193 -34.582073516111514,-58.451211500310698 -34.582925642158997)));;1547;15_10_9;COMUNA 15;10;9;766;345;421;81,95%;352;352;100,00%;0;0,00%;297;26;8,75%;271;91,25%
MULTIPOLYGON (((-58.449810337716606 -34.582407804849126,-58.449192003025637 -34.581188250968545,-58.448459589734576 -34.5814578971885,-58.448393424505994 -34.581482256656123,-58.448279657689767 -34.581524146409642,-58.447092494096132 -34.582034444001316,-58.447184080625917 -34.582221787352744,-58.447635950303436 -34.583288225885127,-58.448073957430893 -34.584321913080686,-58.449216269637354 -34.583829841374779,-58.449376110521072 -34.583760982866124,-58.450286358766263 -34.583346695640849,-58.449810337716606 -34.582407804849126)));;1548;15_11_1;COMUNA 15;11;1;789;380;409;92,91%;424;423;99,76%;1;0,24%;308;56;18,18%;252;81,82%
MULTIPOLYGON (((-58.447057780368993 -34.588250185936332,-58.446006864971707 -34.588684078256527,-58.446335691318751 -34.58980247749345,-58.447388498975933 -34.589333581257598,-58.448437292130826 -34.588866436066652,-58.449755101336073 -34.5882794466768,-58.449668686934928 -34.588156052229749,-58.449147400359678 -34.58738737289665,-58.448112006167371 -34.587814876422335,-58.447057780368993 -34.588250185936332)));;1549;15_11_10;COMUNA 15;11;10;670;311;359;86,63%;333;333;100,00%;0;0,00%;268;22;8,21%;246;91,79%
MULTIPOLYGON (((-58.449755101336073 -34.5882794466768,-58.448437292130826 -34.588866436066652,-58.447388498975933 -34.589333581257598,-58.448748759214652 -34.590615767427799,-58.449173170134308 -34.590214109035621,-58.449516153862852 -34.589889485706593,-58.450337958244347 -34.589111723656657,-58.450767466042272 -34.588690693159741,-58.450767134374281 -34.588689656330516,-58.450767081658753 -34.588689491536186,-58.450526071589039 -34.587936061476242,-58.450303151589885 -34.587239250339785,-58.450212674281907 -34.586953595757073,-58.449996964115435 -34.587036605024608,-58.449147400359678 -34.58738737289665,-58.449668686934928 -34.588156052229749,-58.449755101336073 -34.5882794466768)));;1550;15_11_11;COMUNA 15;11;11;1164;540;624;86,54%;681;680;99,85%;1;0,15%;531;23;4,33%;508;95,67%
MULTIPOLYGON (((-58.447388498975933 -34.589333581257598,-58.446335691318751 -34.58980247749345,-58.446349562836126 -34.58984952348807,-58.446641208187728 -34.590841432791734,-58.44667833106049 -34.590874889707784,-58.4468029834782 -34.590981529973433,-58.447598579416081 -34.591702645597238,-58.447888852519959 -34.59142957173318,-58.448748759214652 -34.590615767427799,-58.447388498975933 -34.589333581257598)));;1551;15_11_12;COMUNA 15;11;12;865;399;466;85,62%;458;457;99,78%;1;0,22%;376;1;0,27%;375;99,73%
MULTIPOLYGON (((-58.444665328477178 -34.591605208311918,-58.444754183958636 -34.591647819151966,-58.444893944251341 -34.591714862778062,-58.445029006969627 -34.591779477188155,-58.44515349980778 -34.591838747503651,-58.445277405532835 -34.591898017607768,-58.445400136953829 -34.591956801744075,-58.445526979183526 -34.592017529034976,-58.445647949280939 -34.592075341323095,-58.445683142099114 -34.592092072533156,-58.445777728132448 -34.592137040112519,-58.445899873063183 -34.592195337987732,-58.446016733017821 -34.592251206642842,-58.446157669728912 -34.592319220326097,-58.446299194058632 -34.592386748249886,-58.446446590894134 -34.59245767651587,-58.446600447750228 -34.592531033830284,-58.446671450274941 -34.592565259380279,-58.446703475290207 -34.592535592728574,-58.447349529046207 -34.591936849169691,-58.447598579416081 -34.591702645597238,-58.4468029834782 -34.590981529973433,-58.44667833106049 -34.590874889707784,-58.446641208187728 -34.590841432791734,-58.446349562836126 -34.58984952348807,-58.446335691318751 -34.58980247749345,-58.446006864971707 -34.588684078256527,-58.445932336279917 -34.588766465716461,-58.445067986672221 -34.589610180556306,-58.444182325329919 -34.590474731824862,-58.443640681323849 -34.591003401898277,-58.443600308554466 -34.591044154300612,-58.443566118615664 -34.591077371069247,-58.443616144363915 -34.591101262060185,-58.443649227370621 -34.591116981206788,-58.44376236240884 -34.591170736372916,-58.443910929291867 -34.591242639246673,-58.444058322076202 -34.591313570409319,-58.444204540861321 -34.591383044190074,-58.444348410742613 -34.591452517441702,-58.444486408732246 -34.591518589921442,-58.444621470606862 -34.591584176134504,-58.444665328477178 -34.591605208311918)));;1552;15_11_13;COMUNA 15;11;13;923;442;481;91,89%;450;450;100,00%;0;0,00%;364;35;9,62%;329;90,38%
MULTIPOLYGON (((-58.445786009801267 -34.582595983240964,-58.444448595179608 -34.583170814225561,-58.444399798995633 -34.583191793696543,-58.444785675749735 -34.584513524823564,-58.446427382788087 -34.583807810367652,-58.446954624885365 -34.584804047037423,-58.448073957430893 -34.584321913080686,-58.447635950303436 -34.583288225885127,-58.447184080625917 -34.582221787352744,-58.447092494096132 -34.582034444001316,-58.445786009801267 -34.582595983240964)));;1553;15_11_2;COMUNA 15;11;2;764;383;381;100,52%;589;589;100,00%;0;0,00%;358;9;2,51%;349;97,49%
MULTIPOLYGON (((-58.448073957430893 -34.584321913080686,-58.446954624885365 -34.584804047037423,-58.447463407540603 -34.585765488818204,-58.448489242457661 -34.585337989535788,-58.449403509191079 -34.584956950265685,-58.44955364473045 -34.584887597501869,-58.449744571124171 -34.584799445304718,-58.450771329392694 -34.584300374645146,-58.450473041606607 -34.583714969035604,-58.450286358766263 -34.583346695640849,-58.449376110521072 -34.583760982866124,-58.449216269637354 -34.583829841374779,-58.448073957430893 -34.584321913080686)));;1554;15_11_3;COMUNA 15;11;3;736;347;389;89,20%;376;375;99,73%;1;0,27%;305;16;5,25%;289;94,75%
MULTIPOLYGON (((-58.448489242457661 -34.585337989535788,-58.447463407540603 -34.585765488818204,-58.446954624885365 -34.584804047037423,-58.446427382788087 -34.583807810367652,-58.444785675749735 -34.584513524823564,-58.445103235479955 -34.5856014322883,-58.445401997719976 -34.586624544713395,-58.44549432530156 -34.586940838179309,-58.44570366151023 -34.587652868118617,-58.447793962388076 -34.586786627418832,-58.447963432839401 -34.586716363462585,-58.448817679070658 -34.586360533697949,-58.448489242457661 -34.585337989535788)));;1555;15_11_4;COMUNA 15;11;4;821;392;429;91,38%;337;337;100,00%;0;0,00%;308;5;1,62%;303;98,38%
MULTIPOLYGON (((-58.442425204672894 -34.586098713066995,-58.441397561441391 -34.586780255804022,-58.442370187122421 -34.58753017032177,-58.442519489799039 -34.58742681064512,-58.443385404404133 -34.586825447560948,-58.444298574360403 -34.58619126717209,-58.445103235479955 -34.5856014322883,-58.444785675749735 -34.584513524823564,-58.444585789851651 -34.584665755062176,-58.44347727388044 -34.585400967604635,-58.442425204672894 -34.586098713066995)));;1556;15_11_5;COMUNA 15;11;5;701;320;381;83,99%;320;320;100,00%;0;0,00%;245;17;6,94%;228;93,06%
MULTIPOLYGON (((-58.439976149094093 -34.589350723687076,-58.440034177563597 -34.58937844531318,-58.440189197518933 -34.589452296636793,-58.440340694369347 -34.589525175766845,-58.440492778887361 -34.589597569139741,-58.440647799655657 -34.589671419878471,-58.440794012341179 -34.589742354787646,-58.440947271945753 -34.589815719152995,-58.441064125125791 -34.589872078245257,-58.441089760001589 -34.589884388608468,-58.441173499413338 -34.589924601830781,-58.441210745467586 -34.5898847664523,-58.441210784136793 -34.589884784593565,-58.441374502077821 -34.589711214819665,-58.44227419048412 -34.58902972168795,-58.443303750518439 -34.588249999164113,-58.442370187122421 -34.58753017032177,-58.441397561441391 -34.586780255804022,-58.441089248187268 -34.586984646493349,-58.440156549311396 -34.587601122404742,-58.439389070312068 -34.588108322618254,-58.438614342268707 -34.588620375880893,-58.43860903146836 -34.588623716827414,-58.438595184551104 -34.588632396598477,-58.438582779991641 -34.588640265649744,-58.438568586903394 -34.588649136173657,-58.438554393812147 -34.58865800669588,-58.438541066118219 -34.588666448033102,-58.438533389209098 -34.588671257682599,-58.438673652247807 -34.588737579416851,-58.438813990465611 -34.588803173124006,-58.438966072481279 -34.588875082731761,-58.439119916429384 -34.588947478164904,-58.439267301632285 -34.589016472436697,-58.439418210157953 -34.589087409902895,-58.439572642160485 -34.589159804875145,-58.439727074430976 -34.589232199651221,-58.439878570743751 -34.589304108006871,-58.439976149094093 -34.589350723687076)));;1557;15_11_6;COMUNA 15;11;6;798;384;414;92,75%;288;288;100,00%;0;0,00%;266;22;8,27%;244;91,73%
MULTIPOLYGON (((-58.441374502077821 -34.589711214819665,-58.441210784136793 -34.589884784593565,-58.441210745467586 -34.5898847664523,-58.441173499413338 -34.589924601830781,-58.44121386192392 -34.589943984624277,-58.441361837274165 -34.59001540483564,-58.441509225600512 -34.590086824764867,-58.441654852713405 -34.590156787186153,-58.441790497436301 -34.5902223766467,-58.441920857469398 -34.590285536680462,-58.442061200362829 -34.590353069339194,-58.442203892124567 -34.590422544930867,-58.442334840063317 -34.590485704619176,-58.44237504509222 -34.590505131130165,-58.442481642890293 -34.590556637595974,-58.442628445966854 -34.590627570395434,-58.442769964339256 -34.590696073779057,-58.442907959828005 -34.590762148051063,-58.443045368367223 -34.590827736396726,-58.443183364178211 -34.590894296031109,-58.443329581387395 -34.590964256539557,-58.443471688302182 -34.591032273524199,-58.443566118615664 -34.591077371069247,-58.443600308554466 -34.591044154300612,-58.443640681323849 -34.591003401898277,-58.444182325329919 -34.590474731824862,-58.445067986672221 -34.589610180556306,-58.445932336279917 -34.588766465716461,-58.445114876924393 -34.58814350870945,-58.444282189492739 -34.587508923680552,-58.443303750518439 -34.588249999164113,-58.44227419048412 -34.58902972168795,-58.441374502077821 -34.589711214819665)));;1558;15_11_7;COMUNA 15;11;7;679;317;362;87,57%;305;305;100,00%;0;0,00%;258;22;8,53%;236;91,47%
MULTIPOLYGON (((-58.442519489799039 -34.58742681064512,-58.442370187122421 -34.58753017032177,-58.443303750518439 -34.588249999164113,-58.444282189492739 -34.587508923680552,-58.445114876924393 -34.58814350870945,-58.445932336279917 -34.588766465716461,-58.446006864971707 -34.588684078256527,-58.44570366151023 -34.587652868118617,-58.44549432530156 -34.586940838179309,-58.445401997719976 -34.586624544713395,-58.445103235479955 -34.5856014322883,-58.444298574360403 -34.58619126717209,-58.443385404404133 -34.586825447560948,-58.442519489799039 -34.58742681064512)));;1559;15_11_8;COMUNA 15;11;8;726;341;385;88,57%;332;331;99,70%;1;0,30%;276;11;3,99%;265;96,01%
MULTIPOLYGON (((-58.447793962388076 -34.586786627418832,-58.44570366151023 -34.587652868118617,-58.446006864971707 -34.588684078256527,-58.447057780368993 -34.588250185936332,-58.448112006167371 -34.587814876422335,-58.449147400359678 -34.58738737289665,-58.449996964115435 -34.587036605024608,-58.450212674281907 -34.586953595757073,-58.450191395597464 -34.586886478184837,-58.449882176695773 -34.585917111000946,-58.44955364473045 -34.584887597501869,-58.449403509191079 -34.584956950265685,-58.448489242457661 -34.585337989535788,-58.448817679070658 -34.586360533697949,-58.447963432839401 -34.586716363462585,-58.447793962388076 -34.586786627418832)));;1560;15_11_9;COMUNA 15;11;9;1092;494;598;82,61%;456;453;99,34%;3;0,66%;382;6;1,57%;376;98,43%
MULTIPOLYGON (((-58.443489830411295 -34.591151764431636,-58.443489977106445 -34.591151832475312,-58.443563666863994 -34.591080030183633,-58.443566118615664 -34.591077371069247,-58.443471688302182 -34.591032273524199,-58.443329581387395 -34.590964256539557,-58.443183364178211 -34.590894296031109,-58.443045368367223 -34.590827736396726,-58.442907959828005 -34.590762148051063,-58.442769964339256 -34.590696073779057,-58.442628445966854 -34.590627570395434,-58.442481642890293 -34.590556637595974,-58.44237504509222 -34.590505131130165,-58.442334840063317 -34.590485704619176,-58.442203892124567 -34.590422544930867,-58.442061200362829 -34.590353069339194,-58.441920857469398 -34.590285536680462,-58.441790497436301 -34.5902223766467,-58.441654852713405 -34.590156787186153,-58.441509225600512 -34.590086824764867,-58.441361837274165 -34.59001540483564,-58.44121386192392 -34.589943984624277,-58.441173499413338 -34.589924601830781,-58.441089760001589 -34.589884388608468,-58.441064125125791 -34.589872078245257,-58.440947271945753 -34.589815719152995,-58.440794012341179 -34.589742354787646,-58.440647799655657 -34.589671419878471,-58.440492778887361 -34.589597569139741,-58.440340694369347 -34.589525175766845,-58.440189197518933 -34.589452296636793,-58.440034177563597 -34.58937844531318,-58.439976149094093 -34.589350723687076,-58.439878570743751 -34.589304108006871,-58.439727074430976 -34.589232199651221,-58.439572642160485 -34.589159804875145,-58.439418210157953 -34.589087409902895,-58.439267301632285 -34.589016472436697,-58.439119916429384 -34.588947478164904,-58.438966072481279 -34.588875082731761,-58.438813990465611 -34.588803173124006,-58.438673652247807 -34.588737579416851,-58.438533389209098 -34.588671257682599,-58.438526526841557 -34.588675557013914,-58.438513199169641 -34.588683902935919,-58.438498470381028 -34.588690004541398,-58.438498057721922 -34.588690004459565,-58.438425501972375 -34.588738461270488,-58.438412866640654 -34.588746330258445,-58.438398385312908 -34.588754437407879,-58.438387480641467 -34.588761925089237,-58.438373748812197 -34.58877141586111,-58.438360190063058 -34.588780811253798,-58.438345881278572 -34.588790635849939,-58.438332380222271 -34.588799983544945,-58.438318013718195 -34.588809903538404,-58.438303358742978 -34.588819966590705,-58.438288934532871 -34.588829934275232,-58.438275318079505 -34.588839329646859,-58.438261413155168 -34.588848868077399,-58.438251316177706 -34.588855926553563,-58.438249887619811 -34.588856862204963,-58.43839929634693 -34.589292402471592,-58.438649789203559 -34.590022551728502,-58.438838342490676 -34.590571906437901,-58.439139063320091 -34.591084520488558,-58.43965815269118 -34.591541468745021,-58.440703040682614 -34.5922669015821,-58.441647893977716 -34.591258859222187,-58.441890548834337 -34.591456655178504,-58.442623543602885 -34.592054829865127,-58.443176882144023 -34.591464614530402,-58.443326201684961 -34.591314632365894,-58.443489830411295 -34.591151764431636)));;1561;15_12_1;COMUNA 15;12;1;781;389;392;99,23%;272;272;100,00%;0;0,00%;277;78;28,16%;199;71,84%
MULTIPOLYGON (((-58.437124392853306 -34.589612013914063,-58.436173915655843 -34.590249723836827,-58.436036696170994 -34.590341810285196,-58.435310818557852 -34.590821879938801,-58.436342248146296 -34.59140917266685,-58.437460029734446 -34.592045631391947,-58.438026779305126 -34.591440089466175,-58.438187445051518 -34.591543294954938,-58.438322567940055 -34.591630508580877,-58.439139063320091 -34.591084520488558,-58.438838342490676 -34.590571906437901,-58.438649789203559 -34.590022551728502,-58.43839929634693 -34.589292402471592,-58.438249887619811 -34.588856862204963,-58.438123319433693 -34.588941840193613,-58.438051432688709 -34.588990067067968,-58.437124392853306 -34.589612013914063)));;1562;15_12_2;COMUNA 15;12;2;765;365;400;91,25%;346;345;99,71%;1;0,29%;283;32;11,31%;251;88,69%
MULTIPOLYGON (((-58.438322567940055 -34.591630508580877,-58.438187445051518 -34.591543294954938,-58.438026779305126 -34.591440089466175,-58.437460029734446 -34.592045631391947,-58.438584895581911 -34.592686025034084,-58.439709863818507 -34.593326549114046,-58.440177705314731 -34.592827391305534,-58.440703040682614 -34.5922669015821,-58.43965815269118 -34.591541468745021,-58.439139063320091 -34.591084520488558,-58.438322567940055 -34.591630508580877)));;1563;15_12_3;COMUNA 15;12;3;752;347;405;85,68%;370;369;99,73%;1;0,27%;309;19;6,15%;290;93,85%
MULTIPOLYGON (((-58.443528722694928 -34.594228511877631,-58.442720325328224 -34.593667303801169,-58.441745988488186 -34.59299091655047,-58.440703040682614 -34.5922669015821,-58.440177705314731 -34.592827391305534,-58.439709863818507 -34.593326549114046,-58.440832465156653 -34.593965653829507,-58.441879810469075 -34.594561987182658,-58.442713695400627 -34.595036652239592,-58.443528722694928 -34.594228511877631)));;1564;15_12_4;COMUNA 15;12;4;693;310;383;80,94%;415;415;100,00%;0;0,00%;324;2;0,62%;322;99,38%
MULTIPOLYGON (((-58.441745988488186 -34.59299091655047,-58.442720325328224 -34.593667303801169,-58.443535863922754 -34.592799160921011,-58.443701712458108 -34.592622560153998,-58.444236135841237 -34.592058324069889,-58.444595083032866 -34.591679348732768,-58.444665328477178 -34.591605208311918,-58.444621470606862 -34.591584176134504,-58.444486408732246 -34.591518589921442,-58.444348410742613 -34.591452517441702,-58.444204540861321 -34.591383044190074,-58.444058322076202 -34.591313570409319,-58.443910929291867 -34.591242639246673,-58.44376236240884 -34.591170736372916,-58.443649227370621 -34.591116981206788,-58.443616144363915 -34.591101262060185,-58.443566118615664 -34.591077371069247,-58.443563666863994 -34.591080030183633,-58.443489977106445 -34.591151832475312,-58.443489830411295 -34.591151764431636,-58.443326201684961 -34.591314632365894,-58.443176882144023 -34.591464614530402,-58.442623543602885 -34.592054829865127,-58.441890548834337 -34.591456655178504,-58.441647893977716 -34.591258859222187,-58.440703040682614 -34.5922669015821,-58.441745988488186 -34.59299091655047)));;1565;15_12_5;COMUNA 15;12;5;927;409;518;78,96%;405;403;99,51%;2;0,50%;333;20;6,01%;313;93,99%
MULTIPOLYGON (((-58.444665328477178 -34.591605208311918,-58.444595083032866 -34.591679348732768,-58.444236135841237 -34.592058324069889,-58.443701712458108 -34.592622560153998,-58.443535863922754 -34.592799160921011,-58.444322694706351 -34.593441208685277,-58.44504799775757 -34.592721921167659,-58.445820789924866 -34.593353463879708,-58.445963632289889 -34.59322115439187,-58.446584058679093 -34.592646215195082,-58.446671450274941 -34.592565259380279,-58.446600447750228 -34.592531033830284,-58.446446590894134 -34.59245767651587,-58.446299194058632 -34.592386748249886,-58.446157669728912 -34.592319220326097,-58.446016733017821 -34.592251206642842,-58.445899873063183 -34.592195337987732,-58.445777728132448 -34.592137040112519,-58.445683142099114 -34.592092072533156,-58.445647949280939 -34.592075341323095,-58.445526979183526 -34.592017529034976,-58.445400136953829 -34.591956801744075,-58.445277405532835 -34.591898017607768,-58.44515349980778 -34.591838747503651,-58.445029006969627 -34.591779477188155,-58.444893944251341 -34.591714862778062,-58.444754183958636 -34.591647819151966,-58.444665328477178 -34.591605208311918)));;1566;15_12_6;COMUNA 15;12;6;726;338;388;87,11%;396;396;100,00%;0;0,00%;308;5;1,62%;303;98,38%
MULTIPOLYGON (((-58.445820789924866 -34.593353463879708,-58.44504799775757 -34.592721921167659,-58.444322694706351 -34.593441208685277,-58.444954825976602 -34.593950758916854,-58.445077865958581 -34.594041977515268,-58.445820789924866 -34.593353463879708)));;1567;15_12_7;COMUNA 15;12;7;497;217;280;77,50%;275;275;100,00%;0;0,00%;235;3;1,28%;232;98,72%
MULTIPOLYGON (((-58.444322694706351 -34.593441208685277,-58.443535863922754 -34.592799160921011,-58.442720325328224 -34.593667303801169,-58.443528722694928 -34.594228511877631,-58.444300175878503 -34.594764003751621,-58.444345236286978 -34.594722107486859,-58.444440892750862 -34.594637400206082,-58.444986469894687 -34.59412217870296,-58.445077865958581 -34.594041977515268,-58.444954825976602 -34.593950758916854,-58.444322694706351 -34.593441208685277)));;1568;15_12_8;COMUNA 15;12;8;741;344;397;86,65%;458;458;100,00%;0;0,00%;373;3;0,80%;370;99,20%
MULTIPOLYGON (((-58.444300175878503 -34.594764003751621,-58.443528722694928 -34.594228511877631,-58.442713695400627 -34.595036652239592,-58.442832651052996 -34.595109561840808,-58.443365107957888 -34.59540796889187,-58.44353814575453 -34.595471660645607,-58.444300175878503 -34.594764003751621)));;1569;15_12_9;COMUNA 15;12;9;520;235;285;82,46%;309;309;100,00%;0;0,00%;245;4;1,63%;241;98,37%
MULTIPOLYGON (((-58.434363212859914 -34.591448660343744,-58.434132633784301 -34.591601077426027,-58.433445575289454 -34.59205839758171,-58.433653064214731 -34.592191762282454,-58.433794569683961 -34.59228116561583,-58.434880561951879 -34.592967078911499,-58.435959590251109 -34.59364847372472,-58.437041531113458 -34.594331761020634,-58.437810537515048 -34.593511747203792,-58.438584895581911 -34.592686025034084,-58.437460029734446 -34.592045631391947,-58.436342248146296 -34.59140917266685,-58.435310818557852 -34.590821879938801,-58.434363212859914 -34.591448660343744)));;1570;15_13_1;COMUNA 15;13;1;849;423;426;99,30%;390;390;100,00%;0;0,00%;304;10;3,29%;294;96,71%
MULTIPOLYGON (((-58.442713695400627 -34.595036652239592,-58.441879810469075 -34.594561987182658,-58.441224559247296 -34.595259506579126,-58.441047199868557 -34.595448707985582,-58.441151423148817 -34.595514574077001,-58.442428352977679 -34.596276301453663,-58.442590402798821 -34.596351753737764,-58.44353814575453 -34.595471660645607,-58.443365107957888 -34.59540796889187,-58.442832651052996 -34.595109561840808,-58.442713695400627 -34.595036652239592)));;1571;15_13_10;COMUNA 15;13;10;652;291;361;80,61%;370;370;100,00%;0;0,00%;297;0;0,00%;297;100,00%
MULTIPOLYGON (((-58.435959590251109 -34.59364847372472,-58.434880561951879 -34.592967078911499,-58.433794569683961 -34.59228116561583,-58.433653064214731 -34.592191762282454,-58.433445575289454 -34.59205839758171,-58.432358668529012 -34.592781681922091,-58.432573052710147 -34.592922937792693,-58.432963342195514 -34.59317212785227,-58.434041929153331 -34.593860863719463,-58.435117724129718 -34.594547828716898,-58.436194303157222 -34.595235206879458,-58.437041531113458 -34.594331761020634,-58.435959590251109 -34.59364847372472)));;1572;15_13_2;COMUNA 15;13;2;742;330;412;80,10%;348;347;99,71%;1;0,29%;257;19;7,39%;238;92,61%
MULTIPOLYGON (((-58.438125703503374 -34.595016518032011,-58.437041531113458 -34.594331761020634,-58.436194303157222 -34.595235206879458,-58.436480139390497 -34.595417740549351,-58.437273709480628 -34.595925393071241,-58.438351345426987 -34.596614794609913,-58.438733596924891 -34.596207671343009,-58.439208616488045 -34.595700349567046,-58.438125703503374 -34.595016518032011)));;1573;15_13_3;COMUNA 15;13;3;634;292;342;85,38%;364;364;100,00%;0;0,00%;298;14;4,70%;284;95,30%
MULTIPOLYGON (((-58.439709863818507 -34.593326549114046,-58.438584895581911 -34.592686025034084,-58.437810537515048 -34.593511747203792,-58.437041531113458 -34.594331761020634,-58.438125703503374 -34.595016518032011,-58.438916087903728 -34.594173402143923,-58.440019782565571 -34.594833849425378,-58.440832465156653 -34.593965653829507,-58.439709863818507 -34.593326549114046)));;1574;15_13_4;COMUNA 15;13;4;686;293;393;74,55%;344;343;99,71%;1;0,29%;262;3;1,15%;259;98,85%
MULTIPOLYGON (((-58.441879810469075 -34.594561987182658,-58.440832465156653 -34.593965653829507,-58.440019782565571 -34.594833849425378,-58.441047199868557 -34.595448707985582,-58.441224559247296 -34.595259506579126,-58.441879810469075 -34.594561987182658)));;1575;15_13_5;COMUNA 15;13;5;426;188;238;78,99%;243;243;100,00%;0;0,00%;212;2;0,94%;210;99,06%
MULTIPOLYGON (((-58.441047199868557 -34.595448707985582,-58.440019782565571 -34.594833849425378,-58.438916087903728 -34.594173402143923,-58.438125703503374 -34.595016518032011,-58.439208616488045 -34.595700349567046,-58.440215508191201 -34.59633612739718,-58.441047199868557 -34.595448707985582)));;1576;15_13_6;COMUNA 15;13;6;498;217;281;77,22%;291;290;99,66%;1;0,34%;238;7;2,94%;231;97,06%
MULTIPOLYGON (((-58.440215508191201 -34.59633612739718,-58.439208616488045 -34.595700349567046,-58.438733596924891 -34.596207671343009,-58.438351345426987 -34.596614794609913,-58.439353470880349 -34.597255860402399,-58.440215508191201 -34.59633612739718)));;1577;15_13_7;COMUNA 15;13;7;686;317;369;85,91%;340;340;100,00%;0;0,00%;292;2;0,68%;290;99,32%
MULTIPOLYGON (((-58.441652180761196 -34.597222403995382,-58.441498218893585 -34.597154487385048,-58.440215508191201 -34.59633612739718,-58.439353470880349 -34.597255860402399,-58.440692812729786 -34.598112621320503,-58.441652180761196 -34.597222403995382)));;1578;15_13_8;COMUNA 15;13;8;439;186;253;73,52%;247;247;100,00%;0;0,00%;194;0;0,00%;194;100,00%
MULTIPOLYGON (((-58.441047199868557 -34.595448707985582,-58.440215508191201 -34.59633612739718,-58.441498218893585 -34.597154487385048,-58.441652180761196 -34.597222403995382,-58.442590402798821 -34.596351753737764,-58.442428352977679 -34.596276301453663,-58.441151423148817 -34.595514574077001,-58.441047199868557 -34.595448707985582)));;1579;15_13_9;COMUNA 15;13;9;1052;487;565;86,19%;568;568;100,00%;0;0,00%;462;42;9,09%;420;90,91%
MULTIPOLYGON (((-58.446633342706455 -34.596309886578361,-58.445554547277823 -34.595561330303525,-58.444345236286978 -34.594722107486859,-58.444300175878503 -34.594764003751621,-58.44353814575453 -34.595471660645607,-58.444647547082383 -34.596377569355482,-58.445650277891858 -34.597196477786952,-58.446066555281917 -34.596825323645369,-58.446633342706455 -34.596309886578361)));;1580;15_14_1;COMUNA 15;14;1;848;412;436;94,50%;414;414;100,00%;0;0,00%;364;12;3,30%;352;96,70%
MULTIPOLYGON (((-58.444748421995229 -34.599754123180098,-58.443792896210681 -34.600619011992912,-58.444711195303135 -34.601372489438631,-58.444871751450449 -34.601319623663535,-58.44495828985508 -34.601291114063002,-58.445333998700299 -34.601167431000334,-58.446149804960356 -34.600899998957857,-58.446309507499194 -34.600847624147328,-58.447593593735277 -34.600426858291137,-58.446712916330036 -34.599709465075236,-58.445800066184056 -34.598965721927172,-58.445706738986765 -34.598886762263909,-58.444748421995229 -34.599754123180098)));;1581;15_14_10;COMUNA 15;14;10;684;314;370;84,86%;346;345;99,71%;1;0,29%;272;12;4,41%;260;95,59%
MULTIPOLYGON (((-58.448189213591277 -34.600225514414646,-58.447970998380065 -34.60030189964607,-58.447915039148583 -34.600321471092833,-58.447593593735277 -34.600426858291137,-58.446309507499194 -34.600847624147328,-58.446149804960356 -34.600899998957857,-58.445333998700299 -34.601167431000334,-58.44495828985508 -34.601291114063002,-58.444871751450449 -34.601319623663535,-58.444721477690443 -34.601479889411685,-58.445697651991956 -34.602103151631113,-58.446675458941186 -34.602727392146761,-58.44765498375574 -34.603352751779767,-58.448538971346537 -34.60240535691117,-58.448629354078179 -34.602307053777068,-58.448743844252448 -34.602182484730953,-58.449596545551913 -34.60126247384391,-58.449664266682049 -34.601190013545136,-58.45025100769903 -34.600563219889011,-58.450355100671025 -34.60045083179844,-58.451241838671471 -34.599494050611284,-58.450938755815564 -34.599286760286695,-58.449617223305104 -34.599750728090449,-58.449396370992574 -34.599823594332555,-58.44932738117452 -34.599846404568147,-58.449024336601028 -34.599946374816234,-58.44836603406484 -34.600163561109142,-58.448189213591277 -34.600225514414646)));;1582;15_14_11;COMUNA 15;14;11;1025;486;539;90,17%;383;383;100,00%;0;0,00%;376;26;6,91%;350;93,09%
MULTIPOLYGON (((-58.44353814575453 -34.595471660645607,-58.442590402798821 -34.596351753737764,-58.443685075095665 -34.597243654011145,-58.444647547082383 -34.596377569355482,-58.44353814575453 -34.595471660645607)));;1583;15_14_2;COMUNA 15;14;2;899;415;484;85,74%;473;473;100,00%;0;0,00%;386;2;0,52%;384;99,48%
MULTIPOLYGON (((-58.442590402798821 -34.596351753737764,-58.441652180761196 -34.597222403995382,-58.442729568285699 -34.598103393815933,-58.443685075095665 -34.597243654011145,-58.442590402798821 -34.596351753737764)));;1584;15_14_3;COMUNA 15;14;3;722;324;398;81,41%;376;375;99,73%;1;0,27%;302;7;2,32%;295;97,68%
MULTIPOLYGON (((-58.442729568285699 -34.598103393815933,-58.441652180761196 -34.597222403995382,-58.440692812729786 -34.598112621320503,-58.441666239331155 -34.598886766508485,-58.441769952326823 -34.598968829754064,-58.442620446560674 -34.598201619140028,-58.442729568285699 -34.598103393815933)));;1585;15_14_4;COMUNA 15;14;4;714;326;388;84,02%;379;379;100,00%;0;0,00%;308;33;10,71%;275;89,29%
MULTIPOLYGON (((-58.442729568285699 -34.598103393815933,-58.442620446560674 -34.598201619140028,-58.441769952326823 -34.598968829754064,-58.441883798433118 -34.599058923117376,-58.442782223623311 -34.599792833658981,-58.443737750462958 -34.598927741367845,-58.444692320491221 -34.598063416004734,-58.444583922780559 -34.597975931790238,-58.443685075095665 -34.597243654011145,-58.442729568285699 -34.598103393815933)));;1586;15_14_5;COMUNA 15;14;5;952;422;530;79,62%;506;506;100,00%;0;0,00%;421;2;0,48%;419;99,52%
MULTIPOLYGON (((-58.444748421995229 -34.599754123180098,-58.443737750462958 -34.598927741367845,-58.442782223623311 -34.599792833658981,-58.443658865452925 -34.600508986945322,-58.443792896210681 -34.600619011992912,-58.444748421995229 -34.599754123180098)));;1587;15_14_6;COMUNA 15;14;6;522;223;299;74,58%;342;342;100,00%;0;0,00%;286;9;3,15%;277;96,85%
MULTIPOLYGON (((-58.445706738986765 -34.598886762263909,-58.445592549674835 -34.598790052442602,-58.444692320491221 -34.598063416004734,-58.443737750462958 -34.598927741367845,-58.444748421995229 -34.599754123180098,-58.445706738986765 -34.598886762263909)));;1588;15_14_7;COMUNA 15;14;7;883;406;477;85,12%;486;486;100,00%;0;0,00%;392;2;0,51%;390;99,49%
MULTIPOLYGON (((-58.446633342706455 -34.596309886578361,-58.446066555281917 -34.596825323645369,-58.445650277891858 -34.597196477786952,-58.444647547082383 -34.596377569355482,-58.443685075095665 -34.597243654011145,-58.444583922780559 -34.597975931790238,-58.444692320491221 -34.598063416004734,-58.445592549674835 -34.598790052442602,-58.445706738986765 -34.598886762263909,-58.445800066184056 -34.598965721927172,-58.446712916330036 -34.599709465075236,-58.447670785846796 -34.598846032480076,-58.447538626033754 -34.598738547201073,-58.446661628821197 -34.59802242153075,-58.447212917587578 -34.59752289594514,-58.447720332346471 -34.597064068254632,-58.446633342706455 -34.596309886578361)));;1589;15_14_8;COMUNA 15;14;8;841;387;454;85,24%;391;391;100,00%;0;0,00%;326;37;11,35%;289;88,65%
MULTIPOLYGON (((-58.447670785846796 -34.598846032480076,-58.446712916330036 -34.599709465075236,-58.447593593735277 -34.600426858291137,-58.447915039148583 -34.600321471092833,-58.447970998380065 -34.60030189964607,-58.448189213591277 -34.600225514414646,-58.44836603406484 -34.600163561109142,-58.449024336601028 -34.599946374816234,-58.44932738117452 -34.599846404568147,-58.449396370992574 -34.599823594332555,-58.449617223305104 -34.599750728090449,-58.450938755815564 -34.599286760286695,-58.450041353246235 -34.598673055313341,-58.449894285605772 -34.598571134629744,-58.448809726110433 -34.597819296810208,-58.447858538539435 -34.597160004357676,-58.447720332346471 -34.597064068254632,-58.447212917587578 -34.59752289594514,-58.446661628821197 -34.59802242153075,-58.447538626033754 -34.598738547201073,-58.447670785846796 -34.598846032480076)));;1590;15_14_9;COMUNA 15;14;9;862;425;437;97,25%;380;380;100,00%;0;0,00%;347;26;7,49%;321;92,51%
MULTIPOLYGON (((-58.445820789924866 -34.593353463879708,-58.445077865958581 -34.594041977515268,-58.444986469894687 -34.59412217870296,-58.444440892750862 -34.594637400206082,-58.444345236286978 -34.594722107486859,-58.445554547277823 -34.595561330303525,-58.446267409025147 -34.594919853990774,-58.447019015286223 -34.594243447479982,-58.445820789924866 -34.593353463879708)));;1591;15_15_1;COMUNA 15;15;1;696;326;370;88,11%;363;363;100,00%;0;0,00%;293;22;7,51%;271;92,49%
MULTIPOLYGON (((-58.457069962489641 -34.601892860253351,-58.456824242741604 -34.601945104176671,-58.456414710605998 -34.602389607698051,-58.456019654457826 -34.602818476210579,-58.457422448575713 -34.603767665337443,-58.458197656981923 -34.604292152788744,-58.458473946988917 -34.604491818070478,-58.458934822710226 -34.604373659703114,-58.458277569362906 -34.603906929930922,-58.458162931719208 -34.603829105885929,-58.457918021808595 -34.603038644132852,-58.457532528021062 -34.601794426269926,-58.457251355569014 -34.600886985075967,-58.457213293070431 -34.600763387098496,-58.456985090764036 -34.600022080640784,-58.45685051455343 -34.600168840452547,-58.456246959979929 -34.600827004225302,-58.456139126673214 -34.600943904349101,-58.456946575497298 -34.601535446527194,-58.457069962489641 -34.601892860253351)));;1592;15_15_10;COMUNA 15;15;10;934;416;518;80,31%;473;473;100,00%;0;0,00%;413;20;4,84%;393;95,16%
MULTIPOLYGON (((-58.446267409025147 -34.594919853990774,-58.445554547277823 -34.595561330303525,-58.446633342706455 -34.596309886578361,-58.447316305346369 -34.595693894229562,-58.448070295281127 -34.595013889939978,-58.449128492146173 -34.595789394638366,-58.450061189734797 -34.596472901720631,-58.450194287416622 -34.596571088267318,-58.450984461117848 -34.595858674140317,-58.451553936564629 -34.595345256723519,-58.451704523576026 -34.595209490426136,-58.451330862289751 -34.594947614949014,-58.450761689016446 -34.594548812568057,-58.4507466451822 -34.594538559506482,-58.450596070073033 -34.594402498677518,-58.450548292267754 -34.594359326152357,-58.450476913447851 -34.594339651294433,-58.450432280388355 -34.594324105221396,-58.450311888859588 -34.594280867999871,-58.450173291903674 -34.594231315019051,-58.450063472446864 -34.594186135937278,-58.449921940605797 -34.594127840219258,-58.449785108005855 -34.594065659435252,-58.449647688760855 -34.594000564385368,-58.44952260243064 -34.593939841586121,-58.449399278116829 -34.593879604524972,-58.449275366755728 -34.593818881599191,-58.449136186800423 -34.593751357402745,-58.449002879697218 -34.59368626208051,-58.448870159943134 -34.593622138028302,-58.44874096404051 -34.593558985584011,-58.448612355634673 -34.593495833070129,-58.448472002318894 -34.593427336627485,-58.448333410883457 -34.593360297254776,-58.448195407139345 -34.593292286444047,-58.448050943668846 -34.593222332001602,-58.447913527251714 -34.593156749315675,-58.447774349329208 -34.59309019490906,-58.447639869485997 -34.593026554972447,-58.447494232258016 -34.592957085398112,-58.447347420678646 -34.592887615501482,-58.447200609433956 -34.59281765975259,-58.447054385640342 -34.592748189576568,-58.446905225980551 -34.592676776144799,-58.446749606795798 -34.592602933311042,-58.446671450274941 -34.592565259380279,-58.446584058679093 -34.592646215195082,-58.445963632289889 -34.59322115439187,-58.445820789924866 -34.593353463879708,-58.447019015286223 -34.594243447479982,-58.446267409025147 -34.594919853990774)));;1593;15_15_2;COMUNA 15;15;2;759;353;406;86,95%;257;257;100,00%;0;0,00%;235;13;5,53%;222;94,47%
MULTIPOLYGON (((-58.447316305346369 -34.595693894229562,-58.446633342706455 -34.596309886578361,-58.447720332346471 -34.597064068254632,-58.448373055370375 -34.596473208175063,-58.448223610404966 -34.596363397531725,-58.447316305346369 -34.595693894229562)));;1594;15_15_3;COMUNA 15;15;3;1044;461;583;79,07%;434;434;100,00%;0;0,00%;401;0;0,00%;401;100,00%
MULTIPOLYGON (((-58.449128492146173 -34.595789394638366,-58.448070295281127 -34.595013889939978,-58.447316305346369 -34.595693894229562,-58.448223610404966 -34.596363397531725,-58.448373055370375 -34.596473208175063,-58.447720332346471 -34.597064068254632,-58.447858538539435 -34.597160004357676,-58.448809726110433 -34.597819296810208,-58.449894285605772 -34.598571134629744,-58.45002929328443 -34.598450862392198,-58.450494875662592 -34.598032513405592,-58.451252523074373 -34.597351644976385,-58.450194287416622 -34.596571088267318,-58.450061189734797 -34.596472901720631,-58.449128492146173 -34.595789394638366)));;1595;15_15_4;COMUNA 15;15;4;988;494;494;100,00%;379;379;100,00%;0;0,00%;352;31;8,81%;321;91,19%
MULTIPOLYGON (((-58.450494875662592 -34.598032513405592,-58.45002929328443 -34.598450862392198,-58.449894285605772 -34.598571134629744,-58.450041353246235 -34.598673055313341,-58.450938755815564 -34.599286760286695,-58.451818999153105 -34.599005563524898,-58.452701280642358 -34.5987237267395,-58.452988389198481 -34.598632056251127,-58.453687633458991 -34.598408650572331,-58.45421806862992 -34.598239175007244,-58.455484103399634 -34.597834733757843,-58.454794814882561 -34.597352700547866,-58.453816335219884 -34.596668451737791,-58.453767454242303 -34.596634221486163,-58.45365521548721 -34.59655568903711,-58.452820071765622 -34.595988630360445,-58.452607263942163 -34.595844100265175,-58.452083722289927 -34.595475731597787,-58.451886501224912 -34.595336976462384,-58.451704523576026 -34.595209490426136,-58.451553936564629 -34.595345256723519,-58.450984461117848 -34.595858674140317,-58.450194287416622 -34.596571088267318,-58.451252523074373 -34.597351644976385,-58.450494875662592 -34.598032513405592)));;1596;15_15_5;COMUNA 15;15;5;849;413;436;94,72%;360;360;100,00%;0;0,00%;297;21;7,07%;276;92,93%
MULTIPOLYGON (((-58.453687633458991 -34.598408650572331,-58.452988389198481 -34.598632056251127,-58.452701280642358 -34.5987237267395,-58.451818999153105 -34.599005563524898,-58.450938755815564 -34.599286760286695,-58.451241838671471 -34.599494050611284,-58.452093527460363 -34.600076403480756,-58.452052300357437 -34.600120415661614,-58.452679173710344 -34.600547316081283,-58.453087441093544 -34.600825387724996,-58.454038883289691 -34.601473300587898,-58.454495016284341 -34.6009771864275,-58.454880616922509 -34.600557759096766,-58.455175074521598 -34.600237554085602,-58.455885783829871 -34.599464467588732,-58.456582085601831 -34.598707080962981,-58.456564970687978 -34.598657500727043,-58.456236394266476 -34.597590048139395,-58.456057626312358 -34.597651519793978,-58.455920505679281 -34.597695316766163,-58.455484103399634 -34.597834733757843,-58.45421806862992 -34.598239175007244,-58.453687633458991 -34.598408650572331)));;1597;15_15_6;COMUNA 15;15;6;881;415;466;89,06%;329;329;100,00%;0;0,00%;311;25;8,04%;286;91,96%
MULTIPOLYGON (((-58.456582085601831 -34.598707080962981,-58.455885783829871 -34.599464467588732,-58.455175074521598 -34.600237554085602,-58.454880616922509 -34.600557759096766,-58.454495016284341 -34.6009771864275,-58.454038883289691 -34.601473300587898,-58.454992043562669 -34.602122403301415,-58.455171316335722 -34.602244531809212,-58.455952628423944 -34.602773118691609,-58.456019654457826 -34.602818476210579,-58.456414710605998 -34.602389607698051,-58.456824242741604 -34.601945104176671,-58.457069962489641 -34.601892860253351,-58.456946575497298 -34.601535446527194,-58.456139126673214 -34.600943904349101,-58.456246959979929 -34.600827004225302,-58.45685051455343 -34.600168840452547,-58.456985090764036 -34.600022080640784,-58.456899261305765 -34.599731642912936,-58.456582085601831 -34.598707080962981)));;1598;15_15_7;COMUNA 15;15;7;858;405;453;89,40%;434;434;100,00%;0;0,00%;361;61;16,90%;300;83,10%
MULTIPOLYGON (((-58.454992043562669 -34.602122403301415,-58.454038883289691 -34.601473300587898,-58.453087441093544 -34.600825387724996,-58.452679173710344 -34.600547316081283,-58.452052300357437 -34.600120415661614,-58.452093527460363 -34.600076403480756,-58.451241838671471 -34.599494050611284,-58.450355100671025 -34.60045083179844,-58.451222551405046 -34.601018332527616,-58.451863140602683 -34.601437421167056,-58.452277457572421 -34.601708453495988,-58.45324857941052 -34.602343697569623,-58.45404189038458 -34.602862649353625,-58.454212136306694 -34.602973862708843,-58.454992043562669 -34.602122403301415)));;1599;15_15_8;COMUNA 15;15;8;666;340;326;104,29%;340;340;100,00%;0;0,00%;260;5;1,92%;255;98,08%
MULTIPOLYGON (((-58.458473946988917 -34.604491818070478,-58.458197656981923 -34.604292152788744,-58.457422448575713 -34.603767665337443,-58.456019654457826 -34.602818476210579,-58.455952628423944 -34.602773118691609,-58.455171316335722 -34.602244531809212,-58.454992043562669 -34.602122403301415,-58.454212136306694 -34.602973862708843,-58.455055878039232 -34.603525136509816,-58.455182776677823 -34.603607964422416,-58.456804205818223 -34.60466541731374,-58.456563312843784 -34.604986262555556,-58.458080102055661 -34.604592793506569,-58.458473946988917 -34.604491818070478)));;1600;15_15_9;COMUNA 15;15;9;1037;482;555;86,85%;531;531;100,00%;0;0,00%;430;4;0,93%;426;99,07%
MULTIPOLYGON (((-58.455182776677823 -34.603607964422416,-58.455055878039232 -34.603525136509816,-58.454212136306694 -34.602973862708843,-58.453639376448088 -34.603599197275805,-58.45353775416924 -34.60370968681552,-58.454507291067173 -34.604340342909332,-58.455803379713785 -34.605183412463504,-58.456563312843784 -34.604986262555556,-58.456804205818223 -34.60466541731374,-58.455182776677823 -34.603607964422416)));;1601;15_16_1;COMUNA 15;16;1;863;404;459;88,02%;382;382;100,00%;0;0,00%;355;28;7,89%;327;92,11%
MULTIPOLYGON (((-58.448224215685492 -34.606128065717684,-58.447551203670599 -34.606861321203937,-58.446772290397696 -34.606338174355564,-58.446563724914235 -34.606196099398119,-58.446026558020137 -34.606901475993091,-58.445878739846215 -34.607094772750791,-58.445677757181507 -34.607357430690371,-58.445864445442062 -34.607442037197558,-58.446247447131995 -34.607615617009024,-58.446627265396941 -34.607521016236795,-58.44704004740607 -34.607418178773464,-58.44906160831394 -34.606914599953079,-58.449061988758643 -34.606914181999706,-58.449290078128513 -34.60685772359399,-58.449289972558667 -34.606857651315075,-58.450236986600054 -34.606621757022303,-58.450655978031683 -34.606515104984872,-58.450738771085163 -34.606494056006589,-58.451049926099159 -34.606414857807671,-58.451507586089662 -34.606298417430423,-58.452015073824754 -34.606167260848622,-58.451679006049339 -34.605931799627342,-58.451563008588465 -34.605856997566903,-58.451410389648714 -34.605758458730463,-58.450593900932574 -34.605235050999184,-58.449618079636821 -34.604609433843258,-58.44892609496754 -34.605363400064412,-58.448224215685492 -34.606128065717684)));;1602;15_16_10;COMUNA 15;16;10;805;385;420;91,67%;435;435;100,00%;0;0,00%;337;28;8,31%;309;91,69%
MULTIPOLYGON (((-58.446563724914235 -34.606196099398119,-58.445585205460233 -34.605529462283684,-58.444875302458222 -34.606225231712394,-58.444757226813948 -34.606334936808047,-58.444645795839371 -34.60643844535673,-58.444167261047618 -34.606922898691295,-58.445131478052822 -34.607175092963423,-58.445263491037579 -34.607219127620496,-58.445677757181507 -34.607357430690371,-58.445878739846215 -34.607094772750791,-58.446026558020137 -34.606901475993091,-58.446563724914235 -34.606196099398119)));;1603;15_16_11;COMUNA 15;16;11;763;335;428;78,27%;359;359;100,00%;0;0,00%;307;5;1,63%;302;98,37%
MULTIPOLYGON (((-58.451222551405046 -34.601018332527616,-58.450355100671025 -34.60045083179844,-58.45025100769903 -34.600563219889011,-58.449664266682049 -34.601190013545136,-58.450540322227951 -34.601759914432108,-58.451599320482259 -34.602448844358889,-58.452568231922527 -34.603079093380146,-58.45353775416924 -34.60370968681552,-58.453639376448088 -34.603599197275805,-58.454212136306694 -34.602973862708843,-58.45404189038458 -34.602862649353625,-58.45324857941052 -34.602343697569623,-58.452277457572421 -34.601708453495988,-58.451863140602683 -34.601437421167056,-58.451222551405046 -34.601018332527616)));;1604;15_16_2;COMUNA 15;16;2;848;406;442;91,86%;353;353;100,00%;0;0,00%;327;19;5,81%;308;94,19%
MULTIPOLYGON (((-58.448629354078179 -34.602307053777068,-58.448538971346537 -34.60240535691117,-58.44765498375574 -34.603352751779767,-58.448173706944907 -34.603683883475945,-58.448303580001685 -34.603766789319465,-58.448549274870828 -34.603924288787333,-58.449520064974841 -34.602869075951801,-58.449726073922221 -34.602999032526675,-58.45059780902821 -34.60354195952516,-58.450704434692895 -34.60360838101213,-58.451584188451157 -34.604153555304713,-58.452568231922527 -34.603079093380146,-58.451599320482259 -34.602448844358889,-58.450540322227951 -34.601759914432108,-58.449664266682049 -34.601190013545136,-58.449596545551913 -34.60126247384391,-58.448743844252448 -34.602182484730953,-58.448629354078179 -34.602307053777068)));;1605;15_16_3;COMUNA 15;16;3;1065;483;582;82,99%;454;454;100,00%;0;0,00%;388;28;7,22%;360;92,78%
MULTIPOLYGON (((-58.45353775416924 -34.60370968681552,-58.452568231922527 -34.603079093380146,-58.451584188451157 -34.604153555304713,-58.452568538371047 -34.604763593527935,-58.453551880680948 -34.605372919422933,-58.45440388023723 -34.604452523241285,-58.454507291067173 -34.604340342909332,-58.45353775416924 -34.60370968681552)));;1606;15_16_4;COMUNA 15;16;4;745;336;409;82,15%;362;362;100,00%;0;0,00%;293;5;1,71%;288;98,29%
MULTIPOLYGON (((-58.455803379713785 -34.605183412463504,-58.454507291067173 -34.604340342909332,-58.45440388023723 -34.604452523241285,-58.453551880680948 -34.605372919422933,-58.454001824616746 -34.605651765583758,-58.454982371897444 -34.605396751573814,-58.455524600386426 -34.605255723042504,-58.455803379713785 -34.605183412463504)));;1607;15_16_5;COMUNA 15;16;5;642;279;363;76,86%;336;336;100,00%;0;0,00%;276;4;1,45%;272;98,55%
MULTIPOLYGON (((-58.452568538371047 -34.604763593527935,-58.451584188451157 -34.604153555304713,-58.451501558985825 -34.604243832838542,-58.450593900932574 -34.605235050999184,-58.451410389648714 -34.605758458730463,-58.451563008588465 -34.605856997566903,-58.451679006049339 -34.605931799627342,-58.452015073824754 -34.606167260848622,-58.452428268854995 -34.606060461358609,-58.452958836663989 -34.605923105372128,-58.453069225918895 -34.605894310242007,-58.454001824616746 -34.605651765583758,-58.453551880680948 -34.605372919422933,-58.452568538371047 -34.604763593527935)));;1608;15_16_6;COMUNA 15;16;6;794;353;441;80,05%;380;379;99,74%;1;0,26%;308;7;2,27%;301;97,73%
MULTIPOLYGON (((-58.45059780902821 -34.60354195952516,-58.449726073922221 -34.602999032526675,-58.449520064974841 -34.602869075951801,-58.448549274870828 -34.603924288787333,-58.449618079636821 -34.604609433843258,-58.450593900932574 -34.605235050999184,-58.451501558985825 -34.604243832838542,-58.451584188451157 -34.604153555304713,-58.450704434692895 -34.60360838101213,-58.45059780902821 -34.60354195952516)));;1609;15_16_7;COMUNA 15;16;7;848;398;450;88,44%;369;369;100,00%;0;0,00%;316;19;6,01%;297;93,99%
MULTIPOLYGON (((-58.448549274870828 -34.603924288787333,-58.448303580001685 -34.603766789319465,-58.448173706944907 -34.603683883475945,-58.44765498375574 -34.603352751779767,-58.44693684087337 -34.604122338037108,-58.446983765407765 -34.604151570542911,-58.446303616238261 -34.604821999207161,-58.445717762538123 -34.605399546363927,-58.445585205460233 -34.605529462283684,-58.446563724914235 -34.606196099398119,-58.447166823439076 -34.605404105805135,-58.44747471533428 -34.604999833684872,-58.447552411824205 -34.6048987128001,-58.447774589139897 -34.604644998257342,-58.447845530391227 -34.604689233928298,-58.44892609496754 -34.605363400064412,-58.449618079636821 -34.604609433843258,-58.448549274870828 -34.603924288787333)));;1610;15_16_8;COMUNA 15;16;8;839;384;455;84,40%;457;456;99,78%;1;0,22%;354;10;2,82%;344;97,18%
MULTIPOLYGON (((-58.447845530391227 -34.604689233928298,-58.447774589139897 -34.604644998257342,-58.447552411824205 -34.6048987128001,-58.44747471533428 -34.604999833684872,-58.447166823439076 -34.605404105805135,-58.446563724914235 -34.606196099398119,-58.446772290397696 -34.606338174355564,-58.447551203670599 -34.606861321203937,-58.448224215685492 -34.606128065717684,-58.44892609496754 -34.605363400064412,-58.447845530391227 -34.604689233928298)));;1611;15_16_9;COMUNA 15;16;9;735;323;412;78,40%;395;394;99,75%;1;0,25%;306;0;0,00%;306;100,00%
MULTIPOLYGON (((-58.443792896210681 -34.600619011992912,-58.443658865452925 -34.600508986945322,-58.442782223623311 -34.599792833658981,-58.441823269434558 -34.600661016464898,-58.442833006032657 -34.601487765873486,-58.443792896210681 -34.600619011992912)));;1612;15_17_1;COMUNA 15;17;1;732;330;402;82,09%;365;365;100,00%;0;0,00%;323;6;1,86%;317;98,14%
MULTIPOLYGON (((-58.441048591037131 -34.60518443292726,-58.440889428686326 -34.605080949998381,-58.440033245923608 -34.604524223763107,-58.439285379801042 -34.605605813230582,-58.440141570568926 -34.605840560765486,-58.440335072220684 -34.605893626537863,-58.441465256261914 -34.606203487913398,-58.441599737974499 -34.606239075951137,-58.44282404436408 -34.606571477016217,-58.442980075282399 -34.606612348925985,-58.443852979596357 -34.605723017074332,-58.443729666320905 -34.605640107540466,-58.443334180719567 -34.605370317006162,-58.442823561836263 -34.6050219824062,-58.442024522868643 -34.60581913299108,-58.441048591037131 -34.60518443292726)));;1613;15_17_10;COMUNA 15;17;10;912;382;530;72,08%;424;423;99,76%;1;0,24%;342;7;2,05%;335;97,95%
MULTIPOLYGON (((-58.439430956306992 -34.603445672556276,-58.439390221272753 -34.603502643135592,-58.439021407985017 -34.603867387171285,-58.43916711123606 -34.603961080860365,-58.440033245923608 -34.604524223763107,-58.440889428686326 -34.605080949998381,-58.441048591037131 -34.60518443292726,-58.441870294086307 -34.604367714321263,-58.440826519854895 -34.603650603259311,-58.440698614890913 -34.60356191494602,-58.440149359030634 -34.603180884791414,-58.44008794349066 -34.603206226496312,-58.439430956306992 -34.603445672556276)));;1614;15_17_11;COMUNA 15;17;11;822;384;438;87,67%;418;418;100,00%;0;0,00%;356;14;3,93%;342;96,07%
MULTIPOLYGON (((-58.439021407985017 -34.603867387171285,-58.438848710470388 -34.603756293011131,-58.437659878619804 -34.604322062056497,-58.437174579122861 -34.604553026519788,-58.437974998936333 -34.604959685472195,-58.438516280984409 -34.605234663414016,-58.439201660228242 -34.605582838530729,-58.439285379801042 -34.605605813230582,-58.440033245923608 -34.604524223763107,-58.43916711123606 -34.603961080860365,-58.439021407985017 -34.603867387171285)));;1615;15_17_12;COMUNA 15;17;12;730;332;398;83,42%;352;352;100,00%;0;0,00%;302;1;0,33%;301;99,67%
MULTIPOLYGON (((-58.442046275180203 -34.601902158056397,-58.442160724691107 -34.601980419785463,-58.44226163341353 -34.602054242350597,-58.442488146461379 -34.602219990599778,-58.443023581499574 -34.601995351272556,-58.443301861670633 -34.601871729157594,-58.443472560711392 -34.601793725039052,-58.444453879143204 -34.601457313620344,-58.444711195303135 -34.601372489438631,-58.443792896210681 -34.600619011992912,-58.442833006032657 -34.601487765873486,-58.441823269434558 -34.600661016464898,-58.441089118286456 -34.60129837776536,-58.441827936092764 -34.601752819451939,-58.442046275180203 -34.601902158056397)));;1616;15_17_2;COMUNA 15;17;2;584;249;335;74,33%;316;316;100,00%;0;0,00%;271;2;0,74%;269;99,26%
MULTIPOLYGON (((-58.443301861670633 -34.601871729157594,-58.443023581499574 -34.601995351272556,-58.442488146461379 -34.602219990599778,-58.443397196256392 -34.602850091253416,-58.444243756281132 -34.603423131227878,-58.444351908168223 -34.60349709399329,-58.444960845760669 -34.602889485011097,-58.445697651991956 -34.602103151631113,-58.444721477690443 -34.601479889411685,-58.444871751450449 -34.601319623663535,-58.444711195303135 -34.601372489438631,-58.444453879143204 -34.601457313620344,-58.443472560711392 -34.601793725039052,-58.443301861670633 -34.601871729157594)));;1617;15_17_3;COMUNA 15;17;3;854;381;473;80,55%;439;439;100,00%;0;0,00%;368;6;1,63%;362;98,37%
MULTIPOLYGON (((-58.444960845760669 -34.602889485011097,-58.444351908168223 -34.60349709399329,-58.445320514678627 -34.604160077694139,-58.445947005061235 -34.603504718073509,-58.44693684087337 -34.604122338037108,-58.44765498375574 -34.603352751779767,-58.446675458941186 -34.602727392146761,-58.445697651991956 -34.602103151631113,-58.444960845760669 -34.602889485011097)));;1618;15_17_4;COMUNA 15;17;4;1006;455;551;82,58%;443;443;100,00%;0;0,00%;409;46;11,25%;363;88,75%
MULTIPOLYGON (((-58.444660438028706 -34.604899516728047,-58.444554969932369 -34.605007885437082,-58.443852979596357 -34.605723017074332,-58.442980075282399 -34.606612348925985,-58.444167261047618 -34.606922898691295,-58.444645795839371 -34.60643844535673,-58.444757226813948 -34.606334936808047,-58.444875302458222 -34.606225231712394,-58.445585205460233 -34.605529462283684,-58.445717762538123 -34.605399546363927,-58.446303616238261 -34.604821999207161,-58.446983765407765 -34.604151570542911,-58.44693684087337 -34.604122338037108,-58.445947005061235 -34.603504718073509,-58.445320514678627 -34.604160077694139,-58.444660438028706 -34.604899516728047)));;1619;15_17_5;COMUNA 15;17;5;879;406;473;85,84%;436;436;100,00%;0;0,00%;349;17;4,87%;332;95,13%
MULTIPOLYGON (((-58.443334180719567 -34.605370317006162,-58.443729666320905 -34.605640107540466,-58.443852979596357 -34.605723017074332,-58.444554969932369 -34.605007885437082,-58.444660438028706 -34.604899516728047,-58.445320514678627 -34.604160077694139,-58.444351908168223 -34.60349709399329,-58.443642179699914 -34.604205251339565,-58.442823561836263 -34.6050219824062,-58.443334180719567 -34.605370317006162)));;1620;15_17_6;COMUNA 15;17;6;711;295;416;70,91%;356;356;100,00%;0;0,00%;308;15;4,87%;293;95,13%
MULTIPOLYGON (((-58.444351908168223 -34.60349709399329,-58.444243756281132 -34.603423131227878,-58.443397196256392 -34.602850091253416,-58.442488146461379 -34.602219990599778,-58.44225322238772 -34.602316715695231,-58.44219896341049 -34.602338186279148,-58.441481070400336 -34.602631595805711,-58.441397082983187 -34.602666230371483,-58.442690277184198 -34.603552750416846,-58.443642179699914 -34.604205251339565,-58.444351908168223 -34.60349709399329)));;1621;15_17_7;COMUNA 15;17;7;738;323;415;77,83%;411;411;100,00%;0;0,00%;333;18;5,41%;315;94,59%
MULTIPOLYGON (((-58.441397082983187 -34.602666230371483,-58.441286178593536 -34.602711987340371,-58.440149359030634 -34.603180884791414,-58.440698614890913 -34.60356191494602,-58.440826519854895 -34.603650603259311,-58.441870294086307 -34.604367714321263,-58.442690277184198 -34.603552750416846,-58.441397082983187 -34.602666230371483)));;1622;15_17_8;COMUNA 15;17;8;594;260;334;77,84%;333;333;100,00%;0;0,00%;270;1;0,37%;269;99,63%
MULTIPOLYGON (((-58.443642179699914 -34.604205251339565,-58.442690277184198 -34.603552750416846,-58.441870294086307 -34.604367714321263,-58.441048591037131 -34.60518443292726,-58.442024522868643 -34.60581913299108,-58.442823561836263 -34.6050219824062,-58.443642179699914 -34.604205251339565)));;1623;15_17_9;COMUNA 15;17;9;678;306;372;82,26%;310;310;100,00%;0;0,00%;266;13;4,89%;253;95,11%
MULTIPOLYGON (((-58.442782223623311 -34.599792833658981,-58.441883798433118 -34.599058923117376,-58.441769952326823 -34.598968829754064,-58.440812020154738 -34.599832990666734,-58.441823269434558 -34.600661016464898,-58.442782223623311 -34.599792833658981)));;1624;15_18_1;COMUNA 15;18;1;570;254;316;80,38%;330;330;100,00%;0;0,00%;257;4;1,56%;253;98,44%
MULTIPOLYGON (((-58.439021407985017 -34.603867387171285,-58.439390221272753 -34.603502643135592,-58.439430956306992 -34.603445672556276,-58.439773204936479 -34.60300425872088,-58.438510774582497 -34.602194265991685,-58.437848101124594 -34.602923244958134,-58.437739727484185 -34.603042875250011,-58.438848710470388 -34.603756293011131,-58.439021407985017 -34.603867387171285)));;1625;15_18_10;COMUNA 15;18;10;582;263;319;82,45%;278;278;100,00%;0;0,00%;240;7;2,92%;233;97,08%
MULTIPOLYGON (((-58.436976843165141 -34.603885213393625,-58.436616184548512 -34.604283391254107,-58.437053311827349 -34.604491379057066,-58.437174579122861 -34.604553026519788,-58.437659878619804 -34.604322062056497,-58.438848710470388 -34.603756293011131,-58.437739727484185 -34.603042875250011,-58.436976843165141 -34.603885213393625)));;1626;15_18_11;COMUNA 15;18;11;657;291;366;79,51%;339;338;99,71%;1;0,30%;294;2;0,68%;292;99,32%
MULTIPOLYGON (((-58.437739727484185 -34.603042875250011,-58.43647706149968 -34.602230607834038,-58.435668783426863 -34.603048490602596,-58.436976843165141 -34.603885213393625,-58.437739727484185 -34.603042875250011)));;1627;15_18_12;COMUNA 15;18;12;560;256;304;84,21%;317;317;100,00%;0;0,00%;244;7;2,87%;237;97,13%
MULTIPOLYGON (((-58.435668783426863 -34.603048490602596,-58.435148382703275 -34.603574943385588,-58.435338027726786 -34.603675130682234,-58.436616184548512 -34.604283391254107,-58.436976843165141 -34.603885213393625,-58.435668783426863 -34.603048490602596)));;1628;15_18_13;COMUNA 15;18;13;546;242;304;79,61%;304;304;100,00%;0;0,00%;254;0;0,00%;254;100,00%
MULTIPOLYGON (((-58.440812020154738 -34.599832990666734,-58.439955955320137 -34.600605187617226,-58.441089118286456 -34.60129837776536,-58.441823269434558 -34.600661016464898,-58.440812020154738 -34.599832990666734)));;1629;15_18_2;COMUNA 15;18;2;500;241;259;93,05%;232;232;100,00%;0;0,00%;213;0;0,00%;213;100,00%
MULTIPOLYGON (((-58.439763836700116 -34.598974596161909,-58.438945248517172 -34.599734116626216,-58.438764907609155 -34.599874368454905,-58.439955955320137 -34.600605187617226,-58.440812020154738 -34.599832990666734,-58.441769952326823 -34.598968829754064,-58.441666239331155 -34.598886766508485,-58.440692812729786 -34.598112621320503,-58.439763836700116 -34.598974596161909)));;1630;15_18_3;COMUNA 15;18;3;714;300;414;72,46%;421;420;99,76%;1;0,24%;310;50;16,13%;260;83,87%
MULTIPOLYGON (((-58.438764907609155 -34.599874368454905,-58.438105326848458 -34.600583137666888,-58.439310602060552 -34.601314529313107,-58.439955955320137 -34.600605187617226,-58.438764907609155 -34.599874368454905)));;1631;15_18_4;COMUNA 15;18;4;467;210;257;81,71%;235;235;100,00%;0;0,00%;209;10;4,78%;199;95,22%
MULTIPOLYGON (((-58.441089118286456 -34.60129837776536,-58.439955955320137 -34.600605187617226,-58.439310602060552 -34.601314529313107,-58.440513599183014 -34.602044500052301,-58.441089118286456 -34.60129837776536)));;1632;15_18_5;COMUNA 15;18;5;490;218;272;80,15%;278;278;100,00%;0;0,00%;215;2;0,93%;213;99,07%
MULTIPOLYGON (((-58.440513599183014 -34.602044500052301,-58.439773204936479 -34.60300425872088,-58.439430956306992 -34.603445672556276,-58.44008794349066 -34.603206226496312,-58.440149359030634 -34.603180884791414,-58.441286178593536 -34.602711987340371,-58.441397082983187 -34.602666230371483,-58.441481070400336 -34.602631595805711,-58.44219896341049 -34.602338186279148,-58.44225322238772 -34.602316715695231,-58.442488146461379 -34.602219990599778,-58.44226163341353 -34.602054242350597,-58.442160724691107 -34.601980419785463,-58.442046275180203 -34.601902158056397,-58.441827936092764 -34.601752819451939,-58.441089118286456 -34.60129837776536,-58.440513599183014 -34.602044500052301)));;1633;15_18_6;COMUNA 15;18;6;517;257;260;98,85%;253;253;100,00%;0;0,00%;210;6;2,86%;204;97,14%
MULTIPOLYGON (((-58.440513599183014 -34.602044500052301,-58.439310602060552 -34.601314529313107,-58.438510774582497 -34.602194265991685,-58.439773204936479 -34.60300425872088,-58.440513599183014 -34.602044500052301)));;1634;15_18_7;COMUNA 15;18;7;771;354;417;84,89%;326;326;100,00%;0;0,00%;316;1;0,32%;315;99,68%
MULTIPOLYGON (((-58.439310602060552 -34.601314529313107,-58.438105326848458 -34.600583137666888,-58.437288220372494 -34.6014098327638,-58.438510774582497 -34.602194265991685,-58.439310602060552 -34.601314529313107)));;1635;15_18_8;COMUNA 15;18;8;569;236;333;70,87%;260;259;99,62%;1;0,39%;218;2;0,92%;216;99,08%
MULTIPOLYGON (((-58.438510774582497 -34.602194265991685,-58.437288220372494 -34.6014098327638,-58.43647706149968 -34.602230607834038,-58.437739727484185 -34.603042875250011,-58.437848101124594 -34.602923244958134,-58.438510774582497 -34.602194265991685)));;1636;15_18_9;COMUNA 15;18;9;492;200;292;68,49%;267;267;100,00%;0;0,00%;222;0;0,00%;222;100,00%
MULTIPOLYGON (((-58.438105326848458 -34.600583137666888,-58.437600286175453 -34.600264290241121,-58.436222027472425 -34.600725636316596,-58.437288220372494 -34.6014098327638,-58.438105326848458 -34.600583137666888)));;1637;15_19_1;COMUNA 15;19;1;465;212;253;83,79%;290;290;100,00%;0;0,00%;230;2;0,87%;228;99,13%
MULTIPOLYGON (((-58.433473045355072 -34.60164581857078,-58.432503440355639 -34.601023305255218,-58.431872682782206 -34.601697398552766,-58.43219849130174 -34.602072424251517,-58.433473045355072 -34.60164581857078)));;1638;15_19_10;COMUNA 15;19;10;964;423;541;78,19%;451;450;99,78%;1;0,22%;412;1;0,24%;411;99,76%
MULTIPOLYGON (((-58.434363674284953 -34.600873886558105,-58.43328771942317 -34.600185225362175,-58.432503440355639 -34.601023305255218,-58.433473045355072 -34.60164581857078,-58.433720152128075 -34.60156312788282,-58.434363674284953 -34.600873886558105)));;1639;15_19_11;COMUNA 15;19;11;806;364;442;82,35%;488;488;100,00%;0;0,00%;383;3;0,78%;380;99,22%
MULTIPOLYGON (((-58.437600286175453 -34.600264290241121,-58.436933548193437 -34.599837656063201,-58.435930473756372 -34.599195795780034,-58.435148104280266 -34.600033752385094,-58.436150331836515 -34.600673224370496,-58.436055163516365 -34.600781517621954,-58.436222027472425 -34.600725636316596,-58.437600286175453 -34.600264290241121)));;1640;15_19_2;COMUNA 15;19;2;794;351;443;79,23%;440;440;100,00%;0;0,00%;335;9;2,69%;326;97,31%
MULTIPOLYGON (((-58.435930473756372 -34.599195795780034,-58.434856485924669 -34.598508627591386,-58.43407189758873 -34.59934706985991,-58.435148104280266 -34.600033752385094,-58.435930473756372 -34.599195795780034)));;1641;15_19_3;COMUNA 15;19;3;685;305;380;80,26%;375;375;100,00%;0;0,00%;310;5;1,61%;305;98,39%
MULTIPOLYGON (((-58.435148104280266 -34.600033752385094,-58.43407189758873 -34.59934706985991,-58.43328771942317 -34.600185225362175,-58.434363674284953 -34.600873886558105,-58.435148104280266 -34.600033752385094)));;1642;15_19_4;COMUNA 15;19;4;757;348;409;85,09%;429;429;100,00%;0;0,00%;343;2;0,58%;341;99,42%
MULTIPOLYGON (((-58.435335931657065 -34.60149652655543,-58.43485107891054 -34.601184573996875,-58.436055163516365 -34.600781517621954,-58.436150331836515 -34.600673224370496,-58.435148104280266 -34.600033752385094,-58.434363674284953 -34.600873886558105,-58.433720152128075 -34.60156312788282,-58.433473045355072 -34.60164581857078,-58.43380939284107 -34.601859075789356,-58.434509084938846 -34.602306650801061,-58.435240084269402 -34.6015917903391,-58.435335931657065 -34.60149652655543)));;1643;15_19_5;COMUNA 15;19;5;841;376;465;80,86%;492;492;100,00%;0;0,00%;383;7;1,83%;376;98,17%
MULTIPOLYGON (((-58.436222027472425 -34.600725636316596,-58.436055163516365 -34.600781517621954,-58.43485107891054 -34.601184573996875,-58.435335931657065 -34.60149652655543,-58.43647706149968 -34.602230607834038,-58.437288220372494 -34.6014098327638,-58.436222027472425 -34.600725636316596)));;1644;15_19_6;COMUNA 15;19;6;765;329;436;75,46%;408;408;100,00%;0;0,00%;338;2;0,59%;336;99,41%
MULTIPOLYGON (((-58.43647706149968 -34.602230607834038,-58.435335931657065 -34.60149652655543,-58.435240084269402 -34.6015917903391,-58.434509084938846 -34.602306650801061,-58.435668783426863 -34.603048490602596,-58.43647706149968 -34.602230607834038)));;1645;15_19_7;COMUNA 15;19;7;743;297;446;66,59%;469;468;99,79%;1;0,21%;374;1;0,27%;373;99,73%
MULTIPOLYGON (((-58.434509084938846 -34.602306650801061,-58.433865744028203 -34.602935820076731,-58.433913942752547 -34.602959635174308,-58.434971767153215 -34.603481589997941,-58.435148382703275 -34.603574943385588,-58.435668783426863 -34.603048490602596,-58.434509084938846 -34.602306650801061)));;1646;15_19_8;COMUNA 15;19;8;599;268;331;80,97%;388;388;100,00%;0;0,00%;294;2;0,68%;292;99,32%
MULTIPOLYGON (((-58.43380939284107 -34.601859075789356,-58.433473045355072 -34.60164581857078,-58.43219849130174 -34.602072424251517,-58.432240628247122 -34.602133775133495,-58.433141829586376 -34.602578591091984,-58.433334112118949 -34.602673429841985,-58.433865744028203 -34.602935820076731,-58.434509084938846 -34.602306650801061,-58.43380939284107 -34.601859075789356)));;1647;15_19_9;COMUNA 15;19;9;661;294;367;80,11%;370;370;100,00%;0;0,00%;286;5;1,75%;281;98,25%
MULTIPOLYGON (((-58.486375513169527 -34.586630094145711,-58.486652400001752 -34.586801244233698,-58.486802725930261 -34.586897134012979,-58.486893983042854 -34.586797252759524,-58.487443572160736 -34.586222682670439,-58.488086367296376 -34.585550621948819,-58.488193967031165 -34.585438200579986,-58.488793593920711 -34.58481818943666,-58.488103649614509 -34.584418670789297,-58.487033103476314 -34.583798652275703,-58.486455985241115 -34.58453879624993,-58.485891880624692 -34.585262384965361,-58.485329638931326 -34.585983435330007,-58.485488988930044 -34.586082001232363,-58.486375513169527 -34.586630094145711)));;1648;15_2_1;COMUNA 15;2;1;756;344;412;83,50%;330;330;100,00%;0;0,00%;280;3;1,07%;277;98,93%
MULTIPOLYGON (((-58.486440502016521 -34.587284685468362,-58.48669597528756 -34.587014061186778,-58.486802725930261 -34.586897134012979,-58.486652400001752 -34.586801244233698,-58.486375513169527 -34.586630094145711,-58.485488988930044 -34.586082001232363,-58.485329638931326 -34.585983435330007,-58.484984787445917 -34.586385275655481,-58.484581698411617 -34.586831563855078,-58.484509082347273 -34.586912002643551,-58.48416890011741 -34.587288557057803,-58.483931639098913 -34.587551285229758,-58.483851700394617 -34.587639612533749,-58.483505808271616 -34.588022152202065,-58.483410377097492 -34.588138088596104,-58.484230505512215 -34.588756844794247,-58.484710459604173 -34.589118956811745,-58.485078233943618 -34.588728592572238,-58.485434341776894 -34.588350553813484,-58.485561273070431 -34.588215876796269,-58.486111474517926 -34.587633213802626,-58.486440502016521 -34.587284685468362)));;1649;15_2_10;COMUNA 15;2;10;603;286;317;90,22%;284;284;100,00%;0;0,00%;233;1;0,43%;232;99,57%
MULTIPOLYGON (((-58.486455985241115 -34.58453879624993,-58.487033103476314 -34.583798652275703,-58.485959677627953 -34.583176934643767,-58.485824350784434 -34.583098506431426,-58.485095429448613 -34.5826748925397,-58.484746854545975 -34.582472342026094,-58.48458009468829 -34.58266223900899,-58.484526036310115 -34.582709081601763,-58.484198103114991 -34.582969502628245,-58.484080873304976 -34.58305924521926,-58.484424343582525 -34.583275672333144,-58.484541019792346 -34.583348471400654,-58.483961150149895 -34.584058955027672,-58.483474824963061 -34.5846547673627,-58.483379484106493 -34.58477619696253,-58.484274156823005 -34.585330008339675,-58.485329638931326 -34.585983435330007,-58.485891880624692 -34.585262384965361,-58.486455985241115 -34.58453879624993)));;1650;15_2_2;COMUNA 15;2;2;817;387;430;90,00%;328;328;100,00%;0;0,00%;300;0;0,00%;300;100,00%
MULTIPOLYGON (((-58.483134132097369 -34.581535048778576,-58.482839087576245 -34.581880957182037,-58.482770219748353 -34.581957309706524,-58.482703650201827 -34.582030985647769,-58.482472362053628 -34.582302302131914,-58.482159690770452 -34.582669057633417,-58.482069251935428 -34.582630690157544,-58.482003259946325 -34.582629362529318,-58.481489712774973 -34.582610850355898,-58.481479717352386 -34.58284353752822,-58.481472066371914 -34.582899526923931,-58.481456163134027 -34.582988406263475,-58.481442041330126 -34.583047424943722,-58.481421790573918 -34.583115106889927,-58.481385707918939 -34.583210679726626,-58.481362642317244 -34.583257023187528,-58.481338042788437 -34.583298084970906,-58.481220907919756 -34.583447897684628,-58.481759991936784 -34.583779518433715,-58.482148680131999 -34.584018621841771,-58.482552870517246 -34.58426722891268,-58.483245007440175 -34.584692976838795,-58.483379484106493 -34.58477619696253,-58.483474824963061 -34.5846547673627,-58.483961150149895 -34.584058955027672,-58.484541019792346 -34.583348471400654,-58.484424343582525 -34.583275672333144,-58.484080873304976 -34.58305924521926,-58.484198103114991 -34.582969502628245,-58.484526036310115 -34.582709081601763,-58.48458009468829 -34.58266223900899,-58.484746854545975 -34.582472342026094,-58.484120905802641 -34.582108565249364,-58.483134132097369 -34.581535048778576)));;1651;15_2_3;COMUNA 15;2;3;828;405;423;95,74%;335;335;100,00%;0;0,00%;292;0;0,00%;292;100,00%
MULTIPOLYGON (((-58.480440865480709 -34.581182215917643,-58.480237628743737 -34.581654800054523,-58.480396119704615 -34.581785134678157,-58.480576588561362 -34.581956312633132,-58.48069446436206 -34.582087990888176,-58.480775983363053 -34.582228618447282,-58.480845068936461 -34.582361148872351,-58.48088366746007 -34.5824779789289,-58.48090097732603 -34.582589600665308,-58.480903630581615 -34.58265192677986,-58.480905100623822 -34.582755029396488,-58.480883675799213 -34.582907221950812,-58.480852783900126 -34.582989342602531,-58.480770823029445 -34.58317168620362,-58.481220907919756 -34.583447897684628,-58.481338042788437 -34.583298084970906,-58.481362642317244 -34.583257023187528,-58.481385707918939 -34.583210679726626,-58.481421790573918 -34.583115106889927,-58.481442041330126 -34.583047424943722,-58.481456163134027 -34.582988406263475,-58.481472066371914 -34.582899526923931,-58.481479717352386 -34.58284353752822,-58.481489712774973 -34.582610850355898,-58.482003259946325 -34.582629362529318,-58.482069251935428 -34.582630690157544,-58.482159690770452 -34.582669057633417,-58.482472362053628 -34.582302302131914,-58.482703650201827 -34.582030985647769,-58.482770219748353 -34.581957309706524,-58.482839087576245 -34.581880957182037,-58.483134132097369 -34.581535048778576,-58.483013543429173 -34.581464925162038,-58.48214558336155 -34.580959552643478,-58.481129201162872 -34.580367713943829,-58.481044926200433 -34.580466956113817,-58.480770478252367 -34.580791940120143,-58.480440865480709 -34.581182215917643)));;1652;15_2_4;COMUNA 15;2;4;554;255;299;85,28%;245;245;100,00%;0;0,00%;208;2;0,96%;206;99,04%
MULTIPOLYGON (((-58.4804836125763 -34.579993498376773,-58.480183429969721 -34.579819802118507,-58.479232647018669 -34.579269418700775,-58.478988076277027 -34.579124938508393,-58.479040476607565 -34.579738548645381,-58.479044232958941 -34.579788902352448,-58.479073687772789 -34.580191098240597,-58.479118681122245 -34.580802948593536,-58.479154709735255 -34.581289372350518,-58.479239690368587 -34.581298164045457,-58.479336423546705 -34.581316672792028,-58.47947377457961 -34.58134327481325,-58.479557906794938 -34.581366855747639,-58.479617429485756 -34.58138339749253,-58.479683509455541 -34.581403670844921,-58.479748993800399 -34.581425845731772,-58.479802045841303 -34.581445416584458,-58.479860292742167 -34.581468507956181,-58.479922883078807 -34.581495401661385,-58.480237628743737 -34.581654800054523,-58.480440865480709 -34.581182215917643,-58.480770478252367 -34.580791940120143,-58.481044926200433 -34.580466956113817,-58.481129201162872 -34.580367713943829,-58.480993713004558 -34.580288787383687,-58.4804836125763 -34.579993498376773)));;1653;15_2_5;COMUNA 15;2;5;517;246;271;90,77%;242;242;100,00%;0;0,00%;208;1;0,48%;207;99,52%
MULTIPOLYGON (((-58.480481069490089 -34.584044933592779,-58.480612107021187 -34.58399181366557,-58.480755994811496 -34.58390397196461,-58.480889322452185 -34.583811413163836,-58.4809929342426 -34.583729704188634,-58.481147277941076 -34.583565448870189,-58.481220907919756 -34.583447897684628,-58.480770823029445 -34.58317168620362,-58.480852783900126 -34.582989342602531,-58.480883675799213 -34.582907221950812,-58.480905100623822 -34.582755029396488,-58.480903630581615 -34.58265192677986,-58.48090097732603 -34.582589600665308,-58.48088366746007 -34.5824779789289,-58.480845068936461 -34.582361148872351,-58.480775983363053 -34.582228618447282,-58.48069446436206 -34.582087990888176,-58.480576588561362 -34.581956312633132,-58.480396119704615 -34.581785134678157,-58.480237628743737 -34.581654800054523,-58.479922883078807 -34.581495401661385,-58.479860292742167 -34.581468507956181,-58.479802045841303 -34.581445416584458,-58.479748993800399 -34.581425845731772,-58.479683509455541 -34.581403670844921,-58.479617429485756 -34.58138339749253,-58.479557906794938 -34.581366855747639,-58.47947377457961 -34.58134327481325,-58.479336423546705 -34.581316672792028,-58.479239690368587 -34.581298164045457,-58.479154709735255 -34.581289372350518,-58.479183322446097 -34.581733753068782,-58.479191778288211 -34.581865517934141,-58.479250317740849 -34.582504691308692,-58.479305820374925 -34.583283236924579,-58.479337756489663 -34.583732617213876,-58.479373791504571 -34.584238337235455,-58.479580877328878 -34.584216969866915,-58.479675991733885 -34.58421413965754,-58.479793670793519 -34.584208066646546,-58.479910157081505 -34.584198965397363,-58.480042564176472 -34.584177255626031,-58.48015334200695 -34.584152872640104,-58.480373446772646 -34.584089387664008,-58.480481069490089 -34.584044933592779)));;1654;15_2_6;COMUNA 15;2;6;709;338;371;91,11%;307;307;100,00%;0;0,00%;268;2;0,75%;266;99,25%
MULTIPOLYGON (((-58.482552870517246 -34.58426722891268,-58.482148680131999 -34.584018621841771,-58.481759991936784 -34.583779518433715,-58.481220907919756 -34.583447897684628,-58.481147277941076 -34.583565448870189,-58.4809929342426 -34.583729704188634,-58.480889322452185 -34.583811413163836,-58.480755994811496 -34.58390397196461,-58.480612107021187 -34.58399181366557,-58.480481069490089 -34.584044933592779,-58.480373446772646 -34.584089387664008,-58.48015334200695 -34.584152872640104,-58.480042564176472 -34.584177255626031,-58.479910157081505 -34.584198965397363,-58.479793670793519 -34.584208066646546,-58.479675991733885 -34.58421413965754,-58.479580877328878 -34.584216969866915,-58.479373791504571 -34.584238337235455,-58.479380622747371 -34.584333762741053,-58.479421013263867 -34.584900329657202,-58.479429979592901 -34.585026460334959,-58.479438092073821 -34.585140900509117,-58.479691206023226 -34.585331929657606,-58.480694901061014 -34.586089210969192,-58.481171489315983 -34.585617782579533,-58.481635898039883 -34.585158467353367,-58.482160150170124 -34.584639913028035,-58.482552870517246 -34.58426722891268)));;1655;15_2_7;COMUNA 15;2;7;666;310;356;87,08%;306;306;100,00%;0;0,00%;279;2;0,72%;277;99,28%
MULTIPOLYGON (((-58.484509082347273 -34.586912002643551,-58.484581698411617 -34.586831563855078,-58.484984787445917 -34.586385275655481,-58.485329638931326 -34.585983435330007,-58.484274156823005 -34.585330008339675,-58.483379484106493 -34.58477619696253,-58.483245007440175 -34.584692976838795,-58.482552870517246 -34.58426722891268,-58.482160150170124 -34.584639913028035,-58.481635898039883 -34.585158467353367,-58.482081421079698 -34.585533130988466,-58.482485214396732 -34.585872727897744,-58.483286593302033 -34.586546636792839,-58.48416890011741 -34.587288557057803,-58.484509082347273 -34.586912002643551)));;1656;15_2_8;COMUNA 15;2;8;668;315;353;89,24%;272;272;100,00%;0;0,00%;236;1;0,42%;235;99,58%
MULTIPOLYGON (((-58.482528767516058 -34.587472926501526,-58.483410377097492 -34.588138088596104,-58.483505808271616 -34.588022152202065,-58.483851700394617 -34.587639612533749,-58.483931639098913 -34.587551285229758,-58.48416890011741 -34.587288557057803,-58.483286593302033 -34.586546636792839,-58.482485214396732 -34.585872727897744,-58.482081421079698 -34.585533130988466,-58.481635898039883 -34.585158467353367,-58.481171489315983 -34.585617782579533,-58.480694901061014 -34.586089210969192,-58.481690608390572 -34.586840499014677,-58.482528767516058 -34.587472926501526)));;1657;15_2_9;COMUNA 15;2;9;581;268;313;85,62%;268;268;100,00%;0;0,00%;212;0;0,00%;212;100,00%
MULTIPOLYGON (((-58.440692812729786 -34.598112621320503,-58.439353470880349 -34.597255860402399,-58.4384865585656 -34.598180797676633,-58.439763836700116 -34.598974596161909,-58.440692812729786 -34.598112621320503)));;1658;15_20_1;COMUNA 15;20;1;858;408;450;90,67%;417;417;100,00%;0;0,00%;347;5;1,44%;342;98,56%
MULTIPOLYGON (((-58.434249003545375 -34.59547583459689,-58.433171245045109 -34.594788791143927,-58.432288699194267 -34.595729315379508,-58.431622623307057 -34.59643917521246,-58.432700985420865 -34.597129260594038,-58.433366035849744 -34.596418901730878,-58.434442879441661 -34.597108126257083,-58.435326779818439 -34.596162798037021,-58.434249003545375 -34.59547583459689)));;1659;15_20_10;COMUNA 15;20;10;804;380;424;89,62%;387;387;100,00%;0;0,00%;319;7;2,19%;312;97,81%
MULTIPOLYGON (((-58.434041929153331 -34.593860863719463,-58.432963342195514 -34.59317212785227,-58.432095036853092 -34.594102724442692,-58.431217255200551 -34.595043453504502,-58.430554070876696 -34.595754294283672,-58.430677442717773 -34.595834329839612,-58.431622623307057 -34.59643917521246,-58.432288699194267 -34.595729315379508,-58.433171245045109 -34.594788791143927,-58.434041929153331 -34.593860863719463)));;1660;15_20_11;COMUNA 15;20;11;728;319;409;78,00%;422;421;99,76%;1;0,24%;344;26;7,56%;318;92,44%
MULTIPOLYGON (((-58.431219440560653 -34.593539733106347,-58.430282249452482 -34.594163385499115,-58.430059495633415 -34.594302345659997,-58.429348808142571 -34.594745410303688,-58.429169070241493 -34.594855294928706,-58.430554070876696 -34.595754294283672,-58.431217255200551 -34.595043453504502,-58.432095036853092 -34.594102724442692,-58.432963342195514 -34.59317212785227,-58.432573052710147 -34.592922937792693,-58.432358668529012 -34.592781681922091,-58.431219440560653 -34.593539733106347)));;1661;15_20_12;COMUNA 15;20;12;738;314;424;74,06%;453;452;99,78%;1;0,22%;342;4;1,17%;338;98,83%
MULTIPOLYGON (((-58.437598754308652 -34.599128049153776,-58.436933548193437 -34.599837656063201,-58.437600286175453 -34.600264290241121,-58.438105326848458 -34.600583137666888,-58.438764907609155 -34.599874368454905,-58.438945248517172 -34.599734116626216,-58.439763836700116 -34.598974596161909,-58.4384865585656 -34.598180797676633,-58.437598754308652 -34.599128049153776)));;1662;15_20_2;COMUNA 15;20;2;805;351;454;77,31%;535;535;100,00%;0;0,00%;366;5;1,37%;361;98,63%
MULTIPOLYGON (((-58.43659483180901 -34.598485560256243,-58.436376816901017 -34.598717705467678,-58.435930473756372 -34.599195795780034,-58.436933548193437 -34.599837656063201,-58.437598754308652 -34.599128049153776,-58.4384865585656 -34.598180797676633,-58.437482895689229 -34.597539724543338,-58.43659483180901 -34.598485560256243)));;1663;15_20_3;COMUNA 15;20;3;791;336;455;73,85%;460;460;100,00%;0;0,00%;346;5;1,45%;341;98,55%
MULTIPOLYGON (((-58.439353470880349 -34.597255860402399,-58.438351345426987 -34.596614794609913,-58.437482895689229 -34.597539724543338,-58.4384865585656 -34.598180797676633,-58.439353470880349 -34.597255860402399)));;1664;15_20_4;COMUNA 15;20;4;635;283;352;80,40%;334;334;100,00%;0;0,00%;278;1;0,36%;277;99,64%
MULTIPOLYGON (((-58.438351345426987 -34.596614794609913,-58.437273709480628 -34.595925393071241,-58.437127860819878 -34.596081002462228,-58.436406361551519 -34.596852146733241,-58.437482895689229 -34.597539724543338,-58.438351345426987 -34.596614794609913)));;1665;15_20_5;COMUNA 15;20;5;595;275;320;85,94%;350;350;100,00%;0;0,00%;274;3;1,09%;271;98,91%
MULTIPOLYGON (((-58.437482895689229 -34.597539724543338,-58.436406361551519 -34.596852146733241,-58.435521103183724 -34.597798257042932,-58.434856485924669 -34.598508627591386,-58.435930473756372 -34.599195795780034,-58.436376816901017 -34.598717705467678,-58.43659483180901 -34.598485560256243,-58.437482895689229 -34.597539724543338)));;1666;15_20_6;COMUNA 15;20;6;713;317;396;80,05%;388;388;100,00%;0;0,00%;321;0;0,00%;321;100,00%
MULTIPOLYGON (((-58.435521103183724 -34.597798257042932,-58.436406361551519 -34.596852146733241,-58.435534708050504 -34.596295314447261,-58.435326779818439 -34.596162798037021,-58.434442879441661 -34.597108126257083,-58.433366035849744 -34.596418901730878,-58.432700985420865 -34.597129260594038,-58.433778428742961 -34.597818772752916,-58.434856485924669 -34.598508627591386,-58.435521103183724 -34.597798257042932)));;1667;15_20_7;COMUNA 15;20;7;729;328;401;81,80%;343;341;99,42%;2;0,59%;289;11;3,81%;278;96,19%
MULTIPOLYGON (((-58.437273709480628 -34.595925393071241,-58.436480139390497 -34.595417740549351,-58.436194303157222 -34.595235206879458,-58.435117724129718 -34.594547828716898,-58.434249003545375 -34.59547583459689,-58.435326779818439 -34.596162798037021,-58.435534708050504 -34.596295314447261,-58.436406361551519 -34.596852146733241,-58.437127860819878 -34.596081002462228,-58.437273709480628 -34.595925393071241)));;1668;15_20_8;COMUNA 15;20;8;659;276;383;72,06%;309;308;99,68%;1;0,32%;268;1;0,37%;267;99,63%
MULTIPOLYGON (((-58.435117724129718 -34.594547828716898,-58.434041929153331 -34.593860863719463,-58.433171245045109 -34.594788791143927,-58.434249003545375 -34.59547583459689,-58.435117724129718 -34.594547828716898)));;1669;15_20_9;COMUNA 15;20;9;491;233;258;90,31%;265;265;100,00%;0;0,00%;225;8;3,56%;217;96,44%
MULTIPOLYGON (((-58.434856485924669 -34.598508627591386,-58.433778428742961 -34.597818772752916,-58.432993069042354 -34.598658686925951,-58.43407189758873 -34.59934706985991,-58.434856485924669 -34.598508627591386)));;1670;15_21_1;COMUNA 15;21;1;722;342;380;90,00%;383;383;100,00%;0;0,00%;320;7;2,19%;313;97,81%
MULTIPOLYGON (((-58.431128966114777 -34.598803506153317,-58.430051276634927 -34.598113618522362,-58.429220123503022 -34.598999272507442,-58.429428903013694 -34.599126165473635,-58.42964659896429 -34.599320668726008,-58.430150189717729 -34.599770539662018,-58.430187991152359 -34.599804353852228,-58.431128966114777 -34.598803506153317)));;1671;15_21_10;COMUNA 15;21;10;613;269;344;78,20%;387;387;100,00%;0;0,00%;278;26;9,35%;252;90,65%
MULTIPOLYGON (((-58.430051276634927 -34.598113618522362,-58.428987738776115 -34.597432880495269,-58.427852517534767 -34.598364006014627,-58.427987566853034 -34.598423905969199,-58.428548032099265 -34.598672524393407,-58.429161800075114 -34.598959114102527,-58.429220123503022 -34.598999272507442,-58.430051276634927 -34.598113618522362)));;1672;15_21_11;COMUNA 15;21;11;697;339;358;94,69%;438;438;100,00%;0;0,00%;335;6;1,79%;329;98,21%
MULTIPOLYGON (((-58.428987738776115 -34.597432880495269,-58.427835585276121 -34.596695345075013,-58.426564822219788 -34.597915797304339,-58.426785219968636 -34.597944243749005,-58.427773242114284 -34.598328911574995,-58.427852517534767 -34.598364006014627,-58.428987738776115 -34.597432880495269)));;1673;15_21_12;COMUNA 15;21;12;510;235;275;85,45%;276;276;100,00%;0;0,00%;217;37;17,05%;180;82,95%
MULTIPOLYGON (((-58.427023849584934 -34.596165582832882,-58.426950248335388 -34.596210492618049,-58.426240186158154 -34.596511843547994,-58.426024078358139 -34.596614036279803,-58.424842979796452 -34.597061861977465,-58.423537943011517 -34.597631993061718,-58.423367161030654 -34.597748680950346,-58.42374689704716 -34.597824750217065,-58.424954103811018 -34.597851786114518,-58.426302780729216 -34.59788198572793,-58.426439379507428 -34.597899632709328,-58.426564822219788 -34.597915797304339,-58.427835585276121 -34.596695345075013,-58.427023849584934 -34.596165582832882)));;1674;15_21_13;COMUNA 15;21;13;895;405;490;82,65%;498;496;99,60%;2;0,40%;389;16;4,11%;373;95,89%
MULTIPOLYGON (((-58.433778428742961 -34.597818772752916,-58.432700985420865 -34.597129260594038,-58.431622623307057 -34.59643917521246,-58.430836063268217 -34.597277314753413,-58.431913492324064 -34.597968885687173,-58.43216663199911 -34.598131349928224,-58.432993069042354 -34.598658686925951,-58.433778428742961 -34.597818772752916)));;1675;15_21_2;COMUNA 15;21;2;822;379;443;85,55%;453;453;100,00%;0;0,00%;374;2;0,53%;372;99,47%
MULTIPOLYGON (((-58.429169070241493 -34.594855294928706,-58.428088929447696 -34.595515019140421,-58.429770827470776 -34.596593766005071,-58.430216979645529 -34.596879882603083,-58.430836063268217 -34.597277314753413,-58.431622623307057 -34.59643917521246,-58.430677442717773 -34.595834329839612,-58.430554070876696 -34.595754294283672,-58.429169070241493 -34.594855294928706)));;1676;15_21_3;COMUNA 15;21;3;631;293;338;86,69%;343;343;100,00%;0;0,00%;293;37;12,63%;256;87,37%
MULTIPOLYGON (((-58.428088929447696 -34.595515019140421,-58.427023849584934 -34.596165582832882,-58.427835585276121 -34.596695345075013,-58.428987738776115 -34.597432880495269,-58.430051276634927 -34.598113618522362,-58.430836063268217 -34.597277314753413,-58.430216979645529 -34.596879882603083,-58.429770827470776 -34.596593766005071,-58.428088929447696 -34.595515019140421)));;1677;15_21_4;COMUNA 15;21;4;726;302;424;71,23%;402;402;100,00%;0;0,00%;343;18;5,25%;325;94,75%
MULTIPOLYGON (((-58.431913492324064 -34.597968885687173,-58.430836063268217 -34.597277314753413,-58.430051276634927 -34.598113618522362,-58.431128966114777 -34.598803506153317,-58.431913492324064 -34.597968885687173)));;1678;15_21_5;COMUNA 15;21;5;472;213;259;82,24%;232;232;100,00%;0;0,00%;201;20;9,95%;181;90,05%
MULTIPOLYGON (((-58.43407189758873 -34.59934706985991,-58.432993069042354 -34.598658686925951,-58.43216663199911 -34.598131349928224,-58.431913492324064 -34.597968885687173,-58.431128966114777 -34.598803506153317,-58.432210419951012 -34.599495709166888,-58.43328771942317 -34.600185225362175,-58.43407189758873 -34.59934706985991)));;1679;15_21_6;COMUNA 15;21;6;1045;490;555;88,29%;496;494;99,60%;2;0,40%;418;10;2,39%;408;97,61%
MULTIPOLYGON (((-58.43328771942317 -34.600185225362175,-58.432210419951012 -34.599495709166888,-58.431427840348817 -34.600332655861237,-58.432503440355639 -34.601023305255218,-58.43328771942317 -34.600185225362175)));;1680;15_21_7;COMUNA 15;21;7;411;183;228;80,26%;217;217;100,00%;0;0,00%;175;2;1,14%;173;98,86%
MULTIPOLYGON (((-58.431427840348817 -34.600332655861237,-58.43103820616335 -34.600749261442722,-58.431154326851278 -34.60088119796017,-58.431872682782206 -34.601697398552766,-58.432503440355639 -34.601023305255218,-58.431427840348817 -34.600332655861237)));;1681;15_21_8;COMUNA 15;21;8;574;241;333;72,37%;320;320;100,00%;0;0,00%;261;1;0,38%;260;99,62%
MULTIPOLYGON (((-58.432210419951012 -34.599495709166888,-58.431128966114777 -34.598803506153317,-58.430187991152359 -34.599804353852228,-58.430275087843569 -34.599882196910556,-58.43103820616335 -34.600749261442722,-58.431427840348817 -34.600332655861237,-58.432210419951012 -34.599495709166888)));;1682;15_21_9;COMUNA 15;21;9;863;390;473;82,45%;509;508;99,80%;1;0,20%;392;2;0,51%;390;99,49%
MULTIPOLYGON (((-58.475513244709198 -34.578692103732521,-58.475619763490506 -34.577204694763772,-58.475594329657419 -34.577190263095581,-58.475006865103317 -34.576856929421695,-58.474850867146664 -34.57676813849141,-58.47461899961057 -34.576636113532544,-58.473749378974134 -34.577617645114266,-58.473691907531972 -34.577630819870691,-58.473568620574007 -34.577659001108444,-58.473267299418012 -34.577727974125281,-58.472398328257945 -34.577938195930855,-58.472181722937925 -34.57798687696306,-58.472168589110431 -34.578549295917938,-58.472155455362085 -34.579113968434783,-58.473682227392985 -34.579126658045951,-58.473682945166651 -34.578757558047954,-58.473684033229276 -34.578614312520557,-58.473910353829361 -34.578624010660377,-58.475501411178648 -34.578691603472109,-58.475513244709198 -34.578692103732521)));;1683;15_3_13;COMUNA 15;3;13;770;364;406;89,66%;339;338;99,71%;1;0,30%;291;6;2,06%;285;97,94%
MULTIPOLYGON (((-58.464717087855483 -34.578570915011426,-58.465205034559332 -34.577656783130138,-58.465019244178755 -34.577551359836477,-58.464202691492439 -34.577079169657438,-58.464072844299203 -34.577004731432361,-58.463512089203853 -34.577899633232498,-58.462566461517909 -34.577372782739154,-58.4616052644052 -34.576837262398648,-58.460546973025899 -34.577942928621667,-58.460224856101227 -34.57829526123389,-58.460527720930415 -34.578294633170451,-58.460793887768553 -34.578294074213396,-58.460956772545792 -34.578283653676408,-58.461763106433295 -34.578277183384394,-58.463208803046591 -34.578383669254762,-58.464643865132096 -34.578708245890503,-58.464717087855483 -34.578570915011426)));;1684;15_3_10;COMUNA 15;3;10;868;386;482;80,08%;428;427;99,77%;1;0,23%;340;2;0,59%;338;99,41%
MULTIPOLYGON (((-58.461862702894265 -34.580720314179686,-58.462028657580682 -34.580714892445016,-58.463296094323169 -34.580679891382779,-58.463250362337078 -34.579586958801357,-58.461815031238302 -34.579629071265721,-58.461763106433295 -34.578277183384394,-58.460956772545792 -34.578283653676408,-58.460793887768553 -34.578294074213396,-58.460527720930415 -34.578294633170451,-58.460529303035443 -34.57966680322383,-58.460530636677682 -34.580772130909779,-58.461862702894265 -34.580720314179686)));;1685;15_3_11;COMUNA 15;3;11;755;345;410;84,15%;400;400;100,00%;0;0,00%;340;37;10,88%;303;89,12%
MULTIPOLYGON (((-58.463250362337078 -34.579586958801357,-58.463296094323169 -34.580679891382779,-58.464569320099805 -34.580644736219433,-58.464715434870023 -34.580640015388347,-58.465989595829221 -34.580598647952975,-58.466136221349537 -34.580594418385431,-58.466129402742702 -34.580430608955183,-58.466087642459613 -34.579503670122236,-58.46467274959079 -34.579545252220349,-58.464643865132096 -34.578708245890503,-58.463208803046591 -34.578383669254762,-58.461763106433295 -34.578277183384394,-58.461815031238302 -34.579629071265721,-58.463250362337078 -34.579586958801357)));;1686;15_3_12;COMUNA 15;3;12;1210;563;647;87,02%;457;457;100,00%;0;0,00%;411;17;4,14%;394;95,86%
MULTIPOLYGON (((-58.476568899875268 -34.578730784263044,-58.475652632427852 -34.57869799623699,-58.475501411178648 -34.578691603472116,-58.473910353829396 -34.578624010660384,-58.473684033229269 -34.578614312520557,-58.473682945166665 -34.578757558047982,-58.473682227392985 -34.579126658045951,-58.47368110732797 -34.579674075350823,-58.473678716260075 -34.580916451158366,-58.47431022894277 -34.581269576370076,-58.474461770276754 -34.581097864607045,-58.474682354642283 -34.580842269174234,-58.474920986051465 -34.580565614314075,-58.474996498756902 -34.580470743634763,-58.475424120852082 -34.579958284129823,-58.475499303656193 -34.579940458625785,-58.476271282489627 -34.579069564270853,-58.476568899875268 -34.578730784263044)));;1687;15_3_2;COMUNA 15;3;2;941;418;523;79,92%;478;478;100,00%;0;0,00%;399;3;0,75%;396;99,25%
MULTIPOLYGON (((-58.472155455362099 -34.579113968434783,-58.472168589110431 -34.578549295917945,-58.47218172293794 -34.577986876963081,-58.471985040990326 -34.578030978439784,-58.471421984572785 -34.578157433725373,-58.471294268346938 -34.578184345321212,-58.470967399573155 -34.578253173599919,-58.470873315103667 -34.578273251200059,-58.470342609722252 -34.578386388914332,-58.469580649495491 -34.578548905838694,-58.46948213681987 -34.57856989814637,-58.470867885421505 -34.579344775247122,-58.472133593482354 -34.580052530382801,-58.473678716260075 -34.580916451158366,-58.47368110732797 -34.579674075350823,-58.473682227392985 -34.579126658045951,-58.472155455362099 -34.579113968434783)));;1688;15_3_3;COMUNA 15;3;3;918;414;504;82,14%;417;417;100,00%;0;0,00%;382;5;1,31%;377;98,69%
MULTIPOLYGON (((-58.471818004958578 -34.576656074049907,-58.471658860160524 -34.57656481437909,-58.470878298134181 -34.576120061660546,-58.470712684156339 -34.576025702458629,-58.469945840986838 -34.575588971344764,-58.468904374023083 -34.576827038774667,-58.46982789756521 -34.577351517463576,-58.469059956646937 -34.578251738533403,-58.469580649495491 -34.578548905838694,-58.470342609722252 -34.578386388914332,-58.470873315103667 -34.578273251200059,-58.470967399573155 -34.578253173599919,-58.471294268346938 -34.578184345321212,-58.471421984572785 -34.578157433725373,-58.471985040990326 -34.578030978439784,-58.472627975884421 -34.577301742278742,-58.472734648244227 -34.577181235528009,-58.471818004958578 -34.576656074049907)));;1689;15_3_4;COMUNA 15;3;4;800;377;423;89,13%;304;302;99,34%;2;0,66%;269;9;3,35%;260;96,65%
MULTIPOLYGON (((-58.473684725238414 -34.576107657748111,-58.473547122953228 -34.576032737309397,-58.472886701329585 -34.575655031752653,-58.472742458323978 -34.575571800744079,-58.471958408116556 -34.575119519615953,-58.471805907701011 -34.57503255556643,-58.470865027192218 -34.574496120465113,-58.469945840986838 -34.575588971344764,-58.470712684156339 -34.576025702458629,-58.470878298134181 -34.576120061660546,-58.471658860160524 -34.57656481437909,-58.471818004958578 -34.576656074049907,-58.472734648244227 -34.577181235528009,-58.472627975884421 -34.577301742278742,-58.471985040990326 -34.578030978439784,-58.47218172293794 -34.577986876963081,-58.472398328257952 -34.577938195930855,-58.473267299418019 -34.577727974125295,-58.473568620574014 -34.577659001108451,-58.473691907531993 -34.577630819870706,-58.473749378974148 -34.577617645114252,-58.474618999610584 -34.576636113532544,-58.473829054651894 -34.576186380395164,-58.473684725238414 -34.576107657748111)));;1690;15_3_5;COMUNA 15;3;5;801;375;426;88,03%;274;274;100,00%;0;0,00%;242;22;9,09%;220;90,91%
MULTIPOLYGON (((-58.466786853317593 -34.575628978834438,-58.465885130303271 -34.576440166749471,-58.466071345043353 -34.5765460112857,-58.467220659049708 -34.577201987689591,-58.468145112973346 -34.577729648191635,-58.469059956646937 -34.578251738533403,-58.46982789756521 -34.577351517463576,-58.468904374023083 -34.576827038774667,-58.469945840986838 -34.575588971344764,-58.470865027192218 -34.574496120465113,-58.469925606246086 -34.573960452657751,-58.469826596338429 -34.574076590186955,-58.469012203353252 -34.575053296260627,-58.468188415346091 -34.574580006116982,-58.468042220521376 -34.574495431541564,-58.467935884082209 -34.574595088273767,-58.466786853317593 -34.575628978834438)));;1691;15_3_6;COMUNA 15;3;6;731;349;382;91,36%;324;324;100,00%;0;0,00%;272;1;0,37%;271;99,63%
MULTIPOLYGON (((-58.46412152359931 -34.575621996423024,-58.464727923171353 -34.575959255648179,-58.465794370696436 -34.576552427342705,-58.465885130303271 -34.576440166749471,-58.466786853317593 -34.575628978834438,-58.467935884082209 -34.574595088273767,-58.468042220521376 -34.574495431541564,-58.468188415346091 -34.574580006116982,-58.469012203353252 -34.575053296260627,-58.469826596338429 -34.574076590186955,-58.469925606246086 -34.573960452657751,-58.469133838630654 -34.573508998827798,-58.468287587386541 -34.57302648466802,-58.46808128372858 -34.572908812846634,-58.46736429130177 -34.572496148620381,-58.466037414444052 -34.573335875926468,-58.464991559484496 -34.573995012669833,-58.463355568645603 -34.575008385375881,-58.463189625913067 -34.575103671888222,-58.46412152359931 -34.575621996423024)));;1692;15_3_7;COMUNA 15;3;7;812;387;425;91,06%;311;309;99,36%;2;0,65%;251;1;0,40%;250;99,60%
MULTIPOLYGON (((-58.46412152359931 -34.575621996423024,-58.463189625913067 -34.575103671888222,-58.462376082057915 -34.576031880768262,-58.462247088424121 -34.576166674787565,-58.4616052644052 -34.576837262398648,-58.462566461517909 -34.577372782739154,-58.463512089203853 -34.577899633232498,-58.464072844299203 -34.577004731432361,-58.464727923171353 -34.575959255648179,-58.46412152359931 -34.575621996423024)));;1693;15_3_8;COMUNA 15;3;8;917;446;471;94,69%;380;380;100,00%;0;0,00%;329;5;1,52%;324;98,48%
MULTIPOLYGON (((-58.465794370696436 -34.576552427342705,-58.464727923171353 -34.575959255648179,-58.464072844299203 -34.577004731432361,-58.464202691492439 -34.577079169657438,-58.465019244178755 -34.577551359836477,-58.465205034559332 -34.577656783130138,-58.464717087855483 -34.578570915011426,-58.464643865132096 -34.578708245890503,-58.46467274959079 -34.579545252220349,-58.466087642459613 -34.579503670122236,-58.466022740924181 -34.579020201018125,-58.46631544416222 -34.578287485980482,-58.467121301117032 -34.577321151272358,-58.467220659049708 -34.577201987689591,-58.466071345043353 -34.5765460112857,-58.465885130303271 -34.576440166749471,-58.465794370696436 -34.576552427342705)));;1694;15_3_9;COMUNA 15;3;9;877;409;468;87,39%;439;439;100,00%;0;0,00%;349;4;1,15%;345;98,85%
MULTIPOLYGON (((-58.470871828353644 -34.580482075859429,-58.470871424462587 -34.581575360645481,-58.471043085663716 -34.581573799672107,-58.472098426721871 -34.581559497029041,-58.472087410423967 -34.582032052617983,-58.472080878313413 -34.582249526884461,-58.473570772894831 -34.581764946652811,-58.473857714828299 -34.581671607041763,-58.473994969910095 -34.581626944683407,-58.47431022894277 -34.581269576370076,-58.473678716260075 -34.580916451158366,-58.472133593482354 -34.580052530382801,-58.470867885421505 -34.579344775247122,-58.47087208488837 -34.579623237284515,-58.470871828353644 -34.580482075859429)));;1695;15_4_1;COMUNA 15;4;1;852;394;458;86,03%;423;423;100,00%;0;0,00%;337;2;0,59%;335;99,41%
MULTIPOLYGON (((-58.460405765846026 -34.585431545567232,-58.460378709795059 -34.58552804208702,-58.460526591271091 -34.585569550984076,-58.460771849431524 -34.585638329058931,-58.460971845645062 -34.585694918218572,-58.4612192097795 -34.585763695422827,-58.461462363840511 -34.585832472082316,-58.461700254550131 -34.585955222706012,-58.461865515330452 -34.586039667910875,-58.461966566369405 -34.586125853634421,-58.462183405763774 -34.586310412677932,-58.462394982996152 -34.586488877423839,-58.462611824279811 -34.586674306251425,-58.462830771793278 -34.586859734685866,-58.462976087983634 -34.586982513022349,-58.463080100746325 -34.586905640494535,-58.464356895068036 -34.58597122573191,-58.465293275172648 -34.586843146215884,-58.466348310064049 -34.586070341408572,-58.466793649837044 -34.585744046411889,-58.467400174876467 -34.585299781118621,-58.466524416618768 -34.584384985616204,-58.466284702007322 -34.584134630532795,-58.464883961988953 -34.584590104804356,-58.464792338583372 -34.584619896359499,-58.463491551655956 -34.585042886746564,-58.46341568076096 -34.585094861166382,-58.462055871036426 -34.585134511069477,-58.460990179647766 -34.585143163117323,-58.460758988877423 -34.585145061145454,-58.460667364623681 -34.585124213733245,-58.460614485085323 -34.585102662666309,-58.460573272128201 -34.585058153097151,-58.460535637448224 -34.584943922422028,-58.460470663309401 -34.585036108113115,-58.460425527659353 -34.585203226772762,-58.460446302754526 -34.585287737645665,-58.460413941372416 -34.585402389603288,-58.460405765846026 -34.585431545567232)));;1696;15_4_10;COMUNA 15;4;10;643;297;346;85,84%;301;301;100,00%;0;0,00%;257;2;0,78%;255;99,22%
MULTIPOLYGON (((-58.469656866795411 -34.583793766715402,-58.469633643374813 -34.583045497873258,-58.469557690729523 -34.583070221490921,-58.469492551933868 -34.583091423188293,-58.468517254147656 -34.583408599278464,-58.468419928318454 -34.583440224895327,-58.467393617442539 -34.583774014768743,-58.467293140204674 -34.583806695987697,-58.467175121924797 -34.58384508222742,-58.466284702007322 -34.584134630532795,-58.466524416618768 -34.584384985616204,-58.467400174876467 -34.585299781118621,-58.466793649837044 -34.585744046411889,-58.467737887379194 -34.58662108896111,-58.468343647434132 -34.586177664179218,-58.468768373859973 -34.585866645245922,-58.469195566442096 -34.58555393447795,-58.469610749948181 -34.585250026055185,-58.469732856263064 -34.585209454045923,-58.469697765185416 -34.585114452188883,-58.469656866795411 -34.583793766715402)));;1697;15_4_11;COMUNA 15;4;11;771;380;391;97,19%;331;331;100,00%;0;0,00%;296;9;3,04%;287;96,96%
MULTIPOLYGON (((-58.472080878313413 -34.582249526884461,-58.470871018061906 -34.58264308080242,-58.469633643374813 -34.583045497873258,-58.469656866795411 -34.583793766715402,-58.470724413855038 -34.583789898222477,-58.470871896125502 -34.583784324828322,-58.471029170790011 -34.583778398460936,-58.47204613683946 -34.583768958240007,-58.472020299432636 -34.584968023349667,-58.47212971970648 -34.584956887729888,-58.472460209921721 -34.584328526214044,-58.472981475340838 -34.583337456874098,-58.47353848268552 -34.582278491855263,-58.473647787088083 -34.58206150131501,-58.473630408019474 -34.58199678189056,-58.473656453753826 -34.581919522843407,-58.473630389431904 -34.581854804196823,-58.473570772894831 -34.581764946652811,-58.472080878313413 -34.582249526884461)));;1698;15_4_12;COMUNA 15;4;12;812;377;435;86,67%;376;376;100,00%;0;0,00%;353;20;5,67%;333;94,33%
MULTIPOLYGON (((-58.470889272815356 -34.587314889941439,-58.471166740568158 -34.586787525723572,-58.47212971970648 -34.584956887729888,-58.472020299432636 -34.584968023349667,-58.47204613683946 -34.583768958240007,-58.471029170790011 -34.583778398460936,-58.470871896125502 -34.583784324828322,-58.470724413855038 -34.583789898222477,-58.469656866795411 -34.583793766715402,-58.469697765185416 -34.585114452188883,-58.469732856263064 -34.585209454045923,-58.469610749948181 -34.585250026055185,-58.469195566442096 -34.58555393447795,-58.468768373859973 -34.585866645245922,-58.468343647434132 -34.586177664179218,-58.469286884348868 -34.587055258130007,-58.470230822408602 -34.587933548873721,-58.470819458352274 -34.587447646449974,-58.470853088517813 -34.587383697962032,-58.470889272815356 -34.587314889941439)));;1699;15_4_13;COMUNA 15;4;13;768;331;437;75,74%;414;414;100,00%;0;0,00%;328;3;0,91%;325;99,09%
MULTIPOLYGON (((-58.463080100746325 -34.586905640494535,-58.462976087983634 -34.586982513022349,-58.46302550958022 -34.587024269440718,-58.463190774181065 -34.587170522323333,-58.463381302952378 -34.587348114860845,-58.463574990495758 -34.587529189297527,-58.463751836378925 -34.587694593558389,-58.463942367540142 -34.587872185204674,-58.464139215536569 -34.588057611478199,-58.464336064373441 -34.588241296316603,-58.464520282013396 -34.588414534349305,-58.4647108164949 -34.588593865886708,-58.464898193777223 -34.588771456066411,-58.46508557185691 -34.588949045953235,-58.465269792641308 -34.589123153390176,-58.465451908808966 -34.589295519479862,-58.465644552727689 -34.589477461153358,-58.465805616264468 -34.589628063316304,-58.465983523719395 -34.589794334814911,-58.466163537372289 -34.589964088212859,-58.466348815396366 -34.59013993507336,-58.46651093427807 -34.590293147924548,-58.466650946477301 -34.590424597382082,-58.466815171955531 -34.590580421420704,-58.466827519389149 -34.590593549000126,-58.466875894027226 -34.590564308253015,-58.466957643822283 -34.590515078112119,-58.467117990763597 -34.590388377215071,-58.467661191142483 -34.589959043412314,-58.4678926393022 -34.589776139142685,-58.468076741196796 -34.589630632387738,-58.468190676296565 -34.589540905411269,-58.468895229143392 -34.588985778993674,-58.469211653265781 -34.588736527156151,-58.470230822408602 -34.587933548873721,-58.469286884348868 -34.587055258130007,-58.468343647434132 -34.586177664179218,-58.467737887379194 -34.58662108896111,-58.466793649837044 -34.585744046411889,-58.466348310064049 -34.586070341408572,-58.465293275172648 -34.586843146215884,-58.464356895068036 -34.58597122573191,-58.463080100746325 -34.586905640494535)));;1700;15_4_14;COMUNA 15;4;14;897;446;451;98,89%;324;324;100,00%;0;0,00%;318;54;16,98%;264;83,02%
MULTIPOLYGON (((-58.470871018061906 -34.58264308080242,-58.472080878313413 -34.582249526884461,-58.472087410423967 -34.582032052617983,-58.472098426721871 -34.581559497029041,-58.471043085663716 -34.581573799672107,-58.470871424462587 -34.581575360645481,-58.470871828353644 -34.580482075859429,-58.47087208488837 -34.579623237284515,-58.470867885421505 -34.579344775247122,-58.46948213681987 -34.57856989814637,-58.469521201921843 -34.579402818102288,-58.469530401821366 -34.58049251084303,-58.469539687868746 -34.581591429117204,-58.469541063590654 -34.581754111823493,-58.469552805657727 -34.582686896131158,-58.469557690729523 -34.583070221490921,-58.469633643374813 -34.583045497873258,-58.470871018061906 -34.58264308080242)));;1701;15_4_2;COMUNA 15;4;2;691;318;373;85,25%;328;328;100,00%;0;0,00%;256;6;2,34%;250;97,66%
MULTIPOLYGON (((-58.469332196518209 -34.57860187955508,-58.46948213681987 -34.57856989814637,-58.469580649495491 -34.578548905838694,-58.469059956646937 -34.578251738533403,-58.468145112973346 -34.577729648191635,-58.467220659049708 -34.577201987689591,-58.467121301117032 -34.577321151272358,-58.46631544416222 -34.578287485980482,-58.466022740924181 -34.579020201018125,-58.466087642459613 -34.579503670122236,-58.46722078186049 -34.57947039258891,-58.468352472857454 -34.579437175028104,-58.468327397697287 -34.578816164332189,-58.468634261641732 -34.578750724526842,-58.469332196518209 -34.57860187955508)));;1702;15_4_3;COMUNA 15;4;3;955;442;513;86,16%;514;514;100,00%;0;0,00%;401;4;1,00%;397;99,00%
MULTIPOLYGON (((-58.468352472857454 -34.579437175028104,-58.468396398084479 -34.580527218363223,-58.468440580296445 -34.581622895511352,-58.468446551025323 -34.581771985901931,-58.468487403301189 -34.582718008917844,-58.468517254147656 -34.583408599278464,-58.469492551933868 -34.583091423188293,-58.469557690729523 -34.583070221490921,-58.469552805657727 -34.582686896131158,-58.469541063590654 -34.581754111823493,-58.469539687868746 -34.581591429117204,-58.469530401821366 -34.58049251084303,-58.469521201921843 -34.579402818102288,-58.46948213681987 -34.57856989814637,-58.469332196518209 -34.57860187955508,-58.468634261641732 -34.578750724526842,-58.468327397697287 -34.578816164332189,-58.468352472857454 -34.579437175028104)));;1703;15_4_4;COMUNA 15;4;4;564;275;289;95,16%;235;235;100,00%;0;0,00%;206;15;7,28%;191;92,72%
MULTIPOLYGON (((-58.468352472857454 -34.579437175028104,-58.46722078186049 -34.57947039258891,-58.467264607259246 -34.580561844838982,-58.467308519129951 -34.581656466019787,-58.467352517308392 -34.582751157410357,-58.467393617442539 -34.583774014768743,-58.468419928318454 -34.583440224895327,-58.468517254147656 -34.583408599278464,-58.468487403301189 -34.582718008917844,-58.468446551025323 -34.581771985901931,-58.468440580296445 -34.581622895511352,-58.468396398084479 -34.580527218363223,-58.468352472857454 -34.579437175028104)));;1704;15_4_5;COMUNA 15;4;5;636;298;338;88,17%;264;264;100,00%;0;0,00%;230;12;5,22%;218;94,78%
MULTIPOLYGON (((-58.466226826681655 -34.582784083808264,-58.466271492285273 -34.583874056864019,-58.466284702007322 -34.584134630532795,-58.467175121924797 -34.58384508222742,-58.467293140204674 -34.583806695987697,-58.467393617442539 -34.583774014768743,-58.467352517308392 -34.582751157410357,-58.467308519129951 -34.581656466019787,-58.467264607259246 -34.580561844838982,-58.46722078186049 -34.57947039258891,-58.466087642459613 -34.579503670122236,-58.466129402742702 -34.580430608955183,-58.466136221349537 -34.580594418385431,-58.46618199177307 -34.581689955444709,-58.466187532036443 -34.581822566402316,-58.466226826681655 -34.582784083808264)));;1705;15_4_6;COMUNA 15;4;6;801;357;444;80,41%;327;324;99,08%;3;0,93%;270;4;1,48%;266;98,52%
MULTIPOLYGON (((-58.464715434870023 -34.580640015388347,-58.464569320099805 -34.580644736219433,-58.463296094323169 -34.580679891382779,-58.463302140921449 -34.58082546077511,-58.463344722596595 -34.581772894161318,-58.463393863055316 -34.582866741826827,-58.463442834483722 -34.583958969492635,-58.464690309212415 -34.583924869620795,-58.464854226445539 -34.583919655356432,-58.466271492285273 -34.583874056864019,-58.466226826681655 -34.582784083808264,-58.466187532036443 -34.581822566402316,-58.46618199177307 -34.581689955444709,-58.466136221349537 -34.580594418385431,-58.465989595829221 -34.580598647952975,-58.464715434870023 -34.580640015388347)));;1706;15_4_7;COMUNA 15;4;7;827;400;427;93,68%;365;365;100,00%;0;0,00%;308;19;6,17%;289;93,83%
MULTIPOLYGON (((-58.461958475646043 -34.582908644679407,-58.46200623619071 -34.584001084183043,-58.46325831031929 -34.583963970681125,-58.463442834483722 -34.583958969492635,-58.463393863055316 -34.582866741826827,-58.463344722596595 -34.581772894161318,-58.463302140921449 -34.58082546077511,-58.463296094323169 -34.580679891382779,-58.462028657580682 -34.580714892445016,-58.461862702894265 -34.580720314179686,-58.460530636677682 -34.580772130909779,-58.460531970983538 -34.581853232042135,-58.460533219759213 -34.582950249129098,-58.461958475646043 -34.582908644679407)));;1707;15_4_8;COMUNA 15;4;8;755;336;419;80,19%;344;344;100,00%;0;0,00%;297;11;3,70%;286;96,30%
MULTIPOLYGON (((-58.46200623619071 -34.584001084183043,-58.461958475646043 -34.582908644679407,-58.460533219759213 -34.582950249129098,-58.460534553748161 -34.584046139213456,-58.460535637448224 -34.584943922422028,-58.460573272128201 -34.585058153097151,-58.460614485085323 -34.585102662666309,-58.460667364623681 -34.585124213733245,-58.460758988877423 -34.585145061145454,-58.460990179647766 -34.585143163117323,-58.462055871036426 -34.585134511069477,-58.46341568076096 -34.585094861166382,-58.463491551655956 -34.585042886746564,-58.464792338583372 -34.584619896359499,-58.464883961988953 -34.584590104804356,-58.466284702007322 -34.584134630532795,-58.466271492285273 -34.583874056864019,-58.464854226445539 -34.583919655356432,-58.464690309212415 -34.583924869620795,-58.463442834483722 -34.583958969492635,-58.46325831031929 -34.583963970681125,-58.46200623619071 -34.584001084183043)));;1708;15_4_9;COMUNA 15;4;9;642;298;344;86,63%;304;304;100,00%;0;0,00%;264;18;6,82%;246;93,18%
MULTIPOLYGON (((-58.477574292983974 -34.580543206208873,-58.479073687772789 -34.580191098240597,-58.479044232958941 -34.579788902352448,-58.479040476607565 -34.579738548645381,-58.478988076277027 -34.579124938508393,-58.477222709705174 -34.57953299524484,-58.475499303656193 -34.579940458625785,-58.475424120852082 -34.579958284129823,-58.474996498756902 -34.580470743634763,-58.475196018278837 -34.580583826659769,-58.475260308657781 -34.580605651953078,-58.475324681684427 -34.580610715944651,-58.475420811193878 -34.580590071303973,-58.475983280816472 -34.580456695989426,-58.476426621519614 -34.580812154650808,-58.476587120650137 -34.580775022279006,-58.477574292983974 -34.580543206208873)));;1709;15_5_1;COMUNA 15;5;1;779;367;412;89,08%;397;396;99,75%;1;0,25%;303;3;0,99%;300;99,01%
MULTIPOLYGON (((-58.4750052473198 -34.588988766716255,-58.474059972712176 -34.590009321784805,-58.475033101166794 -34.590768412553672,-58.475724164284642 -34.591307517151009,-58.47575849693645 -34.591393221114878,-58.476130494721339 -34.590995136738265,-58.476740294369037 -34.590342647728193,-58.477696950489886 -34.589318901418736,-58.477800311544634 -34.589208320859726,-58.478609054865899 -34.588339662090959,-58.47781332741377 -34.587724527166351,-58.476997262759525 -34.588619238993516,-58.47689798855972 -34.588727846497498,-58.476797235497294 -34.588653277715103,-58.475922231840308 -34.587998630987542,-58.4750052473198 -34.588988766716255)));;1710;15_5_10;COMUNA 15;5;10;661;318;343;92,71%;250;248;99,20%;2;0,81%;224;11;4,91%;213;95,09%
MULTIPOLYGON (((-58.476740294369037 -34.590342647728193,-58.476130494721339 -34.590995136738265,-58.47575849693645 -34.591393221114878,-58.47587969084816 -34.591678753428326,-58.47596234833663 -34.591659213459131,-58.476726926217808 -34.59146625920323,-58.47672839114869 -34.591468750285649,-58.47782494036062 -34.591189382853749,-58.478082960903492 -34.591123714188257,-58.478856712996894 -34.590220127482219,-58.479625936026373 -34.589321606992939,-58.479726482786816 -34.58920341925446,-58.478609054865899 -34.588339662090959,-58.477800311544634 -34.589208320859726,-58.477696950489886 -34.589318901418736,-58.476740294369037 -34.590342647728193)));;1711;15_5_11;COMUNA 15;5;11;749;366;383;95,56%;305;305;100,00%;0;0,00%;274;12;4,38%;262;95,62%
MULTIPOLYGON (((-58.48094995747288 -34.587738324353019,-58.481177518407648 -34.587465321347622,-58.481260182023689 -34.587364741361682,-58.481690608390572 -34.586840499014677,-58.480694901061014 -34.586089210969192,-58.479691206023226 -34.585331929657606,-58.479438092073821 -34.585140900509117,-58.479457903382936 -34.585418796437764,-58.479493512884027 -34.585918530183548,-58.478955876853789 -34.586488133141508,-58.478860097698089 -34.586589628848884,-58.477913195164959 -34.587615073721715,-58.47781332741377 -34.587724527166351,-58.478609054865899 -34.588339662090959,-58.479726482786816 -34.58920341925446,-58.479835713194376 -34.589075018534601,-58.480510240480605 -34.588265804935425,-58.48094995747288 -34.587738324353019)));;1712;15_5_12;COMUNA 15;5;12;718;335;383;87,47%;312;312;100,00%;0;0,00%;272;4;1,47%;268;98,53%
MULTIPOLYGON (((-58.478856712996894 -34.590220127482219,-58.478082960903492 -34.591123714188257,-58.479544899255849 -34.59075125280679,-58.480870919180738 -34.590413373049358,-58.481182239890153 -34.590328675032218,-58.481288425993803 -34.590299784512446,-58.481457793884005 -34.590245812781617,-58.481285015729426 -34.589899698624947,-58.481169916257571 -34.589669002644108,-58.481219456510786 -34.58957187857267,-58.481218074566939 -34.589484340065511,-58.481229117141105 -34.58935862912773,-58.4812500414806 -34.589248903241142,-58.481261441643717 -34.589199815032565,-58.481287480254124 -34.589112201921921,-58.481308841812286 -34.589054379445493,-58.481469639069346 -34.588767441893786,-58.482099450298406 -34.587997664551189,-58.482528767516058 -34.587472926501526,-58.481690608390572 -34.586840499014677,-58.481260182023689 -34.587364741361682,-58.481177518407648 -34.587465321347622,-58.48094995747288 -34.587738324353019,-58.480510240480605 -34.588265804935425,-58.479835713194376 -34.589075018534601,-58.479726482786816 -34.58920341925446,-58.479625936026373 -34.589321606992939,-58.478856712996894 -34.590220127482219)));;1713;15_5_13;COMUNA 15;5;13;742;364;378;96,30%;364;364;100,00%;0;0,00%;289;2;0,69%;287;99,31%
MULTIPOLYGON (((-58.483650516479635 -34.589491059688854,-58.484710459604173 -34.589118956811745,-58.484230505512215 -34.588756844794247,-58.483410377097492 -34.588138088596104,-58.482528767516058 -34.587472926501526,-58.482099450298406 -34.587997664551189,-58.481469639069346 -34.588767441893786,-58.481308841812286 -34.589054379445493,-58.481287480254124 -34.589112201921921,-58.481261441643717 -34.589199815032565,-58.4812500414806 -34.589248903241142,-58.481229117141105 -34.58935862912773,-58.481218074566939 -34.589484340065511,-58.481219456510786 -34.58957187857267,-58.481169916257571 -34.589669002644108,-58.481285015729426 -34.589899698624947,-58.481457793884005 -34.590245812781617,-58.481861585128037 -34.590117153363792,-58.482012132621833 -34.590064451472031,-58.482501495837816 -34.589893239450028,-58.483650516479635 -34.589491059688854)));;1714;15_5_14;COMUNA 15;5;14;722;347;375;92,53%;290;290;100,00%;0;0,00%;261;0;0,00%;261;100,00%
MULTIPOLYGON (((-58.476913142471822 -34.581202255982433,-58.477704632277181 -34.581836905812906,-58.478173675234103 -34.582042700820296,-58.479250317740849 -34.582504691308692,-58.479191778288211 -34.581865517934141,-58.479183322446097 -34.581733753068782,-58.479154709735255 -34.581289372350518,-58.479118681122245 -34.580802948593536,-58.479073687772789 -34.580191098240597,-58.477574292983974 -34.580543206208873,-58.476587120650137 -34.580775022279006,-58.476426621519614 -34.580812154650808,-58.475983280816472 -34.580456695989426,-58.475420811193878 -34.580590071303973,-58.475324681684427 -34.580610715944651,-58.475260308657781 -34.580605651953078,-58.475196018278837 -34.580583826659769,-58.474996498756902 -34.580470743634763,-58.474920986051465 -34.580565614314075,-58.474682354642283 -34.580842269174234,-58.474461770276754 -34.581097864607045,-58.47431022894277 -34.581269576370076,-58.474478246385281 -34.581398086719659,-58.475488318994735 -34.58216027009022,-58.475993013896094 -34.581690689730792,-58.475718033504222 -34.581483316425995,-58.476260073820718 -34.581355928195308,-58.476913142471822 -34.581202255982433)));;1715;15_5_2;COMUNA 15;5;2;995;458;537;85,29%;398;397;99,75%;1;0,25%;358;4;1,12%;354;98,88%
MULTIPOLYGON (((-58.479250317740849 -34.582504691308692,-58.478173675234103 -34.582042700820296,-58.477704632277181 -34.581836905812906,-58.476913142471822 -34.581202255982433,-58.476260073820718 -34.581355928195308,-58.475718033504222 -34.581483316425995,-58.475993013896094 -34.581690689730792,-58.475488318994735 -34.58216027009022,-58.476651360292969 -34.583037995747731,-58.478002467379511 -34.584057593978976,-58.478260611011557 -34.583400773846201,-58.478448364747393 -34.582922983651216,-58.478654794912806 -34.583051131125522,-58.478730843194093 -34.583095137054478,-58.478824177794934 -34.583142098521222,-58.478883788450283 -34.583167373360546,-58.478965198736304 -34.583197293345705,-58.47902744803028 -34.583216792877785,-58.479080500031685 -34.583231222981937,-58.479305820374925 -34.583283236924579,-58.479250317740849 -34.582504691308692)));;1716;15_5_3;COMUNA 15;5;3;762;361;401;90,02%;320;320;100,00%;0;0,00%;278;1;0,36%;277;99,64%
MULTIPOLYGON (((-58.472981475340838 -34.583337456874098,-58.472460209921721 -34.584328526214044,-58.473044784479796 -34.585048648331295,-58.473735948565142 -34.584230385344419,-58.474314632681065 -34.583545233146261,-58.474652797088716 -34.583144902365831,-58.475040336993771 -34.582686042103788,-58.475113638876117 -34.582599974787847,-58.475488318994735 -34.58216027009022,-58.474478246385281 -34.581398086719659,-58.47431022894277 -34.581269576370076,-58.473994969910095 -34.581626944683407,-58.473857714828299 -34.581671607041763,-58.473570772894831 -34.581764946652811,-58.473630389431904 -34.581854804196823,-58.473656453753826 -34.581919522843407,-58.473630408019474 -34.58199678189056,-58.473647787088083 -34.58206150131501,-58.47353848268552 -34.582278491855263,-58.472981475340838 -34.583337456874098)));;1717;15_5_4;COMUNA 15;5;4;582;274;308;88,96%;283;283;100,00%;0;0,00%;235;17;7,23%;218;92,77%
MULTIPOLYGON (((-58.473735948565142 -34.584230385344419,-58.473044784479796 -34.585048648331295,-58.473978131815066 -34.586198401179544,-58.474458321301732 -34.585629107368348,-58.47468794152531 -34.585356961273199,-58.47528722874911 -34.584646449416169,-58.475800773779802 -34.584037638075301,-58.476205083051518 -34.583558278582437,-58.476277618387648 -34.583473760023963,-58.476651360292969 -34.583037995747731,-58.475488318994735 -34.58216027009022,-58.475113638876117 -34.582599974787847,-58.475040336993771 -34.582686042103788,-58.474652797088716 -34.583144902365831,-58.474314632681065 -34.583545233146261,-58.473735948565142 -34.584230385344419)));;1718;15_5_5;COMUNA 15;5;5;775;356;419;84,96%;362;362;100,00%;0;0,00%;301;3;1,00%;298;99,00%
MULTIPOLYGON (((-58.477139203418261 -34.585083586157822,-58.477240855156822 -34.584962935365184,-58.477635711323778 -34.584498150392911,-58.476373170030747 -34.583545512865363,-58.476277618387648 -34.583473760023963,-58.476205083051518 -34.583558278582437,-58.475800773779802 -34.584037638075301,-58.47528722874911 -34.584646449416169,-58.47468794152531 -34.585356961273199,-58.476025007211518 -34.586348412227629,-58.476143641828195 -34.586439107122494,-58.476761260833818 -34.586908000191862,-58.476860394409421 -34.58698609048276,-58.477923260302049 -34.585839296301707,-58.478003800047162 -34.585753226391425,-58.477292585041617 -34.585203502382413,-58.477139203418261 -34.585083586157822)));;1719;15_5_6;COMUNA 15;5;6;779;360;419;85,92%;332;331;99,70%;1;0,30%;282;1;0,35%;281;99,65%
MULTIPOLYGON (((-58.476651360292969 -34.583037995747731,-58.476277618387648 -34.583473760023963,-58.476373170030747 -34.583545512865363,-58.477635711323778 -34.584498150392911,-58.477240855156822 -34.584962935365184,-58.477139203418261 -34.585083586157822,-58.477292585041617 -34.585203502382413,-58.478003800047162 -34.585753226391425,-58.478828807589359 -34.586391033385766,-58.478955876853789 -34.586488133141508,-58.479493512884027 -34.585918530183548,-58.479457903382936 -34.585418796437764,-58.479438092073821 -34.585140900509117,-58.479429979592901 -34.585026460334959,-58.479421013263867 -34.584900329657202,-58.479380622747371 -34.584333762741053,-58.479373791504571 -34.584238337235455,-58.479337756489663 -34.583732617213876,-58.479305820374925 -34.583283236924579,-58.479080500031685 -34.583231222981937,-58.47902744803028 -34.583216792877785,-58.478965198736304 -34.583197293345705,-58.478883788450283 -34.583167373360546,-58.478824177794934 -34.583142098521222,-58.478730843194093 -34.583095137054478,-58.478654794912806 -34.583051131125522,-58.478448364747393 -34.582922983651216,-58.478260611011557 -34.583400773846201,-58.478002467379511 -34.584057593978976,-58.476651360292969 -34.583037995747731)));;1720;15_5_7;COMUNA 15;5;7;703;318;385;82,60%;329;329;100,00%;0;0,00%;281;2;0,71%;279;99,29%
MULTIPOLYGON (((-58.475922231840308 -34.587998630987542,-58.476797235497294 -34.588653277715103,-58.47689798855972 -34.588727846497498,-58.476997262759525 -34.588619238993516,-58.47781332741377 -34.587724527166351,-58.477913195164959 -34.587615073721715,-58.478860097698089 -34.586589628848884,-58.478955876853789 -34.586488133141508,-58.478828807589359 -34.586391033385766,-58.478003800047162 -34.585753226391425,-58.477923260302049 -34.585839296301707,-58.476860394409421 -34.58698609048276,-58.476761260833818 -34.586908000191862,-58.476143641828195 -34.586439107122494,-58.476025007211518 -34.586348412227629,-58.47468794152531 -34.585356961273199,-58.474458321301732 -34.585629107368348,-58.473978131815066 -34.586198401179544,-58.47469312784402 -34.587079143360207,-58.475308272684686 -34.587539804207601,-58.475434828208371 -34.587633879373243,-58.475922231840308 -34.587998630987542)));;1721;15_5_8;COMUNA 15;5;8;907;437;470;92,98%;395;395;100,00%;0;0,00%;334;4;1,20%;330;98,80%
MULTIPOLYGON (((-58.472460209921721 -34.584328526214044,-58.47212971970648 -34.584956887729888,-58.471166740568158 -34.586787525723572,-58.470889272815356 -34.587314889941439,-58.470853088517813 -34.587383697962032,-58.470819458352274 -34.587447646449974,-58.471116250585609 -34.58769967877533,-58.471234712703371 -34.587802350748184,-58.471893449793008 -34.588317253233626,-58.472117430769835 -34.588492313623817,-58.472896346833018 -34.589101078311096,-58.473086095437061 -34.589249378119305,-58.473219379762611 -34.589353596234744,-58.474059972712176 -34.590009321784805,-58.4750052473198 -34.588988766716255,-58.475922231840308 -34.587998630987542,-58.475434828208371 -34.587633879373243,-58.475308272684686 -34.587539804207601,-58.47469312784402 -34.587079143360207,-58.473978131815066 -34.586198401179544,-58.473044784479796 -34.585048648331295,-58.472460209921721 -34.584328526214044)));;1722;15_5_9;COMUNA 15;5;9;916;433;483;89,65%;276;275;99,64%;1;0,36%;258;9;3,49%;249;96,51%
MULTIPOLYGON (((-58.500253621625284 -34.595217869903799,-58.500709716484167 -34.595503373643496,-58.501792895150956 -34.59510083264923,-58.502757452638221 -34.594742336820033,-58.502876659364262 -34.594698000123508,-58.502876875202681 -34.594697918069137,-58.502506346387072 -34.59446910713595,-58.502403973569045 -34.594451948010054,-58.501117420413621 -34.594263549603944,-58.500231843218792 -34.594133820085588,-58.499288099321134 -34.593995650554589,-58.497958124905487 -34.593800823130202,-58.498781778151837 -34.594315109614321,-58.498924632378362 -34.594399788923091,-58.49909644971612 -34.59450171362549,-58.500106929113592 -34.595126080385775,-58.500253621625284 -34.595217869903799)));;1723;15_6_1;COMUNA 15;6;1;678;310;368;84,24%;354;354;100,00%;0;0,00%;291;1;0,34%;290;99,66%
MULTIPOLYGON (((-58.497591178743143 -34.59587755914707,-58.496895447230365 -34.596644828181503,-58.497128262049465 -34.596788500692718,-58.4971751147229 -34.596817361824876,-58.498384861946384 -34.596367630400898,-58.499550828958974 -34.595934168422879,-58.499633935481931 -34.595903297026013,-58.500126357310904 -34.595720182118733,-58.500709716484167 -34.595503373643496,-58.500253621625284 -34.595217869903799,-58.500106929113592 -34.595126080385775,-58.49909644971612 -34.59450171362549,-58.498924632378362 -34.594399788923091,-58.498261189679894 -34.595137336861868,-58.498117757156926 -34.595296750998571,-58.497591178743143 -34.59587755914707)));;1724;15_6_2;COMUNA 15;6;2;681;300;381;78,74%;349;348;99,71%;1;0,29%;285;1;0,35%;284;99,65%
MULTIPOLYGON (((-58.496264078056051 -34.595057969803506,-58.495568000727211 -34.595825794871814,-58.496895447230365 -34.596644828181503,-58.497591178743143 -34.59587755914707,-58.498117757156926 -34.595296750998571,-58.498261189679894 -34.595137336861868,-58.498924632378362 -34.594399788923091,-58.498781778151837 -34.594315109614321,-58.497958124905487 -34.593800823130202,-58.497468754474653 -34.593729129731123,-58.496935882261965 -34.594316909097017,-58.496264078056051 -34.595057969803506)));;1725;15_6_3;COMUNA 15;6;3;641;303;338;89,64%;341;341;100,00%;0;0,00%;286;10;3,50%;276;96,50%
MULTIPOLYGON (((-58.497468754474653 -34.593729129731123,-58.495930094844255 -34.593504092241254,-58.49565186771472 -34.593495261367117,-58.494976017148069 -34.594262511467221,-58.494279849667457 -34.595030963140914,-58.493129238087221 -34.596743927858874,-58.492908863143228 -34.597067445869691,-58.493417713175766 -34.597033373859873,-58.494715769031906 -34.596947684774236,-58.496784886019391 -34.59681113317415,-58.497128262049465 -34.596788500692718,-58.496895447230365 -34.596644828181503,-58.495568000727211 -34.595825794871814,-58.496264078056051 -34.595057969803506,-58.496935882261965 -34.594316909097017,-58.497468754474653 -34.593729129731123)));;1726;15_6_4;COMUNA 15;6;4;722;340;382;89,01%;301;300;99,67%;1;0,33%;250;3;1,20%;247;98,80%
MULTIPOLYGON (((-58.49201086554428 -34.593630770053799,-58.493143261146756 -34.594329604781393,-58.494279849667457 -34.595030963140914,-58.494976017148069 -34.594262511467221,-58.49565186771472 -34.593495261367117,-58.495720051231444 -34.593429187732234,-58.495812541887453 -34.59333915247327,-58.495838589887455 -34.593310411876658,-58.495225137501265 -34.593221981881214,-58.495132136078851 -34.593208555398974,-58.494276643678504 -34.593085183339447,-58.492708318482272 -34.592859020839256,-58.492645455829376 -34.59282044320846,-58.490992948868154 -34.592800513858691,-58.490959766533933 -34.592797572379268,-58.490629602668342 -34.592778375722034,-58.490701487575329 -34.592822735807552,-58.490865712106661 -34.592924110468296,-58.491000535187581 -34.593003278248759,-58.49201086554428 -34.593630770053799)));;1727;15_6_5;COMUNA 15;6;5;526;247;279;88,53%;233;233;100,00%;0;0,00%;192;4;2,08%;188;97,92%
MULTIPOLYGON (((-58.479747274925536 -34.599276276763575,-58.4803223590066 -34.599028509481656,-58.480780260760007 -34.598831181376823,-58.482127383768947 -34.598250740693189,-58.482915261924937 -34.597911233402215,-58.48303701540528 -34.597771278181284,-58.483272644138225 -34.59766743184948,-58.483209511213268 -34.597565748398942,-58.48423264688661 -34.596396653532857,-58.484705554949826 -34.596677988563442,-58.484751295676965 -34.596705164461362,-58.485815657742044 -34.596600245100937,-58.486369980014842 -34.596545700100528,-58.48690778006047 -34.596492705216541,-58.487023770494638 -34.5964793717745,-58.487676368808771 -34.596416984004556,-58.487713998670472 -34.596373946453696,-58.488055049420346 -34.595983790454497,-58.488401134820023 -34.596189430292704,-58.490186189136978 -34.597250068405124,-58.491217519354493 -34.597180885407859,-58.492489944005619 -34.597095460048536,-58.492908863143228 -34.597067445869691,-58.493129238087221 -34.596743927858874,-58.494279849667457 -34.595030963140914,-58.493143261146756 -34.594329604781393,-58.49201086554428 -34.593630770053799,-58.491000535187581 -34.593003278248759,-58.490865712106661 -34.592924110468296,-58.490701487575329 -34.592822735807552,-58.490459203346084 -34.592818776917881,-58.489396300667252 -34.592791055218768,-58.488664250446107 -34.592768747491654,-58.487472157950599 -34.592734275620842,-58.486325032265071 -34.592703022972209,-58.485621087968255 -34.592685339615855,-58.484879672395273 -34.592664560300875,-58.484134424954419 -34.592643777154379,-58.483448280404133 -34.592626852814782,-58.482713423429956 -34.592606763476276,-58.482106989716733 -34.592589043817924,-58.481534280244787 -34.592572865302692,-58.480895911770602 -34.592555144550367,-58.480283857884096 -34.592535867312698,-58.479589284558593 -34.592521246524825,-58.47896403161085 -34.59250344342523,-58.478338864392711 -34.592487256893406,-58.477728685122585 -34.592467966599799,-58.47710718057963 -34.592453322664007,-58.476541967128604 -34.592437119833875,-58.476306667361591 -34.592430174189424,-58.476148949459372 -34.592426740832032,-58.476192144724102 -34.592543430822452,-58.476205692028913 -34.592585191539264,-58.476708887026028 -34.593990049373716,-58.477115730604829 -34.595114975700568,-58.477588771050172 -34.596338607535913,-58.477638436351363 -34.596461756236337,-58.477695197402099 -34.596605429836693,-58.477783891142685 -34.596853194560722,-58.477879748796603 -34.597088058547506,-58.478347711915504 -34.598342484616097,-58.478561333886411 -34.598917620057819,-58.47860651376029 -34.599134101383214,-58.478831289142441 -34.599670923492965,-58.479747274925536 -34.599276276763575)));;1728;15_6_6;COMUNA 15;6;6;516;243;273;89,01%;188;188;100,00%;0;0,00%;183;0;0,00%;183;100,00%
MULTIPOLYGON (((-58.488401134820023 -34.596189430292704,-58.488055049420346 -34.595983790454497,-58.487713998670472 -34.596373946453696,-58.487676368808771 -34.596416984004556,-58.487023770494638 -34.5964793717745,-58.48690778006047 -34.596492705216541,-58.486369980014842 -34.596545700100528,-58.485815657742044 -34.596600245100937,-58.484751295676965 -34.596705164461362,-58.484705554949826 -34.596677988563442,-58.48423264688661 -34.596396653532857,-58.483209511213268 -34.597565748398942,-58.483272644138225 -34.59766743184948,-58.48303701540528 -34.597771278181284,-58.484853484884169 -34.597634759471646,-58.484855152351585 -34.59763462318368,-58.486130519700119 -34.597537404511314,-58.486486930962769 -34.59751120778315,-58.486681104748648 -34.597496943874738,-58.487143374330792 -34.597462907175313,-58.487353643849318 -34.597447441741949,-58.487798284463594 -34.597416293557608,-58.488544489606717 -34.597363952676851,-58.48952676783378 -34.597296554980588,-58.490186189136978 -34.597250068405124,-58.488401134820023 -34.596189430292704)));;1729;15_6_7;COMUNA 15;6;7;656;297;359;82,73%;299;299;100,00%;0;0,00%;255;0;0,00%;255;100,00%
MULTIPOLYGON (((-58.470230822408602 -34.587933548873721,-58.469211653265781 -34.588736527156151,-58.468895229143392 -34.588985778993674,-58.468190676296565 -34.589540905411269,-58.468076741196796 -34.589630632387738,-58.4678926393022 -34.589776139142685,-58.467661191142483 -34.589959043412314,-58.467117990763597 -34.590388377215071,-58.466957643822283 -34.590515078112119,-58.466875894027226 -34.590564308253015,-58.466827519389149 -34.590593549000126,-58.466771164128396 -34.590627613699425,-58.466770130089103 -34.590628046762909,-58.466853674551565 -34.590703610341649,-58.466901535467422 -34.590736849465124,-58.467287751546024 -34.5911150900614,-58.467350517300964 -34.591176357729758,-58.467716125267067 -34.591495651722219,-58.467775143937907 -34.591546073821,-58.467870783220839 -34.59162663638697,-58.46803199783173 -34.591739802957839,-58.468303839426888 -34.59190881157005,-58.468386362143661 -34.591947752959626,-58.468469736567677 -34.591987116804859,-58.468810983546199 -34.592129711481832,-58.468839091785036 -34.592202529858326,-58.469278699212602 -34.59232730062751,-58.469643531464861 -34.592385944709434,-58.469780300559421 -34.592401430422058,-58.469758400259344 -34.592235368775853,-58.469750645704856 -34.592176634502529,-58.471122412699678 -34.592225422713817,-58.472943488218064 -34.59227965179268,-58.473236610995507 -34.592284979160816,-58.474033969843951 -34.592299344902464,-58.474301970365033 -34.592304179064989,-58.474332497829202 -34.5923027142683,-58.476123590379295 -34.592354961446368,-58.476016295398274 -34.592056459021634,-58.475950011400514 -34.59187138847453,-58.475875807780305 -34.591685966614421,-58.47587969084816 -34.591678753428326,-58.47575849693645 -34.591393221114878,-58.475724164284642 -34.591307517151009,-58.475033101166794 -34.590768412553672,-58.474059972712176 -34.590009321784805,-58.473219379762611 -34.589353596234744,-58.473086095437061 -34.589249378119305,-58.472896346833018 -34.589101078311096,-58.472117430769835 -34.588492313623817,-58.471893449793008 -34.588317253233626,-58.471234712703371 -34.587802350748184,-58.471116250585609 -34.58769967877533,-58.470819458352274 -34.587447646449974,-58.470230822408602 -34.587933548873721)));;1730;15_7_1;COMUNA 15;7;1;900;446;454;98,24%;330;329;99,70%;1;0,30%;300;14;4,67%;286;95,33%
MULTIPOLYGON (((-58.470310151361623 -34.601542176099798,-58.469134487245356 -34.601809014479421,-58.468912282203199 -34.601860365976052,-58.469292165288543 -34.602165075938004,-58.470194519069594 -34.60280610450927,-58.470434117686743 -34.602937502985199,-58.471548389081292 -34.602706784729421,-58.47252561782188 -34.602504448760534,-58.473394081813559 -34.602324650606597,-58.473100919437798 -34.600918354796505,-58.472209475527677 -34.601114068797486,-58.472006691942617 -34.60115711424347,-58.471263094678051 -34.601325837097868,-58.470310151361623 -34.601542176099798)));;1731;15_7_10;COMUNA 15;7;10;984;480;504;95,24%;447;447;100,00%;0;0,00%;379;54;14,25%;325;85,75%
MULTIPOLYGON (((-58.471803525938768 -34.603941601366635,-58.472649264489768 -34.604467541056174,-58.472983508219208 -34.604674352104979,-58.473038619408946 -34.604708433235409,-58.474016658573369 -34.605311115537432,-58.47364259580295 -34.603516715960609,-58.473394081813559 -34.602324650606597,-58.47252561782188 -34.602504448760534,-58.471548389081292 -34.602706784729421,-58.470434117686743 -34.602937502985199,-58.471609660895197 -34.603821047750358,-58.471710085644737 -34.603883507520372,-58.471803525938768 -34.603941601366635)));;1732;15_7_11;COMUNA 15;7;11;891;406;485;83,71%;382;382;100,00%;0;0,00%;329;5;1,52%;324;98,48%
MULTIPOLYGON (((-58.47697146327441 -34.601583904373477,-58.476786736225755 -34.601622166731978,-58.476190481457103 -34.601745619088561,-58.475273654343717 -34.601935512960289,-58.474335190379101 -34.602129838791093,-58.473394081813559 -34.602324650606597,-58.47364259580295 -34.603516715960609,-58.474016658573369 -34.605311115537432,-58.474932449839223 -34.604174012623481,-58.475705240325283 -34.60320967096559,-58.475736321879637 -34.603170863364525,-58.47638161959793 -34.602365691792485,-58.47697146327441 -34.601583904373477)));;1733;15_7_12;COMUNA 15;7;12;971;475;496;95,77%;361;361;100,00%;0;0,00%;348;4;1,15%;344;98,85%
MULTIPOLYGON (((-58.466592323682647 -34.590735169510815,-58.466530670395542 -34.590772285617192,-58.466318886195836 -34.5909082834158,-58.466116298254008 -34.5910384352836,-58.465977662748081 -34.591129287772858,-58.465952967203016 -34.591145486261411,-58.465028074698999 -34.591936383905683,-58.464409142308909 -34.592467260250139,-58.464381807455531 -34.592551489315433,-58.464440572431627 -34.592748397688148,-58.464679127012225 -34.593547580526668,-58.464826724838645 -34.594042245403436,-58.465025576103649 -34.594721397134187,-58.465107082109469 -34.594990974784515,-58.465202173873024 -34.595330755010295,-58.465290460431184 -34.595207196028994,-58.465395726234469 -34.595103293425545,-58.466105700970267 -34.594291944536685,-58.466708025341859 -34.593673944186577,-58.467082887498854 -34.593289338675234,-58.46798366662798 -34.592365181968376,-58.468092239053924 -34.592253764355839,-58.468386362143661 -34.591947752959626,-58.468303839426888 -34.59190881157005,-58.46803199783173 -34.591739802957839,-58.467870783220839 -34.59162663638697,-58.467775143937907 -34.591546073821,-58.467716125267067 -34.591495651722219,-58.467350517300964 -34.591176357729758,-58.467287751546024 -34.5911150900614,-58.466901535467422 -34.590736849465124,-58.466853674551565 -34.590703610341649,-58.466770130089103 -34.590628046762909,-58.466592323682647 -34.590735169510815)));;1734;15_7_2;COMUNA 15;7;2;705;326;379;86,02%;246;246;100,00%;0;0,00%;244;19;7,79%;225;92,21%
MULTIPOLYGON (((-58.469453141632314 -34.594849996118036,-58.470322452909336 -34.595422291260483,-58.470616370883612 -34.595615801236853,-58.470540293044486 -34.595333119043026,-58.470228745546102 -34.594174712964694,-58.470121490703939 -34.593775971456566,-58.469780300559421 -34.592401430422058,-58.469643531464861 -34.592385944709434,-58.469278699212602 -34.59232730062751,-58.468839091785036 -34.592202529858326,-58.468810983546199 -34.592129711481832,-58.468469736567677 -34.591987116804859,-58.468386362143661 -34.591947752959626,-58.468092239053924 -34.592253764355839,-58.46798366662798 -34.592365181968376,-58.467082887498854 -34.593289338675234,-58.468170531107269 -34.594005520158426,-58.468681272704593 -34.594341777015508,-58.469453141632314 -34.594849996118036)));;1735;15_7_3;COMUNA 15;7;3;647;316;331;95,47%;254;254;100,00%;0;0,00%;230;4;1,74%;226;98,26%
MULTIPOLYGON (((-58.4777284926517 -34.599910932656826,-58.478542837475196 -34.599734977826692,-58.478831289142441 -34.599670923492965,-58.47860651376029 -34.599134101383214,-58.478561333886411 -34.598917620057819,-58.478347711915504 -34.598342484616097,-58.477879748796603 -34.597088058547506,-58.477783891142685 -34.596853194560722,-58.477695197402099 -34.596605429836693,-58.477638436351363 -34.596461756236337,-58.477588771050172 -34.596338607535913,-58.477115730604829 -34.595114975700568,-58.476708887026028 -34.593990049373716,-58.476205692028913 -34.592585191539264,-58.476192144724102 -34.592543430822452,-58.476148949459372 -34.592426740832032,-58.476123590379295 -34.592354961446368,-58.474332497829202 -34.5923027142683,-58.474301970365033 -34.592304179064989,-58.474033969843951 -34.592299344902464,-58.473236610995507 -34.592284979160816,-58.472943488218064 -34.59227965179268,-58.471122412699678 -34.592225422713817,-58.469750645704856 -34.592176634502529,-58.469758400259344 -34.592235368775853,-58.469780300559421 -34.592401430422058,-58.470121490703939 -34.593775971456566,-58.470228745546102 -34.594174712964694,-58.470540293044486 -34.595333119043026,-58.470616370883612 -34.595615801236853,-58.47060113151003 -34.595668057786668,-58.470652594032565 -34.595915176765978,-58.470490541935085 -34.59607808089617,-58.470461077845812 -34.596107661391535,-58.47036927778931 -34.596184571601434,-58.470325425788374 -34.59626838043183,-58.470498653583618 -34.59630322999687,-58.470480946523878 -34.596379994680078,-58.470524306564045 -34.596500137429658,-58.471166036366505 -34.598314108583807,-58.471618799371264 -34.598478448874246,-58.472297521735378 -34.598727984470401,-58.473075644104213 -34.599023988532302,-58.473633430351406 -34.599220074137754,-58.474469646705785 -34.599517683846962,-58.474497753609427 -34.599528526619793,-58.474889627640046 -34.599644760173561,-58.475289849346616 -34.599761766283144,-58.47561613984869 -34.599837650587403,-58.475911428629438 -34.59990663570553,-58.475937651580715 -34.599850856076202,-58.476564845248937 -34.599944522412393,-58.47640354224432 -34.599978696873144,-58.4769147405461 -34.600086741128081,-58.477264343518208 -34.600011204049565,-58.4777284926517 -34.599910932656826)));;1736;15_7_4;COMUNA 15;7;4;942;459;483;95,03%;241;239;99,17%;2;0,84%;216;41;18,98%;175;81,02%
MULTIPOLYGON (((-58.465485442980146 -34.596249501643371,-58.465511846965263 -34.596338659440512,-58.46552547484724 -34.596384576406876,-58.465618305171041 -34.596410842850602,-58.465857529197741 -34.596321326367047,-58.466444738635147 -34.596321802736867,-58.467164378483155 -34.596314102175626,-58.46809403348783 -34.596300261268574,-58.469000693802322 -34.596286837020187,-58.470193250590107 -34.596269092872525,-58.470325425788374 -34.59626838043183,-58.47036927778931 -34.596184571601434,-58.470461077845812 -34.596107661391535,-58.470490541935085 -34.59607808089617,-58.470652594032565 -34.595915176765978,-58.47060113151003 -34.595668057786668,-58.470616370883612 -34.595615801236853,-58.470322452909336 -34.595422291260483,-58.469453141632314 -34.594849996118036,-58.468681272704593 -34.594341777015508,-58.468170531107269 -34.594005520158426,-58.467082887498854 -34.593289338675234,-58.466708025341859 -34.593673944186577,-58.466105700970267 -34.594291944536685,-58.465395726234469 -34.595103293425545,-58.465290460431184 -34.595207196028994,-58.465202173873024 -34.595330755010295,-58.465454695190033 -34.596145836329612,-58.465485442980146 -34.596249501643371)));;1737;15_7_5;COMUNA 15;7;5;888;448;440;101,82%;330;329;99,70%;1;0,30%;293;21;7,17%;272;92,83%
MULTIPOLYGON (((-58.469453838293916 -34.599248547151007,-58.469993279019477 -34.599130553815968,-58.469963378777848 -34.599056045689053,-58.470098366641324 -34.599029698537073,-58.470357110423251 -34.599090177861683,-58.470433080060879 -34.599094046459399,-58.470478045241123 -34.599059887357079,-58.470506146688471 -34.599019602321491,-58.470569944879884 -34.599103333841477,-58.471558852141555 -34.599376163876158,-58.47166531388401 -34.599396508995717,-58.472453217488273 -34.599546454327452,-58.473137897928488 -34.599677106925668,-58.473355507350263 -34.599718639008103,-58.473633758282091 -34.599772771401106,-58.473740647044217 -34.59979438232461,-58.475591149519403 -34.600155411891386,-58.47610464712109 -34.600261698663253,-58.47639233627887 -34.600199551665142,-58.4769147405461 -34.600086741128081,-58.47640354224432 -34.599978696873144,-58.476564845248937 -34.599944522412393,-58.475937651580715 -34.599850856076202,-58.475911428629438 -34.59990663570553,-58.47561613984869 -34.599837650587403,-58.475289849346616 -34.599761766283144,-58.474889627640046 -34.599644760173561,-58.474497753609427 -34.599528526619793,-58.474469646705785 -34.599517683846962,-58.473633430351406 -34.599220074137754,-58.473075644104213 -34.599023988532302,-58.472297521735378 -34.598727984470401,-58.471618799371264 -34.598478448874246,-58.471166036366505 -34.598314108583807,-58.470524306564045 -34.596500137429658,-58.470480946523878 -34.596379994680078,-58.470498653583618 -34.59630322999687,-58.470325425788374 -34.59626838043183,-58.470193250590107 -34.596269092872525,-58.469000693802322 -34.596286837020187,-58.46809403348783 -34.596300261268574,-58.467164378483155 -34.596314102175626,-58.466444738635147 -34.596321802736867,-58.465857529197741 -34.596321326367047,-58.465618305171041 -34.596410842850602,-58.46552547484724 -34.596384576406876,-58.465617252291075 -34.596701239378945,-58.465620284616094 -34.5967075076409,-58.465941984242122 -34.597788352947738,-58.465958593808921 -34.597844481438329,-58.466241300463437 -34.598797045562819,-58.46630297039102 -34.599005009516198,-58.466469838741361 -34.59957326576864,-58.466505102729521 -34.599671930435491,-58.4665759716843 -34.599870456952026,-58.466725780913642 -34.599838408618425,-58.46813393088717 -34.59953630018407,-58.468334838836597 -34.599493190824177,-58.469453838293916 -34.599248547151007)));;1738;15_7_6;COMUNA 15;7;6;1031;508;523;97,13%;327;327;100,00%;0;0,00%;321;148;46,11%;173;53,89%
MULTIPOLYGON (((-58.469908397637724 -34.600469483483188,-58.468568032426873 -34.600764566585724,-58.46813393088717 -34.59953630018407,-58.466725780913642 -34.599838408618425,-58.4665759716843 -34.599870456952026,-58.466623842493966 -34.600004615497532,-58.466966020213214 -34.601113730950416,-58.46700690838373 -34.60124641063252,-58.467334015191483 -34.602249535418416,-58.467492941229011 -34.602210161586854,-58.468766047455425 -34.601894107011063,-58.468912282203199 -34.601860365976052,-58.469134487245356 -34.601809014479421,-58.470310151361623 -34.601542176099798,-58.469908397637724 -34.600469483483188)));;1739;15_7_7;COMUNA 15;7;7;1024;480;544;88,24%;407;405;99,51%;2;0,49%;351;39;11,11%;312;88,89%
MULTIPOLYGON (((-58.469908397637724 -34.600469483483188,-58.470310151361623 -34.601542176099798,-58.471263094678051 -34.601325837097868,-58.472006691942617 -34.60115711424347,-58.472209475527677 -34.601114068797486,-58.473100919437798 -34.600918354796505,-58.47395139408178 -34.60073165249068,-58.474903127409419 -34.600522679794729,-58.475299660260902 -34.600435593910014,-58.475848894686848 -34.600317010297779,-58.47610464712109 -34.600261698663253,-58.475591149519403 -34.600155411891386,-58.473740647044217 -34.59979438232461,-58.473633758282091 -34.599772771401106,-58.473355507350263 -34.599718639008103,-58.473137897928488 -34.599677106925668,-58.472453217488273 -34.599546454327452,-58.47166531388401 -34.599396508995717,-58.471558852141555 -34.599376163876158,-58.470569944879884 -34.599103333841477,-58.470506146688471 -34.599019602321491,-58.470478045241123 -34.599059887357079,-58.470433080060879 -34.599094046459399,-58.470357110423251 -34.599090177861683,-58.470098366641324 -34.599029698537073,-58.469963378777848 -34.599056045689053,-58.469993279019477 -34.599130553815968,-58.469453838293916 -34.599248547151007,-58.468334838836597 -34.599493190824177,-58.46813393088717 -34.59953630018407,-58.468568032426873 -34.600764566585724,-58.469908397637724 -34.600469483483188)));;1740;15_7_8;COMUNA 15;7;8;980;466;514;90,66%;326;325;99,69%;1;0,31%;328;1;0,30%;327;99,70%
MULTIPOLYGON (((-58.47395139408178 -34.60073165249068,-58.473100919437798 -34.600918354796505,-58.473394081813559 -34.602324650606597,-58.474335190379101 -34.602129838791093,-58.475273654343717 -34.601935512960289,-58.476190481457103 -34.601745619088561,-58.476786736225755 -34.601622166731978,-58.47697146327441 -34.601583904373477,-58.477498785852312 -34.600825080226478,-58.476732020502283 -34.600391633107527,-58.476455754686818 -34.600238899007316,-58.476403359039573 -34.60020039792515,-58.47610464712109 -34.600261698663253,-58.475848894686848 -34.600317010297779,-58.475299660260902 -34.600435593910014,-58.474903127409419 -34.600522679794729,-58.47395139408178 -34.60073165249068)));;1741;15_7_9;COMUNA 15;7;9;801;388;413;93,95%;313;313;100,00%;0;0,00%;283;7;2,47%;276;97,53%
MULTIPOLYGON (((-58.465620284616094 -34.5967075076409,-58.465617252291075 -34.596701239378945,-58.465532351375806 -34.596643572701474,-58.465450483712416 -34.596617247569029,-58.465339908393659 -34.596611913354167,-58.465296985129541 -34.596605716851002,-58.465271094909994 -34.596601984859674,-58.465161401867476 -34.596576141045567,-58.464614045539811 -34.59647854142618,-58.463863743954462 -34.596429394045025,-58.464070108640641 -34.597085262472469,-58.463334537050862 -34.597238795599942,-58.462601091895216 -34.597391831314411,-58.462932985241423 -34.598439406873062,-58.46161937060279 -34.598719201837561,-58.461477311649162 -34.59874920165349,-58.461523299848693 -34.598889841328784,-58.46180084993432 -34.599785582361235,-58.461982939585432 -34.599746990536438,-58.463264972020326 -34.599476769688444,-58.464555512855561 -34.599204633748172,-58.464725080394956 -34.599167798648644,-58.464900439134034 -34.599129695554545,-58.466241300463437 -34.598797045562819,-58.465958593808921 -34.597844481438329,-58.465941984242122 -34.597788352947738,-58.465620284616094 -34.5967075076409)));;1742;15_8_1;COMUNA 15;8;1;974;473;501;94,41%;336;336;100,00%;0;0,00%;336;31;9,23%;305;90,77%
MULTIPOLYGON (((-58.465511175774942 -34.601694781202326,-58.465096507255467 -34.602539681311484,-58.464945762974217 -34.602843075960919,-58.465278524191064 -34.602758911264544,-58.465796955896977 -34.602630373209024,-58.466082701622533 -34.602559588290077,-58.467334015191483 -34.602249535418416,-58.46700690838373 -34.60124641063252,-58.466966020213214 -34.601113730950416,-58.466623842493966 -34.600004615497532,-58.4665759716843 -34.599870456952026,-58.466386559508393 -34.59991095733286,-58.465660893846476 -34.601390188593477,-58.465432470259977 -34.601437590095209,-58.465474207971056 -34.601573932376212,-58.465511175774942 -34.601694781202326)));;1743;15_8_10;COMUNA 15;8;10;888;393;495;79,39%;467;467;100,00%;0;0,00%;382;3;0,79%;379;99,21%
MULTIPOLYGON (((-58.462601091895216 -34.597391831314411,-58.463334537050862 -34.597238795599942,-58.464070108640641 -34.597085262472469,-58.463863743954462 -34.596429394045025,-58.463767848547207 -34.596427423014106,-58.462480244218156 -34.59650419103999,-58.462322093313247 -34.596511021904483,-58.461504852140187 -34.596546651826543,-58.461008511316265 -34.59657714010018,-58.460771752888675 -34.596590799092063,-58.459275403753999 -34.596677459785759,-58.459208207977397 -34.596693655694502,-58.458246768933456 -34.596926098220344,-58.457938381693864 -34.597000596512949,-58.457829878934177 -34.597039466979929,-58.45821978297765 -34.598300023694541,-58.458551538526365 -34.599372400693689,-58.458698624576378 -34.599340432545176,-58.460013025296455 -34.59906059864408,-58.461322136825629 -34.598781877315986,-58.461477311649162 -34.59874920165349,-58.46161937060279 -34.598719201837561,-58.462932985241423 -34.598439406873062,-58.462601091895216 -34.597391831314411)));;1744;15_8_2;COMUNA 15;8;2;720;352;368;95,65%;249;249;100,00%;0;0,00%;237;20;8,44%;217;91,56%
MULTIPOLYGON (((-58.460013025296455 -34.59906059864408,-58.458698624576378 -34.599340432545176,-58.458551538526365 -34.599372400693689,-58.458872147151745 -34.600408718535157,-58.458910126812462 -34.600531541322354,-58.45915384684313 -34.601311367166467,-58.459194211798156 -34.601440950737455,-58.460657180267575 -34.601129774948966,-58.460795410933379 -34.601100339441693,-58.462120904343564 -34.600819004158993,-58.462279063565695 -34.600785411974037,-58.463412491668926 -34.60054342953611,-58.463584958176092 -34.600506877712959,-58.46330679040441 -34.599616986142593,-58.463264972020326 -34.599476769688444,-58.461982939585432 -34.599746990536438,-58.46180084993432 -34.599785582361235,-58.461523299848693 -34.598889841328784,-58.461477311649162 -34.59874920165349,-58.461322136825629 -34.598781877315986,-58.460013025296455 -34.59906059864408)));;1745;15_8_3;COMUNA 15;8;3;1008;451;557;80,97%;444;444;100,00%;0;0,00%;373;18;4,83%;355;95,17%
MULTIPOLYGON (((-58.456564970687978 -34.598657500727043,-58.456582085601831 -34.598707080962981,-58.456899261305765 -34.599731642912936,-58.456985090764036 -34.600022080640784,-58.457213293070431 -34.600763387098496,-58.457251355569014 -34.600886985075967,-58.457532528021062 -34.601794426269926,-58.459194211798156 -34.601440950737455,-58.45915384684313 -34.601311367166467,-58.458910126812462 -34.600531541322354,-58.458872147151745 -34.600408718535157,-58.458551538526365 -34.599372400693689,-58.45821978297765 -34.598300023694541,-58.457829878934177 -34.597039466979929,-58.457614320965263 -34.597116503431366,-58.457073338192636 -34.597302472818363,-58.45649402746146 -34.597501536957161,-58.456236394266476 -34.597590048139395,-58.456564970687978 -34.598657500727043)));;1746;15_8_4;COMUNA 15;8;4;942;433;509;85,07%;370;370;100,00%;0;0,00%;330;37;11,21%;293;88,79%
MULTIPOLYGON (((-58.457918021808595 -34.603038644132852,-58.458162931719208 -34.603829105885929,-58.458277569362906 -34.603906929930922,-58.458934822710226 -34.604373659703114,-58.460020954527643 -34.60409515677113,-58.459581261887976 -34.602683191557695,-58.459544216987943 -34.6025643832836,-58.459194211798156 -34.601440950737455,-58.457532528021062 -34.601794426269926,-58.457918021808595 -34.603038644132852)));;1747;15_8_5;COMUNA 15;8;5;749;341;408;83,58%;324;324;100,00%;0;0,00%;285;22;7,72%;263;92,28%
MULTIPOLYGON (((-58.461046039288505 -34.602371729516193,-58.460928332848489 -34.602396587962417,-58.459581261887976 -34.602683191557695,-58.460020954527643 -34.60409515677113,-58.460124014023251 -34.604068749544716,-58.460539147232417 -34.603962345141632,-58.46146940288746 -34.603725377300925,-58.461588303522248 -34.603695095609218,-58.462108535370866 -34.603562559025178,-58.462911195019778 -34.603358115932487,-58.462718110616933 -34.602735275639652,-58.462540785531317 -34.602163282001676,-58.462510720577882 -34.602062010504739,-58.461046039288505 -34.602371729516193)));;1748;15_8_6;COMUNA 15;8;6;720;324;396;81,82%;324;324;100,00%;0;0,00%;260;5;1,92%;255;98,08%
MULTIPOLYGON (((-58.463584958176092 -34.600506877712959,-58.463412491668926 -34.60054342953611,-58.462279063565695 -34.600785411974037,-58.462120904343564 -34.600819004158993,-58.460795410933379 -34.601100339441693,-58.460657180267575 -34.601129774948966,-58.459194211798156 -34.601440950737455,-58.459544216987943 -34.6025643832836,-58.459581261887976 -34.602683191557695,-58.460928332848489 -34.602396587962417,-58.461046039288505 -34.602371729516193,-58.462510720577882 -34.602062010504739,-58.46264333088989 -34.60203391097874,-58.463804966211512 -34.601792417931051,-58.463973091397854 -34.601752133069574,-58.46362941787504 -34.600649206770505,-58.463584958176092 -34.600506877712959)));;1749;15_8_7;COMUNA 15;8;7;996;462;534;86,52%;449;447;99,55%;2;0,45%;357;8;2,24%;349;97,76%
MULTIPOLYGON (((-58.466241300463437 -34.598797045562819,-58.464900439134034 -34.599129695554545,-58.464725080394956 -34.599167798648644,-58.464555512855561 -34.599204633748172,-58.463264972020326 -34.599476769688444,-58.46330679040441 -34.599616986142593,-58.463584958176092 -34.600506877712959,-58.46362941787504 -34.600649206770505,-58.463973091397854 -34.601752133069574,-58.464093862074733 -34.601723186986085,-58.465274311047466 -34.601470411686506,-58.465432470259977 -34.601437590095209,-58.465660893846476 -34.601390188593477,-58.466386559508393 -34.59991095733286,-58.4665759716843 -34.599870456952026,-58.466505102729521 -34.599671930435491,-58.466469838741361 -34.59957326576864,-58.46630297039102 -34.599005009516198,-58.466241300463437 -34.598797045562819)));;1750;15_8_8;COMUNA 15;8;8;931;434;497;87,32%;361;361;100,00%;0;0,00%;323;26;8,05%;297;91,95%
MULTIPOLYGON (((-58.465511175774942 -34.601694781202326,-58.465474207971056 -34.601573932376212,-58.465432470259977 -34.601437590095209,-58.465274311047466 -34.601470411686506,-58.464093862074733 -34.601723186986085,-58.463973091397854 -34.601752133069574,-58.463804966211512 -34.601792417931051,-58.46264333088989 -34.60203391097874,-58.462510720577882 -34.602062010504739,-58.462540785531317 -34.602163282001676,-58.462718110616933 -34.602735275639652,-58.462911195019778 -34.603358115932487,-58.463073021085428 -34.603316916804687,-58.464359362319819 -34.602991471245474,-58.464945762974217 -34.602843075960919,-58.465096507255467 -34.602539681311484,-58.465511175774942 -34.601694781202326)));;1751;15_8_9;COMUNA 15;8;9;1025;466;559;83,36%;483;482;99,79%;1;0,21%;433;23;5,31%;410;94,69%
MULTIPOLYGON (((-58.453110167508186 -34.586122908642288,-58.452375698348213 -34.586931613910934,-58.452205961204712 -34.587117240749514,-58.451236835349235 -34.588177266785081,-58.451420963123823 -34.588379142455501,-58.451575769426398 -34.588318742737442,-58.452615460262344 -34.58792132183293,-58.453895915919624 -34.587440556442601,-58.453110167508186 -34.586122908642288)));;1752;15_9_1;COMUNA 15;9;1;518;239;279;85,66%;291;290;99,66%;1;0,34%;228;0;0,00%;228;100,00%
MULTIPOLYGON (((-58.450767466042272 -34.588690693159741,-58.450337958244347 -34.589111723656657,-58.449516153862852 -34.589889485706593,-58.449173170134308 -34.590214109035621,-58.450226181032392 -34.591162428025164,-58.451384716492861 -34.592205821803894,-58.451491835329414 -34.592301539705588,-58.452360205177492 -34.593077703395728,-58.453233180729853 -34.592433452994925,-58.452366768373253 -34.591655394116351,-58.453250970969876 -34.591002552495368,-58.452486245186513 -34.590282743877445,-58.452313209561929 -34.590138573877312,-58.45222892351439 -34.590068276882626,-58.452441158170316 -34.589901034699302,-58.452896795660067 -34.589540705613331,-58.452926538688978 -34.589344080401027,-58.453157078532797 -34.589180148409021,-58.453646600109977 -34.588832002713353,-58.454342977549352 -34.588336680352057,-58.454501779801667 -34.588483246316919,-58.454999212818969 -34.588117630193928,-58.455048696801967 -34.588027559253767,-58.455416027563288 -34.587988918544788,-58.455590987390714 -34.587756410389673,-58.455634181014986 -34.587503781748694,-58.455634260672895 -34.587503315848259,-58.455566029443169 -34.587365433408408,-58.455518138002923 -34.587267256124569,-58.455441088793187 -34.587186300682085,-58.455440572630273 -34.587186257963168,-58.455364039357178 -34.587103507171406,-58.455116092682687 -34.586981187359783,-58.455115229675357 -34.586979880959177,-58.454930898209547 -34.586689368607715,-58.454245748636374 -34.585620084816838,-58.453964872751307 -34.585181737321349,-58.453515465076805 -34.585676583641302,-58.453110167508186 -34.586122908642288,-58.453895915919624 -34.587440556442601,-58.452615460262344 -34.58792132183293,-58.451575769426398 -34.588318742737442,-58.451420963123823 -34.588379142455501,-58.451236835349235 -34.588177266785081,-58.450768247237889 -34.588689838644456,-58.450768122278028 -34.588689975332507,-58.450767466042272 -34.588690693159741)));;1753;15_9_2;COMUNA 15;9;2;495;228;267;85,39%;248;248;100,00%;0;0,00%;209;1;0,48%;208;99,52%
MULTIPOLYGON (((-58.449173170134308 -34.590214109035621,-58.448748759214652 -34.590615767427799,-58.447888852519959 -34.59142957173318,-58.447598579416081 -34.591702645597238,-58.447349529046207 -34.591936849169691,-58.446703475290207 -34.592535592728574,-58.446671450274941 -34.592565259380279,-58.446749606795798 -34.592602933311042,-58.446905225980551 -34.592676776144799,-58.447054385640342 -34.592748189576568,-58.447200609433956 -34.59281765975259,-58.447347420678646 -34.592887615501482,-58.447494232258016 -34.592957085398112,-58.447639869485997 -34.593026554972447,-58.447774349329208 -34.59309019490906,-58.447913527251714 -34.593156749315675,-58.448050943668846 -34.593222332001602,-58.448195407139345 -34.593292286444047,-58.448333410883457 -34.593360297254776,-58.448472002318894 -34.593427336627485,-58.448612355634673 -34.593495833070129,-58.44874096404051 -34.593558985584011,-58.448870159943134 -34.593622138028302,-58.449002879697218 -34.59368626208051,-58.449136186800423 -34.593751357402745,-58.449275366755728 -34.593818881599191,-58.449399278116829 -34.593879604524972,-58.44952260243064 -34.593939841586121,-58.449647688760855 -34.594000564385368,-58.449785108005855 -34.594065659435252,-58.449921940605797 -34.594127840219258,-58.450063472446864 -34.594186135937278,-58.450173291903674 -34.594231315019051,-58.450311888859588 -34.594280867999871,-58.450432280388355 -34.594324105221396,-58.450476913447851 -34.594339651294433,-58.450548292267754 -34.594359326152357,-58.450436495676136 -34.594255670222786,-58.449719358162959 -34.593610359400209,-58.450622169306108 -34.592943665230408,-58.451491835329414 -34.592301539705588,-58.451384716492861 -34.592205821803894,-58.450226181032392 -34.591162428025164,-58.449173170134308 -34.590214109035621)));;1754;15_9_3;COMUNA 15;9;3;517;261;256;101,95%;280;280;100,00%;0;0,00%;230;2;0,87%;228;99,13%
MULTIPOLYGON (((-58.452360205177492 -34.593077703395728,-58.451491835329414 -34.592301539705588,-58.450622169306108 -34.592943665230408,-58.449719358162959 -34.593610359400209,-58.450436495676136 -34.594255670222786,-58.450548292267754 -34.594359326152357,-58.450596070073033 -34.594402498677518,-58.4507466451822 -34.594538559506482,-58.450761689016446 -34.594548812568057,-58.451120976300082 -34.594651315996487,-58.451925736575504 -34.59487125747733,-58.452027843239883 -34.594901197199938,-58.452118793923056 -34.594928670984849,-58.45218113190419 -34.594939873995969,-58.452260075231756 -34.594962909846323,-58.452316365105133 -34.594986718398239,-58.4524853240639 -34.59502560741992,-58.452955836463993 -34.595148115480846,-58.453124454529608 -34.595194539095544,-58.453217364852087 -34.595220251581893,-58.453438527674173 -34.595279144110272,-58.45349481907602 -34.595294078531005,-58.453643100706671 -34.595183381069731,-58.454227536034644 -34.594746927075889,-58.453293818703408 -34.593912178009269,-58.453155103880029 -34.593788148273546,-58.452360205177492 -34.593077703395728)));;1755;15_9_4;COMUNA 15;9;4;734;374;360;103,89%;279;279;100,00%;0;0,00%;253;30;11,86%;223;88,14%
MULTIPOLYGON (((-58.455096341347371 -34.594106395774894,-58.455918802407488 -34.5935027585166,-58.455775997299 -34.593370421337305,-58.455672534129164 -34.593274566572369,-58.455004925657391 -34.592655910317553,-58.454095411836541 -34.591797153585269,-58.453944608501573 -34.591655447092919,-58.453250970969876 -34.591002552495368,-58.452366768373253 -34.591655394116351,-58.453233180729853 -34.592433452994925,-58.452360205177492 -34.593077703395728,-58.453155103880029 -34.593788148273546,-58.453293818703408 -34.593912178009269,-58.454227536034644 -34.594746927075889,-58.454350009431685 -34.594655805183656,-58.454965863879039 -34.594202165987461,-58.455096341347371 -34.594106395774894)));;1756;15_9_5;COMUNA 15;9;5;760;375;385;97,40%;296;296;100,00%;0;0,00%;249;13;5,22%;236;94,78%
MULTIPOLYGON (((-58.457363061161004 -34.596129764176879,-58.457525807547874 -34.596172519331184,-58.457912960393855 -34.596249298687624,-58.458049818116649 -34.596277192390112,-58.458272862004641 -34.59631283587688,-58.458399415161573 -34.59633840477855,-58.458727468766135 -34.596343063967424,-58.458936461909673 -34.596357719049912,-58.457692618698339 -34.595184248256757,-58.457564284951111 -34.595063252271466,-58.456807745470684 -34.59434417580578,-58.456026694300583 -34.593601782450378,-58.455918802407488 -34.5935027585166,-58.455096341347371 -34.594106395774894,-58.454965863879039 -34.594202165987461,-58.454350009431685 -34.594655805183656,-58.454227536034644 -34.594746927075889,-58.453643100706671 -34.595183381069731,-58.453747933854963 -34.595210925094072,-58.454155600619821 -34.595312507588027,-58.45470582852753 -34.595452902474818,-58.454944877466282 -34.595511018763261,-58.455134873415297 -34.595558074781685,-58.455216032660459 -34.595578221418144,-58.455320952199749 -34.595603369635,-58.455863861792125 -34.595720518507036,-58.455732633909378 -34.595604238938222,-58.455900403492329 -34.595642207631137,-58.455988541699355 -34.595721300106121,-58.456055995467089 -34.595671724396489,-58.456155379387454 -34.595701167536411,-58.456061608147273 -34.595773982215832,-58.456204085892693 -34.595794201940095,-58.456594979925192 -34.595912818299887,-58.456694449608676 -34.595940570797175,-58.456801243456795 -34.595968605268638,-58.457148961582767 -34.596076372262566,-58.457363061161004 -34.596129764176879)));;1757;15_9_6;COMUNA 15;9;6;612;296;316;93,67%;260;260;100,00%;0;0,00%;213;22;10,33%;191;89,67%
MULTIPOLYGON (((-58.455920505679281 -34.597695316766163,-58.456057626312358 -34.597651519793978,-58.456236394266476 -34.597590048139395,-58.45649402746146 -34.597501536957161,-58.457073338192636 -34.597302472818363,-58.457614320965263 -34.597116503431366,-58.457829878934177 -34.597039466979929,-58.457938381693864 -34.597000596512949,-58.458246768933456 -34.596926098220344,-58.459208207977397 -34.596693655694502,-58.459275403753999 -34.596677459785759,-58.45904836353057 -34.59646321951513,-58.458963117292392 -34.596382861693229,-58.458936461909673 -34.596357719049912,-58.458727468766135 -34.596343063967424,-58.458399415161573 -34.59633840477855,-58.458272862004641 -34.59631283587688,-58.458049818116649 -34.596277192390112,-58.457912960393855 -34.596249298687624,-58.457525807547874 -34.596172519331184,-58.457363061161004 -34.596129764176879,-58.457148961582767 -34.596076372262566,-58.456801243456795 -34.595968605268638,-58.456694449608676 -34.595940570797175,-58.456594979925192 -34.595912818299887,-58.456204085892693 -34.595794201940095,-58.456061608147273 -34.595773982215832,-58.456155379387454 -34.595701167536411,-58.456055995467089 -34.595671724396489,-58.455988541699355 -34.595721300106121,-58.455900403492329 -34.595642207631137,-58.455732633909378 -34.595604238938222,-58.455863861792125 -34.595720518507036,-58.455320952199749 -34.595603369635,-58.455216032660459 -34.595578221418144,-58.455134873415297 -34.595558074781685,-58.454944877466282 -34.595511018763261,-58.45470582852753 -34.595452902474818,-58.454155600619821 -34.595312507588027,-58.453747933854963 -34.595210925094072,-58.453643100706671 -34.595183381069731,-58.45349481907602 -34.595294078531005,-58.453438527674173 -34.595279144110272,-58.453217364852087 -34.595220251581893,-58.453124454529608 -34.595194539095544,-58.452955836463993 -34.595148115480846,-58.4524853240639 -34.59502560741992,-58.452316365105133 -34.594986718398239,-58.452260075231756 -34.594962909846323,-58.45218113190419 -34.594939873995969,-58.452118793923056 -34.594928670984849,-58.452027843239883 -34.594901197199938,-58.451925736575504 -34.59487125747733,-58.451120976300082 -34.594651315996487,-58.450761689016446 -34.594548812568057,-58.451330862289751 -34.594947614949014,-58.451704523576026 -34.595209490426136,-58.451886501224912 -34.595336976462384,-58.452083722289927 -34.595475731597787,-58.452607263942163 -34.595844100265175,-58.452820071765622 -34.595988630360445,-58.45365521548721 -34.59655568903711,-58.453767454242303 -34.596634221486163,-58.453816335219884 -34.596668451737791,-58.454794814882561 -34.597352700547866,-58.455484103399634 -34.597834733757843,-58.455920505679281 -34.597695316766163)));;1758;15_9_7;COMUNA 15;9;7;730;362;368;98,37%;332;332;100,00%;0;0,00%;270;40;14,81%;230;85,19%
MULTIPOLYGON (((-58.453646600109977 -34.588832002713353,-58.453157078532797 -34.589180148409021,-58.452926538688978 -34.589344080401027,-58.452896795660067 -34.589540705613331,-58.452441158170316 -34.589901034699302,-58.45222892351439 -34.590068276882626,-58.452313209561929 -34.590138573877312,-58.452486245186513 -34.590282743877445,-58.453250970969876 -34.591002552495368,-58.453944608501573 -34.591655447092919,-58.454095411836541 -34.591797153585269,-58.455004925657391 -34.592655910317553,-58.455672534129164 -34.593274566572369,-58.455775997299 -34.593370421337305,-58.455918802407488 -34.5935027585166,-58.456026694300583 -34.593601782450378,-58.456807745470684 -34.59434417580578,-58.457564284951111 -34.595063252271466,-58.457692618698339 -34.595184248256757,-58.458936461909673 -34.596357719049912,-58.458963117292392 -34.596382861693229,-58.45904836353057 -34.59646321951513,-58.459275403753999 -34.596677459785759,-58.460771752888675 -34.596590799092063,-58.461008511316265 -34.59657714010018,-58.461504852140187 -34.596546651826543,-58.462322093313247 -34.596511021904483,-58.462480244218156 -34.59650419103999,-58.463767848547207 -34.596427423014106,-58.463863743954462 -34.596429394045025,-58.464614045539811 -34.59647854142618,-58.465161401867476 -34.596576141045567,-58.465271094909994 -34.596601984859674,-58.465296985129541 -34.596605716851002,-58.465339908393659 -34.596611913354167,-58.465450483712416 -34.596617247569029,-58.465532351375806 -34.596643572701474,-58.465617252291075 -34.596701239378945,-58.46552547484724 -34.596384576406876,-58.465511846965263 -34.596338659440512,-58.465485442980146 -34.596249501643371,-58.465454695190033 -34.596145836329612,-58.465202173873024 -34.595330755010295,-58.465107082109469 -34.594990974784515,-58.465025576103649 -34.594721397134187,-58.464826724838645 -34.594042245403436,-58.464679127012225 -34.593547580526668,-58.464440572431627 -34.592748397688148,-58.464381807455531 -34.592551489315433,-58.464409142308909 -34.592467260250139,-58.465028074698999 -34.591936383905683,-58.465952967203016 -34.591145486261411,-58.465977662748081 -34.591129287772858,-58.466116298254008 -34.5910384352836,-58.466318886195836 -34.5909082834158,-58.466530670395542 -34.590772285617192,-58.466592323682647 -34.590735169510815,-58.466770130089103 -34.590628046762909,-58.466771164128396 -34.590627613699425,-58.466827519389149 -34.590593549000126,-58.466815171955531 -34.590580421420704,-58.466650946477301 -34.590424597382082,-58.46651093427807 -34.590293147924548,-58.466348815396366 -34.59013993507336,-58.466163537372289 -34.589964088212859,-58.465983523719395 -34.589794334814911,-58.465805616264468 -34.589628063316304,-58.465644552727689 -34.589477461153358,-58.465451908808966 -34.589295519479862,-58.465269792641308 -34.589123153390176,-58.46508557185691 -34.588949045953235,-58.464898193777223 -34.588771456066411,-58.4647108164949 -34.588593865886708,-58.464520282013396 -34.588414534349305,-58.464336064373441 -34.588241296316603,-58.464139215536569 -34.588057611478199,-58.463942367540142 -34.587872185204674,-58.463751836378925 -34.587694593558389,-58.463574990495758 -34.587529189297527,-58.463381302952378 -34.587348114860845,-58.463190774181065 -34.587170522323333,-58.46302550958022 -34.587024269440718,-58.462976087983634 -34.586982513022349,-58.462830771793278 -34.586859734685866,-58.462611824279811 -34.586674306251425,-58.462394982996152 -34.586488877423839,-58.462183405763774 -34.586310412677932,-58.461966566369405 -34.586125853634421,-58.461865515330452 -34.586039667910875,-58.461700254550131 -34.585955222706012,-58.461462363840511 -34.585832472082316,-58.4612192097795 -34.585763695422827,-58.460971845645062 -34.585694918218572,-58.460771849431524 -34.585638329058931,-58.460526591271091 -34.585569550984076,-58.460378709795059 -34.58552804208702,-58.460405765846026 -34.585431545567232,-58.460413941372416 -34.585402389603288,-58.460446302754526 -34.585287737645665,-58.460425527659353 -34.585203226772762,-58.460470663309401 -34.585036108113115,-58.460535637448224 -34.584943922422028,-58.460534553748161 -34.584046139213456,-58.460533219759213 -34.582950249129098,-58.458831561873453 -34.58300626570059,-58.457495604008336 -34.583402992915829,-58.45620807832664 -34.58388288049067,-58.454913980872661 -34.584365359765641,-58.454828074877597 -34.584230630432351,-58.454184081613654 -34.584940334514798,-58.453964872751307 -34.585181737321349,-58.454245748636374 -34.585620084816838,-58.454930898209547 -34.586689368607715,-58.455115229675357 -34.586979880959177,-58.455116092682687 -34.586981187359783,-58.455364039357178 -34.587103507171406,-58.455440572630273 -34.587186257963168,-58.455441088793187 -34.587186300682085,-58.455518138002923 -34.587267256124569,-58.455566029443169 -34.587365433408408,-58.455634260672895 -34.587503315848259,-58.455634181014986 -34.587503781748694,-58.455590987390714 -34.587756410389673,-58.455416027563288 -34.587988918544788,-58.455048696801967 -34.588027559253767,-58.454999212818969 -34.588117630193928,-58.454501779801667 -34.588483246316919,-58.454342977549352 -34.588336680352057,-58.453646600109977 -34.588832002713353)));;1759;15_9_8;COMUNA 15;9;8;2324;1140;1184;96,28%;668;668;100,00%;0;0,00%;727;168;23,11%;559;76,89%
MULTIPOLYGON (((-58.387623988884421 -34.569201319994036,-58.387421462162116 -34.569185983345648,-58.387175946034915 -34.569165549130815,-58.387053178832474 -34.569165473114644,-58.38687525221868 -34.569155221443161,-58.386697254417541 -34.569129687119286,-58.386531493226315 -34.569129583802543,-58.386310581991516 -34.569109163197439,-58.386083460603707 -34.569083597228392,-58.385985302679494 -34.569078464940475,-58.385868665448328 -34.5690783915853,-58.385696821331557 -34.569027506470036,-58.385518814730524 -34.569012182130145,-58.385291755427815 -34.569012038358338,-58.385101484557126 -34.569001776273225,-58.384947992799511 -34.568991466897479,-58.384812985104958 -34.568971098267092,-58.384585949626931 -34.568945599992212,-58.384426318639257 -34.568945497739634,-58.384211543072475 -34.568919936203478,-58.384002807483924 -34.568899519250124,-58.383800282236543 -34.56888410616947,-58.383597756997837 -34.568868763178465,-58.383413626116251 -34.568848361158913,-58.383186581817647 -34.568832931132455,-58.383014715593788 -34.5688074658582,-58.382775312085755 -34.568807309347278,-58.38262803100536 -34.568802142187643,-58.382560537317708 -34.568781815332628,-58.382431694608982 -34.568725812776286,-58.382315092037786 -34.568690241560404,-58.382161676493944 -34.568690140439514,-58.382075698658177 -34.56867994240212,-58.381946817148432 -34.568664574863341,-58.381811810720649 -34.56864420291442,-58.381768826758183 -34.56863403314216,-58.381621477075164 -34.568699924125163,-58.381510930700081 -34.568740486206849,-58.381418863808939 -34.568775919427225,-58.3813390514715 -34.568816501812869,-58.381265288686514 -34.568852017540593,-58.381222350252358 -34.568882412734901,-58.381191576340051 -34.568923027744248,-58.381154742853163 -34.568978850620923,-58.38113621863954 -34.569029615079828,-58.381111610009626 -34.569121011021259,-58.381105425613711 -34.56917685436192,-58.381062322387073 -34.569288520490325,-58.381074492767183 -34.569379941011498,-58.381080638330594 -34.569451004514214,-58.381080568826633 -34.56952213428599,-58.381080469593854 -34.569623687879478,-58.381067985805572 -34.569765798312375,-58.381074046184878 -34.569836932179548,-58.381037187428035 -34.569918108195765,-58.381012573467075 -34.570014574740128,-58.381000114302267 -34.570131331973528,-58.380975530071559 -34.570197304261917,-58.380957085652781 -34.570253139376312,-58.380926256429404 -34.570349601735749,-58.380873814764954 -34.570433091298966,-58.380686867267691 -34.570417049665679,-58.38066216465316 -34.570429850516994,-58.380628879142741 -34.570426306865002,-58.380401579899498 -34.57040657552983,-58.380232692585381 -34.570379629415271,-58.379918218925212 -34.57035314782847,-58.379525341152245 -34.570318865223818,-58.379491118656638 -34.57031588402765,-58.379460386256341 -34.570313468606265,-58.37942386539288 -34.570310133695905,-58.379392877582902 -34.570307718083555,-58.379360272435761 -34.570305019656665,-58.379333200762076 -34.570302817979112,-58.379300595548457 -34.570300189961785,-58.379251645620272 -34.570295790124391,-58.3792248299996 -34.570292954768099,-58.37920005585957 -34.570291951866523,-58.379146934819325 -34.570286915303953,-58.379098323132524 -34.570284839680191,-58.379074484243986 -34.570285105053571,-58.379041023575553 -34.5702865610629,-58.379017012364436 -34.570288868647978,-58.378972821849132 -34.570292782176772,-58.378949149914831 -34.570296357641134,-58.378926329428076 -34.570299863259471,-58.378898568821555 -34.57030547824921,-58.378875490372145 -34.570311519000946,-58.378845173217101 -34.570319526691392,-58.37880625196226 -34.570332669526763,-58.378774568977065 -34.57034426796416,-58.378752338489967 -34.570353689702038,-58.378733089171604 -34.570361775401118,-58.378696206232853 -34.570379849391777,-58.378673717833856 -34.570391735832089,-58.378654721999808 -34.570401723183075,-58.378632573928414 -34.570413821126714,-58.378585210598544 -34.570440198080448,-58.378550284420413 -34.5704596114605,-58.378410914128402 -34.570543180857214,-58.37836150534811 -34.570571528226338,-58.378178608721214 -34.570675138556538,-58.377793553407919 -34.570901430314443,-58.377695926122946 -34.570958900038818,-58.377527847050679 -34.571057519490012,-58.377384131512002 -34.571142211481344,-58.377233346203973 -34.571229785799503,-58.377120044871894 -34.571294779616991,-58.37705513031883 -34.571332482178072,-58.37683048374587 -34.571463808834885,-58.376691113178033 -34.57154434795337,-58.376548763049264 -34.571624321404315,-58.376445602482292 -34.571679391747026,-58.376426605507433 -34.571689942152084,-58.376282641601286 -34.571765688617923,-58.376121726578226 -34.571849240125132,-58.376029982918304 -34.571895867147461,-58.375990796368214 -34.571917389530576,-58.375954249343735 -34.571938702500212,-58.375866073814116 -34.571992585763752,-58.375819554911608 -34.572023962449478,-58.375789135141439 -34.57204788547471,-58.375757008967646 -34.572075258127782,-58.375726585200638 -34.572102984112895,-58.375694797563341 -34.572132258479726,-58.375675280379589 -34.572151611587337,-58.375631129006159 -34.57219855392988,-58.375601293787092 -34.572233322855674,-58.375581089268337 -34.572258591201646,-58.375564720221362 -34.572279848026859,-58.375544596484225 -34.572309271530521,-58.375522165132629 -34.572347144445587,-58.375506295791162 -34.572379035874114,-58.375498615249164 -34.572396214215757,-58.375483846826704 -34.57243374046957,-58.375471292401315 -34.57247091617586,-58.375464885120365 -34.572491757552278,-58.375450437067911 -34.572548580623867,-58.375444962124135 -34.572573436920159,-58.375439658487679 -34.572597307381251,-58.37543597847327 -34.57261547453539,-58.375431270813465 -34.572639345422033,-58.375427158029169 -34.572664273116551,-58.375422952963376 -34.57269603202046,-58.375419258221342 -34.57272828426759,-58.37541685118078 -34.572750396160181,-58.375413491622609 -34.572787789709558,-58.375412195232009 -34.572806240268939,-58.375410207485892 -34.572834479481209,-58.375409161141945 -34.572858071282191,-58.37550629056593 -34.572873352614494,-58.375509330036905 -34.572816310114213,-58.375511400022198 -34.572790817554242,-58.375516735188853 -34.572736734564707,-58.375519572168081 -34.572710538296874,-58.375522147990701 -34.572689835033103,-58.375526693506117 -34.572658146794367,-58.375533455825348 -34.57262343184086,-58.375538930599113 -34.572598716391667,-58.375544320082447 -34.572574141732325,-58.375549794041333 -34.572550200962553,-58.375555778176725 -34.572526894386542,-58.375562358436618 -34.572503447384555,-58.375572608827596 -34.572471270236761,-58.375592669856452 -34.572420366899649,-58.375602739002552 -34.57239868302284,-58.375613658148254 -34.572378337836547,-58.375624149679631 -34.57235982340783,-58.375640608271816 -34.572334341106973,-58.375658684659534 -34.572308719106367,-58.375691591521182 -34.572267614059015,-58.37572884121623 -34.572225807841519,-58.375756881992032 -34.57219723505284,-58.375804522559527 -34.572151703659245,-58.375854033366409 -34.572108849747387,-58.375885220202903 -34.572084152570959,-58.375912569514917 -34.572065438828126,-58.375932335238431 -34.572052635433224,-58.37595286750539 -34.572039550877733,-58.376002790928382 -34.572009162516736,-58.376052457288885 -34.571980323314349,-58.376092324750267 -34.571959012671392,-58.376137472449706 -34.571936156398166,-58.376182705191056 -34.57191337059394,-58.376470802766448 -34.571762793383321,-58.376604375654694 -34.571690771920359,-58.376717080355206 -34.571627327527935,-58.37679928810951 -34.571580341148753,-58.376872892375303 -34.571537574197023,-58.37694521947909 -34.571494806303356,-58.377182472292596 -34.571357854225162,-58.377477142320949 -34.571187207948014,-58.377624521031372 -34.571100335209103,-58.377798137951309 -34.570997916497937,-58.3779151033144 -34.570928980761671,-58.378249725361897 -34.57073350013011,-58.378320175532721 -34.570693195010662,-58.378442163833455 -34.570623628407283,-58.378548820819553 -34.57056024856135,-58.37860001948691 -34.570529860008456,-58.378638354538559 -34.570507138961112,-58.378678307617967 -34.570483996462009,-58.378700967379693 -34.570471053755718,-58.378728482269267 -34.570455860767531,-58.378764086960992 -34.570438983122777,-58.378799518886396 -34.570424570243112,-58.378832820722955 -34.570411775677307,-58.378865866499183 -34.570399614756496,-58.378897975182696 -34.570388016587735,-58.378920884223348 -34.570381130608936,-58.378948304442879 -34.570375374529796,-58.378969932452989 -34.570372431493674,-58.379061378671722 -34.570364465671439,-58.379135623976815 -34.57035951630548,-58.379130053509947 -34.570395992927473,-58.379166225395174 -34.57040777875271,-58.379218706234411 -34.570371968049287,-58.379399098000086 -34.570387725755175,-58.379588769175911 -34.570404193768177,-58.379843736119163 -34.570425917315212,-58.380312040946492 -34.570466235997834,-58.380305955572304 -34.570507360412051,-58.380299096097779 -34.570556442390263,-58.380288120727101 -34.570635170745156,-58.380284084206657 -34.570670662496454,-58.380280987817848 -34.570702492753618,-58.380278491564766 -34.570730097883001,-58.380275226840773 -34.570759956110649,-58.380315408746405 -34.570763434088036,-58.380348439656913 -34.570766273398092,-58.38035153137038 -34.570739161648035,-58.380352493512945 -34.570713175269944,-58.3803538746809 -34.570693950027042,-58.380359016026297 -34.570660430934147,-58.380362701409034 -34.570635643626886,-58.380365450685694 -34.570610433134718,-58.380370003412231 -34.570569448535657,-58.380376017503842 -34.570514238960335,-58.380380656260243 -34.570472338886262,-58.380397287122236 -34.570442982645652,-58.380680516570742 -34.570468456051238,-58.380676574284855 -34.5704948629839,-58.381125216229684 -34.57053185533227,-58.381163657074644 -34.570574488472872,-58.381150766568524 -34.570697161168994,-58.381104669525385 -34.570735230586486,-58.381189031315181 -34.570745850780035,-58.381063212925021 -34.570816403524915,-58.380757312252534 -34.570988036894896,-58.378338153583734 -34.572281021611019,-58.378312511028653 -34.572296286226077,-58.378297935233611 -34.572312966998808,-58.378286501852877 -34.572337326325453,-58.378246484660714 -34.572675482021047,-58.378251564738257 -34.572703514894172,-58.378261081018778 -34.572722747645351,-58.378277749736561 -34.572741351512953,-58.378297999625261 -34.572754746365767,-58.378321913190668 -34.572765538003424,-58.378357239632223 -34.57277232326792,-58.378408746100263 -34.572775809696701,-58.378454972943011 -34.572780207991833,-58.383524109542307 -34.573184463338691,-58.383546841747631 -34.573184900634658,-58.383575527073631 -34.573192454762882,-58.383595859528555 -34.573209581342816,-58.383602050867147 -34.573234868117069,-58.383588630996293 -34.573380428970182,-58.38357233195768 -34.573419574994091,-58.383552397731115 -34.573431393557378,-58.383046300024539 -34.573718823011838,-58.381890806524652 -34.574375063106167,-58.381867974957089 -34.574388992239179,-58.381844377648662 -34.574402357456634,-58.38182223415938 -34.574409103635197,-58.381793712991836 -34.574407605798378,-58.381766811572447 -34.574403996263726,-58.37611324523445 -34.573952985241874,-58.37551423788922 -34.5739055850486,-58.3754385265092 -34.573925179663966,-58.373295045192393 -34.575155863462811,-58.370760796907234 -34.576597914585861,-58.370742216527468 -34.576615084404757,-58.370695797561481 -34.577015347802075,-58.370699775000226 -34.577037464397193,-58.370717294570625 -34.577055858648322,-58.370744278326079 -34.577062358123229,-58.370769223185405 -34.577064700953891,-58.376005030905702 -34.577478901308879,-58.376035850181871 -34.577482092341171,-58.376057975879846 -34.577493728251007,-58.376067144164701 -34.577520144308728,-58.376046190913975 -34.577691474592804,-58.376039954979504 -34.577711048444641,-58.376015838933178 -34.577730187046335,-58.375161577505025 -34.578214034114012,-58.374303728020109 -34.57869977404517,-58.3738505825076 -34.57894498558219,-58.373972662806899 -34.5791002663181,-58.373971739765643 -34.579102296303169,-58.375126962143703 -34.580535192916891,-58.376011101490874 -34.580030865147833,-58.376161962059733 -34.579948318648306,-58.379838201737435 -34.580162578897813,-58.38285750642455 -34.578428206957817,-58.38301665274534 -34.578343733380677,-58.383215568421086 -34.578255761433304,-58.383371831195703 -34.578215923680041,-58.383553644499599 -34.578190198560364,-58.383735437696437 -34.578185617551988,-58.383917246390155 -34.578164590641833,-58.384266644718601 -34.578140147202539,-58.38445695250757 -34.578142618722381,-58.384712573054102 -34.57816392671235,-58.385411282063195 -34.578209009315685,-58.385616139384958 -34.57822214070211,-58.385729905848045 -34.578209817615232,-58.385949405437209 -34.57821728008448,-58.386065548951798 -34.578212564129743,-58.386181042953893 -34.578210669003631,-58.386408259646899 -34.578231955632567,-58.386519874897282 -34.578133760738424,-58.386628552308444 -34.578099531317299,-58.386734424943889 -34.578059666016202,-58.386835156554824 -34.578040368271729,-58.38892529989554 -34.578186951468737,-58.389200167144878 -34.57818503509781,-58.389728606799672 -34.577833595978639,-58.390381170294759 -34.57733361136804,-58.390956649000998 -34.576759067776166,-58.391267662010804 -34.576284793676891,-58.39145569315879 -34.575946649933208,-58.391663745603189 -34.575591897115878,-58.391945572914992 -34.575287118390314,-58.392408444260923 -34.574943568509411,-58.392958398440641 -34.574616757484037,-58.393575357608704 -34.574389774877055,-58.394084255699674 -34.574281817991078,-58.393271438949242 -34.573318993644875,-58.393752104220134 -34.573059325472315,-58.394018117066373 -34.572915596081145,-58.39456820216671 -34.572612933713714,-58.394831403479529 -34.572468074159687,-58.395205818732599 -34.572190664289522,-58.394820293937968 -34.57230939924775,-58.394451138344472 -34.572295319575659,-58.39432351746499 -34.572290459218024,-58.394191302682692 -34.572281159339894,-58.39392474488298 -34.572262346678258,-58.393177984498131 -34.572213568830861,-58.392787192516657 -34.572234716766197,-58.392673202680115 -34.572486947780327,-58.390698837233522 -34.573571996765494,-58.38747742054386 -34.575312879151696,-58.38523727101601 -34.576536055846326,-58.383414881617618 -34.576404739405838,-58.382906007543419 -34.575746774597484,-58.382887153888781 -34.575696337618851,-58.382858322122722 -34.575663007505256,-58.382885728531242 -34.575584148876985,-58.382914397637073 -34.575520362122703,-58.38297083197584 -34.575447579036634,-58.383054924551885 -34.575388617370955,-58.383161232565875 -34.575336783099985,-58.383963290733327 -34.574874396300082,-58.391301604257464 -34.570643447464676,-58.391324280225547 -34.570609304331342,-58.391338703726305 -34.570568184239463,-58.391330726190525 -34.570538389565215,-58.391314494173834 -34.57050401240209,-58.391193278628606 -34.570280340308855,-58.391032899737866 -34.570057419782067,-58.390907905013293 -34.569972976510293,-58.390811982228854 -34.569941228555074,-58.390684015324361 -34.56994713930029,-58.390667898403095 -34.56987846486669,-58.39062503292309 -34.569827662733147,-58.390588203433524 -34.569787075856937,-58.390569848846603 -34.569746429461773,-58.390563736534276 -34.569726072861314,-58.390533001956669 -34.569726054695401,-58.3905269422307 -34.569644850435317,-58.390520873813905 -34.569573717024824,-58.390520926454791 -34.569512798940032,-58.390484119134747 -34.569446788413281,-58.390404376501621 -34.56941117630015,-58.390300038079431 -34.569365478693179,-58.390238654326922 -34.569365442271234,-58.39018960663099 -34.569375554428774,-58.39003610907433 -34.569370392513626,-58.389870450275744 -34.569349940801956,-58.38972308264654 -34.569344782150104,-58.389600324048629 -34.569334567418771,-58.389428526613528 -34.569324323138808,-58.389226012698799 -34.569293707143295,-58.388992746567176 -34.569283425236968,-58.388734974607971 -34.569257845690267,-58.388630596825841 -34.569257782401472,-58.38856919059171 -34.569283168757131,-58.38850780239823 -34.569288202103237,-58.388471023264373 -34.569288179744191,-58.388378918691124 -34.569272911779592,-58.388293006557539 -34.56928300072525,-58.38818865142381 -34.569257513441805,-58.388084358780205 -34.569257449737911,-58.387992267917426 -34.569226969566834,-58.38788797531241 -34.569226905695317,-58.387789750222133 -34.569201421827472,-58.387623988884421 -34.569201319994036)));;1760;2_1_1;COMUNA 1;1;1;105;63;42;150,00%;14;9;64,29%;5;55,56%;21;8;38,10%;13;61,90%
MULTIPOLYGON (((-58.398978210908112 -34.57005231843204,-58.39879730864503 -34.570143495398085,-58.398350990520612 -34.570397919775004,-58.395205818732599 -34.572190664289522,-58.394831403479529 -34.572468074159907,-58.39456820216671 -34.572612933713714,-58.394018117066373 -34.572915596081145,-58.393752104220134 -34.573059325472315,-58.393271438949242 -34.573318993644875,-58.394084255699674 -34.574281817991078,-58.393575357608704 -34.574389774877091,-58.392958398440641 -34.574616757484037,-58.392408444260923 -34.574943568509411,-58.391945572914992 -34.575287118390314,-58.391663745603189 -34.575591897116013,-58.39145569315879 -34.575946649933208,-58.391267662010804 -34.576284793676905,-58.390956649000998 -34.576759067776166,-58.390381170294773 -34.577333611367997,-58.389728606799672 -34.577833595978639,-58.389200167144878 -34.57818503509781,-58.389484181712866 -34.578225680180928,-58.389914910713699 -34.578240132599468,-58.390155464679097 -34.578607258363469,-58.390906770492734 -34.579733450114247,-58.391004015846079 -34.579881157348645,-58.391223489901542 -34.580188611055718,-58.391611097134088 -34.580765739184173,-58.392203230949846 -34.580513541747862,-58.392268834376885 -34.580467098830283,-58.392664923491587 -34.580289009528428,-58.393106755488638 -34.580086789097017,-58.394034962812299 -34.579660959141265,-58.394086426045867 -34.579723032905861,-58.394307979691973 -34.579619490985955,-58.394518874364437 -34.579534323751595,-58.394599251466239 -34.579641204037983,-58.394617284637008 -34.579663398115997,-58.394682703310771 -34.579632236113625,-58.396420719778391 -34.578791608045918,-58.396662668030601 -34.578669655392147,-58.396582320808548 -34.578542213278944,-58.396559474961506 -34.578506408493965,-58.397147078344517 -34.578120058653468,-58.39720552006888 -34.578079925897811,-58.398060838616402 -34.577515535654051,-58.398128796098099 -34.57746974757162,-58.398429081780904 -34.577272581363701,-58.398482766741324 -34.577237365340586,-58.398583073815168 -34.577171566205863,-58.398761960755856 -34.577073933766776,-58.398982509416228 -34.576956852449378,-58.399265546482169 -34.576815839689495,-58.399528653636096 -34.576689044304352,-58.399780891587518 -34.576567484769619,-58.399929427076223 -34.576494921783791,-58.400123713498523 -34.57638231804566,-58.40035876052572 -34.576243524704331,-58.400601963421224 -34.576093502148908,-58.400849700585418 -34.575932248494723,-58.401144992895638 -34.575737694030288,-58.401167837015954 -34.575717500959044,-58.401236684411089 -34.575661082338215,-58.401655027521883 -34.575315205199708,-58.401845280751949 -34.575089400632699,-58.40209620575073 -34.574783324123104,-58.402321281215379 -34.574514754269842,-58.402549845201477 -34.574241379242707,-58.402617889850305 -34.574161144782572,-58.402647090942622 -34.574140968282293,-58.402644715081934 -34.574138719636728,-58.402515582619451 -34.574011236783114,-58.402140959851472 -34.57363194068575,-58.402039363735376 -34.573525295579763,-58.401898957179988 -34.573326589795847,-58.401827550037943 -34.573226405822929,-58.401776602322322 -34.573154964475521,-58.401757406607331 -34.57312775447862,-58.400555285489276 -34.57179088210728,-58.400533426245637 -34.571761855651417,-58.400377859943283 -34.5715557815968,-58.400286157335074 -34.571452068333663,-58.399916627016957 -34.571034184878187,-58.399721523743779 -34.570762382577286,-58.399659577773797 -34.570490648792358,-58.399668694623706 -34.570255643397395,-58.399775412327955 -34.569976672363353,-58.399987793181417 -34.569611394216032,-58.400125652295358 -34.56935079656683,-58.399339758784372 -34.569870033983101,-58.398978210908112 -34.57005231843204)));;1761;2_1_2;COMUNA 2;1;2;518;268;250;107,20%;124;124;100,00%;0;0,00%;133;36;27,07%;97;72,93%
MULTIPOLYGON (((-58.40190870538737 -34.586468300480355,-58.401048092982371 -34.586985636119358,-58.400948075846891 -34.58704671477529,-58.401880591288688 -34.587771930504346,-58.401980083909748 -34.587846842206183,-58.402980496076466 -34.587250199167919,-58.40190870538737 -34.586468300480355)));;1762;2_10_1;COMUNA 2;10;1;975;437;538;81,23%;736;736;100,00%;0;0,00%;519;5;0,96%;514;99,04%
MULTIPOLYGON (((-58.40190870538737 -34.586468300480355,-58.401177366432101 -34.585934673018997,-58.400217660709686 -34.586531744806379,-58.400849267806471 -34.586969830659868,-58.400948075846891 -34.58704671477529,-58.401048092982371 -34.586985636119358,-58.40190870538737 -34.586468300480355)));;1763;2_10_2;COMUNA 2;10;2;637;266;371;71,70%;553;552;99,82%;1;0,18%;366;2;0,55%;364;99,45%
MULTIPOLYGON (((-58.399930885993513 -34.585025339516875,-58.399297424587957 -34.585596936672026,-58.399113792555433 -34.585762481644018,-58.399312263766298 -34.585903787782449,-58.400217660709686 -34.586531744806379,-58.401177366432101 -34.585934673018997,-58.399930885993513 -34.585025339516875)));;1764;2_10_3;COMUNA 2;10;3;441;202;239;84,52%;327;326;99,69%;1;0,31%;209;1;0,48%;208;99,52%
MULTIPOLYGON (((-58.399113792555433 -34.585762481644018,-58.39894379382654 -34.585915709015602,-58.398243511600917 -34.586547127252679,-58.399167037788366 -34.58718524283055,-58.400217660709686 -34.586531744806379,-58.399312263766298 -34.585903787782449,-58.399113792555433 -34.585762481644018)));;1765;2_10_4;COMUNA 2;10;4;785;351;434;80,88%;492;491;99,80%;1;0,20%;344;1;0,29%;343;99,71%
MULTIPOLYGON (((-58.400948075846891 -34.58704671477529,-58.400849267806471 -34.586969830659868,-58.400217660709686 -34.586531744806379,-58.399167037788366 -34.58718524283055,-58.399786815104612 -34.587613468425417,-58.399890389841751 -34.587692750308427,-58.400948075846891 -34.58704671477529)));;1766;2_10_5;COMUNA 2;10;5;812;371;441;84,13%;672;672;100,00%;0;0,00%;426;6;1,41%;420;98,59%
MULTIPOLYGON (((-58.400948075846891 -34.58704671477529,-58.399890389841751 -34.587692750308427,-58.399999326466933 -34.587776189953829,-58.400838387038391 -34.588437841839898,-58.400902045727136 -34.588489636726969,-58.401980083909748 -34.587846842206183,-58.401880591288688 -34.587771930504346,-58.400948075846891 -34.58704671477529)));;1767;2_10_6;COMUNA 2;10;6;695;322;373;86,33%;403;402;99,75%;1;0,25%;321;3;0,93%;318;99,07%
MULTIPOLYGON (((-58.399890389841751 -34.587692750308427,-58.398749706358302 -34.588389439389346,-58.3998273136677 -34.589130310590747,-58.400001197205597 -34.589026804363506,-58.400902045727136 -34.588489636726969,-58.400838387038391 -34.588437841839898,-58.399999326466933 -34.587776189953829,-58.399890389841751 -34.587692750308427)));;1768;2_10_7;COMUNA 2;10;7;868;366;502;72,91%;713;713;100,00%;0;0,00%;483;2;0,41%;481;99,59%
MULTIPOLYGON (((-58.399890389841751 -34.587692750308427,-58.399786815104612 -34.587613468425417,-58.399167037788366 -34.58718524283055,-58.39801867755012 -34.587899527480552,-58.398749706358302 -34.588389439389346,-58.399890389841751 -34.587692750308427)));;1769;2_10_8;COMUNA 2;10;8;856;358;498;71,89%;624;624;100,00%;0;0,00%;443;3;0,68%;440;99,32%
MULTIPOLYGON (((-58.398243511600917 -34.586547127252679,-58.397568783401525 -34.587155385094192,-58.397287146669221 -34.587409258762662,-58.39801867755012 -34.587899527480552,-58.399167037788366 -34.58718524283055,-58.398243511600917 -34.586547127252679)));;1770;2_10_9;COMUNA 2;10;9;611;285;326;87,42%;407;407;100,00%;0;0,00%;299;3;1,00%;296;99,00%
MULTIPOLYGON (((-58.406398224353566 -34.583808515090148,-58.405064973377826 -34.58459215008449,-58.405894073355462 -34.585512717025338,-58.407091807139686 -34.584798450869428,-58.406398224353566 -34.583808515090148)));;1771;2_11_1;COMUNA 2;11;1;1196;495;701;70,61%;900;900;100,00%;0;0,00%;621;3;0,48%;618;99,52%
MULTIPOLYGON (((-58.405359872729868 -34.583452946744231,-58.404026664812399 -34.583442594395876,-58.404247973932591 -34.583684823155124,-58.405064973377826 -34.58459215008449,-58.406398224353566 -34.583808515090148,-58.406172382963348 -34.583459241503078,-58.405359872729868 -34.583452946744231)));;1772;2_11_2;COMUNA 2;11;2;564;245;319;76,80%;307;307;100,00%;0;0,00%;241;1;0,41%;240;99,59%
MULTIPOLYGON (((-58.404026664812399 -34.583442594395876,-58.402043926335487 -34.583427187904427,-58.402067212174245 -34.583490018943053,-58.403548538213684 -34.585487939827203,-58.404954741204186 -34.584656889347549,-58.405064973377826 -34.58459215008449,-58.404247973932591 -34.583684823155124,-58.404026664812399 -34.583442594395876)));;1773;2_11_3;COMUNA 2;11;3;1643;701;942;74,42%;975;970;99,49%;5;0,52%;672;17;2,53%;655;97,47%
MULTIPOLYGON (((-58.405064973377826 -34.58459215008449,-58.404954741204186 -34.584656889347549,-58.403548538213684 -34.585487939827203,-58.404517335630302 -34.586333791855282,-58.405894073355462 -34.585512717025338,-58.405064973377826 -34.58459215008449)));;1774;2_11_4;COMUNA 2;11;4;1393;600;793;75,66%;882;882;100,00%;0;0,00%;668;38;5,69%;630;94,31%
MULTIPOLYGON (((-58.403548538213684 -34.585487939827203,-58.402847767752505 -34.585903741787803,-58.402765133374977 -34.585952646877161,-58.403659810560029 -34.586845161247311,-58.404517335630302 -34.586333791855282,-58.403548538213684 -34.585487939827203)));;1775;2_11_5;COMUNA 2;11;5;309;133;176;75,57%;231;231;100,00%;0;0,00%;169;0;0,00%;169;100,00%
MULTIPOLYGON (((-58.40190870538737 -34.586468300480355,-58.402980496076466 -34.587250199167919,-58.403659810560029 -34.586845161247311,-58.402765133374977 -34.585952646877161,-58.402847767752505 -34.585903741787803,-58.403548538213684 -34.585487939827203,-58.402067212174245 -34.583490018943053,-58.402043926335487 -34.583427187904427,-58.40194310773196 -34.583426363078139,-58.401345927466444 -34.583792769448948,-58.401215409716244 -34.583881439781408,-58.401126636988991 -34.583941820026993,-58.400543718374358 -34.584471827838954,-58.400472312220856 -34.584536794096351,-58.399930885993513 -34.585025339516875,-58.401177366432101 -34.585934673018997,-58.40190870538737 -34.586468300480355)));;1776;2_11_6;COMUNA 2;11;6;527;238;289;82,35%;499;499;100,00%;0;0,00%;305;1;0,33%;304;99,67%
MULTIPOLYGON (((-58.408038247127045 -34.586149144470831,-58.407625723100381 -34.585560484472026,-58.40662337746295 -34.586326115386335,-58.407352270142773 -34.587139297825203,-58.407442978879665 -34.587239976785625,-58.408316698126171 -34.586545904619399,-58.408136083069081 -34.586288841786434,-58.408038247127045 -34.586149144470831)));;1777;2_12_1;COMUNA 2;12;1;970;402;568;70,77%;593;591;99,66%;2;0,34%;435;1;0,23%;434;99,77%
MULTIPOLYGON (((-58.407091807139686 -34.584798450869428,-58.405894073355462 -34.585512717025338,-58.405968356230616 -34.585595290135124,-58.40662337746295 -34.586326115386335,-58.407625723100381 -34.585560484472026,-58.407091807139686 -34.584798450869428)));;1778;2_12_2;COMUNA 2;12;2;818;334;484;69,01%;568;568;100,00%;0;0,00%;402;2;0,50%;400;99,50%
MULTIPOLYGON (((-58.40662337746295 -34.586326115386335,-58.405968356230616 -34.585595290135124,-58.405894073355462 -34.585512717025338,-58.404517335630302 -34.586333791855282,-58.404622097454968 -34.586424549643652,-58.405497820045646 -34.587178021780808,-58.405593749557667 -34.587112571110147,-58.40662337746295 -34.586326115386335)));;1779;2_12_3;COMUNA 2;12;3;943;391;552;70,83%;595;595;100,00%;0;0,00%;457;1;0,22%;456;99,78%
MULTIPOLYGON (((-58.40662337746295 -34.586326115386335,-58.405593749557667 -34.587112571110147,-58.405497820045646 -34.587178021780808,-58.405598414279169 -34.58726455124399,-58.406451101133477 -34.587982511283315,-58.407332815114799 -34.587327465593276,-58.407442978879665 -34.587239976785625,-58.407352270142773 -34.587139297825203,-58.40662337746295 -34.586326115386335)));;1780;2_12_4;COMUNA 2;12;4;1250;529;721;73,37%;1003;1003;100,00%;0;0,00%;704;5;0,71%;699;99,29%
MULTIPOLYGON (((-58.405497820045646 -34.587178021780808,-58.405375650242092 -34.587261418522282,-58.404556719351731 -34.587739923613242,-58.404054434857834 -34.588033357042306,-58.405230702356178 -34.588889091718904,-58.406451101133477 -34.587982511283315,-58.405598414279169 -34.58726455124399,-58.405497820045646 -34.587178021780808)));;1781;2_12_5;COMUNA 2;12;5;1242;551;691;79,74%;828;828;100,00%;0;0,00%;615;20;3,25%;595;96,75%
MULTIPOLYGON (((-58.403659810560029 -34.586845161247311,-58.402980496076466 -34.587250199167919,-58.403922510512146 -34.587937444659445,-58.404054434857834 -34.588033357042306,-58.404556719351731 -34.587739923613242,-58.405375650242092 -34.587261418522282,-58.405497820045646 -34.587178021780808,-58.404622097454968 -34.586424549643652,-58.404517335630302 -34.586333791855282,-58.403659810560029 -34.586845161247311)));;1782;2_12_6;COMUNA 2;12;6;983;427;556;76,80%;655;655;100,00%;0;0,00%;498;2;0,40%;496;99,60%
MULTIPOLYGON (((-58.404054434857834 -34.588033357042306,-58.403891634610389 -34.588128493788872,-58.403037503391751 -34.588626056911885,-58.404318793696362 -34.589566854981847,-58.404434838754753 -34.589480357693056,-58.405230702356178 -34.588889091718904,-58.404054434857834 -34.588033357042306)));;1783;2_13_1;COMUNA 2;13;1;1196;526;670;78,51%;887;886;99,89%;1;0,11%;595;0;0,00%;595;100,00%
MULTIPOLYGON (((-58.402980496076466 -34.587250199167919,-58.401980083909748 -34.587846842206183,-58.402129450884608 -34.587959244881588,-58.403037503391751 -34.588626056911885,-58.403891634610389 -34.588128493788872,-58.404054434857834 -34.588033357042306,-58.403922510512146 -34.587937444659445,-58.402980496076466 -34.587250199167919)));;1784;2_13_2;COMUNA 2;13;2;890;386;504;76,59%;573;573;100,00%;0;0,00%;418;4;0,96%;414;99,04%
MULTIPOLYGON (((-58.401980083909748 -34.587846842206183,-58.400902045727136 -34.588489636726969,-58.401783062554713 -34.589206868885697,-58.401893449080667 -34.589292561156576,-58.403037503391751 -34.588626056911885,-58.402129450884608 -34.587959244881588,-58.401980083909748 -34.587846842206183)));;1785;2_13_3;COMUNA 2;13;3;973;409;564;72,52%;718;718;100,00%;0;0,00%;516;2;0,39%;514;99,61%
MULTIPOLYGON (((-58.403037503391751 -34.588626056911885,-58.401893449080667 -34.589292561156576,-58.403190358612974 -34.590299578565748,-58.403261767237524 -34.590354685977275,-58.404318793696362 -34.589566854981847,-58.403037503391751 -34.588626056911885)));;1786;2_13_4;COMUNA 2;13;4;1112;502;610;82,30%;742;742;100,00%;0;0,00%;555;1;0,18%;554;99,82%
MULTIPOLYGON (((-58.401893449080667 -34.589292561156576,-58.400885006592482 -34.589880035704994,-58.40232224662735 -34.590898682995238,-58.402422760648051 -34.590980003510055,-58.403261767237524 -34.590354685977275,-58.403190358612974 -34.590299578565748,-58.401893449080667 -34.589292561156576)));;1787;2_13_5;COMUNA 2;13;5;1371;597;774;77,13%;889;888;99,89%;1;0,11%;647;4;0,62%;643;99,38%
MULTIPOLYGON (((-58.3998273136677 -34.589130310590747,-58.400354412016334 -34.590189214720418,-58.400598666689113 -34.590046798380321,-58.400885006592482 -34.589880035704994,-58.401893449080667 -34.589292561156576,-58.401783062554713 -34.589206868885697,-58.400902045727136 -34.588489636726969,-58.400001197205597 -34.589026804363506,-58.3998273136677 -34.589130310590747)));;1788;2_13_6;COMUNA 2;13;6;1052;453;599;75,63%;566;563;99,47%;3;0,53%;382;5;1,31%;377;98,69%
MULTIPOLYGON (((-58.400885006592482 -34.589880035704994,-58.400598666689113 -34.590046798380321,-58.400354412016334 -34.590189214720418,-58.400488846166283 -34.590458941923877,-58.401032533726415 -34.59156341654046,-58.402422760648051 -34.590980003510055,-58.40232224662735 -34.590898682995238,-58.400885006592482 -34.589880035704994)));;1789;2_13_7;COMUNA 2;13;7;1211;516;695;74,24%;888;888;100,00%;0;0,00%;634;7;1,10%;627;98,90%
MULTIPOLYGON (((-58.403261767237524 -34.590354685977275,-58.402422760648051 -34.590980003510055,-58.401032533726415 -34.59156341654046,-58.401112974161855 -34.591726843899593,-58.40148580451735 -34.592538683208964,-58.40278661004799 -34.59209677612796,-58.403299696366055 -34.591743280590705,-58.404160993452152 -34.591149800049209,-58.404230857895087 -34.591101451343754,-58.404140723218163 -34.591031757478554,-58.403261767237524 -34.590354685977275)));;1790;2_14_1;COMUNA 2;14;1;760;341;419;81,38%;372;370;99,46%;2;0,54%;248;1;0,40%;247;99,60%
MULTIPOLYGON (((-58.403613475576542 -34.59407782047991,-58.403507587851024 -34.594121644120143,-58.402347871304684 -34.594442849219298,-58.402822257283219 -34.595824826870832,-58.404060403350783 -34.595294844116445,-58.404176778782428 -34.595234756796657,-58.403864428833479 -34.59458908847121,-58.403613475576542 -34.59407782047991)));;1791;2_14_10;COMUNA 2;14;10;1006;418;588;71,09%;814;814;100,00%;0;0,00%;537;27;5,03%;510;94,97%
MULTIPOLYGON (((-58.404230857895087 -34.591101451343754,-58.404160993452152 -34.591149800049209,-58.403299696366055 -34.591743280590705,-58.404062593250821 -34.592420648088002,-58.404169573817903 -34.592515069360203,-58.404226822414785 -34.592485588599956,-58.405099015955102 -34.591776116233738,-58.404997136686085 -34.591693529630597,-58.404230857895087 -34.591101451343754)));;1792;2_14_2;COMUNA 2;14;2;575;230;345;66,67%;426;425;99,77%;1;0,24%;306;3;0,98%;303;99,02%
MULTIPOLYGON (((-58.403299696366055 -34.591743280590705,-58.40278661004799 -34.59209677612796,-58.402997648595679 -34.592794864796922,-58.403046364432413 -34.592908695912833,-58.404169573817903 -34.592515069360203,-58.404062593250821 -34.592420648088002,-58.403299696366055 -34.591743280590705)));;1793;2_14_3;COMUNA 2;14;3;355;141;214;65,89%;262;261;99,62%;1;0,38%;175;1;0,57%;174;99,43%
MULTIPOLYGON (((-58.40278661004799 -34.59209677612796,-58.40148580451735 -34.592538683208964,-58.401714522633341 -34.593036845479084,-58.401846224053386 -34.593329246646832,-58.403046364432413 -34.592908695912833,-58.402997648595679 -34.592794864796922,-58.40278661004799 -34.59209677612796)));;1794;2_14_4;COMUNA 2;14;4;743;320;423;75,65%;539;539;100,00%;0;0,00%;369;0;0,00%;369;100,00%
MULTIPOLYGON (((-58.403046364432413 -34.592908695912833,-58.401846224053386 -34.593329246646832,-58.402347871304684 -34.594442849219298,-58.403507587851024 -34.594121644120143,-58.403613475576542 -34.59407782047991,-58.403092955096199 -34.593017314496791,-58.403046364432413 -34.592908695912833)));;1795;2_14_5;COMUNA 2;14;5;1124;496;628;78,98%;622;621;99,84%;1;0,16%;499;3;0,60%;496;99,40%
MULTIPOLYGON (((-58.404169573817903 -34.592515069360203,-58.403046364432413 -34.592908695912833,-58.403092955096199 -34.593017314496791,-58.403613475576542 -34.59407782047991,-58.403753864008756 -34.594019646658097,-58.405003442342021 -34.593412543980627,-58.405106451411044 -34.593341885638687,-58.404169573817903 -34.592515069360203)));;1796;2_14_6;COMUNA 2;14;6;1031;424;607;69,85%;734;734;100,00%;0;0,00%;532;6;1,13%;526;98,87%
MULTIPOLYGON (((-58.405099015955102 -34.591776116233738,-58.404226822414785 -34.592485588599956,-58.404169573817903 -34.592515069360203,-58.405106451411044 -34.593341885638687,-58.405304204408203 -34.593206339678858,-58.406081732338087 -34.592571396214652,-58.405955766245462 -34.592465911018159,-58.405200725202924 -34.591858561820032,-58.405099015955102 -34.591776116233738)));;1797;2_14_7;COMUNA 2;14;7;648;282;366;77,05%;489;489;100,00%;0;0,00%;348;17;4,89%;331;95,11%
MULTIPOLYGON (((-58.406081732338087 -34.592571396214652,-58.405304204408203 -34.593206339678858,-58.405106451411044 -34.593341885638687,-58.406090158926112 -34.594209844725015,-58.407106350310031 -34.59364726167491,-58.407265573679453 -34.593562964600821,-58.406081732338087 -34.592571396214652)));;1798;2_14_8;COMUNA 2;14;8;695;272;423;64,30%;566;566;100,00%;0;0,00%;380;4;1,05%;376;98,95%
MULTIPOLYGON (((-58.405106451411044 -34.593341885638687,-58.405003442342021 -34.593412543980627,-58.403753864008756 -34.594019646658097,-58.403613475576542 -34.59407782047991,-58.403864428833479 -34.59458908847121,-58.404176778782428 -34.595234756796657,-58.404373577305222 -34.595133086491728,-58.405105230700222 -34.594740460934538,-58.405962196888709 -34.594280703563818,-58.406090158926112 -34.594209844725015,-58.405106451411044 -34.593341885638687)));;1799;2_14_9;COMUNA 2;14;9;1475;682;793;86,00%;894;893;99,89%;1;0,11%;605;68;11,24%;537;88,76%
MULTIPOLYGON (((-58.401032533726415 -34.59156341654046,-58.399958766599937 -34.592001971059403,-58.399989728193056 -34.592050791715408,-58.400357216944613 -34.592932423154409,-58.401286306577042 -34.592608937856347,-58.40148580451735 -34.592538683208964,-58.401112974161855 -34.591726843899593,-58.401032533726415 -34.59156341654046)));;1800;2_15_1;COMUNA 2;15;1;601;266;335;79,40%;365;365;100,00%;0;0,00%;266;2;0,75%;264;99,25%
MULTIPOLYGON (((-58.399958766599937 -34.592001971059403,-58.398742300568948 -34.592497556311891,-58.399106977002795 -34.593255311872554,-58.399150164852081 -34.593352662132062,-58.400357216944613 -34.592932423154409,-58.399989728193056 -34.592050791715408,-58.399958766599937 -34.592001971059403)));;1801;2_15_2;COMUNA 2;15;2;798;336;462;72,73%;589;588;99,83%;1;0,17%;388;1;0,26%;387;99,74%
MULTIPOLYGON (((-58.398742300568948 -34.592497556311891,-58.397467067163824 -34.592873656678996,-58.397508293868114 -34.592971429027877,-58.39807170755266 -34.594306640143301,-58.398096784505789 -34.594366021937034,-58.398122795775592 -34.594428643782571,-58.399492859153789 -34.594133786183825,-58.399438284934035 -34.594001921763535,-58.399150164852081 -34.593352662132062,-58.399106977002795 -34.593255311872554,-58.398742300568948 -34.592497556311891)));;1802;2_15_3;COMUNA 2;15;3;1393;618;775;79,74%;931;931;100,00%;0;0,00%;630;4;0,63%;626;99,37%
MULTIPOLYGON (((-58.400357216944613 -34.592932423154409,-58.399150164852081 -34.593352662132062,-58.399438284934035 -34.594001921763535,-58.399492859153789 -34.594133786183825,-58.399641406318757 -34.594101819528305,-58.400691389525704 -34.593733892455774,-58.400357216944613 -34.592932423154409)));;1803;2_15_4;COMUNA 2;15;4;628;285;343;83,09%;457;457;100,00%;0;0,00%;310;1;0,32%;309;99,68%
MULTIPOLYGON (((-58.40148580451735 -34.592538683208964,-58.401286306577042 -34.592608937856347,-58.400357216944613 -34.592932423154409,-58.400691389525704 -34.593733892455774,-58.401846224053386 -34.593329246646832,-58.401714522633341 -34.593036845479084,-58.40148580451735 -34.592538683208964)));;1804;2_15_5;COMUNA 2;15;5;555;230;325;70,77%;416;416;100,00%;0;0,00%;267;5;1,87%;262;98,13%
MULTIPOLYGON (((-58.401846224053386 -34.593329246646832,-58.400691389525704 -34.593733892455774,-58.400741205631583 -34.593853429480674,-58.401061945410824 -34.594633833669747,-58.401112761252662 -34.594784921557064,-58.402347871304684 -34.594442849219298,-58.401846224053386 -34.593329246646832)));;1805;2_15_6;COMUNA 2;15;6;605;273;332;82,23%;441;441;100,00%;0;0,00%;286;1;0,35%;285;99,65%
MULTIPOLYGON (((-58.400691389525704 -34.593733892455774,-58.399641406318757 -34.594101819528305,-58.399492859153789 -34.594133786183825,-58.399899790535038 -34.595117696627987,-58.40037262735305 -34.594989905892412,-58.401112761252662 -34.594784921557064,-58.401061945410824 -34.594633833669747,-58.400741205631583 -34.593853429480674,-58.400691389525704 -34.593733892455774)));;1806;2_15_7;COMUNA 2;15;7;756;334;422;79,15%;523;523;100,00%;0;0,00%;367;2;0,54%;365;99,46%
MULTIPOLYGON (((-58.399492859153789 -34.594133786183825,-58.398122795775592 -34.594428643782571,-58.398521639927246 -34.595389102870378,-58.399671171367586 -34.595171876647868,-58.399765034711699 -34.595154177922879,-58.399899790535038 -34.595117696627987,-58.399492859153789 -34.594133786183825)));;1807;2_15_8;COMUNA 2;15;8;708;309;399;77,44%;487;487;100,00%;0;0,00%;339;5;1,47%;334;98,53%
MULTIPOLYGON (((-58.397467067163824 -34.592873656678996,-58.397196448076592 -34.592953444436468,-58.396996017533084 -34.59301256436477,-58.396854275855013 -34.59305509527352,-58.397133349764218 -34.59435487387384,-58.397153796808595 -34.594453057704015,-58.397305740235034 -34.594436025878565,-58.39807170755266 -34.594306640143301,-58.397508293868114 -34.592971429027877,-58.397467067163824 -34.592873656678996)));;1808;2_16_1;COMUNA 2;16;1;807;344;463;74,30%;497;494;99,40%;3;0,61%;321;2;0,62%;319;99,38%
MULTIPOLYGON (((-58.396854275855013 -34.59305509527352,-58.395752195259774 -34.593385846666813,-58.395689501316873 -34.593404615810186,-58.395887136135009 -34.594606038736508,-58.396054239000541 -34.594589087194336,-58.39700960378066 -34.594469248409155,-58.397153796808595 -34.594453057704015,-58.397133349764218 -34.59435487387384,-58.396854275855013 -34.59305509527352)));;1809;2_16_2;COMUNA 2;16;2;712;306;406;75,37%;434;433;99,77%;1;0,23%;308;15;4,87%;293;95,13%
MULTIPOLYGON (((-58.395689501316873 -34.593404615810186,-58.394316860992461 -34.593620764248413,-58.394506976872051 -34.594724505280794,-58.395755889651504 -34.594619347610681,-58.395887136135009 -34.594606038736508,-58.395689501316873 -34.593404615810186)));;1810;2_16_3;COMUNA 2;16;3;698;329;369;89,16%;506;506;100,00%;0;0,00%;305;1;0,33%;304;99,67%
MULTIPOLYGON (((-58.393196370858931 -34.594835660960314,-58.393210181635411 -34.5949532192679,-58.393311961499158 -34.595863030826315,-58.394686638258889 -34.595809013896151,-58.394666605411402 -34.595623784275524,-58.394524437220781 -34.594826349989155,-58.394506976872051 -34.594724505280794,-58.394505626318612 -34.594716664581625,-58.393196370858931 -34.594835660960314)));;1811;2_16_8;COMUNA 2;16;8;425;187;238;78,57%;394;394;100,00%;0;0,00%;196;2;1,02%;194;98,98%
MULTIPOLYGON (((-58.395887136135009 -34.594606038736508,-58.395755889651504 -34.594619347610681,-58.394506976872051 -34.594724505280794,-58.394524437220809 -34.594826349989162,-58.394666605411402 -34.595623784275539,-58.394686638258918 -34.595809013896151,-58.394810215382293 -34.595803871240207,-58.395898986716311 -34.595760104194397,-58.3960940301966 -34.595737463447712,-58.396087598618692 -34.595579566484126,-58.395887136135009 -34.594606038736508)));;1812;2_16_5;COMUNA 2;16;5;822;350;472;74,15%;572;572;100,00%;0;0,00%;386;23;5,96%;363;94,04%
MULTIPOLYGON (((-58.397153796808595 -34.594453057704015,-58.39700960378066 -34.594469248409155,-58.396054239000541 -34.594589087194336,-58.395887136135009 -34.594606038736508,-58.396087598618692 -34.595579566484126,-58.3960940301966 -34.595737463447712,-58.39626369244511 -34.595717696009416,-58.397370435798571 -34.595559625403112,-58.397355300193183 -34.595420809089028,-58.397153796808595 -34.594453057704015)));;1813;2_16_6;COMUNA 2;16;6;675;267;408;65,44%;466;466;100,00%;0;0,00%;318;1;0,31%;317;99,69%
MULTIPOLYGON (((-58.398122795775592 -34.594428643782571,-58.398096784505789 -34.594366021937034,-58.39807170755266 -34.594306640143301,-58.397305740235034 -34.594436025878565,-58.397153796808595 -34.594453057704015,-58.397355300193183 -34.595420809089028,-58.397370435798571 -34.595559625403112,-58.398390724489289 -34.595413823644527,-58.398521639927246 -34.595389102870378,-58.398122795775592 -34.594428643782571)));;1814;2_16_7;COMUNA 2;16;7;770;327;443;73,81%;454;453;99,78%;1;0,22%;359;0;0,00%;359;100,00%
MULTIPOLYGON (((-58.398521639927246 -34.595389102870378,-58.398390724489289 -34.595413823644527,-58.397370435798571 -34.595559625403112,-58.397551388497774 -34.597221758308208,-58.397670120030348 -34.59720773658956,-58.398869030027747 -34.597048715568974,-58.398521639927246 -34.595389102870378)));;1815;2_17_1;COMUNA 2;17;1;1217;542;675;80,30%;868;867;99,88%;1;0,12%;571;2;0,35%;569;99,65%
MULTIPOLYGON (((-58.397370435798571 -34.595559625403112,-58.39626369244511 -34.595717696009416,-58.3960940301966 -34.595737463447712,-58.396100295404771 -34.595890430547442,-58.396110941395172 -34.597170485862264,-58.396099767822683 -34.597298372019722,-58.396254517289805 -34.597293667464626,-58.397397054424026 -34.59724005680394,-58.397551388497774 -34.597221758308208,-58.397370435798571 -34.595559625403112)));;1816;2_17_2;COMUNA 2;17;2;838;371;467;79,44%;565;564;99,82%;1;0,18%;382;1;0,26%;381;99,74%
MULTIPOLYGON (((-58.3960940301966 -34.595737463447712,-58.395898986716311 -34.595760104194397,-58.394810215382293 -34.595803871240207,-58.394686638258918 -34.595809013896151,-58.394702697690505 -34.595958394834241,-58.394777866753273 -34.597147215050697,-58.394765929066999 -34.597269677915712,-58.395967928469801 -34.597302314231719,-58.396099767822683 -34.597298372019722,-58.396110941395172 -34.597170485862264,-58.396100295404771 -34.595890430547442,-58.3960940301966 -34.595737463447712)));;1817;2_17_3;COMUNA 2;17;3;931;396;535;74,02%;765;764;99,87%;1;0,13%;454;2;0,44%;452;99,56%
MULTIPOLYGON (((-58.394686638258918 -34.595809013896151,-58.39331196149918 -34.595863030826322,-58.393323880449955 -34.595970295280935,-58.393191335992043 -34.597232029175238,-58.394632307429234 -34.597266011765505,-58.394765929066999 -34.597269677915712,-58.394777866753273 -34.597147215050697,-58.394702697690505 -34.595958394834241,-58.394686638258918 -34.595809013896151)));;1818;2_17_4;COMUNA 2;17;4;339;136;203;67,00%;394;393;99,75%;1;0,25%;168;3;1,79%;165;98,21%
MULTIPOLYGON (((-58.394765929066999 -34.597269677915712,-58.394632307429234 -34.597266011765505,-58.393191335992043 -34.597232029175238,-58.393035780777623 -34.598711786049471,-58.394402965057942 -34.598712629348604,-58.394548260377547 -34.598712006331745,-58.394755537285583 -34.59737622553174,-58.394765929066999 -34.597269677915712)));;1819;2_17_5;COMUNA 2;17;5;532;233;299;77,93%;592;592;100,00%;0;0,00%;290;1;0,34%;289;99,66%
MULTIPOLYGON (((-58.396099767822683 -34.597298372019722,-58.395967928469801 -34.597302314231719,-58.394765929066999 -34.597269677915712,-58.394755537285583 -34.59737622553174,-58.394548260377547 -34.598712006331745,-58.395776371999311 -34.598706699920044,-58.395878404488244 -34.598703586701191,-58.396088766289651 -34.597424075084646,-58.396099767822683 -34.597298372019722)));;1820;2_17_6;COMUNA 2;17;6;986;442;544;81,25%;692;690;99,71%;2;0,29%;452;4;0,88%;448;99,12%
MULTIPOLYGON (((-58.397551388497774 -34.597221758308208,-58.397397054424026 -34.59724005680394,-58.396254517289805 -34.597293667464626,-58.396099767822683 -34.597298372019722,-58.396088766289651 -34.597424075084646,-58.395878404488244 -34.598703586701191,-58.396032560461677 -34.598698811680016,-58.397327278096121 -34.598577465243231,-58.397351249448299 -34.598418317048107,-58.397551388497774 -34.597221758308208)));;1821;2_17_7;COMUNA 2;17;7;1121;473;648;72,99%;939;939;100,00%;0;0,00%;577;2;0,35%;575;99,65%
MULTIPOLYGON (((-58.397327278096121 -34.598577465243231,-58.396032560461677 -34.598698811680016,-58.395878404488244 -34.598703586701191,-58.395816368011872 -34.599703379673151,-58.397185677358515 -34.599730250300937,-58.397312981125019 -34.598672038673982,-58.397327278096121 -34.598577465243231)));;1822;2_17_8;COMUNA 2;17;8;913;380;533;71,29%;724;724;100,00%;0;0,00%;489;59;12,07%;430;87,93%
MULTIPOLYGON (((-58.394548260377547 -34.598712006331745,-58.394402965057942 -34.598712629348604,-58.393035780777623 -34.598711786049471,-58.392961005350962 -34.599423671965695,-58.392930847848312 -34.59963711357576,-58.394396131192302 -34.599674000300134,-58.394711757134132 -34.599681852917257,-58.395816368011872 -34.599703379673151,-58.395878404488244 -34.598703586701191,-58.395776371999311 -34.598706699920044,-58.394548260377547 -34.598712006331745)));;1823;2_17_9;COMUNA 2;17;9;741;315;426;73,94%;560;560;100,00%;0;0,00%;366;8;2,19%;358;97,81%
MULTIPOLYGON (((-58.402347871304684 -34.594442849219298,-58.401112761252662 -34.594784921557064,-58.401174794502616 -34.594968974106528,-58.40160658878191 -34.596341357038014,-58.402822257283219 -34.595824826870832,-58.402347871304684 -34.594442849219298)));;1824;2_18_1;COMUNA 2;18;1;891;398;493;80,73%;659;658;99,85%;1;0,15%;458;24;5,24%;434;94,76%
MULTIPOLYGON (((-58.401112761252662 -34.594784921557064,-58.40037262735305 -34.594989905892412,-58.399899790535038 -34.595117696627987,-58.399765034711699 -34.595154177922879,-58.399671171367586 -34.595171876647868,-58.400285385687916 -34.596744084317557,-58.400423548871352 -34.596709716955665,-58.40160658878191 -34.596341357038014,-58.401174794502616 -34.594968974106528,-58.401112761252662 -34.594784921557064)));;1825;2_18_2;COMUNA 2;18;2;1188;493;695;70,94%;868;868;100,00%;0;0,00%;548;14;2,55%;534;97,45%
MULTIPOLYGON (((-58.399671171367586 -34.595171876647868,-58.398521639927246 -34.595389102870378,-58.398869030027747 -34.597048715568974,-58.3990010495544 -34.597031178242055,-58.400157955179552 -34.596775780864192,-58.400285385687916 -34.596744084317557,-58.399671171367586 -34.595171876647868)));;1826;2_18_3;COMUNA 2;18;3;787;322;465;69,25%;734;731;99,59%;3;0,41%;397;3;0,76%;394;99,24%
MULTIPOLYGON (((-58.398869030027747 -34.597048715568974,-58.397670120030348 -34.59720773658956,-58.397551388497774 -34.597221758308208,-58.397351249448299 -34.598418317048107,-58.397327278096121 -34.598577465243231,-58.397312981125019 -34.598672038673982,-58.397185677358515 -34.599730250300937,-58.39872302166269 -34.599760292490146,-58.399920929080487 -34.599621543160424,-58.40106943391087 -34.599484588179223,-58.400687530832592 -34.598009619835366,-58.400790850340464 -34.597992277262641,-58.402088180097302 -34.597767708625391,-58.401826685600355 -34.596998393856978,-58.401647118056353 -34.596470114703102,-58.40160658878191 -34.596341357038014,-58.400423548871352 -34.596709716955665,-58.400285385687916 -34.596744084317557,-58.400157955179552 -34.596775780864192,-58.3990010495544 -34.597031178242055,-58.398869030027747 -34.597048715568974)));;1827;2_18_4;COMUNA 2;18;4;1185;501;684;73,25%;451;445;98,67%;6;1,35%;267;6;2,25%;261;97,75%
MULTIPOLYGON (((-58.402822257283219 -34.595824826870832,-58.40160658878191 -34.596341357038014,-58.401647118056353 -34.596470114703102,-58.401826685600355 -34.596998393856978,-58.402860849712653 -34.596637835067483,-58.403077048658425 -34.59656702265621,-58.402822257283219 -34.595824826870832)));;1828;2_18_5;COMUNA 2;18;5;549;234;315;74,29%;334;334;100,00%;0;0,00%;250;6;2,40%;244;97,60%
MULTIPOLYGON (((-58.403077048658425 -34.59656702265621,-58.402860849712653 -34.596637835067483,-58.401826685600355 -34.596998393856978,-58.402088180097302 -34.597767708625391,-58.403410629933511 -34.597538701600286,-58.403077048658425 -34.59656702265621)));;1829;2_18_6;COMUNA 2;18;6;744;314;430;73,02%;516;516;100,00%;0;0,00%;367;19;5,18%;348;94,82%
MULTIPOLYGON (((-58.403410629933511 -34.597538701600286,-58.402088180097302 -34.597767708625391,-58.402536819719863 -34.599087488369427,-58.403082780232545 -34.598796055010837,-58.403721518526567 -34.598455084702366,-58.403674015932879 -34.598305830647575,-58.403410629933511 -34.597538701600286)));;1830;2_18_7;COMUNA 2;18;7;595;228;367;62,13%;362;361;99,72%;1;0,28%;277;24;8,66%;253;91,34%
MULTIPOLYGON (((-58.402088180097302 -34.597767708625391,-58.400790850340464 -34.597992277262641,-58.400687530832592 -34.598009619835366,-58.40106943391087 -34.599484588179223,-58.401208184302661 -34.599468108251116,-58.402008236296744 -34.599369702208541,-58.402474367990948 -34.599120839121952,-58.402536819719863 -34.599087488369427,-58.402088180097302 -34.597767708625391)));;1831;2_18_8;COMUNA 2;18;8;912;373;539;69,20%;550;548;99,64%;2;0,36%;335;88;26,27%;247;73,73%
MULTIPOLYGON (((-58.406090158926112 -34.594209844725015,-58.405962196888709 -34.594280703563818,-58.405105230700222 -34.594740460934538,-58.405603772133006 -34.595739396084205,-58.406233528556648 -34.595533131788109,-58.406490268629412 -34.595449021689333,-58.406681502979097 -34.595386431130507,-58.406636770740647 -34.595291477313467,-58.406090158926112 -34.594209844725015)));;1832;2_19_1;COMUNA 2;19;1;854;382;472;80,93%;570;570;100,00%;0;0,00%;393;4;1,02%;389;98,98%
MULTIPOLYGON (((-58.405105230700222 -34.594740460934538,-58.404373577305222 -34.595133086491728,-58.404176778782428 -34.595234756796657,-58.404582679258269 -34.59607392706183,-58.405603772133006 -34.595739396084205,-58.405105230700222 -34.594740460934538)));;1833;2_19_2;COMUNA 2;19;2;675;302;373;80,97%;425;425;100,00%;0;0,00%;306;1;0,33%;305;99,67%
MULTIPOLYGON (((-58.404176778782428 -34.595234756796657,-58.404060403350783 -34.595294844116445,-58.402822257283219 -34.595824826870832,-58.403077048658425 -34.59656702265621,-58.404289987771044 -34.59616977695292,-58.404582679258269 -34.59607392706183,-58.404176778782428 -34.595234756796657)));;1834;2_19_3;COMUNA 2;19;3;717;307;410;74,88%;400;400;100,00%;0;0,00%;305;12;3,93%;293;96,07%
MULTIPOLYGON (((-58.404582679258269 -34.59607392706183,-58.404289987771044 -34.59616977695292,-58.403077048658425 -34.59656702265621,-58.403410629933511 -34.597538701600286,-58.405177689565065 -34.597232774972561,-58.404638551794761 -34.596189451097715,-58.404582679258269 -34.59607392706183)));;1835;2_19_4;COMUNA 2;19;4;997;436;561;77,72%;690;690;100,00%;0;0,00%;499;28;5,61%;471;94,39%
MULTIPOLYGON (((-58.406233528556648 -34.595533131788109,-58.405603772133006 -34.595739396084205,-58.404582679258269 -34.59607392706183,-58.404638551794761 -34.596189451097715,-58.405177689565065 -34.597232774972561,-58.406506851346165 -34.597002540297623,-58.406465086577327 -34.596799978011653,-58.406233528556648 -34.595533131788109)));;1836;2_19_5;COMUNA 2;19;5;790;334;456;73,25%;524;523;99,81%;1;0,19%;361;3;0,83%;358;99,17%
MULTIPOLYGON (((-58.406681502979097 -34.595386431130507,-58.406490268629412 -34.595449021689333,-58.406233528556648 -34.595533131788109,-58.406465086577327 -34.596799978011653,-58.406506851346165 -34.597002540297623,-58.406983736715418 -34.59680704717411,-58.407366411302711 -34.596636087912621,-58.407312227185152 -34.596536834134476,-58.406728361386769 -34.595485893122614,-58.406681502979097 -34.595386431130507)));;1837;2_19_6;COMUNA 2;19;6;745;327;418;78,23%;574;572;99,65%;2;0,35%;424;2;0,47%;422;99,53%
MULTIPOLYGON (((-58.406983736715418 -34.59680704717411,-58.406506851346165 -34.597002540297623,-58.405177689565065 -34.597232774972561,-58.405490853322803 -34.597838649783576,-58.405586271166591 -34.598040955790573,-58.406626233202516 -34.598045804477216,-58.408147969034488 -34.598068959919956,-58.407558225624243 -34.59698773764319,-58.407366411302711 -34.596636087912621,-58.406983736715418 -34.59680704717411)));;1838;2_19_7;COMUNA 2;19;7;682;310;372;83,33%;452;451;99,78%;1;0,22%;324;5;1,54%;319;98,46%
MULTIPOLYGON (((-58.405177689565065 -34.597232774972561,-58.403410629933511 -34.597538701600286,-58.403674015932879 -34.598305830647575,-58.403721518526567 -34.598455084702366,-58.404506707064108 -34.598035938510762,-58.404731971115886 -34.598036961258522,-58.405586271166591 -34.598040955790573,-58.405490853322803 -34.597838649783576,-58.405177689565065 -34.597232774972561)));;1839;2_19_8;COMUNA 2;19;8;831;357;474;75,32%;516;514;99,61%;2;0,39%;377;21;5,57%;356;94,43%
MULTIPOLYGON (((-58.39993899380196 -34.583641836671205,-58.399093879146747 -34.584404880974816,-58.39977990762435 -34.584915186883137,-58.399930885993513 -34.585025339516875,-58.400472312220856 -34.584536794096351,-58.400543718374358 -34.584471827838954,-58.39993899380196 -34.583641836671205)));;1840;2_2_1;COMUNA 2;2;1;587;267;320;83,44%;335;333;99,40%;2;0,60%;252;11;4,37%;241;95,63%
MULTIPOLYGON (((-58.398109317234791 -34.580702099490452,-58.397949178178607 -34.580779130498684,-58.397844152625858 -34.580827104886957,-58.396078717159476 -34.581633581628942,-58.395985870287987 -34.581675997448237,-58.397219255344012 -34.583095526385726,-58.397311486704972 -34.583079166712402,-58.399093879146747 -34.584404880974816,-58.39993899380196 -34.583641836671205,-58.399274993061546 -34.582730399826893,-58.39936160293162 -34.582715021637327,-58.398109317234791 -34.580702099490452)));;1841;2_2_2;COMUNA 2;2;2;878;390;488;79,92%;523;523;100,00%;0;0,00%;362;1;0,28%;361;99,72%
MULTIPOLYGON (((-58.391291887909581 -34.584893895390977,-58.391718535122124 -34.584756744333212,-58.392264987937139 -34.585026438044935,-58.392339891360507 -34.58506345457959,-58.393316710716689 -34.58554072325677,-58.393510101172204 -34.585635203061344,-58.394319283578305 -34.584739003069082,-58.39442796110513 -34.584919493768219,-58.394882829534076 -34.585570830089004,-58.395430890671747 -34.585977417434087,-58.395506562107833 -34.585909428201688,-58.39602925509466 -34.5855664615395,-58.396403188818979 -34.585321091914118,-58.396541476519197 -34.585322645888688,-58.396643290286391 -34.585242250721038,-58.398386660743654 -34.58565723723909,-58.398605634851471 -34.585710664450858,-58.398716569326318 -34.585737766007753,-58.39894379382654 -34.585915709015602,-58.399113792555418 -34.585762481644025,-58.399297424587942 -34.585596936672019,-58.399930885993513 -34.585025339516868,-58.39977990762435 -34.584915186883151,-58.399093879146747 -34.584404880974809,-58.397311486704965 -34.583079166712388,-58.397219255344012 -34.583095526385726,-58.395985870287973 -34.581675997448222,-58.396078717159476 -34.581633581628928,-58.397844152625858 -34.580827104886957,-58.397949178178592 -34.580779130498676,-58.398109317234791 -34.580702099490452,-58.397960044224639 -34.580492223006459,-58.396913346414593 -34.579041310874281,-58.396771433382021 -34.578839308521609,-58.396755753462905 -34.5788173907358,-58.396662668030601 -34.578669655392147,-58.396420719778391 -34.578791608046011,-58.394682703310771 -34.579632236113603,-58.394617284637008 -34.579663398115997,-58.394599251466239 -34.579641204037983,-58.394518874364437 -34.579534323751595,-58.394307979691973 -34.579619490985941,-58.394086426045867 -34.579723032905861,-58.394034962812299 -34.579660959141265,-58.393106755488638 -34.580086789097017,-58.392664923491587 -34.580289009528428,-58.392268834376885 -34.580467098830283,-58.392203230949846 -34.580513541747841,-58.391611097134088 -34.580765739184173,-58.391653517558012 -34.580828900549946,-58.391626502636093 -34.580835192382736,-58.391532307685623 -34.580859222994683,-58.391457528750514 -34.580880729552746,-58.391392967023123 -34.58090294628893,-58.391339390233128 -34.580924253883246,-58.391290751743597 -34.580945916470476,-58.391170213856988 -34.581006975166275,-58.391094482415866 -34.581046721130711,-58.391044221550267 -34.581073523724086,-58.390921635122837 -34.58113993330317,-58.390799133467574 -34.581206554084531,-58.390717267170785 -34.581250662575997,-58.390670328456544 -34.581275635912363,-58.390610271031449 -34.581307221473317,-58.390550128533526 -34.581338666103385,-58.39042941802137 -34.581401132469502,-58.390187401205253 -34.581525148956729,-58.390026226397453 -34.581608014248808,-58.389934308528829 -34.581655707923026,-58.389771768917875 -34.581740755251502,-58.389609569204772 -34.581826225118228,-58.389501634437565 -34.581883345878644,-58.38935783438815 -34.58195988241323,-58.389166412464654 -34.582062306650592,-58.389057283561186 -34.58212104608068,-58.388932649607575 -34.582188367943587,-58.388790380652935 -34.582265538559227,-58.388628005867453 -34.58235410572518,-58.388442713657263 -34.582455757860046,-58.388391938310846 -34.582484671803371,-58.388341671008895 -34.582516755178681,-58.388090662752937 -34.58269034149491,-58.387873479309938 -34.582840496369059,-58.387839568302716 -34.582863927236382,-58.387822611686609 -34.582876875110493,-58.387413436251755 -34.583188889663433,-58.386963594745779 -34.583551372612952,-58.386733656457622 -34.58377074568871,-58.386642805820586 -34.583857382774831,-58.3864214464393 -34.584098381193009,-58.385975650779066 -34.584588614630285,-58.385599309138534 -34.585014380639109,-58.385325200285919 -34.585383447454454,-58.385058294057309 -34.585879565591583,-58.384711397732815 -34.586452829513647,-58.384507476795299 -34.586956140004986,-58.384317385724039 -34.587081176023503,-58.383837304309303 -34.587416396573175,-58.383682673085254 -34.587496184605435,-58.383843385900349 -34.587679172576642,-58.385025030491526 -34.587035295157222,-58.385824270393414 -34.586600290762341,-58.385845569724836 -34.58658868399128,-58.387440196028678 -34.58590331207256,-58.388578846985958 -34.585350267425405,-58.388627170412668 -34.585321004466792,-58.389283190523351 -34.585118205684545,-58.389562902537499 -34.58503907463853,-58.389849388332109 -34.585003399458564,-58.389994988278168 -34.585016726254914,-58.390340767079906 -34.585048341474973,-58.390699021365357 -34.585030242751607,-58.391002288303412 -34.584986968821795,-58.391291887909581 -34.584893895390977)));;1842;2_2_3;COMUNA 2;2;3;572;265;307;86,32%;303;303;100,00%;0;0,00%;229;2;0,87%;227;99,13%
MULTIPOLYGON (((-58.396643290286406 -34.585242250721045,-58.396541476519197 -34.585322645888688,-58.397123109589479 -34.5867942164151,-58.398386660743668 -34.585657237239104,-58.396643290286406 -34.585242250721045)));;1843;2_2_4;COMUNA 2;2;4;540;232;308;75,32%;240;240;100,00%;0;0,00%;205;0;0,00%;205;100,00%
MULTIPOLYGON (((-58.397567014514628 -34.587152401053807,-58.397568783401525 -34.587155385094192,-58.398243511600917 -34.586547127252679,-58.39894379382654 -34.585915709015602,-58.398716569326325 -34.585737766007753,-58.398605634851499 -34.585710664450865,-58.398386660743668 -34.585657237239104,-58.397123109589479 -34.5867942164151,-58.397567014514628 -34.587152401053807)));;1844;2_2_5;COMUNA 2;2;5;600;256;344;74,42%;361;361;100,00%;0;0,00%;259;0;0,00%;259;100,00%
MULTIPOLYGON (((-58.39651434839152 -34.586781140801897,-58.396919979159485 -34.587079670928269,-58.397337019702022 -34.58705758425041,-58.397567014514628 -34.587152401053807,-58.397123109589479 -34.5867942164151,-58.396541476519197 -34.585322645888688,-58.396403188818994 -34.585321091914132,-58.396029255094646 -34.585566461539493,-58.395506562107833 -34.585909428201688,-58.395430890671761 -34.585977417434087,-58.39651434839152 -34.586781140801897)));;1845;2_2_6;COMUNA 2;2;6;472;207;265;78,11%;289;289;100,00%;0;0,00%;197;0;0,00%;197;100,00%
MULTIPOLYGON (((-58.395430890671761 -34.585977417434087,-58.395340987997749 -34.586058286609457,-58.394977651566009 -34.586353660844679,-58.396216243948267 -34.58696683132451,-58.397215575101868 -34.587461546426169,-58.397287146669221 -34.587409258762662,-58.397568783401525 -34.587155385094192,-58.397567014514628 -34.587152401053807,-58.397337019702022 -34.58705758425041,-58.396919979159485 -34.587079670928269,-58.39651434839152 -34.586781140801897,-58.395430890671761 -34.585977417434087)));;1846;2_2_7;COMUNA 2;2;7;301;136;165;82,42%;196;196;100,00%;0;0,00%;141;0;0,00%;141;100,00%
MULTIPOLYGON (((-58.394319283578305 -34.584739003069096,-58.393510101172218 -34.585635203061358,-58.393778652452738 -34.585766416650465,-58.394750551337246 -34.586241206139874,-58.394977651566009 -34.586353660844679,-58.395340987997749 -34.586058286609457,-58.395430890671761 -34.585977417434087,-58.39488282953409 -34.585570830089004,-58.394427961105123 -34.584919493768226,-58.394319283578305 -34.584739003069096)));;1847;2_2_8;COMUNA 2;2;8;697;303;394;76,90%;428;427;99,77%;1;0,23%;282;3;1,06%;279;98,94%
MULTIPOLYGON (((-58.410329887193306 -34.593929825416581,-58.409055419399756 -34.594486758430655,-58.40962364317209 -34.595662545703249,-58.41097180419623 -34.595084933096629,-58.410329887193306 -34.593929825416581)));;1848;2_20_1;COMUNA 2;20;1;959;422;537;78,58%;595;595;100,00%;0;0,00%;457;1;0,22%;456;99,78%
MULTIPOLYGON (((-58.409055419399756 -34.594486758430655,-58.408940843376911 -34.594536850814578,-58.408105328808354 -34.594901987109751,-58.407869794930676 -34.594990265237506,-58.408454613963883 -34.596163741271646,-58.408724574838807 -34.596047729709582,-58.40962364317209 -34.595662545703249,-58.409055419399756 -34.594486758430655)));;1849;2_20_2;COMUNA 2;20;2;822;358;464;77,16%;652;651;99,85%;1;0,15%;449;38;8,46%;411;91,54%
MULTIPOLYGON (((-58.407869794930676 -34.594990265237506,-58.407716292967272 -34.595047874475647,-58.406681502979097 -34.595386431130507,-58.406728361386769 -34.595485893122614,-58.407312227185152 -34.596536834134476,-58.407366411302711 -34.596636087912621,-58.407647197358102 -34.596510646667305,-58.408454613963883 -34.596163741271646,-58.407869794930676 -34.594990265237506)));;1850;2_20_3;COMUNA 2;20;3;751;278;473;58,77%;514;512;99,61%;2;0,39%;372;20;5,38%;352;94,62%
MULTIPOLYGON (((-58.407558225624243 -34.59698773764319,-58.408147969034488 -34.598068959919956,-58.408721472702624 -34.598078511092915,-58.409428091242809 -34.598088399457446,-58.408861691307571 -34.596968530196555,-58.408454613963883 -34.596163741271646,-58.407647197358102 -34.596510646667305,-58.407366411302711 -34.596636087912621,-58.407558225624243 -34.59698773764319)));;1851;2_20_4;COMUNA 2;20;4;841;389;452;86,06%;527;526;99,81%;1;0,19%;386;14;3,63%;372;96,37%
MULTIPOLYGON (((-58.40962364317209 -34.595662545703249,-58.408724574838807 -34.596047729709582,-58.408454613963883 -34.596163741271646,-58.408861691307571 -34.596968530196555,-58.410229882485936 -34.596948421146195,-58.410203790445657 -34.596863124933087,-58.40962364317209 -34.595662545703249)));;1852;2_20_5;COMUNA 2;20;5;504;220;284;77,46%;303;302;99,67%;1;0,33%;251;10;3,98%;241;96,02%
MULTIPOLYGON (((-58.41115189276946 -34.595411993880212,-58.41097180419623 -34.595084933096629,-58.40962364317209 -34.595662545703249,-58.410203790445657 -34.596863124933087,-58.410229882485936 -34.596948421146195,-58.410294457249591 -34.596917250504987,-58.411471192225861 -34.59634857320151,-58.411619861091651 -34.596255885445323,-58.41115189276946 -34.595411993880212)));;1853;2_20_6;COMUNA 2;20;6;637;287;350;82,00%;426;426;100,00%;0;0,00%;356;36;10,11%;320;89,89%
MULTIPOLYGON (((-58.410229882485936 -34.596948421146195,-58.410250790257969 -34.597016601786265,-58.410294144817939 -34.598092718286765,-58.411918832167956 -34.598003049628126,-58.411739730263434 -34.596883072551883,-58.411619861091651 -34.596255885445323,-58.411471192225861 -34.59634857320151,-58.410294457249591 -34.596917250504987,-58.410229882485936 -34.596948421146195)));;1854;2_20_7;COMUNA 2;20;7;569;250;319;78,37%;380;378;99,47%;2;0,53%;247;5;2,02%;242;97,98%
MULTIPOLYGON (((-58.410229882485936 -34.596948421146195,-58.408861691307571 -34.596968530196555,-58.409428091242809 -34.598088399457446,-58.410294144817939 -34.598092718286765,-58.410250790257969 -34.597016601786265,-58.410229882485936 -34.596948421146195)));;1855;2_20_8;COMUNA 2;20;8;671;304;367;82,83%;407;405;99,51%;2;0,49%;301;0;0,00%;301;100,00%
MULTIPOLYGON (((-58.407938245149182 -34.59086914791947,-58.407136619397548 -34.591673535757955,-58.40734929044298 -34.591889486005599,-58.407872538501522 -34.592499464582701,-58.408977187800211 -34.591789857423976,-58.409099017518145 -34.591710330383833,-58.407938245149182 -34.59086914791947)));;1856;2_21_1;COMUNA 2;21;1;1058;458;600;76,33%;658;658;100,00%;0;0,00%;462;23;4,98%;439;95,02%
MULTIPOLYGON (((-58.407872538501522 -34.592499464582701,-58.40734929044298 -34.591889486005599,-58.407136619397548 -34.591673535757955,-58.406232635300789 -34.592448151415581,-58.406081732338087 -34.592571396214652,-58.407265573679453 -34.593562964600821,-58.407403328541328 -34.593489925639389,-58.408104851443511 -34.593158327058703,-58.408373754139475 -34.593083796241977,-58.407872538501522 -34.592499464582701)));;1857;2_21_2;COMUNA 2;21;2;959;393;566;69,43%;605;605;100,00%;0;0,00%;442;3;0,68%;439;99,32%
MULTIPOLYGON (((-58.409099017518145 -34.591710330383833,-58.408977187800211 -34.591789857423976,-58.407872538501522 -34.592499464582701,-58.408373754139475 -34.593083796241977,-58.408461485950909 -34.59305953853648,-58.408593083641044 -34.593023046221788,-58.409566519172671 -34.59282078990698,-58.409698877487997 -34.592792113938373,-58.409099017518145 -34.591710330383833)));;1858;2_21_3;COMUNA 2;21;3;775;352;423;83,22%;473;473;100,00%;0;0,00%;369;2;0,54%;367;99,46%
MULTIPOLYGON (((-58.409698877487997 -34.592792113938373,-58.409566519172671 -34.59282078990698,-58.408593083641044 -34.593023046221788,-58.408461485950909 -34.59305953853648,-58.408940843376911 -34.594536850814578,-58.409055419399756 -34.594486758430655,-58.410329887193306 -34.593929825416581,-58.410226702530153 -34.593743858308521,-58.409698877487997 -34.592792113938373)));;1859;2_21_4;COMUNA 2;21;4;1046;436;610;71,48%;774;773;99,87%;1;0,13%;530;5;0,94%;525;99,06%
MULTIPOLYGON (((-58.408461485950909 -34.59305953853648,-58.408373754139475 -34.593083796241977,-58.408104851443511 -34.593158327058703,-58.407403328541328 -34.593489925639389,-58.407265573679453 -34.593562964600821,-58.407869794930676 -34.594990265237506,-58.408105328808354 -34.594901987109751,-58.408940843376911 -34.594536850814578,-58.408461485950909 -34.59305953853648)));;1860;2_21_5;COMUNA 2;21;5;984;417;567;73,54%;652;651;99,85%;1;0,15%;508;2;0,39%;506;99,61%
MULTIPOLYGON (((-58.407265573679453 -34.593562964600821,-58.407106350310031 -34.59364726167491,-58.406090158926112 -34.594209844725015,-58.406636770740647 -34.595291477313467,-58.406681502979097 -34.595386431130507,-58.407716292967272 -34.595047874475647,-58.407869794930676 -34.594990265237506,-58.407265573679453 -34.593562964600821)));;1861;2_21_6;COMUNA 2;21;6;926;373;553;67,45%;671;668;99,55%;3;0,45%;481;17;3,53%;464;96,47%
MULTIPOLYGON (((-58.407938245149182 -34.59086914791947,-58.407140016595683 -34.590280172186453,-58.407022044476633 -34.590194199509604,-58.406256045694619 -34.590824154362103,-58.406146640711668 -34.590914107281975,-58.406259930720218 -34.590997825019173,-58.407034581913202 -34.591569964035649,-58.407136619397548 -34.591673535757955,-58.407938245149182 -34.59086914791947)));;1862;2_22_1;COMUNA 2;22;1;699;298;401;74,31%;556;555;99,82%;1;0,18%;368;4;1,09%;364;98,91%
MULTIPOLYGON (((-58.407022044476633 -34.590194199509604,-58.406411333936511 -34.589749394610912,-58.406290214054565 -34.589661095731678,-58.405548809984147 -34.590189222529929,-58.405350552428054 -34.590326458928061,-58.405500951392234 -34.590437238138385,-58.406146640711668 -34.590914107281975,-58.406256045694619 -34.590824154362103,-58.407022044476633 -34.590194199509604)));;1863;2_22_2;COMUNA 2;22;2;534;233;301;77,41%;378;378;100,00%;0;0,00%;281;1;0,36%;280;99,64%
MULTIPOLYGON (((-58.405230702356178 -34.588889091718904,-58.404434838754753 -34.589480357693056,-58.404318793696362 -34.589566854981847,-58.404465530204448 -34.589674675864096,-58.405350552428054 -34.590326458928061,-58.405548809984147 -34.590189222529929,-58.406290214054565 -34.589661095731678,-58.405369183509187 -34.588989794678454,-58.405230702356178 -34.588889091718904)));;1864;2_22_3;COMUNA 2;22;3;439;192;247;77,73%;305;305;100,00%;0;0,00%;205;0;0,00%;205;100,00%
MULTIPOLYGON (((-58.405350552428054 -34.590326458928061,-58.404465530204448 -34.589674675864096,-58.404318793696362 -34.589566854981847,-58.403261767237524 -34.590354685977275,-58.404140723218163 -34.591031757478554,-58.404230857895087 -34.591101451343754,-58.405350552428054 -34.590326458928061)));;1865;2_22_4;COMUNA 2;22;4;959;397;562;70,64%;695;694;99,86%;1;0,14%;483;2;0,41%;481;99,59%
MULTIPOLYGON (((-58.406146640711668 -34.590914107281975,-58.405500951392234 -34.590437238138385,-58.405350552428054 -34.590326458928061,-58.404230857895087 -34.591101451343754,-58.404997136686085 -34.591693529630597,-58.405099015955102 -34.591776116233738,-58.405205952302879 -34.591687994162221,-58.406146640711668 -34.590914107281975)));;1866;2_22_5;COMUNA 2;22;5;1093;473;620;76,29%;744;744;100,00%;0;0,00%;528;1;0,19%;527;99,81%
MULTIPOLYGON (((-58.407136619397548 -34.591673535757955,-58.407034581913202 -34.591569964035649,-58.406259930720218 -34.590997825019173,-58.406146640711668 -34.590914107281975,-58.405205952302879 -34.591687994162221,-58.405099015955102 -34.591776116233738,-58.405200725202924 -34.591858561820032,-58.405955766245462 -34.592465911018159,-58.406081732338087 -34.592571396214652,-58.406232635300789 -34.592448151415581,-58.407136619397548 -34.591673535757955)));;1867;2_22_6;COMUNA 2;22;6;1016;420;596;70,47%;919;918;99,89%;1;0,11%;557;1;0,18%;556;99,82%
MULTIPOLYGON (((-58.408316698126171 -34.586545904619399,-58.407442978879665 -34.587239976785625,-58.408279194686834 -34.588167643333442,-58.409028704891838 -34.587559288825922,-58.408316698126171 -34.586545904619399)));;1868;2_23_1;COMUNA 2;23;1;1079;443;636;69,65%;630;629;99,84%;1;0,16%;435;1;0,23%;434;99,77%
MULTIPOLYGON (((-58.407442978879665 -34.587239976785625,-58.407332815114799 -34.587327465593276,-58.406451101133477 -34.587982511283315,-58.407454616352432 -34.588827440146169,-58.407604482310731 -34.588713770949383,-58.408180190687482 -34.588248024907017,-58.408279194686834 -34.588167643333442,-58.407442978879665 -34.587239976785625)));;1869;2_23_2;COMUNA 2;23;2;1025;421;604;69,70%;797;797;100,00%;0;0,00%;512;0;0,00%;512;100,00%
MULTIPOLYGON (((-58.407454616352432 -34.588827440146169,-58.406451101133477 -34.587982511283315,-58.405230702356178 -34.588889091718904,-58.405369183509187 -34.588989794678454,-58.406290214054565 -34.589661095731678,-58.407364901051487 -34.588895500816712,-58.407454616352432 -34.588827440146169)));;1870;2_23_3;COMUNA 2;23;3;928;384;544;70,59%;712;712;100,00%;0;0,00%;441;4;0,91%;437;99,09%
MULTIPOLYGON (((-58.408077706422361 -34.589352107776577,-58.407454616352432 -34.588827440146169,-58.407364901051487 -34.588895500816712,-58.406290214054565 -34.589661095731678,-58.406411333936511 -34.589749394610912,-58.407022044476633 -34.590194199509604,-58.407138434384485 -34.590098474095925,-58.408077706422361 -34.589352107776577)));;1871;2_23_4;COMUNA 2;23;4;849;356;493;72,21%;516;515;99,81%;1;0,19%;381;19;4,99%;362;95,01%
MULTIPOLYGON (((-58.40881716687845 -34.588764455248182,-58.408279194686834 -34.588167643333442,-58.408180190687482 -34.588248024907017,-58.407604482310731 -34.588713770949383,-58.407454616352432 -34.588827440146169,-58.408077706422361 -34.589352107776577,-58.40881716687845 -34.588764455248182)));;1872;2_23_5;COMUNA 2;23;5;650;283;367;77,11%;441;441;100,00%;0;0,00%;295;1;0,34%;294;99,66%
MULTIPOLYGON (((-58.409028704891838 -34.587559288825922,-58.408279194686834 -34.588167643333442,-58.40881716687845 -34.588764455248182,-58.40891599938508 -34.588685904148328,-58.409497827064001 -34.588227126691763,-58.409028704891838 -34.587559288825922)));;1873;2_23_6;COMUNA 2;23;6;406;178;228;78,07%;312;312;100,00%;0;0,00%;203;0;0,00%;203;100,00%
MULTIPOLYGON (((-58.409497827064001 -34.588227126691763,-58.40891599938508 -34.588685904148328,-58.40881716687845 -34.588764455248182,-58.409403822340451 -34.589415231823352,-58.409503211859395 -34.589531969986908,-58.40992564819328 -34.589176082836026,-58.410081049957441 -34.589057131095537,-58.409497827064001 -34.588227126691763)));;1874;2_23_7;COMUNA 2;23;7;456;192;264;72,73%;371;371;100,00%;0;0,00%;237;1;0,42%;236;99,58%
MULTIPOLYGON (((-58.40881716687845 -34.588764455248182,-58.408077706422361 -34.589352107776577,-58.408897242241956 -34.590042147223727,-58.409503211859395 -34.589531969986908,-58.409403822340451 -34.589415231823352,-58.40881716687845 -34.588764455248182)));;1875;2_23_8;COMUNA 2;23;8;445;195;250;78,00%;251;251;100,00%;0;0,00%;187;4;2,14%;183;97,86%
MULTIPOLYGON (((-58.408897242241956 -34.590042147223727,-58.408077706422361 -34.589352107776577,-58.407138434384485 -34.590098474095925,-58.407022044476633 -34.590194199509604,-58.407140016595683 -34.590280172186453,-58.407938245149182 -34.59086914791947,-58.408034538020068 -34.59077256753789,-58.408667530129435 -34.5902365605196,-58.408897242241956 -34.590042147223727)));;1876;2_23_9;COMUNA 2;23;9;943;395;548;72,08%;660;660;100,00%;0;0,00%;463;1;0,22%;462;99,78%
MULTIPOLYGON (((-58.411188829187509 -34.590346810058932,-58.410504727957637 -34.590793156857288,-58.411531964476445 -34.592100333781268,-58.41161288611432 -34.592207695866378,-58.412390845500376 -34.591750888318508,-58.412327020599243 -34.591676351999482,-58.411188829187509 -34.590346810058932)));;1877;2_24_1;COMUNA 2;24;1;1012;424;588;72,11%;610;610;100,00%;0;0,00%;450;1;0,22%;449;99,78%
MULTIPOLYGON (((-58.410081049957441 -34.589057131095537,-58.40992564819328 -34.589176082836026,-58.409503211859395 -34.589531969986908,-58.409637830610542 -34.589690133492581,-58.410504727957637 -34.590793156857288,-58.411188829187509 -34.590346810058932,-58.410081049957441 -34.589057131095537)));;1878;2_24_2;COMUNA 2;24;2;787;348;439;79,27%;529;529;100,00%;0;0,00%;377;1;0,27%;376;99,73%
MULTIPOLYGON (((-58.409503211859395 -34.589531969986908,-58.408897242241956 -34.590042147223727,-58.408667530129435 -34.5902365605196,-58.409879233216586 -34.591201284212993,-58.410504727957637 -34.590793156857288,-58.409637830610542 -34.589690133492581,-58.409503211859395 -34.589531969986908)));;1879;2_24_3;COMUNA 2;24;3;795;350;445;78,65%;450;450;100,00%;0;0,00%;335;1;0,30%;334;99,70%
MULTIPOLYGON (((-58.410504727957637 -34.590793156857288,-58.409879233216586 -34.591201284212993,-58.409751185805725 -34.591284823585411,-58.410645058961641 -34.592585470800849,-58.411018456676267 -34.592499569775669,-58.411120751871046 -34.592471583780572,-58.411200560835077 -34.592449715214457,-58.41161288611432 -34.592207695866378,-58.411531964476445 -34.592100333781268,-58.410504727957637 -34.590793156857288)));;1880;2_24_4;COMUNA 2;24;4;1050;446;604;73,84%;642;641;99,84%;1;0,16%;464;13;2,80%;451;97,20%
MULTIPOLYGON (((-58.409751185805725 -34.591284823585411,-58.409099017518145 -34.591710330383833,-58.409698877487997 -34.592792113938373,-58.410498902179555 -34.592619071667073,-58.410645058961641 -34.592585470800849,-58.409751185805725 -34.591284823585411)));;1881;2_24_5;COMUNA 2;24;5;922;371;551;67,33%;730;730;100,00%;0;0,00%;506;1;0,20%;505;99,80%
MULTIPOLYGON (((-58.408667530129435 -34.5902365605196,-58.408034538020068 -34.59077256753789,-58.407938245149182 -34.59086914791947,-58.409099017518145 -34.591710330383833,-58.409751185805725 -34.591284823585411,-58.409879233216586 -34.591201284212993,-58.408667530129435 -34.5902365605196)));;1882;2_24_6;COMUNA 2;24;6;968;395;573;68,94%;621;621;100,00%;0;0,00%;468;3;0,64%;465;99,36%
MULTIPOLYGON (((-58.412462925218733 -34.591835076270648,-58.412390845500376 -34.591750888318508,-58.41161288611432 -34.592207695866378,-58.411685043541631 -34.592303434055651,-58.412120803215792 -34.592875680247595,-58.412683455422105 -34.592460261967929,-58.412877875766874 -34.592319702145154,-58.412462925218733 -34.591835076270648)));;1883;2_25_1;COMUNA 2;25;1;570;237;333;71,17%;458;458;100,00%;0;0,00%;312;2;0,64%;310;99,36%
MULTIPOLYGON (((-58.41551783498565 -34.596712965487129,-58.414234877107319 -34.596770774802927,-58.414627860244863 -34.597897945649336,-58.415662565039092 -34.597859755848383,-58.416000506878511 -34.597854744604206,-58.41551783498565 -34.596712965487129)));;1884;2_25_10;COMUNA 2;25;10;605;275;330;83,33%;435;435;100,00%;0;0,00%;299;1;0,33%;298;99,67%
MULTIPOLYGON (((-58.412989646617611 -34.596826825372055,-58.411739730263434 -34.596883072551883,-58.411918832167956 -34.598003049628126,-58.412090958845837 -34.597993613729123,-58.412983862368925 -34.597958627311812,-58.413252567550835 -34.597948736107611,-58.414627860244863 -34.597897945649336,-58.414234877107319 -34.596770774802927,-58.412989646617611 -34.596826825372055)));;1885;2_25_11;COMUNA 2;25;11;1037;474;563;84,19%;659;657;99,70%;2;0,30%;501;43;8,58%;458;91,42%
MULTIPOLYGON (((-58.41161288611432 -34.592207695866378,-58.411200560835077 -34.592449715214457,-58.411120751871046 -34.592471583780572,-58.411018456676267 -34.592499569775669,-58.410645058961641 -34.592585470800849,-58.410498902179555 -34.592619071667073,-58.409698877487997 -34.592792113938373,-58.410226702530153 -34.593743858308521,-58.411564475422097 -34.593106302553892,-58.411647520086262 -34.593225144812948,-58.412120803215792 -34.592875680247595,-58.411685043541631 -34.592303434055651,-58.41161288611432 -34.592207695866378)));;1886;2_25_2;COMUNA 2;25;2;647;272;375;72,53%;492;492;100,00%;0;0,00%;349;1;0,29%;348;99,71%
MULTIPOLYGON (((-58.412120803215792 -34.592875680247595,-58.411647520086262 -34.593225144812948,-58.411564475422097 -34.593106302553892,-58.410226702530153 -34.593743858308521,-58.410329887193306 -34.593929825416581,-58.41097180419623 -34.595084933096629,-58.41115189276946 -34.595411993880212,-58.412638745097595 -34.594733431473372,-58.412637674356432 -34.594672794861673,-58.412578812920742 -34.594554174514293,-58.412306175611846 -34.594183202647542,-58.412244146916386 -34.594092821364654,-58.412744032361232 -34.593694278995997,-58.412120803215792 -34.592875680247595)));;1887;2_25_3;COMUNA 2;25;3;743;293;450;65,11%;240;239;99,58%;1;0,42%;177;12;6,78%;165;93,22%
MULTIPOLYGON (((-58.412877875766874 -34.592319702145154,-58.412683455422105 -34.592460261967929,-58.412120803215792 -34.592875680247595,-58.412744032361232 -34.593694278995997,-58.413523033025463 -34.59307316253367,-58.412877875766874 -34.592319702145154)));;1888;2_25_4;COMUNA 2;25;4;757;294;463;63,50%;632;632;100,00%;0;0,00%;427;5;1,17%;422;98,83%
MULTIPOLYGON (((-58.413523033025463 -34.59307316253367,-58.412744032361232 -34.593694278995997,-58.413533467880555 -34.594731048654282,-58.413726709483299 -34.594574007540665,-58.414393664345937 -34.594054041743938,-58.413523033025463 -34.59307316253367)));;1889;2_25_5;COMUNA 2;25;5;930;411;519;79,19%;620;619;99,84%;1;0,16%;469;4;0,85%;465;99,15%
MULTIPOLYGON (((-58.412638745097595 -34.594733431473372,-58.41115189276946 -34.595411993880212,-58.411619861091651 -34.596255885445323,-58.41178020156719 -34.596155948574513,-58.412667024261914 -34.595435160590888,-58.413533467880555 -34.594731048654282,-58.412744032361232 -34.593694278995997,-58.412244146916386 -34.594092821364654,-58.412306175611846 -34.594183202647542,-58.412578812920742 -34.594554174514293,-58.412637674356432 -34.594672794861673,-58.412638745097595 -34.594733431473372)));;1890;2_25_6;COMUNA 2;25;6;759;331;428;77,34%;459;453;98,69%;6;1,32%;355;110;30,99%;245;69,01%
MULTIPOLYGON (((-58.414393664345937 -34.594054041743938,-58.413726709483299 -34.594574007540665,-58.413533467880555 -34.594731048654282,-58.412667024261914 -34.595435160590888,-58.41270515950977 -34.59560743645055,-58.413828896408447 -34.595606201460363,-58.414844304894736 -34.595605054537856,-58.415046402615381 -34.59559795024807,-58.414626010903085 -34.594603591629081,-58.414393664345937 -34.594054041743938)));;1891;2_25_7;COMUNA 2;25;7;768;356;412;86,41%;528;528;100,00%;0;0,00%;386;7;1,81%;379;98,19%
MULTIPOLYGON (((-58.41270515950977 -34.59560743645055,-58.412667024261914 -34.595435160590888,-58.41178020156719 -34.596155948574513,-58.411619861091651 -34.596255885445323,-58.411739730263434 -34.596883072551883,-58.412989646617611 -34.596826825372055,-58.414234877107319 -34.596770774802927,-58.413828896408447 -34.595606201460363,-58.41270515950977 -34.59560743645055)));;1892;2_25_8;COMUNA 2;25;8;1222;586;636;92,14%;746;743;99,60%;3;0,40%;523;12;2,29%;511;97,71%
MULTIPOLYGON (((-58.415046402615381 -34.59559795024807,-58.414844304894736 -34.595605054537856,-58.413828896408447 -34.595606201460363,-58.414234877107319 -34.596770774802927,-58.41551783498565 -34.596712965487129,-58.415046402615381 -34.59559795024807)));;1893;2_25_9;COMUNA 2;25;9;775;340;435;78,16%;677;677;100,00%;0;0,00%;411;1;0,24%;410;99,76%
MULTIPOLYGON (((-58.397215575101868 -34.587461546426169,-58.396216243948267 -34.58696683132451,-58.395185503561343 -34.587734394918449,-58.395284272186814 -34.587854736031865,-58.395857918387989 -34.588553811937132,-58.396517024955443 -34.588023586533964,-58.397215575101868 -34.587461546426169)));;1894;2_3_1;COMUNA 2;3;1;895;362;533;67,92%;610;610;100,00%;0;0,00%;399;3;0,75%;396;99,25%
MULTIPOLYGON (((-58.394977651566009 -34.586353660844679,-58.394407249129465 -34.586817305350941,-58.395059172033299 -34.587580445552049,-58.395185503561343 -34.587734394918449,-58.396216243948267 -34.58696683132451,-58.394977651566009 -34.586353660844679)));;1895;2_3_2;COMUNA 2;3;2;745;327;418;78,23%;735;735;100,00%;0;0,00%;411;5;1,22%;406;98,78%
MULTIPOLYGON (((-58.391718535122138 -34.584756744333212,-58.391291887909581 -34.584893895390991,-58.391002288303426 -34.584986968821802,-58.390719664360851 -34.585186035886274,-58.390672549298081 -34.585215445901305,-58.390627816423326 -34.585247251767875,-58.390585550949424 -34.585281383113575,-58.390545923364961 -34.585317628765544,-58.390509104159598 -34.585355777551008,-58.390475348794602 -34.585395829623678,-58.390444657454907 -34.585437573709989,-58.390417115479622 -34.585480798586595,-58.390392978454457 -34.585525363556307,-58.390372331659236 -34.585571127820863,-58.390355090189395 -34.585617809630158,-58.390341509571876 -34.585665338711756,-58.390331504842045 -34.585713503740287,-58.390325246557445 -34.585762023116303,-58.390357590416151 -34.58607360416638,-58.390373531150118 -34.586152349184793,-58.39051891539895 -34.586319061693288,-58.390610518272354 -34.586444473000242,-58.390677419017521 -34.58657867283226,-58.390761859287522 -34.586715840830216,-58.390832367128844 -34.586815041289832,-58.390916988431755 -34.586841289328447,-58.390948638408688 -34.586873421907889,-58.390902787499272 -34.586917129095831,-58.390874581181293 -34.58694042329541,-58.390853334940751 -34.586989990247666,-58.390860334978292 -34.587068800352725,-58.390849705498546 -34.587150417093184,-58.390828441604789 -34.5872204073844,-58.390784183150068 -34.587293412413885,-58.390793197087476 -34.587406802558121,-58.390816800485375 -34.58768563046236,-58.390776920335185 -34.587717298377342,-58.39091502165234 -34.587841046613917,-58.391749879964486 -34.588553675990575,-58.392006378943101 -34.588343886872337,-58.392324496760182 -34.588173148401161,-58.392374995494713 -34.588272899810661,-58.39286241364097 -34.589106804548848,-58.392989800773051 -34.589218290271695,-58.394025436093948 -34.588654700001015,-58.394164386254928 -34.58858209915163,-58.394512058705445 -34.588400526072199,-58.395284272186814 -34.587854736031865,-58.395185503561343 -34.587734394918449,-58.395059172033299 -34.587580445552049,-58.394407249129465 -34.586817305350941,-58.394977651566009 -34.586353660844679,-58.394750551337246 -34.586241206139874,-58.393778652452738 -34.585766416650465,-58.393510101172218 -34.585635203061358,-58.393316710716689 -34.58554072325677,-58.392339891360507 -34.58506345457959,-58.392264987937139 -34.585026438044935,-58.391718535122138 -34.584756744333212)));;1896;2_3_3;COMUNA 2;3;3;266;114;152;75,00%;112;111;99,11%;1;0,90%;100;0;0,00%;100;100,00%
MULTIPOLYGON (((-58.395857918387989 -34.588553811937132,-58.395284272186814 -34.587854736031865,-58.394512058705445 -34.588400526072199,-58.394164386254928 -34.58858209915163,-58.394908227722055 -34.589317896073226,-58.395025821625254 -34.589223239253819,-58.395857918387989 -34.588553811937132)));;1897;2_3_4;COMUNA 2;3;4;369;159;210;75,71%;267;267;100,00%;0;0,00%;188;1;0,53%;187;99,47%
MULTIPOLYGON (((-58.392989800773051 -34.589218290271695,-58.391926317483147 -34.590068275375344,-58.392034131382339 -34.590164468428959,-58.392912999746329 -34.590936765322581,-58.3938187668711 -34.590195208261115,-58.393968148333727 -34.590074935592682,-58.394908227722055 -34.589317896073226,-58.394164386254928 -34.58858209915163,-58.394025436093948 -34.588654700001015,-58.392989800773051 -34.589218290271695)));;1898;2_3_5;COMUNA 2;3;5;714;331;383;86,42%;503;501;99,60%;2;0,40%;293;3;1,02%;290;98,98%
MULTIPOLYGON (((-58.392324496760182 -34.588173148401161,-58.392006378943101 -34.588343886872337,-58.391749879964486 -34.588553675990575,-58.390954982957062 -34.589201054020059,-58.391926317483147 -34.590068275375344,-58.392989800773051 -34.589218290271695,-58.39286241364097 -34.589106804548848,-58.392374995494713 -34.588272899810661,-58.392324496760182 -34.588173148401161)));;1899;2_3_6;COMUNA 2;3;6;678;288;390;73,85%;555;552;99,46%;3;0,54%;274;18;6,57%;256;93,43%
MULTIPOLYGON (((-58.390954982957062 -34.589201054020059,-58.389955038168686 -34.5900154240543,-58.390808939748908 -34.590781242091296,-58.390923559509915 -34.590884975633053,-58.391029148691317 -34.590795034128782,-58.391926317483147 -34.590068275375344,-58.390954982957062 -34.589201054020059)));;1900;2_3_7;COMUNA 2;3;7;885;368;517;71,18%;511;511;100,00%;0;0,00%;353;2;0,57%;351;99,43%
MULTIPOLYGON (((-58.391926317483147 -34.590068275375344,-58.391029148691317 -34.590795034128782,-58.390923559509915 -34.590884975633053,-58.391725990733825 -34.591611389122036,-58.391890985647201 -34.591764307897336,-58.392135470811034 -34.591573244786531,-58.392912999746329 -34.590936765322581,-58.392034131382339 -34.590164468428959,-58.391926317483147 -34.590068275375344)));;1901;2_3_8;COMUNA 2;3;8;606;267;339;78,76%;347;346;99,71%;1;0,29%;234;2;0,85%;232;99,15%
MULTIPOLYGON (((-58.38862717041269 -34.585321004466806,-58.388578846985958 -34.585350267425405,-58.387440196028706 -34.58590331207256,-58.3883484119578 -34.586803341605567,-58.38893551905182 -34.586457698033307,-58.38940317348446 -34.58618240530712,-58.389487523800817 -34.586128017121773,-58.38862717041269 -34.585321004466806)));;1902;2_4_1;COMUNA 2;4;1;823;356;467;76,23%;473;472;99,79%;1;0,21%;313;1;0,32%;312;99,68%
MULTIPOLYGON (((-58.385025030491526 -34.587035295157222,-58.383843385900349 -34.587679172576628,-58.384948968686885 -34.588792007133939,-58.385063907458729 -34.588725105805977,-58.385969949404931 -34.588197418299458,-58.386093666149904 -34.588121225366329,-58.385025030491526 -34.587035295157222)));;1903;2_4_10;COMUNA 2;4;10;884;365;519;70,33%;722;721;99,86%;1;0,14%;430;2;0,47%;428;99,53%
MULTIPOLYGON (((-58.38893551905182 -34.586457698033307,-58.3883484119578 -34.586803341605567,-58.389199557874335 -34.587646707915475,-58.389317481274972 -34.587569381409871,-58.38976923339078 -34.587274922073057,-58.38893551905182 -34.586457698033307)));;1904;2_4_2;COMUNA 2;4;2;233;112;121;92,56%;252;251;99,60%;1;0,40%;109;4;3,67%;105;96,33%
MULTIPOLYGON (((-58.38976923339078 -34.587274922073057,-58.389317481274972 -34.587569381409871,-58.389199557874335 -34.587646707915475,-58.389966137214024 -34.588321419526871,-58.390776920335185 -34.587717298377342,-58.390816800485375 -34.58768563046236,-58.390793197087476 -34.587406802558121,-58.390784183150068 -34.587293412413885,-58.390828441604789 -34.5872204073844,-58.390849705498546 -34.587150417093184,-58.390860334978292 -34.587068800352725,-58.390853334940751 -34.586989990247666,-58.390874581181293 -34.58694042329541,-58.390902787499272 -34.586917129095831,-58.390948638408688 -34.586873421907889,-58.390916988431755 -34.586841289328447,-58.390832367128844 -34.586815041289832,-58.390761859287522 -34.586715840830216,-58.390677419017521 -34.58657867283226,-58.390610518272354 -34.586444473000242,-58.39051891539895 -34.586319061693288,-58.390373531150118 -34.586152349184793,-58.390357590416151 -34.58607360416638,-58.390325246557445 -34.585762023116303,-58.390331504842045 -34.585713503740287,-58.390341509571876 -34.585665338711756,-58.390355090189395 -34.585617809630158,-58.390372331659236 -34.585571127820863,-58.390392978454457 -34.585525363556307,-58.390417115479622 -34.585480798586595,-58.390444657454907 -34.585437573709989,-58.390475348794602 -34.585395829623678,-58.390509104159598 -34.585355777551008,-58.390545923364961 -34.585317628765544,-58.390585550949424 -34.585281383113575,-58.390627816423326 -34.585247251767875,-58.390672549298081 -34.585215445901305,-58.390719664360851 -34.585186035886274,-58.391002288303426 -34.584986968821802,-58.390699021365371 -34.585030242751628,-58.390340767079906 -34.585048341474987,-58.389994988278168 -34.585016726254914,-58.389849388332109 -34.585003399458557,-58.389562902537506 -34.58503907463853,-58.389283190523365 -34.585118205684537,-58.38862717041269 -34.585321004466806,-58.389487523800817 -34.586128017121773,-58.38940317348446 -34.58618240530712,-58.38893551905182 -34.586457698033307,-58.38976923339078 -34.587274922073057)));;1905;2_4_3;COMUNA 2;4;3;365;144;221;65,16%;259;259;100,00%;0;0,00%;149;78;52,35%;71;47,65%
MULTIPOLYGON (((-58.390776920335185 -34.587717298377342,-58.389966137214024 -34.588321419526871,-58.390602873857638 -34.588886679060266,-58.390954982957062 -34.589201054020059,-58.391749879964486 -34.588553675990575,-58.39091502165234 -34.587841046613917,-58.390776920335185 -34.587717298377342)));;1906;2_4_4;COMUNA 2;4;4;499;210;289;72,66%;322;321;99,69%;1;0,31%;195;1;0,51%;194;99,49%
MULTIPOLYGON (((-58.389966137214024 -34.588321419526871,-58.389103403434248 -34.5890143806864,-58.388975138950215 -34.589131138909451,-58.389847227291533 -34.589918736187741,-58.389955038168686 -34.5900154240543,-58.390954982957062 -34.589201054020059,-58.390602873857638 -34.588886679060266,-58.389966137214024 -34.588321419526871)));;1907;2_4_5;COMUNA 2;4;5;702;317;385;82,34%;459;459;100,00%;0;0,00%;284;1;0,35%;283;99,65%
MULTIPOLYGON (((-58.389966137214024 -34.588321419526871,-58.389199557874335 -34.587646707915475,-58.388115146612577 -34.588357698196759,-58.388349907177897 -34.588566370899244,-58.388975138950215 -34.589131138909451,-58.389103403434248 -34.5890143806864,-58.389966137214024 -34.588321419526871)));;1908;2_4_6;COMUNA 2;4;6;539;226;313;72,20%;301;301;100,00%;0;0,00%;212;2;0,94%;210;99,06%
MULTIPOLYGON (((-58.3883484119578 -34.586803341605567,-58.387222747713587 -34.587465987122847,-58.38708378662691 -34.587546045160501,-58.387993384785865 -34.588249379959443,-58.388115146612577 -34.588357698196759,-58.389199557874335 -34.587646707915475,-58.3883484119578 -34.586803341605567)));;1909;2_4_7;COMUNA 2;4;7;617;273;344;79,36%;446;445;99,78%;1;0,22%;235;1;0,43%;234;99,57%
MULTIPOLYGON (((-58.387440196028706 -34.58590331207256,-58.385845569724836 -34.586588683991302,-58.38708378662691 -34.587546045160501,-58.387222747713587 -34.587465987122847,-58.3883484119578 -34.586803341605567,-58.387440196028706 -34.58590331207256)));;1910;2_4_8;COMUNA 2;4;8;997;465;532;87,41%;716;715;99,86%;1;0,14%;427;5;1,17%;422;98,83%
MULTIPOLYGON (((-58.385845569724836 -34.586588683991302,-58.385824270393414 -34.586600290762327,-58.385025030491526 -34.587035295157222,-58.386093666149904 -34.588121225366329,-58.386208180528399 -34.588050801418078,-58.38708378662691 -34.587546045160501,-58.385845569724836 -34.586588683991302)));;1911;2_4_9;COMUNA 2;4;9;812;365;447;81,66%;529;529;100,00%;0;0,00%;333;3;0,90%;330;99,10%
MULTIPOLYGON (((-58.386093666149904 -34.588121225366329,-58.385969949404931 -34.588197418299458,-58.385063907458729 -34.588725105805977,-58.384948968686885 -34.588792007133939,-58.385935958378099 -34.58978640387754,-58.387031057703339 -34.589068467670714,-58.388115146612577 -34.588357698196759,-58.387993384785865 -34.588249379959443,-58.38708378662691 -34.587546045160501,-58.386208180528399 -34.588050801418078,-58.386093666149904 -34.588121225366329)));;1912;2_5_1;COMUNA 2;5;1;710;350;360;97,22%;406;405;99,75%;1;0,25%;256;1;0,39%;255;99,61%
MULTIPOLYGON (((-58.387031057703339 -34.589068467670714,-58.385935958378099 -34.58978640387754,-58.386917441373527 -34.590775155048043,-58.387001894162296 -34.590708585108999,-58.387927291773302 -34.589973563084904,-58.387031057703339 -34.589068467670714)));;1913;2_5_2;COMUNA 2;5;2;887;394;493;79,92%;433;432;99,77%;1;0,23%;319;10;3,13%;309;96,87%
MULTIPOLYGON (((-58.388115146612577 -34.588357698196759,-58.387031057703339 -34.589068467670714,-58.387927291773302 -34.589973563084904,-58.388017708725421 -34.589901714187299,-58.388849175284385 -34.589245715202054,-58.388975138950215 -34.589131138909451,-58.388349907177897 -34.588566370899244,-58.388115146612577 -34.588357698196759)));;1914;2_5_3;COMUNA 2;5;3;661;284;377;75,33%;338;337;99,70%;1;0,30%;255;0;0,00%;255;100,00%
MULTIPOLYGON (((-58.388975138950215 -34.589131138909451,-58.388849175284385 -34.589245715202054,-58.388017708725421 -34.589901714187299,-58.387927291773302 -34.589973563084904,-58.388013479039166 -34.590060520718232,-58.388936240254594 -34.590845056674048,-58.389955038168686 -34.5900154240543,-58.389847227291533 -34.589918736187741,-58.388975138950215 -34.589131138909451)));;1915;2_5_4;COMUNA 2;5;4;544;233;311;74,92%;413;413;100,00%;0;0,00%;226;0;0,00%;226;100,00%
MULTIPOLYGON (((-58.387927291773302 -34.589973563084904,-58.387001894162296 -34.590708585108999,-58.386917441373527 -34.590775155048043,-58.387878238086628 -34.591591413914081,-58.387949976813594 -34.591648220677847,-58.388936240254594 -34.590845056674048,-58.388013479039166 -34.590060520718232,-58.387927291773302 -34.589973563084904)));;1916;2_5_5;COMUNA 2;5;5;777;327;450;72,67%;523;523;100,00%;0;0,00%;324;1;0,31%;323;99,69%
MULTIPOLYGON (((-58.388936240254594 -34.590845056674048,-58.387949976813594 -34.591648220677847,-58.389005219093761 -34.592484458742867,-58.389921195367123 -34.59171582325142,-58.389826319041049 -34.591627805418454,-58.389022186303961 -34.590918069224756,-58.388936240254594 -34.590845056674048)));;1917;2_5_6;COMUNA 2;5;6;811;339;472;71,82%;525;524;99,81%;1;0,19%;328;1;0,30%;327;99,70%
MULTIPOLYGON (((-58.389955038168686 -34.5900154240543,-58.388936240254594 -34.590845056674048,-58.389022186303961 -34.590918069224756,-58.389826319041049 -34.591627805418454,-58.389921195367123 -34.59171582325142,-58.390016132705661 -34.591636228805243,-58.390699682402861 -34.59107569637073,-58.390923559509915 -34.590884975633053,-58.390808939748908 -34.590781242091296,-58.389955038168686 -34.5900154240543)));;1918;2_5_7;COMUNA 2;5;7;828;358;470;76,17%;473;471;99,58%;2;0,42%;329;17;5,17%;312;94,83%
MULTIPOLYGON (((-58.390923559509915 -34.590884975633053,-58.390699682402861 -34.59107569637073,-58.390016132705661 -34.591636228805243,-58.389921195367123 -34.59171582325142,-58.390759008342521 -34.592493604140962,-58.390855170593497 -34.592574016062066,-58.391890985647201 -34.591764307897336,-58.391725990733825 -34.591611389122036,-58.390923559509915 -34.590884975633053)));;1919;2_5_8;COMUNA 2;5;8;700;304;396;76,77%;523;523;100,00%;0;0,00%;328;4;1,22%;324;98,78%
MULTIPOLYGON (((-58.389921195367123 -34.59171582325142,-58.389005219093761 -34.592484458742867,-58.389140615039253 -34.59259172774005,-58.389457209441815 -34.59282347655018,-58.390017977450199 -34.593233827900328,-58.390762027188352 -34.592646851377189,-58.390855170593497 -34.592574016062066,-58.390759008342521 -34.592493604140962,-58.389921195367123 -34.59171582325142)));;1920;2_5_9;COMUNA 2;5;9;616;246;370;66,49%;393;393;100,00%;0;0,00%;271;1;0,37%;270;99,63%
MULTIPOLYGON (((-58.389457209441815 -34.59282347655018,-58.389140615039253 -34.59259172774005,-58.389005219093761 -34.592484458742867,-58.387949976813594 -34.591648220677847,-58.387909752032606 -34.591681014227184,-58.387566545330003 -34.592830426063571,-58.387853794281185 -34.59282919407265,-58.388460394183632 -34.592830832263239,-58.388593501598578 -34.592829856787652,-58.388804616949137 -34.592828294600537,-58.388592935963416 -34.59452175355748,-58.388565120909568 -34.594676179295398,-58.389197863909956 -34.59469522475144,-58.389736981784772 -34.594360605660306,-58.390060078264561 -34.594274316168381,-58.390017977450199 -34.593233827900328,-58.389457209441815 -34.59282347655018)));;1921;2_6_1;COMUNA 2;6;1;432;186;246;75,61%;238;238;100,00%;0;0,00%;175;0;0,00%;175;100,00%
MULTIPOLYGON (((-58.388201841326449 -34.598368424585779,-58.387083842919544 -34.598292734033386,-58.386959254737612 -34.598281247877281,-58.386943898301546 -34.598404200801241,-58.386863459810989 -34.599292846776159,-58.387951599743658 -34.599343801804551,-58.388147220017892 -34.599354626113765,-58.388153673870363 -34.599185116545215,-58.388191491351186 -34.598513987222049,-58.388201841326449 -34.598368424585779)));;1922;2_6_10;COMUNA 2;6;10;515;235;280;83,93%;515;513;99,61%;2;0,39%;228;1;0,44%;227;99,56%
MULTIPOLYGON (((-58.388804616949137 -34.592828294600537,-58.388593501598578 -34.592829856787652,-58.388460394183632 -34.592830832263239,-58.387853794281185 -34.59282919407265,-58.387566545330003 -34.592830426063571,-58.387309257049317 -34.594546179500362,-58.387290176875347 -34.594644551822242,-58.387436816065822 -34.594656896349036,-58.388459010909131 -34.594672945648867,-58.388565120909568 -34.594676179295398,-58.388592935963416 -34.59452175355748,-58.388804616949137 -34.592828294600537)));;1923;2_6_2;COMUNA 2;6;2;1346;580;766;75,72%;843;842;99,88%;1;0,12%;572;5;0,87%;567;99,13%
MULTIPOLYGON (((-58.388565120909568 -34.594676179295398,-58.388459010909131 -34.594672945648867,-58.387436816065822 -34.594656896349036,-58.387290176875347 -34.594644551822242,-58.387270411788656 -34.594746867531548,-58.387178390444632 -34.595549869969702,-58.387156256726662 -34.59572824346391,-58.388252968566803 -34.595760538414488,-58.388420141758843 -34.59576458410335,-58.388542697176966 -34.594801170534616,-58.388565120909568 -34.594676179295398)));;1924;2_6_3;COMUNA 2;6;3;638;295;343;86,01%;317;316;99,68%;1;0,32%;226;1;0,44%;225;99,56%
MULTIPOLYGON (((-58.389197863909956 -34.59469522475144,-58.388565120909568 -34.594676179295398,-58.388542697176966 -34.594801170534616,-58.388420141758843 -34.59576458410335,-58.389948972586872 -34.595801422022049,-58.390016547013722 -34.595169536363045,-58.390022335327131 -34.595074958670452,-58.390060775715952 -34.594451436164398,-58.390060078264561 -34.594274316168381,-58.389736981784772 -34.594360605660306,-58.389197863909956 -34.59469522475144)));;1925;2_6_4;COMUNA 2;6;4;835;363;472;76,91%;482;482;100,00%;0;0,00%;333;5;1,50%;328;98,50%
MULTIPOLYGON (((-58.389948972586872 -34.595801422022049,-58.388420141758843 -34.59576458410335,-58.388394927296915 -34.595962534165061,-58.388298086252171 -34.597119280389101,-58.388426169489776 -34.597125344562684,-58.389646187574705 -34.597194252691288,-58.389782876729122 -34.597195742951605,-58.389808560325768 -34.597042372104546,-58.389925961143796 -34.596016416628025,-58.389948972586872 -34.595801422022049)));;1926;2_6_5;COMUNA 2;6;5;488;223;265;84,15%;285;285;100,00%;0;0,00%;183;0;0,00%;183;100,00%
MULTIPOLYGON (((-58.388420141758843 -34.59576458410335,-58.388252968566803 -34.595760538414488,-58.387156256726662 -34.59572824346391,-58.387130691734001 -34.595933798974734,-58.387061485400061 -34.596931893236992,-58.387062822959166 -34.597053518470346,-58.387275890631081 -34.597070974963394,-58.388298086252171 -34.597119280389101,-58.388394927296915 -34.595962534165061,-58.388420141758843 -34.59576458410335)));;1927;2_6_6;COMUNA 2;6;6;680;299;381;78,48%;603;603;100,00%;0;0,00%;320;28;8,75%;292;91,25%
MULTIPOLYGON (((-58.388298086252171 -34.597119280389101,-58.387275890631081 -34.597070974963394,-58.387062822959166 -34.597053518470346,-58.387064165054234 -34.597170143511583,-58.386972123088327 -34.59817836459677,-58.386959254737612 -34.598281247877281,-58.387083842919544 -34.598292734033386,-58.388201841326449 -34.598368424585779,-58.388210120676725 -34.598252650555459,-58.388287154262969 -34.597249349154509,-58.388298086252171 -34.597119280389101)));;1928;2_6_7;COMUNA 2;6;7;392;179;213;84,04%;334;333;99,70%;1;0,30%;175;0;0,00%;175;100,00%
MULTIPOLYGON (((-58.389782876729122 -34.597195742951605,-58.389646187574705 -34.597194252691288,-58.388426169489776 -34.597125344562684,-58.388298086252171 -34.597119280389101,-58.388287154262969 -34.597249349154509,-58.388210120676725 -34.598252650555459,-58.388201841326449 -34.598368424585779,-58.388331712523737 -34.598377236534226,-58.389719328540792 -34.598478500714492,-58.389725555086244 -34.598370401704798,-58.389759761731099 -34.597333410494855,-58.389782876729122 -34.597195742951605)));;1929;2_6_8;COMUNA 2;6;8;569;242;327;74,01%;329;329;100,00%;0;0,00%;219;25;11,42%;194;88,58%
MULTIPOLYGON (((-58.389719328540792 -34.598478500714492,-58.388331712523737 -34.598377236534226,-58.388201841326449 -34.598368424585779,-58.388191491351186 -34.598513987222049,-58.388153673870363 -34.599185116545215,-58.388147220017892 -34.599354626113765,-58.389480283447483 -34.599428675528962,-58.38966414981784 -34.599440828432165,-58.389719328540792 -34.598478500714492)));;1930;2_6_9;COMUNA 2;6;9;501;223;278;80,22%;527;527;100,00%;0;0,00%;276;6;2,17%;270;97,83%
MULTIPOLYGON (((-58.391890985647201 -34.591764307897336,-58.390855170593497 -34.592574016062066,-58.390956609301298 -34.592658726951932,-58.392181150092874 -34.593750610236718,-58.392158404687748 -34.59396060529852,-58.393076657833014 -34.593816056555887,-58.393062113062271 -34.593692522299257,-58.392834846129134 -34.592639463796743,-58.391890985647201 -34.591764307897336)));;1931;2_7_1;COMUNA 2;7;1;1419;591;828;71,38%;809;807;99,75%;2;0,25%;573;1;0,17%;572;99,83%
MULTIPOLYGON (((-58.390855170593497 -34.592574016062066,-58.390762027188352 -34.592646851377189,-58.390017977450199 -34.593233827900328,-58.390060078264561 -34.594274316168381,-58.392158404687748 -34.59396060529852,-58.392181150092874 -34.593750610236718,-58.390956609301298 -34.592658726951932,-58.390855170593497 -34.592574016062066)));;1932;2_7_2;COMUNA 2;7;2;1073;470;603;77,94%;773;773;100,00%;0;0,00%;493;4;0,81%;489;99,19%
MULTIPOLYGON (((-58.392158404687748 -34.59396060529852,-58.390060078264561 -34.594274316168381,-58.390060775715952 -34.594451436164398,-58.390022335327131 -34.595074958670452,-58.392054630630383 -34.594921075672424,-58.392158404687748 -34.59396060529852)));;1933;2_7_3;COMUNA 2;7;3;922;373;549;67,94%;548;547;99,82%;1;0,18%;361;7;1,94%;354;98,06%
MULTIPOLYGON (((-58.393076657833014 -34.593816056555887,-58.392158404687748 -34.59396060529852,-58.392054630630383 -34.594921075672424,-58.39319597495323 -34.594832290977799,-58.393076657833014 -34.593816056555887)));;1934;2_7_4;COMUNA 2;7;4;672;304;368;82,61%;390;390;100,00%;0;0,00%;267;2;0,75%;265;99,25%
MULTIPOLYGON (((-58.39319597495323 -34.594832290977799,-58.392054630630383 -34.594921075672424,-58.391955489202871 -34.595838870780774,-58.39331196149918 -34.595863030826322,-58.393210181635425 -34.594953219267914,-58.39319597495323 -34.594832290977799)));;1935;2_7_5;COMUNA 2;7;5;524;232;292;79,45%;445;445;100,00%;0;0,00%;244;1;0,41%;243;99,59%
MULTIPOLYGON (((-58.392054630630383 -34.594921075672424,-58.390022335327131 -34.595074958670452,-58.390016547013722 -34.595169536363045,-58.389948972586872 -34.595801422022049,-58.390225409070787 -34.595808065638977,-58.391955489202871 -34.595838870780774,-58.392054630630383 -34.594921075672424)));;1936;2_7_6;COMUNA 2;7;6;590;257;333;77,18%;560;560;100,00%;0;0,00%;271;1;0,37%;270;99,63%
MULTIPOLYGON (((-58.391955489202871 -34.595838870780774,-58.390225409070787 -34.595808065638977,-58.389948972586872 -34.595801422022049,-58.389925961143796 -34.596016416628025,-58.389808560325768 -34.597042372104546,-58.389782876729122 -34.597195742951605,-58.39134326234749 -34.597213004043496,-58.391624901711772 -34.597216126271562,-58.39180630156747 -34.597219048804185,-58.391955489202871 -34.595838870780774)));;1937;2_7_7;COMUNA 2;7;7;933;412;521;79,08%;695;692;99,57%;3;0,43%;409;3;0,73%;406;99,27%
MULTIPOLYGON (((-58.391654962696265 -34.598619296268339,-58.391195175352706 -34.598586068695646,-58.391077311854659 -34.598577478118941,-58.390953146344074 -34.598568531596989,-58.389719328540792 -34.598478500714492,-58.38966414981784 -34.599440828432165,-58.390140209930728 -34.599472169968394,-58.39137549820525 -34.599553464722582,-58.391552893462041 -34.59956434334326,-58.392930847848312 -34.59963711357576,-58.392961005350962 -34.599423671965695,-58.393035780777623 -34.598711786049471,-58.393191335992043 -34.597232029175238,-58.393323880449955 -34.595970295280935,-58.39331196149918 -34.595863030826322,-58.391955489202871 -34.595838870780774,-58.39180630156747 -34.597219048804185,-58.391654962696265 -34.598619296268339)));;1938;2_7_8;COMUNA 2;7;8;435;174;261;66,67%;315;311;98,73%;4;1,29%;172;3;1,74%;169;98,26%
MULTIPOLYGON (((-58.39134326234749 -34.597213004043496,-58.389782876729122 -34.597195742951605,-58.389759761731099 -34.597333410494855,-58.389725555086244 -34.598370401704798,-58.389719328540792 -34.598478500714492,-58.390953146344074 -34.598568531596989,-58.391077311854659 -34.598577478118941,-58.391195175352706 -34.598586068695646,-58.391654962696265 -34.598619296268339,-58.39180630156747 -34.597219048804185,-58.391624901711772 -34.597216126271562,-58.39134326234749 -34.597213004043496)));;1939;2_7_9;COMUNA 2;7;9;530;220;310;70,97%;429;429;100,00%;0;0,00%;278;0;0,00%;278;100,00%
MULTIPOLYGON (((-58.396604089442071 -34.59238831410417,-58.397196448076592 -34.592953444436468,-58.397467067163824 -34.592873656678996,-58.397132242732376 -34.592078516382898,-58.39708404685193 -34.591964119772548,-58.396764570270591 -34.591153915585899,-58.396000670801833 -34.591819723964207,-58.396487848202405 -34.592277401656432,-58.396604089442071 -34.59238831410417)));;1940;2_8_1;COMUNA 2;8;1;713;304;409;74,33%;540;538;99,63%;2;0,37%;347;2;0,58%;345;99,42%
MULTIPOLYGON (((-58.395791971407114 -34.59019193966548,-58.394943296801024 -34.590910795716276,-58.39593038153739 -34.591753697007995,-58.396000670801833 -34.591819723964207,-58.396764570270591 -34.591153915585899,-58.395791971407114 -34.59019193966548)));;1941;2_8_2;COMUNA 2;8;2;702;297;405;73,33%;456;456;100,00%;0;0,00%;306;2;0,65%;304;99,35%
MULTIPOLYGON (((-58.394908227722055 -34.589317896073226,-58.393968148333727 -34.590074935592682,-58.394113238537145 -34.590201994094301,-58.394943296801024 -34.590910795716276,-58.395791971407114 -34.59019193966548,-58.394908227722055 -34.589317896073226)));;1942;2_8_3;COMUNA 2;8;3;900;397;503;78,93%;714;713;99,86%;1;0,14%;457;3;0,66%;454;99,34%
MULTIPOLYGON (((-58.394943296801024 -34.590910795716276,-58.394113238537145 -34.590201994094301,-58.393968148333727 -34.590074935592682,-58.3938187668711 -34.590195208261115,-58.392912999746329 -34.590936765322581,-58.393891959846705 -34.591796932641024,-58.393993111608658 -34.591715577970561,-58.394943296801024 -34.590910795716276)));;1943;2_8_4;COMUNA 2;8;4;1105;459;646;71,05%;676;676;100,00%;0;0,00%;478;1;0,21%;477;99,79%
MULTIPOLYGON (((-58.394943296801024 -34.590910795716276,-58.393993111608658 -34.591715577970561,-58.393891959846705 -34.591796932641024,-58.393984972299975 -34.591878678411369,-58.394916403026393 -34.592673033388046,-58.395922183784855 -34.591888134445263,-58.396000670801833 -34.591819723964207,-58.39593038153739 -34.591753697007995,-58.394943296801024 -34.590910795716276)));;1944;2_8_5;COMUNA 2;8;5;907;409;498;82,13%;654;653;99,85%;1;0,15%;413;2;0,48%;411;99,52%
MULTIPOLYGON (((-58.396604089442071 -34.59238831410417,-58.396487848202405 -34.592277401656432,-58.396000670801833 -34.591819723964207,-58.395922183784855 -34.591888134445263,-58.394916403026393 -34.592673033388046,-58.395752195259774 -34.593385846666813,-58.396854275855013 -34.59305509527352,-58.396996017533084 -34.59301256436477,-58.397196448076592 -34.592953444436468,-58.396604089442071 -34.59238831410417)));;1945;2_8_6;COMUNA 2;8;6;1247;514;733;70,12%;890;890;100,00%;0;0,00%;625;5;0,80%;620;99,20%
MULTIPOLYGON (((-58.393891959846705 -34.591796932641024,-58.393474056901233 -34.592133118002948,-58.392834846129134 -34.592639463796743,-58.393062113062271 -34.593692522299257,-58.393076657833014 -34.593816056555887,-58.394316860992461 -34.593620764248413,-58.395689501316873 -34.593404615810186,-58.395752195259774 -34.593385846666813,-58.394916403026393 -34.592673033388046,-58.393984972299975 -34.591878678411369,-58.393891959846705 -34.591796932641024)));;1946;2_8_7;COMUNA 2;8;7;1495;613;882;69,50%;991;990;99,90%;1;0,10%;707;23;3,25%;684;96,75%
MULTIPOLYGON (((-58.392912999746329 -34.590936765322581,-58.392135470811034 -34.591573244786531,-58.391890985647201 -34.591764307897336,-58.392834846129134 -34.592639463796743,-58.393474056901233 -34.592133118002948,-58.393891959846705 -34.591796932641024,-58.392912999746329 -34.590936765322581)));;1947;2_8_8;COMUNA 2;8;8;848;363;485;74,85%;493;493;100,00%;0;0,00%;357;2;0,56%;355;99,44%
MULTIPOLYGON (((-58.395857918387989 -34.588553811937132,-58.395025821625254 -34.589223239253819,-58.394908227722055 -34.589317896073226,-58.395791971407114 -34.59019193966548,-58.396623929376865 -34.589487153637485,-58.395857918387989 -34.588553811937132)));;1948;2_9_1;COMUNA 2;9;1;765;306;459;66,67%;592;592;100,00%;0;0,00%;399;3;0,75%;396;99,25%
MULTIPOLYGON (((-58.396517024955443 -34.588023586533964,-58.395857918387989 -34.588553811937132,-58.396623929376865 -34.589487153637485,-58.395791971407114 -34.59019193966548,-58.396764570270591 -34.591153915585899,-58.397435230524536 -34.59056939377254,-58.39860534074446 -34.58986428166876,-58.399050580470885 -34.589596194155867,-58.39831266994009 -34.588738378491371,-58.398634845126047 -34.588481143382879,-58.398749706358302 -34.588389439389346,-58.39801867755012 -34.587899527480552,-58.397287146669221 -34.587409258762662,-58.397215575101868 -34.587461546426169,-58.396517024955443 -34.588023586533964)));;1949;2_9_2;COMUNA 2;9;2;681;227;454;50,00%;319;317;99,37%;2;0,63%;218;1;0,46%;217;99,54%
MULTIPOLYGON (((-58.398749706358302 -34.588389439389346,-58.398634845126047 -34.588481143382879,-58.39831266994009 -34.588738378491371,-58.399050580470885 -34.589596194155867,-58.3998273136677 -34.589130310590747,-58.398749706358302 -34.588389439389346)));;1950;2_9_3;COMUNA 2;9;3;865;386;479;80,58%;682;682;100,00%;0;0,00%;451;0;0,00%;451;100,00%
MULTIPOLYGON (((-58.3998273136677 -34.589130310590747,-58.399050580470885 -34.589596194155867,-58.39860534074446 -34.58986428166876,-58.39922735356182 -34.590846617591303,-58.400354412016334 -34.590189214720418,-58.3998273136677 -34.589130310590747)));;1951;2_9_4;COMUNA 2;9;4;1021;451;570;79,12%;617;617;100,00%;0;0,00%;461;0;0,00%;461;100,00%
MULTIPOLYGON (((-58.39860534074446 -34.58986428166876,-58.397435230524536 -34.59056939377254,-58.398036909062057 -34.591406437336175,-58.398102574270361 -34.591507109892618,-58.398649547105293 -34.591183653001117,-58.39922735356182 -34.590846617591303,-58.39860534074446 -34.58986428166876)));;1952;2_9_5;COMUNA 2;9;5;1028;431;597;72,19%;713;713;100,00%;0;0,00%;488;3;0,61%;485;99,39%
MULTIPOLYGON (((-58.397435230524536 -34.59056939377254,-58.396764570270591 -34.591153915585899,-58.39708404685193 -34.591964119772548,-58.397132242732376 -34.592078516382898,-58.397645823130958 -34.591777230053196,-58.398102574270361 -34.591507109892618,-58.398036909062057 -34.591406437336175,-58.397435230524536 -34.59056939377254)));;1953;2_9_6;COMUNA 2;9;6;900;369;531;69,49%;679;678;99,85%;1;0,15%;441;2;0,45%;439;99,55%
MULTIPOLYGON (((-58.398102574270361 -34.591507109892618,-58.397645823130958 -34.591777230053196,-58.397132242732376 -34.592078516382898,-58.397467067163824 -34.592873656678996,-58.398742300568948 -34.592497556311891,-58.398368299025357 -34.591914238159276,-58.398102574270361 -34.591507109892618)));;1954;2_9_7;COMUNA 2;9;7;949;393;556;70,68%;714;713;99,86%;1;0,14%;472;0;0,00%;472;100,00%
MULTIPOLYGON (((-58.39922735356182 -34.590846617591303,-58.398649547105293 -34.591183653001117,-58.398102574270361 -34.591507109892618,-58.398368299025357 -34.591914238159276,-58.398742300568948 -34.592497556311891,-58.399958766599937 -34.592001971059403,-58.39922735356182 -34.590846617591303)));;1955;2_9_8;COMUNA 2;9;8;1377;604;773;78,14%;898;898;100,00%;0;0,00%;649;4;0,62%;645;99,38%
MULTIPOLYGON (((-58.400354412016334 -34.590189214720418,-58.39922735356182 -34.590846617591303,-58.399958766599937 -34.592001971059403,-58.401032533726415 -34.59156341654046,-58.400488846166283 -34.590458941923877,-58.400354412016334 -34.590189214720418)));;1956;2_9_9;COMUNA 2;9;9;1150;497;653;76,11%;781;781;100,00%;0;0,00%;550;10;1,82%;540;98,18%
MULTIPOLYGON (((-58.412309363423269 -34.600238207136627,-58.4121240654761 -34.599296142299536,-58.411918832167956 -34.598003049628126,-58.410294144817939 -34.598092718286765,-58.410590222921904 -34.599392402035626,-58.409954591551418 -34.599432271316694,-58.40869661549447 -34.599508414138157,-58.409136405918559 -34.600727175623753,-58.409178489571282 -34.600844099948112,-58.410862565045058 -34.600527702252201,-58.410999191750498 -34.600501984587545,-58.412309363423269 -34.600238207136627)));;1957;3_1_1;COMUNA 3;1;1;1026;453;573;79,06%;667;667;100,00%;0;0,00%;488;44;9,02%;444;90,98%
MULTIPOLYGON (((-58.411742231098998 -34.604083348115225,-58.411584836054061 -34.604077436990416,-58.410475156469744 -34.604026260944963,-58.410344499554704 -34.604030219186683,-58.41077079705925 -34.605109174156226,-58.410883658810022 -34.605098094961797,-58.412036475979733 -34.605107663935904,-58.411742231098998 -34.604083348115225)));;1958;3_1_10;COMUNA 3;1;10;438;211;227;92,95%;195;195;100,00%;0;0,00%;192;84;43,75%;108;56,25%
MULTIPOLYGON (((-58.410344499554704 -34.604030219186683,-58.410086081548549 -34.604038136499156,-58.409183046694977 -34.604096055810096,-58.408914738703963 -34.604118966866046,-58.408983712116182 -34.60427653836976,-58.40937752686753 -34.605246043146558,-58.41077079705925 -34.605109174156226,-58.410344499554704 -34.604030219186683)));;1959;3_1_11;COMUNA 3;1;11;462;226;236;95,76%;288;287;99,65%;1;0,35%;230;19;8,26%;211;91,74%
MULTIPOLYGON (((-58.409428091242809 -34.598088399457446,-58.408721472702624 -34.598078511092915,-58.408147969034488 -34.598068959919956,-58.408234224522246 -34.598226962276833,-58.40869661549447 -34.599508414138157,-58.409954591551418 -34.599432271316694,-58.410590222921904 -34.599392402035626,-58.410294144817939 -34.598092718286765,-58.409428091242809 -34.598088399457446)));;1960;3_1_2;COMUNA 3;1;2;903;410;493;83,16%;536;535;99,81%;1;0,19%;419;15;3,58%;404;96,42%
MULTIPOLYGON (((-58.408147969034488 -34.598068959919956,-58.406626233202516 -34.598045804477216,-58.407195302770504 -34.599599363692725,-58.40869661549447 -34.599508414138157,-58.408234224522246 -34.598226962276833,-58.408147969034488 -34.598068959919956)));;1961;3_1_3;COMUNA 3;1;3;960;395;565;69,91%;621;621;100,00%;0;0,00%;467;49;10,49%;418;89,51%
MULTIPOLYGON (((-58.40869661549447 -34.599508414138157,-58.407195302770504 -34.599599363692725,-58.407234834182994 -34.599707132266893,-58.40757821496851 -34.600634435916859,-58.407759822171478 -34.601110662693742,-58.409178489571282 -34.600844099948112,-58.409136405918559 -34.600727175623753,-58.40869661549447 -34.599508414138157)));;1962;3_1_4;COMUNA 3;1;4;490;220;270;81,48%;345;345;100,00%;0;0,00%;248;9;3,63%;239;96,37%
MULTIPOLYGON (((-58.410862565045058 -34.600527702252201,-58.409178489571282 -34.600844099948112,-58.407759822171478 -34.601110662693742,-58.408072201763233 -34.601924354933402,-58.40810952779826 -34.602021699267098,-58.409479879229295 -34.601682643902457,-58.411046054580567 -34.601295062782654,-58.410862565045058 -34.600527702252201)));;1963;3_1_5;COMUNA 3;1;5;909;403;506;79,64%;494;493;99,80%;1;0,20%;374;33;8,82%;341;91,18%
MULTIPOLYGON (((-58.411230229975118 -34.602060592176237,-58.411437791249604 -34.602890499650577,-58.411584862286134 -34.603478611677758,-58.412833266950543 -34.603267078034037,-58.412972712272108 -34.603234528081508,-58.412803993862205 -34.60251168544827,-58.412591613252594 -34.601601845651352,-58.412309363423269 -34.600238207136627,-58.410999191750498 -34.600501984587545,-58.410862565045058 -34.600527702252201,-58.411046054580567 -34.601295062782654,-58.411205166535225 -34.601960436963637,-58.411230229975118 -34.602060592176237)));;1964;3_1_6;COMUNA 3;1;6;715;358;357;100,28%;372;371;99,73%;1;0,27%;262;47;17,94%;215;82,06%
MULTIPOLYGON (((-58.409479879229295 -34.601682643902457,-58.40810952779826 -34.602021699267098,-58.4084651930104 -34.602948160471655,-58.409790459046775 -34.60254379747321,-58.409920200839736 -34.602501809821,-58.411230229975118 -34.602060592176237,-58.411205166535225 -34.601960436963637,-58.411046054580567 -34.601295062782654,-58.409479879229295 -34.601682643902457)));;1965;3_1_7;COMUNA 3;1;7;847;430;417;103,12%;372;371;99,73%;1;0,27%;347;177;51,01%;170;48,99%
MULTIPOLYGON (((-58.408684564853004 -34.603519687751145,-58.408718236164113 -34.603607382005848,-58.408839131935011 -34.603946180552789,-58.408914738703963 -34.604118966866046,-58.409183046694977 -34.604096055810096,-58.410086081548549 -34.604038136499156,-58.410344499554704 -34.604030219186683,-58.410281912131666 -34.603871946936486,-58.410059310872818 -34.603270349607982,-58.409790459046775 -34.60254379747321,-58.4084651930104 -34.602948160471655,-58.408684564853004 -34.603519687751145)));;1966;3_1_8;COMUNA 3;1;8;491;247;244;101,23%;242;241;99,59%;1;0,41%;188;116;61,70%;72;38,30%
MULTIPOLYGON (((-58.411584862286134 -34.603478611677758,-58.411437791249604 -34.602890499650577,-58.411230229975118 -34.602060592176237,-58.409920200839736 -34.602501809821,-58.409790459046775 -34.60254379747321,-58.410059310872818 -34.603270349607982,-58.410281912131666 -34.603871946936486,-58.410344499554704 -34.604030219186683,-58.410475156469744 -34.604026260944963,-58.411584836054061 -34.604077436990416,-58.411742231098998 -34.604083348115225,-58.412036475979733 -34.605107663935904,-58.413412361717995 -34.60511907295993,-58.413221972380555 -34.604302275183834,-58.413183486950764 -34.604137535081144,-58.412972712272108 -34.603234528081508,-58.412833266950543 -34.603267078034037,-58.411584862286134 -34.603478611677758)));;1967;3_1_9;COMUNA 3;1;9;530;247;283;87,28%;295;291;98,64%;4;1,37%;227;2;0,88%;225;99,12%
MULTIPOLYGON (((-58.406119815313758 -34.607743823639126,-58.40487078277004 -34.607634149492377,-58.404748476739066 -34.607624372792834,-58.404670939596762 -34.608764941316466,-58.404574310172983 -34.610042336465966,-58.405544967744113 -34.610096106848438,-58.405965903508431 -34.610120740826467,-58.405985424253423 -34.609723129737858,-58.40600624018839 -34.609299461929048,-58.406029464894416 -34.608840441795166,-58.406036862241024 -34.608734314572082,-58.406119815313758 -34.607743823639126)));;1968;3_10_1;COMUNA 3;10;1;786;341;445;76,63%;521;518;99,42%;3;0,58%;377;6;1,59%;371;98,41%
MULTIPOLYGON (((-58.404748476739066 -34.607624372792834,-58.403633244847882 -34.607534961469277,-58.403466390652895 -34.607527204238927,-58.403397331798544 -34.608698692706419,-58.404670939596762 -34.608764941316466,-58.404748476739066 -34.607624372792834)));;1969;3_10_2;COMUNA 3;10;2;820;379;441;85,94%;436;435;99,77%;1;0,23%;323;27;8,36%;296;91,64%
MULTIPOLYGON (((-58.403466390652895 -34.607527204238927,-58.403316656346504 -34.607520159365379,-58.402106421471025 -34.607478717752642,-58.401968101447473 -34.607470972640911,-58.401908236170833 -34.60862126687914,-58.403397331798544 -34.608698692706419,-58.403466390652895 -34.607527204238927)));;1970;3_10_3;COMUNA 3;10;3;952;449;503;89,26%;314;313;99,68%;1;0,32%;257;27;10,51%;230;89,49%
MULTIPOLYGON (((-58.401968101447473 -34.607470972640911,-58.400633791073211 -34.607396847760626,-58.40049589715111 -34.607389171621833,-58.399256384293324 -34.607322545036482,-58.399218335467573 -34.60840918499327,-58.399213262541089 -34.608471579012516,-58.399305248753365 -34.608477965103617,-58.40041487938683 -34.60855065193978,-58.400552350281075 -34.608557060302076,-58.401742402708891 -34.608612662698569,-58.401908236170833 -34.60862126687914,-58.401968101447473 -34.607470972640911)));;1971;3_10_4;COMUNA 3;10;4;733;331;402;82,34%;417;416;99,76%;1;0,24%;298;11;3,69%;287;96,31%
MULTIPOLYGON (((-58.400552350281075 -34.608557060302076,-58.40041487938683 -34.60855065193978,-58.399305248753365 -34.608477965103617,-58.399213262541089 -34.608471579012516,-58.39910270401996 -34.609698890343346,-58.400073167566575 -34.609774113389022,-58.400470675730283 -34.609799176848654,-58.400504207781175 -34.609289221889838,-58.400552350281075 -34.608557060302076)));;1972;3_10_5;COMUNA 3;10;5;469;192;277;69,31%;302;300;99,34%;2;0,67%;202;17;8,42%;185;91,58%
MULTIPOLYGON (((-58.401908236170833 -34.60862126687914,-58.401742402708891 -34.608612662698569,-58.400552350281075 -34.608557060302076,-58.400504207781175 -34.609289221889838,-58.400470675730283 -34.609799176848654,-58.400770148503362 -34.609818062305884,-58.400962960890844 -34.609832471945467,-58.401464654167192 -34.609869964036015,-58.401781334423468 -34.609887517569511,-58.401853323016041 -34.609753111961332,-58.401908236170833 -34.60862126687914)));;1973;3_10_6;COMUNA 3;10;6;976;445;531;83,80%;509;509;100,00%;0;0,00%;390;61;15,64%;329;84,36%
MULTIPOLYGON (((-58.403397331798544 -34.608698692706419,-58.401908236170833 -34.60862126687914,-58.401853323016041 -34.609753111961332,-58.401781334423468 -34.609887517569511,-58.403323256383217 -34.60997447805174,-58.403397331798544 -34.608698692706419)));;1974;3_10_7;COMUNA 3;10;7;742;324;418;77,51%;415;415;100,00%;0;0,00%;340;43;12,65%;297;87,35%
MULTIPOLYGON (((-58.404670939596762 -34.608764941316466,-58.403397331798544 -34.608698692706419,-58.403323256383217 -34.60997447805174,-58.404574310172983 -34.610042336465966,-58.404670939596762 -34.608764941316466)));;1975;3_10_8;COMUNA 3;10;8;658;300;358;83,80%;334;330;98,80%;4;1,21%;274;43;15,69%;231;84,31%
MULTIPOLYGON (((-58.399256384293324 -34.607322545036482,-58.39911712770477 -34.607315007481176,-58.398007686374719 -34.607240548309818,-58.397849857045891 -34.607239056020809,-58.397839557934532 -34.607339406364261,-58.397736891681113 -34.608252131847827,-58.397726579963141 -34.608368327810872,-58.399213262541089 -34.608471579012516,-58.399218335467573 -34.60840918499327,-58.399256384293324 -34.607322545036482)));;1976;3_11_1;COMUNA 3;11;1;809;355;454;78,19%;457;456;99,78%;1;0,22%;367;0;0,00%;367;100,00%
MULTIPOLYGON (((-58.397849857045891 -34.607239056020809,-58.397721753793817 -34.607237861062814,-58.396469994539196 -34.607153100388629,-58.396455647848413 -34.607307182796397,-58.396379842266285 -34.608270275678265,-58.397608786808874 -34.608360166136329,-58.397726579963141 -34.608368327810872,-58.397736891681113 -34.608252131847827,-58.397839557934532 -34.607339406364261,-58.397849857045891 -34.607239056020809)));;1977;3_11_2;COMUNA 3;11;2;934;420;514;81,71%;569;567;99,65%;2;0,35%;454;109;24,01%;345;75,99%
MULTIPOLYGON (((-58.396469994539196 -34.607153100388629,-58.395031799040297 -34.607055617516217,-58.395027786923897 -34.607171535064936,-58.394944260829732 -34.608076874181791,-58.394942490935883 -34.608158566343199,-58.396264434555299 -34.608261832301963,-58.396379842266285 -34.608270275678265,-58.396455647848413 -34.607307182796397,-58.396469994539196 -34.607153100388629)));;1978;3_11_3;COMUNA 3;11;3;898;399;499;79,96%;457;454;99,34%;3;0,66%;384;97;25,26%;287;74,74%
MULTIPOLYGON (((-58.393564505339988 -34.606923874590386,-58.392315080438898 -34.606808719378535,-58.392112124877315 -34.60678867181602,-58.392042317535122 -34.6078518396288,-58.392033515417324 -34.607986557795435,-58.39196062340968 -34.609169305403668,-58.393373204962451 -34.609276739853527,-58.39346169368104 -34.608058646849123,-58.393579658275684 -34.608064488595396,-58.394815160014865 -34.608148636046309,-58.394942490935883 -34.608158566343199,-58.394944260829732 -34.608076874181791,-58.395027786923897 -34.607171535064936,-58.395031799040297 -34.607055617516217,-58.39489050073751 -34.607046031675679,-58.393564505339988 -34.606923874590386)));;1979;3_11_4;COMUNA 3;11;4;1213;556;657;84,63%;638;628;98,43%;10;1,59%;386;17;4,40%;369;95,60%
MULTIPOLYGON (((-58.394942490935883 -34.608158566343199,-58.394815160014865 -34.608148636046309,-58.393579658275684 -34.608064488595396,-58.39346169368104 -34.608058646849123,-58.393373204962451 -34.609276739853527,-58.394612975112636 -34.60937096256221,-58.394863895250076 -34.609387863508402,-58.394942490935883 -34.608158566343199)));;1980;3_11_5;COMUNA 3;11;5;704;315;389;80,98%;453;452;99,78%;1;0,22%;316;53;16,77%;263;83,23%
MULTIPOLYGON (((-58.396379842266285 -34.608270275678265,-58.396264434555299 -34.608261832301963,-58.394942490935883 -34.608158566343199,-58.394863895250076 -34.609387863508402,-58.396286629502342 -34.609483931429686,-58.396379842266285 -34.608270275678265)));;1981;3_11_6;COMUNA 3;11;6;916;424;492;86,18%;536;533;99,44%;3;0,56%;415;142;34,22%;273;65,78%
MULTIPOLYGON (((-58.397726579963141 -34.608368327810872,-58.397608786808874 -34.608360166136329,-58.396379842266285 -34.608270275678265,-58.396286629502342 -34.609483931429686,-58.396644698466375 -34.609508070353229,-58.397380080185918 -34.609565369765974,-58.397589690637908 -34.609581609157075,-58.397726579963141 -34.608368327810872)));;1982;3_11_7;COMUNA 3;11;7;843;337;506;66,60%;585;584;99,83%;1;0,17%;437;58;13,27%;379;86,73%
MULTIPOLYGON (((-58.399213262541089 -34.608471579012516,-58.397726579963141 -34.608368327810872,-58.397589690637908 -34.609581609157075,-58.39910270401996 -34.609698890343346,-58.399213262541089 -34.608471579012516)));;1983;3_11_8;COMUNA 3;11;8;584;254;330;76,97%;369;369;100,00%;0;0,00%;284;15;5,28%;269;94,72%
MULTIPOLYGON (((-58.400470675730283 -34.609799176848654,-58.400073167566575 -34.609774113389022,-58.39910270401996 -34.609698890343346,-58.399074043191064 -34.610645811331665,-58.399065909381406 -34.610812221592155,-58.399300393723976 -34.610831006317305,-58.400393011943741 -34.610914177839604,-58.400409968121437 -34.610678755401324,-58.400470675730283 -34.609799176848654)));;1984;3_12_1;COMUNA 3;12;1;679;294;385;76,36%;513;513;100,00%;0;0,00%;350;3;0,86%;347;99,14%
MULTIPOLYGON (((-58.400393011943741 -34.610914177839604,-58.399300393723976 -34.610831006317305,-58.399065909381406 -34.610812221592155,-58.397788725350836 -34.610709925352651,-58.397472220513144 -34.610682995012915,-58.397452412395282 -34.610960248018046,-58.397436195218042 -34.611873300604216,-58.397617020242016 -34.611889876669295,-58.398962968905906 -34.611984182181196,-58.399208445981962 -34.612001423471895,-58.400316838847615 -34.612083265800862,-58.400330180935725 -34.611897279979814,-58.400375969647605 -34.611150727023855,-58.400393011943741 -34.610914177839604)));;1985;3_12_10;COMUNA 3;12;10;845;377;468;80,56%;390;390;100,00%;0;0,00%;363;98;27,00%;265;73,00%
MULTIPOLYGON (((-58.39910270401996 -34.609698890343346,-58.397589690637908 -34.609581609157075,-58.397483589278814 -34.610522995270159,-58.397472220513144 -34.610682995012915,-58.397788725350836 -34.610709925352651,-58.399065909381406 -34.610812221592155,-58.399074043191064 -34.610645811331665,-58.39910270401996 -34.609698890343346)));;1986;3_12_2;COMUNA 3;12;2;904;380;524;72,52%;545;545;100,00%;0;0,00%;428;52;12,15%;376;87,85%
MULTIPOLYGON (((-58.397589690637908 -34.609581609157075,-58.397380080185918 -34.609565369765974,-58.396644698466375 -34.609508070353229,-58.396286629502342 -34.609483931429686,-58.396222111600693 -34.61060048629809,-58.397267378341787 -34.610665490326951,-58.397472220513144 -34.610682995012915,-58.397483589278814 -34.610522995270159,-58.397589690637908 -34.609581609157075)));;1987;3_12_3;COMUNA 3;12;3;578;221;357;61,90%;368;368;100,00%;0;0,00%;310;57;18,39%;253;81,61%
MULTIPOLYGON (((-58.396286629502342 -34.609483931429686,-58.394863895250076 -34.609387863508402,-58.394817494387105 -34.610513160423963,-58.396222111600693 -34.61060048629809,-58.396286629502342 -34.609483931429686)));;1988;3_12_4;COMUNA 3;12;4;491;253;238;106,30%;288;287;99,65%;1;0,35%;249;73;29,32%;176;70,68%
MULTIPOLYGON (((-58.394863895250076 -34.609387863508402,-58.394612975112636 -34.60937096256221,-58.393373204962451 -34.609276739853527,-58.393338683611553 -34.610432677881533,-58.394591951897475 -34.610499090556665,-58.394817494387105 -34.610513160423963,-58.394863895250076 -34.609387863508402)));;1989;3_12_5;COMUNA 3;12;5;971;411;560;73,39%;675;674;99,85%;1;0,15%;491;2;0,41%;489;99,59%
MULTIPOLYGON (((-58.393373204962451 -34.609276739853527,-58.39196062340968 -34.609169305403668,-58.391951660757499 -34.609292121598571,-58.391875132652387 -34.610340495708634,-58.391806531758014 -34.611279926588331,-58.391794675321755 -34.611499645963214,-58.392089118470722 -34.611528127614285,-58.393137204319778 -34.611593379930426,-58.393303723068932 -34.611603404697661,-58.393338683611553 -34.610432677881533,-58.393373204962451 -34.609276739853527)));;1990;3_12_6;COMUNA 3;12;6;269;149;120;124,17%;93;85;91,40%;8;9,41%;66;22;33,33%;44;66,67%
MULTIPOLYGON (((-58.394817494387105 -34.610513160423963,-58.394591951897475 -34.610499090556665,-58.393338683611553 -34.610432677881533,-58.393303723068932 -34.611603404697661,-58.394512283990544 -34.611676342284099,-58.39476883322007 -34.611692894444232,-58.394817494387105 -34.610513160423963)));;1991;3_12_7;COMUNA 3;12;7;928;425;503;84,49%;603;603;100,00%;0;0,00%;466;41;8,80%;425;91,20%
MULTIPOLYGON (((-58.396222111600693 -34.61060048629809,-58.394817494387105 -34.610513160423963,-58.39476883322007 -34.611692894444232,-58.395941618620341 -34.611768826225756,-58.396165034594809 -34.611783737538609,-58.396168388467601 -34.611530279489791,-58.396222111600693 -34.61060048629809)));;1992;3_12_8;COMUNA 3;12;8;546;226;320;70,63%;380;379;99,74%;1;0,26%;291;54;18,56%;237;81,44%
MULTIPOLYGON (((-58.397472220513144 -34.610682995012915,-58.397267378341787 -34.610665490326951,-58.396222111600693 -34.61060048629809,-58.396168388467601 -34.611530279489791,-58.396165034594809 -34.611783737538609,-58.397241997838485 -34.611855590295889,-58.397436195218042 -34.611873300604216,-58.397452412395282 -34.610960248018046,-58.397472220513144 -34.610682995012915)));;1993;3_12_9;COMUNA 3;12;9;478;231;247;93,52%;283;280;98,94%;3;1,07%;214;3;1,40%;211;98,60%
MULTIPOLYGON (((-58.401447423569394 -34.613266698219086,-58.401184733193595 -34.613252692309644,-58.400223920876314 -34.613201498016196,-58.40012594643396 -34.614357263915174,-58.401353207320014 -34.61443162224473,-58.401370302567315 -34.614236060459966,-58.401431796926438 -34.613434865432822,-58.401447423569394 -34.613266698219086)));;1994;3_13_1;COMUNA 3;13;1;744;352;392;89,80%;367;366;99,73%;1;0,27%;305;68;22,30%;237;77,70%
MULTIPOLYGON (((-58.396149176295445 -34.612976377547405,-58.394719736531314 -34.612882698758135,-58.394672030404543 -34.614036868516429,-58.394977050492621 -34.61405999678513,-58.395909747916761 -34.614125231594493,-58.396134961788363 -34.614136693117011,-58.396136671703538 -34.61391541852165,-58.396149176295445 -34.612976377547405)));;1995;3_13_10;COMUNA 3;13;10;693;345;348;99,14%;204;204;100,00%;0;0,00%;315;145;46,03%;170;53,97%
MULTIPOLYGON (((-58.398867542089469 -34.613129244011759,-58.398642671659786 -34.61311729473794,-58.397671300090636 -34.613065933947318,-58.397426073323508 -34.613051788402075,-58.396380857922949 -34.612991574672904,-58.396149176295445 -34.612976377547405,-58.396136671703538 -34.61391541852165,-58.396134961788363 -34.614136693117011,-58.397232326780149 -34.614192359317293,-58.397474831240402 -34.614206222095667,-58.397755666318481 -34.614222287979459,-58.398778240822537 -34.614280787865752,-58.398848375378904 -34.613352833570268,-58.398867542089469 -34.613129244011759)));;1996;3_13_11;COMUNA 3;13;11;896;411;485;84,74%;389;385;98,97%;4;1,04%;267;5;1,87%;262;98,13%
MULTIPOLYGON (((-58.398867542089469 -34.613129244011759,-58.398848375378904 -34.613352833570268,-58.398778240822537 -34.614280787865752,-58.39902994517076 -34.614295145348379,-58.399289827105783 -34.614309576987438,-58.399858910114837 -34.614341140170893,-58.40012594643396 -34.614357263915174,-58.400223920876314 -34.613201498016196,-58.401184733193595 -34.613252692309644,-58.401447423569394 -34.613266698219086,-58.401539808251258 -34.612272624224062,-58.401549160138799 -34.612181005882498,-58.401376167672012 -34.612168031261746,-58.400486083393517 -34.612095747036967,-58.400316838847615 -34.612083265800862,-58.399208445981962 -34.612001423471895,-58.398962968905906 -34.611984182181196,-58.398884817136619 -34.612928612025634,-58.398867542089469 -34.613129244011759)));;1997;3_13_2;COMUNA 3;13;2;771;348;423;82,27%;410;410;100,00%;0;0,00%;356;86;24,16%;270;75,84%
MULTIPOLYGON (((-58.398962968905906 -34.611984182181196,-58.397617020242016 -34.611889876669295,-58.397436195218042 -34.611873300604216,-58.397418193553612 -34.612889172700228,-58.397426073323508 -34.613051788402075,-58.397671300090636 -34.613065933947318,-58.398642671659786 -34.61311729473794,-58.398867542089469 -34.613129244011759,-58.398884817136619 -34.612928612025634,-58.398962968905906 -34.611984182181196)));;1998;3_13_3;COMUNA 3;13;3;817;370;447;82,77%;467;466;99,79%;1;0,21%;393;42;10,69%;351;89,31%
MULTIPOLYGON (((-58.397436195218042 -34.611873300604216,-58.397241997838485 -34.611855590295889,-58.396165034594809 -34.611783737538609,-58.396149176295445 -34.612976377547405,-58.396380857922949 -34.612991574672904,-58.397426073323508 -34.613051788402075,-58.397418193553612 -34.612889172700228,-58.397436195218042 -34.611873300604216)));;1999;3_13_4;COMUNA 3;13;4;516;249;267;93,26%;253;252;99,60%;1;0,40%;208;67;32,21%;141;67,79%
MULTIPOLYGON (((-58.396165034594809 -34.611783737538609,-58.395941618620341 -34.611768826225756,-58.39476883322007 -34.611692894444232,-58.394719736531314 -34.612882698758135,-58.396149176295445 -34.612976377547405,-58.396165034594809 -34.611783737538609)));;2000;3_13_5;COMUNA 3;13;5;633;275;358;76,82%;433;433;100,00%;0;0,00%;329;27;8,21%;302;91,79%
MULTIPOLYGON (((-58.39476883322007 -34.611692894444232,-58.394512283990544 -34.611676342284099,-58.393303723068932 -34.611603404697661,-58.393268588573477 -34.612777229882361,-58.394500832027397 -34.612868350722202,-58.394719736531314 -34.612882698758135,-58.39476883322007 -34.611692894444232)));;2001;3_13_6;COMUNA 3;13;6;735;326;409;79,71%;438;438;100,00%;0;0,00%;323;9;2,79%;314;97,21%
MULTIPOLYGON (((-58.393303723068932 -34.611603404697661,-58.393137204319778 -34.611593379930426,-58.392089118470722 -34.611528127614285,-58.391794675321755 -34.611499645963214,-58.391785587824344 -34.611668520029696,-58.391766434342351 -34.612455509132218,-58.391756802642597 -34.612663116642295,-58.392034814632893 -34.612686025285356,-58.393268588573477 -34.612777229882361,-58.393303723068932 -34.611603404697661)));;2002;3_13_7;COMUNA 3;13;7;622;267;355;75,21%;320;319;99,69%;1;0,31%;251;12;4,78%;239;95,22%
MULTIPOLYGON (((-58.393268588573477 -34.612777229882361,-58.392034814632893 -34.612686025285356,-58.391756802642597 -34.612663116642295,-58.391749254192959 -34.61282494906181,-58.391710241598254 -34.613825032680275,-58.392001543030545 -34.613851329532196,-58.393232191867213 -34.613931194245701,-58.393241423581998 -34.613688233052798,-58.393268588573477 -34.612777229882361)));;2003;3_13_8;COMUNA 3;13;8;498;230;268;85,82%;334;334;100,00%;0;0,00%;241;47;19,50%;194;80,50%
MULTIPOLYGON (((-58.394719736531314 -34.612882698758135,-58.394500832027397 -34.612868350722202,-58.393268588573477 -34.612777229882361,-58.393241423581998 -34.613688233052798,-58.393232191867213 -34.613931194245701,-58.393552801482194 -34.613952010924194,-58.394672030404543 -34.614036868516429,-58.394719736531314 -34.612882698758135)));;2004;3_13_9;COMUNA 3;13;9;723;303;420;72,14%;472;472;100,00%;0;0,00%;369;28;7,59%;341;92,41%
MULTIPOLYGON (((-58.408599089913977 -34.613966935261402,-58.408400993045696 -34.615086394379858,-58.409680347595824 -34.615250343204465,-58.409872551003247 -34.61399495910792,-58.410039943662618 -34.612901682267932,-58.410070996252841 -34.612692955738204,-58.408713175261674 -34.612611091905833,-58.408622173954754 -34.613836236577157,-58.408599089913977 -34.613966935261402)));;2005;3_14_1;COMUNA 3;14;1;880;424;456;92,98%;420;411;97,86%;9;2,19%;346;114;32,95%;232;67,05%
MULTIPOLYGON (((-58.407562952625575 -34.613803296512337,-58.406748525165348 -34.613674681675377,-58.406543178944901 -34.613632895687992,-58.406506736922786 -34.613735629078931,-58.406194927460248 -34.614803692351025,-58.407283904268311 -34.614943281342391,-58.408400993045696 -34.615086394379858,-58.408599089913977 -34.613966935261402,-58.407562952625575 -34.613803296512337)));;2006;3_14_10;COMUNA 3;14;10;898;404;494;81,78%;393;392;99,75%;1;0,26%;313;41;13,10%;272;86,90%
MULTIPOLYGON (((-58.408713175261674 -34.612611091905833,-58.406941478832273 -34.61250430530756,-58.40685852321571 -34.612742726680267,-58.406543178944901 -34.613632895687992,-58.406748525165348 -34.613674681675377,-58.407562952625575 -34.613803296512337,-58.408599089913977 -34.613966935261402,-58.408622173954754 -34.613836236577157,-58.408713175261674 -34.612611091905833)));;2007;3_14_2;COMUNA 3;14;2;948;439;509;86,25%;510;508;99,61%;2;0,39%;418;58;13,88%;360;86,12%
MULTIPOLYGON (((-58.406941478832273 -34.61250430530756,-58.40556713956169 -34.612421483385376,-58.405276748646422 -34.613424270528071,-58.406327101459517 -34.613588921219595,-58.406543178944901 -34.613632895687992,-58.40685852321571 -34.612742726680267,-58.406941478832273 -34.61250430530756)));;2008;3_14_3;COMUNA 3;14;3;1052;484;568;85,21%;576;575;99,83%;1;0,17%;454;5;1,10%;449;98,90%
MULTIPOLYGON (((-58.40556713956169 -34.612421483385376,-58.405334179328712 -34.6124074299033,-58.404350124214432 -34.612349918914013,-58.403240348847973 -34.612285014572443,-58.403132854121381 -34.613353451359856,-58.404007648111381 -34.613387749801937,-58.404218296945174 -34.613396442817859,-58.405276748646422 -34.613424270528071,-58.40556713956169 -34.612421483385376)));;2009;3_14_4;COMUNA 3;14;4;802;371;431;86,08%;403;400;99,26%;3;0,75%;299;38;12,71%;261;87,29%
MULTIPOLYGON (((-58.403240348847973 -34.612285014572443,-58.401859030571167 -34.612204260230612,-58.401549160138799 -34.612181005882498,-58.401539808251258 -34.612272624224062,-58.401447423569394 -34.613266698219086,-58.402903891613718 -34.613344465794846,-58.403132854121381 -34.613353451359856,-58.403240348847973 -34.612285014572443)));;2010;3_14_5;COMUNA 3;14;5;844;387;457;84,68%;428;428;100,00%;0;0,00%;365;99;27,12%;266;72,88%
MULTIPOLYGON (((-58.403132854121381 -34.613353451359856,-58.402903891613718 -34.613344465794846,-58.401447423569394 -34.613266698219086,-58.401431796926438 -34.613434865432822,-58.401370302567315 -34.614236060459966,-58.401353207320014 -34.61443162224473,-58.401624332748376 -34.614448096890776,-58.403005343848498 -34.614533572208721,-58.403037110480746 -34.614304776742692,-58.403132854121381 -34.613353451359856)));;2011;3_14_6;COMUNA 3;14;6;1114;513;601;85,36%;633;633;100,00%;0;0,00%;514;22;4,28%;492;95,72%
MULTIPOLYGON (((-58.404218296945174 -34.613396442817859,-58.404007648111381 -34.613387749801937,-58.403132854121381 -34.613353451359856,-58.403037110480746 -34.614304776742692,-58.403005343848498 -34.614533572208721,-58.403300916184016 -34.61455188613985,-58.404070513972961 -34.614597048750944,-58.404218296945174 -34.613396442817859)));;2012;3_14_7;COMUNA 3;14;7;633;288;345;83,48%;322;322;100,00%;0;0,00%;259;14;5,41%;245;94,59%
MULTIPOLYGON (((-58.405276748646422 -34.613424270528071,-58.404218296945174 -34.613396442817859,-58.404070513972961 -34.614597048750944,-58.404911838899153 -34.614639282651801,-58.405242338316434 -34.613543272690769,-58.405276748646422 -34.613424270528071)));;2013;3_14_8;COMUNA 3;14;8;720;322;398;80,90%;398;396;99,50%;2;0,51%;316;42;13,29%;274;86,71%
MULTIPOLYGON (((-58.406543178944901 -34.613632895687992,-58.406327101459517 -34.613588921219595,-58.405276748646422 -34.613424270528071,-58.405242338316434 -34.613543272690769,-58.404911838899153 -34.614639282651801,-58.406194927460248 -34.614803692351025,-58.406506736922786 -34.613735629078931,-58.406543178944901 -34.613632895687992)));;2014;3_14_9;COMUNA 3;14;9;103;48;55;87,27%;55;55;100,00%;0;0,00%;43;23;53,49%;20;46,51%
MULTIPOLYGON (((-58.408581870251091 -34.610311302347526,-58.407665054284024 -34.610237650119927,-58.407407540100898 -34.611165525235677,-58.407336193825131 -34.611370500328782,-58.408797986298637 -34.61147045429545,-58.408882280286178 -34.610335450191876,-58.408581870251091 -34.610311302347526)));;2015;3_15_1;COMUNA 3;15;1;683;314;369;85,09%;388;386;99,48%;2;0,52%;282;2;0,71%;280;99,29%
MULTIPOLYGON (((-58.408797986298637 -34.61147045429545,-58.407336193825131 -34.611370500328782,-58.406941478832273 -34.61250430530756,-58.408713175261674 -34.612611091905833,-58.408797986298637 -34.61147045429545)));;2016;3_15_2;COMUNA 3;15;2;909;407;502;81,08%;489;485;99,18%;4;0,82%;399;13;3,26%;386;96,74%
MULTIPOLYGON (((-58.407336193825131 -34.611370500328782,-58.40583752661091 -34.611263821283181,-58.405652522050879 -34.612126864798597,-58.40556713956169 -34.612421483385376,-58.406941478832273 -34.61250430530756,-58.407336193825131 -34.611370500328782)));;2017;3_15_3;COMUNA 3;15;3;666;304;362;83,98%;334;333;99,70%;1;0,30%;271;41;15,13%;230;84,87%
MULTIPOLYGON (((-58.406416988422997 -34.610151795948916,-58.405965903508431 -34.610120740826467,-58.405544967744113 -34.610096106848438,-58.404574310172983 -34.610042336465966,-58.404507812920407 -34.610980014992144,-58.404490467663095 -34.611179168885855,-58.40583752661091 -34.611263821283181,-58.407336193825131 -34.611370500328782,-58.407407540100898 -34.611165525235677,-58.407665054284024 -34.610237650119927,-58.406416988422997 -34.610151795948916)));;2018;3_15_4;COMUNA 3;15;4;788;361;427;84,54%;474;473;99,79%;1;0,21%;334;12;3,59%;322;96,41%
MULTIPOLYGON (((-58.404350124214432 -34.612349918914013,-58.405334179328712 -34.6124074299033,-58.40556713956169 -34.612421483385376,-58.405652522050879 -34.612126864798597,-58.40583752661091 -34.611263821283181,-58.404490467663095 -34.611179168885855,-58.404507812920407 -34.610980014992144,-58.404574310172983 -34.610042336465966,-58.403323256383217 -34.60997447805174,-58.403282759268777 -34.611102950146631,-58.403240348847973 -34.612285014572443,-58.404350124214432 -34.612349918914013)));;2019;3_15_5;COMUNA 3;15;5;755;364;391;93,09%;508;506;99,61%;2;0,40%;382;47;12,30%;335;87,70%
MULTIPOLYGON (((-58.403323256383217 -34.60997447805174,-58.401781334423468 -34.609887517569511,-58.401669874659738 -34.610998629107158,-58.403282759268777 -34.611102950146631,-58.403323256383217 -34.60997447805174)));;2020;3_15_6;COMUNA 3;15;6;805;371;434;85,48%;488;486;99,59%;2;0,41%;362;78;21,55%;284;78,45%
MULTIPOLYGON (((-58.403282759268777 -34.611102950146631,-58.401669874659738 -34.610998629107158,-58.401646535710938 -34.611231020237284,-58.401549160138799 -34.612181005882498,-58.401859030571167 -34.612204260230612,-58.403240348847973 -34.612285014572443,-58.403282759268777 -34.611102950146631)));;2021;3_15_7;COMUNA 3;15;7;1248;565;683;82,72%;761;760;99,87%;1;0,13%;600;95;15,83%;505;84,17%
MULTIPOLYGON (((-58.401669874659738 -34.610998629107158,-58.40055833577216 -34.610926797824369,-58.400393011943741 -34.610914177839604,-58.400375969647605 -34.611150727023855,-58.400330180935725 -34.611897279979814,-58.400316838847615 -34.612083265800862,-58.400486083393517 -34.612095747036967,-58.401376167672012 -34.612168031261746,-58.401549160138799 -34.612181005882498,-58.401646535710938 -34.611231020237284,-58.401669874659738 -34.610998629107158)));;2022;3_15_8;COMUNA 3;15;8;1281;555;726;76,45%;845;843;99,76%;2;0,24%;617;4;0,65%;613;99,35%
MULTIPOLYGON (((-58.401781334423468 -34.609887517569511,-58.401464654167192 -34.609869964036015,-58.400962960890844 -34.609832471945467,-58.400770148503362 -34.609818062305884,-58.400470675730283 -34.609799176848654,-58.400409968121437 -34.610678755401324,-58.400393011943741 -34.610914177839604,-58.40055833577216 -34.610926797824369,-58.401669874659738 -34.610998629107158,-58.401781334423468 -34.609887517569511)));;2023;3_15_9;COMUNA 3;15;9;275;102;173;58,96%;151;150;99,34%;1;0,67%;116;3;2,59%;113;97,41%
MULTIPOLYGON (((-58.414467053489723 -34.61073639196033,-58.413100496324169 -34.610638094014448,-58.413018393445995 -34.612480451461245,-58.413435360548327 -34.612614428200736,-58.413561234839108 -34.612365103747962,-58.41401427652535 -34.611550467103612,-58.414467053489723 -34.61073639196033)));;2024;3_16_1;COMUNA 3;16;1;891;383;508;75,39%;469;468;99,79%;1;0,21%;375;66;17,60%;309;82,40%
MULTIPOLYGON (((-58.413100496324169 -34.610638094014448,-58.411733261053264 -34.610539639628378,-58.411681006947845 -34.61185713049251,-58.412810336218172 -34.612413603580713,-58.413018393445995 -34.612480451461245,-58.413100496324169 -34.610638094014448)));;2025;3_16_2;COMUNA 3;16;2;1121;525;596;88,09%;608;608;100,00%;0;0,00%;504;63;12,50%;441;87,50%
MULTIPOLYGON (((-58.411733261053264 -34.610539639628378,-58.410346438898301 -34.610439541739687,-58.410233888668692 -34.611568618989381,-58.411234286532491 -34.611637005310158,-58.411681006947845 -34.61185713049251,-58.411733261053264 -34.610539639628378)));;2026;3_16_3;COMUNA 3;16;3;881;406;475;85,47%;416;416;100,00%;0;0,00%;388;90;23,20%;298;76,80%
MULTIPOLYGON (((-58.410346438898301 -34.610439541739687,-58.409994238988453 -34.610415868114266,-58.409164120834816 -34.610360645526242,-58.408882280286178 -34.610335450191876,-58.408797986298637 -34.61147045429545,-58.410233888668692 -34.611568618989381,-58.410346438898301 -34.610439541739687)));;2027;3_16_4;COMUNA 3;16;4;464;217;247;87,85%;253;250;98,81%;3;1,20%;178;3;1,69%;175;98,31%
MULTIPOLYGON (((-58.410233888668692 -34.611568618989381,-58.408797986298637 -34.61147045429545,-58.408713175261674 -34.612611091905833,-58.410070996252841 -34.612692955738204,-58.410224802374394 -34.611659533874146,-58.410233888668692 -34.611568618989381)));;2028;3_16_5;COMUNA 3;16;5;664;348;316;110,13%;295;293;99,32%;2;0,68%;267;96;35,96%;171;64,04%
MULTIPOLYGON (((-58.411681006947845 -34.61185713049251,-58.411234286532491 -34.611637005310158,-58.410233888668692 -34.611568618989381,-58.410224802374394 -34.611659533874146,-58.410070996252841 -34.612692955738204,-58.41146153837925 -34.613037715016496,-58.411681006947845 -34.61185713049251)));;2029;3_16_6;COMUNA 3;16;6;741;380;361;105,26%;350;347;99,14%;3;0,86%;275;48;17,45%;227;82,55%
MULTIPOLYGON (((-58.413018393445995 -34.612480451461245,-58.412810336218172 -34.612413603580713,-58.411681006947845 -34.61185713049251,-58.41146153837925 -34.613037715016496,-58.41311630618177 -34.613416440564158,-58.413314005455966 -34.612854739932587,-58.413435360548327 -34.612614428200736,-58.413018393445995 -34.612480451461245)));;2030;3_16_7;COMUNA 3;16;7;787;383;404;94,80%;367;367;100,00%;0;0,00%;312;103;33,01%;209;66,99%
MULTIPOLYGON (((-58.41146153837925 -34.613037715016496,-58.410070996252841 -34.612692955738204,-58.410039943662618 -34.612901682267932,-58.409872551003247 -34.61399495910792,-58.41131235590197 -34.614053252193614,-58.412870052859198 -34.614116224550962,-58.41311630618177 -34.613416440564158,-58.41146153837925 -34.613037715016496)));;2031;3_16_8;COMUNA 3;16;8;774;368;406;90,64%;397;396;99,75%;1;0,25%;339;86;25,37%;253;74,63%
MULTIPOLYGON (((-58.412870052859198 -34.614116224550962,-58.41131235590197 -34.614053252193614,-58.409872551003247 -34.61399495910792,-58.409680347595824 -34.615250343204465,-58.411149967274632 -34.61534280730713,-58.412816360458045 -34.615443433204597,-58.412870052859198 -34.614116224550962)));;2032;3_16_9;COMUNA 3;16;9;1153;555;598;92,81%;596;596;100,00%;0;0,00%;507;47;9,27%;460;90,73%
MULTIPOLYGON (((-58.412816360458045 -34.615443433204597,-58.411149967274632 -34.61534280730713,-58.41100163230611 -34.616627297283252,-58.412754061909567 -34.616629576680005,-58.412816360458045 -34.615443433204597)));;2033;3_17_1;COMUNA 3;17;1;738;349;389;89,72%;327;326;99,69%;1;0,31%;267;50;18,73%;217;81,27%
MULTIPOLYGON (((-58.411149967274632 -34.61534280730713,-58.409680347595824 -34.615250343204465,-58.408400993045696 -34.615086394379858,-58.408360894092482 -34.615313215608325,-58.408229533721439 -34.616497213236642,-58.409253305716526 -34.616603162750778,-58.409455188211091 -34.616613321809005,-58.409699236141925 -34.61662554118513,-58.41100163230611 -34.616627297283252,-58.411149967274632 -34.61534280730713)));;2034;3_17_2;COMUNA 3;17;2;822;399;423;94,33%;391;390;99,74%;1;0,26%;325;97;29,85%;228;70,15%
MULTIPOLYGON (((-58.408400993045696 -34.615086394379858,-58.407283904268311 -34.614943281342391,-58.406938820418787 -34.616352540491476,-58.408229533721439 -34.616497213236642,-58.408360894092482 -34.615313215608325,-58.408400993045696 -34.615086394379858)));;2035;3_17_3;COMUNA 3;17;3;452;190;262;72,52%;256;256;100,00%;0;0,00%;208;43;20,67%;165;79,33%
MULTIPOLYGON (((-58.408229533721439 -34.616497213236642,-58.406938820418787 -34.616352540491476,-58.406611235976584 -34.617690606685493,-58.406572309098991 -34.617812283214128,-58.406743327297754 -34.617866236916129,-58.408031585684469 -34.618282328611713,-58.408121991437127 -34.617467269935048,-58.408229533721439 -34.616497213236642)));;2036;3_17_4;COMUNA 3;17;4;905;440;465;94,62%;362;361;99,72%;1;0,28%;332;154;46,39%;178;53,61%
MULTIPOLYGON (((-58.41100163230611 -34.616627297283252,-58.409699236141925 -34.61662554118513,-58.409455188211091 -34.616613321809005,-58.409253305716526 -34.616603162750778,-58.408229533721439 -34.616497213236642,-58.408121991437127 -34.617467269935048,-58.408031585684469 -34.618282328611713,-58.40933263243182 -34.618702496926772,-58.410989567034747 -34.619049631138253,-58.410999003166893 -34.617845015300553,-58.41100163230611 -34.616627297283252)));;2037;3_17_5;COMUNA 3;17;5;811;392;419;93,56%;313;310;99,04%;3;0,97%;324;108;33,33%;216;66,67%
MULTIPOLYGON (((-58.410999003166893 -34.617845015300553,-58.410989567034747 -34.619049631138253,-58.412642086994104 -34.619394557844856,-58.412682284497272 -34.618277351996959,-58.412687605348886 -34.618069882080619,-58.412754061909567 -34.616629576680005,-58.41100163230611 -34.616627297283252,-58.410999003166893 -34.617845015300553)));;2038;3_17_6;COMUNA 3;17;6;726;321;405;79,26%;390;390;100,00%;0;0,00%;327;36;11,01%;291;88,99%
MULTIPOLYGON (((-58.410989567034747 -34.619049631138253,-58.40933263243182 -34.618702496926772,-58.409321263033874 -34.61889721709867,-58.409252050252036 -34.620023423394201,-58.410079039996404 -34.620193788856142,-58.410519154249826 -34.620284474022149,-58.41081183140075 -34.620336220381539,-58.412543881188107 -34.620642307566243,-58.412635329115943 -34.61958308279933,-58.412642086994104 -34.619394557844856,-58.410989567034747 -34.619049631138253)));;2039;3_17_7;COMUNA 3;17;7;880;412;468;88,03%;409;409;100,00%;0;0,00%;344;14;4,07%;330;95,93%
MULTIPOLYGON (((-58.408031585684469 -34.618282328611713,-58.406743327297754 -34.617866236916129,-58.406572309098991 -34.617812283214128,-58.40647050614335 -34.618704098694401,-58.406387211635831 -34.619433099907553,-58.407780359348372 -34.619720153517093,-58.409252050252036 -34.620023423394201,-58.409321263033874 -34.61889721709867,-58.40933263243182 -34.618702496926772,-58.408031585684469 -34.618282328611713)));;2040;3_17_8;COMUNA 3;17;8;1182;548;634;86,44%;444;436;98,20%;8;1,83%;383;169;44,13%;214;55,87%
MULTIPOLYGON (((-58.406572309098991 -34.617812283214128,-58.405467083641803 -34.617463799685979,-58.405035128208887 -34.619154500797571,-58.406387211635831 -34.619433099907553,-58.40647050614335 -34.618704098694401,-58.406572309098991 -34.617812283214128)));;2041;3_17_9;COMUNA 3;17;9;707;326;381;85,56%;323;323;100,00%;0;0,00%;281;84;29,89%;197;70,11%
MULTIPOLYGON (((-58.406938820418787 -34.616352540491476,-58.40581702536489 -34.616094337383387,-58.405467083641803 -34.617463799685979,-58.406572309098991 -34.617812283214128,-58.406611235976584 -34.617690606685493,-58.406938820418787 -34.616352540491476)));;2042;3_18_1;COMUNA 3;18;1;573;267;306;87,25%;291;291;100,00%;0;0,00%;256;86;33,59%;170;66,41%
MULTIPOLYGON (((-58.404138559851255 -34.617044914968247,-58.402852536439894 -34.616773154503868,-58.402686359612993 -34.616745536682821,-58.402532873982821 -34.61672003764609,-58.401167045017296 -34.616560195818202,-58.401072284615658 -34.617644129949241,-58.402460808952988 -34.617778771872352,-58.402246623363332 -34.618755812945373,-58.403512874432785 -34.618840239623196,-58.404138559851255 -34.617044914968247)));;2043;3_18_10;COMUNA 3;18;10;581;268;313;85,62%;257;256;99,61%;1;0,39%;208;21;10,10%;187;89,90%
MULTIPOLYGON (((-58.402460808952988 -34.617778771872352,-58.401072284615658 -34.617644129949241,-58.401052525048264 -34.617869620867111,-58.40098020747547 -34.618667358815657,-58.402246623363332 -34.618755812945373,-58.402460808952988 -34.617778771872352)));;2044;3_18_11;COMUNA 3;18;11;597;262;335;78,21%;353;353;100,00%;0;0,00%;249;11;4,42%;238;95,58%
MULTIPOLYGON (((-58.407283904268311 -34.614943281342391,-58.406194927460248 -34.614803692351025,-58.406137294649767 -34.615001278338099,-58.40581702536489 -34.616094337383387,-58.406938820418787 -34.616352540491476,-58.407283904268311 -34.614943281342391)));;2045;3_18_2;COMUNA 3;18;2;761;362;399;90,73%;356;355;99,72%;1;0,28%;302;44;14,57%;258;85,43%
MULTIPOLYGON (((-58.406194927460248 -34.614803692351025,-58.404911838899153 -34.614639282651801,-58.404554179304732 -34.61582542262569,-58.405609548139296 -34.616046562716441,-58.40581702536489 -34.616094337383387,-58.406137294649767 -34.615001278338099,-58.406194927460248 -34.614803692351025)));;2046;3_18_3;COMUNA 3;18;3;486;222;264;84,09%;247;246;99,60%;1;0,41%;189;4;2,12%;185;97,88%
MULTIPOLYGON (((-58.404070513972961 -34.614597048750944,-58.403300916184016 -34.61455188613985,-58.403005343848498 -34.614533572208721,-58.402879473043839 -34.615441923260349,-58.40429925973779 -34.615771989104644,-58.404554179304732 -34.61582542262569,-58.404911838899153 -34.614639282651801,-58.404070513972961 -34.614597048750944)));;2047;3_18_4;COMUNA 3;18;4;830;385;445;86,52%;476;473;99,37%;3;0,63%;377;10;2,65%;367;97,35%
MULTIPOLYGON (((-58.403005343848498 -34.614533572208721,-58.401624332748376 -34.614448096890776,-58.401353207320014 -34.61443162224473,-58.401258881560544 -34.615510345667396,-58.402879473043839 -34.615441923260349,-58.403005343848498 -34.614533572208721)));;2048;3_18_5;COMUNA 3;18;5;396;179;217;82,49%;209;209;100,00%;0;0,00%;171;16;9,36%;155;90,64%
MULTIPOLYGON (((-58.402879473043839 -34.615441923260349,-58.401258881560544 -34.615510345667396,-58.401167045017296 -34.616560195818202,-58.402532873982821 -34.61672003764609,-58.402686359612993 -34.616745536682821,-58.402721403129419 -34.616582167848534,-58.402879473043839 -34.615441923260349)));;2049;3_18_6;COMUNA 3;18;6;644;297;347;85,59%;299;299;100,00%;0;0,00%;255;58;22,75%;197;77,25%
MULTIPOLYGON (((-58.404554179304732 -34.61582542262569,-58.40429925973779 -34.615771989104644,-58.402879473043839 -34.615441923260349,-58.402721403129419 -34.616582167848534,-58.402686359612993 -34.616745536682821,-58.402852536439894 -34.616773154503868,-58.404138559851255 -34.617044914968247,-58.40449372869206 -34.616026034734404,-58.404554179304732 -34.61582542262569)));;2050;3_18_7;COMUNA 3;18;7;709;341;368;92,66%;337;336;99,70%;1;0,30%;275;18;6,55%;257;93,45%
MULTIPOLYGON (((-58.40581702536489 -34.616094337383387,-58.405609548139296 -34.616046562716441,-58.404554179304732 -34.61582542262569,-58.40449372869206 -34.616026034734404,-58.404138559851255 -34.617044914968247,-58.405467083641803 -34.617463799685979,-58.40581702536489 -34.616094337383387)));;2051;3_18_8;COMUNA 3;18;8;538;245;293;83,62%;313;313;100,00%;0;0,00%;254;10;3,94%;244;96,06%
MULTIPOLYGON (((-58.405467083641803 -34.617463799685979,-58.404138559851255 -34.617044914968247,-58.403512874432785 -34.618840239623196,-58.405035128208887 -34.619154500797571,-58.405467083641803 -34.617463799685979)));;2052;3_18_9;COMUNA 3;18;9;895;410;485;84,54%;499;499;100,00%;0;0,00%;395;60;15,19%;335;84,81%
MULTIPOLYGON (((-58.40012594643396 -34.614357263915174,-58.399858910114837 -34.614341140170893,-58.399289827105783 -34.614309576987438,-58.399229048143802 -34.615150209205609,-58.399411736501534 -34.615190728090809,-58.401258881560544 -34.615510345667396,-58.401353207320014 -34.61443162224473,-58.40012594643396 -34.614357263915174)));;2053;3_19_1;COMUNA 3;19;1;1181;528;653;80,86%;625;625;100,00%;0;0,00%;516;4;0,78%;512;99,22%
MULTIPOLYGON (((-58.40012985248385 -34.61755230897186,-58.399316896846983 -34.617471604781066,-58.39906297517183 -34.61744788020826,-58.399044291616832 -34.617707457074012,-58.398962899350892 -34.618538922679527,-58.399242898406023 -34.618553717050048,-58.400039276186313 -34.618603567059175,-58.40012985248385 -34.61755230897186)));;2054;3_19_10;COMUNA 3;19;10;520;245;275;89,09%;279;279;100,00%;0;0,00%;236;51;21,61%;185;78,39%
MULTIPOLYGON (((-58.398778240822537 -34.614280787865752,-58.397755666318481 -34.614222287979459,-58.397474831240402 -34.614206222095667,-58.397478233312562 -34.614430738986798,-58.39744442730187 -34.61474242218452,-58.397863539760543 -34.614838423709529,-58.399082386580417 -34.615117666868883,-58.399229048143802 -34.615150209205609,-58.399289827105783 -34.614309576987438,-58.39902994517076 -34.614295145348379,-58.398778240822537 -34.614280787865752)));;2055;3_19_2;COMUNA 3;19;2;301;140;161;86,96%;167;166;99,40%;1;0,60%;152;15;9,87%;137;90,13%
MULTIPOLYGON (((-58.396119672082989 -34.615256161352534,-58.396117329090856 -34.615416729168665,-58.396096421926963 -34.61599638623845,-58.396382794047106 -34.616019641657537,-58.397520851434052 -34.616140329679709,-58.397735839040926 -34.616164318438365,-58.397811154602451 -34.615382358906068,-58.397863539760543 -34.614838423709529,-58.39744442730187 -34.61474242218452,-58.397478233312562 -34.614430738986798,-58.397474831240402 -34.614206222095667,-58.397232326780149 -34.614192359317293,-58.396134961788363 -34.614136693117011,-58.396133448145505 -34.614325501861927,-58.396119672082989 -34.615256161352534)));;2056;3_19_3;COMUNA 3;19;3;665;287;378;75,93%;407;405;99,51%;2;0,49%;310;31;10,00%;279;90,00%
MULTIPOLYGON (((-58.399229048143802 -34.615150209205609,-58.399082386580417 -34.615117666868883,-58.397863539760543 -34.614838423709529,-58.397811154602451 -34.615382358906068,-58.397735839040926 -34.616164318438365,-58.397914115259844 -34.616184273101247,-58.399144247334235 -34.616324220873899,-58.399229048143802 -34.615150209205609)));;2057;3_19_4;COMUNA 3;19;4;727;325;402;80,85%;361;360;99,72%;1;0,28%;295;38;12,88%;257;87,12%
MULTIPOLYGON (((-58.401258881560544 -34.615510345667396,-58.399411736501534 -34.615190728090809,-58.399229048143802 -34.615150209205609,-58.399144247334235 -34.616324220873899,-58.399421244793551 -34.61635577442992,-58.400224809277411 -34.616449853880894,-58.401167045017296 -34.616560195818202,-58.401258881560544 -34.615510345667396)));;2058;3_19_5;COMUNA 3;19;5;812;407;405;100,49%;361;361;100,00%;0;0,00%;344;114;33,14%;230;66,86%
MULTIPOLYGON (((-58.40012985248385 -34.61755230897186,-58.400039276186313 -34.618603567059175,-58.400293974198028 -34.618619472819042,-58.40098020747547 -34.618667358815657,-58.401052525048264 -34.617869620867111,-58.401072284615658 -34.617644129949241,-58.401167045017296 -34.616560195818202,-58.400224809277411 -34.616449853880894,-58.40012985248385 -34.61755230897186)));;2059;3_19_6;COMUNA 3;19;6;781;359;422;85,07%;416;416;100,00%;0;0,00%;336;14;4,17%;322;95,83%
MULTIPOLYGON (((-58.400224809277411 -34.616449853880894,-58.399421244793551 -34.61635577442992,-58.399144247334235 -34.616324220873899,-58.397914115259844 -34.616184273101247,-58.397735839040926 -34.616164318438365,-58.397520851434052 -34.616140329679709,-58.396382794047106 -34.616019641657537,-58.396096421926963 -34.61599638623845,-58.396053125111692 -34.617197531853527,-58.396276723384837 -34.617215753032902,-58.397623850800677 -34.617326835082594,-58.398841677569649 -34.617427200464334,-58.39906297517183 -34.61744788020826,-58.399316896846983 -34.617471604781066,-58.40012985248385 -34.61755230897186,-58.400224809277411 -34.616449853880894)));;2060;3_19_7;COMUNA 3;19;7;949;456;493;92,49%;398;398;100,00%;0;0,00%;413;107;25,91%;306;74,09%
MULTIPOLYGON (((-58.397623850800677 -34.617326835082594,-58.396276723384837 -34.617215753032902,-58.396053125111692 -34.617197531853527,-58.39599995839302 -34.618169367995399,-58.395989736408048 -34.6183817642289,-58.397514521299563 -34.618462380043823,-58.397623850800677 -34.617326835082594)));;2061;3_19_8;COMUNA 3;19;8;1160;530;630;84,13%;604;604;100,00%;0;0,00%;499;74;14,83%;425;85,17%
MULTIPOLYGON (((-58.39906297517183 -34.61744788020826,-58.398841677569649 -34.617427200464334,-58.397623850800677 -34.617326835082594,-58.397514521299563 -34.618462380043823,-58.398962899350892 -34.618538922679527,-58.399044291616832 -34.617707457074012,-58.39906297517183 -34.61744788020826)));;2062;3_19_9;COMUNA 3;19;9;689;334;355;94,08%;365;365;100,00%;0;0,00%;304;34;11,18%;270;88,82%
MULTIPOLYGON (((-58.406626233202516 -34.598045804477216,-58.405586271166591 -34.598040955790573,-58.405735351995048 -34.598356812271398,-58.406311476526682 -34.599657622678926,-58.40642935696296 -34.599645704807642,-58.407195302770504 -34.599599363692725,-58.406626233202516 -34.598045804477216)));;2063;3_2_1;COMUNA 3;2;1;742;332;410;80,98%;444;444;100,00%;0;0,00%;323;28;8,67%;295;91,33%
MULTIPOLYGON (((-58.4084651930104 -34.602948160471655,-58.407407657073293 -34.603022618232089,-58.407812004760153 -34.604257424662052,-58.408740721732343 -34.604133820171562,-58.408914738703963 -34.604118966866046,-58.408839131935011 -34.603946180552789,-58.408718236164113 -34.603607382005848,-58.408684564853004 -34.603519687751145,-58.4084651930104 -34.602948160471655)));;2064;3_2_10;COMUNA 3;2;10;427;174;253;68,77%;234;234;100,00%;0;0,00%;193;6;3,11%;187;96,89%
MULTIPOLYGON (((-58.408914738703963 -34.604118966866046,-58.408740721732343 -34.604133820171562,-58.407812004760153 -34.604257424662052,-58.407866235993239 -34.604423089055203,-58.408226335667166 -34.605352721719889,-58.408344304649297 -34.605347562868808,-58.40937752686753 -34.605246043146558,-58.408983712116182 -34.60427653836976,-58.408914738703963 -34.604118966866046)));;2065;3_2_11;COMUNA 3;2;11;602;297;305;97,38%;306;306;100,00%;0;0,00%;257;27;10,51%;230;89,49%
MULTIPOLYGON (((-58.407812004760153 -34.604257424662052,-58.406642394982306 -34.60441309594767,-58.406948858939842 -34.605414189262312,-58.407100476510969 -34.605401863617786,-58.408226335667166 -34.605352721719889,-58.407866235993239 -34.604423089055203,-58.407812004760153 -34.604257424662052)));;2066;3_2_12;COMUNA 3;2;12;845;384;461;83,30%;423;423;100,00%;0;0,00%;365;50;13,70%;315;86,30%
MULTIPOLYGON (((-58.405586271166591 -34.598040955790573,-58.404731971115886 -34.598036961258522,-58.405297304689753 -34.599770182288339,-58.405448234185791 -34.599753069441242,-58.406311476526682 -34.599657622678926,-58.405735351995048 -34.598356812271398,-58.405586271166591 -34.598040955790573)));;2067;3_2_2;COMUNA 3;2;2;714;320;394;81,22%;439;438;99,77%;1;0,23%;333;26;7,81%;307;92,19%
MULTIPOLYGON (((-58.406311476526682 -34.599657622678926,-58.405448234185791 -34.599753069441242,-58.405297304689753 -34.599770182288339,-58.405631229658461 -34.600793899067028,-58.405733182541695 -34.600785847807877,-58.406647522893394 -34.600710845847225,-58.406615991342271 -34.600612447331692,-58.406311476526682 -34.599657622678926)));;2068;3_2_3;COMUNA 3;2;3;676;296;380;77,89%;426;426;100,00%;0;0,00%;336;4;1,19%;332;98,81%
MULTIPOLYGON (((-58.407195302770504 -34.599599363692725,-58.40642935696296 -34.599645704807642,-58.406311476526682 -34.599657622678926,-58.406615991342271 -34.600612447331692,-58.406647522893394 -34.600710845847225,-58.40757821496851 -34.600634435916859,-58.407234834182994 -34.599707132266893,-58.407195302770504 -34.599599363692725)));;2069;3_2_4;COMUNA 3;2;4;734;341;393;86,77%;362;361;99,72%;1;0,28%;288;5;1,74%;283;98,26%
MULTIPOLYGON (((-58.406647522893394 -34.600710845847225,-58.405733182541695 -34.600785847807877,-58.405631229658461 -34.600793899067028,-58.405895128802577 -34.6016029261637,-58.40592885661173 -34.601727312771274,-58.406943129131975 -34.601625875189114,-58.407759822171478 -34.601110662693742,-58.40757821496851 -34.600634435916859,-58.406647522893394 -34.600710845847225)));;2070;3_2_5;COMUNA 3;2;5;872;399;473;84,36%;472;472;100,00%;0;0,00%;369;36;9,76%;333;90,24%
MULTIPOLYGON (((-58.407759822171478 -34.601110662693742,-58.406943129131975 -34.601625875189114,-58.407407657073293 -34.603022618232089,-58.4084651930104 -34.602948160471655,-58.40810952779826 -34.602021699267098,-58.408072201763233 -34.601924354933402,-58.407759822171478 -34.601110662693742)));;2071;3_2_6;COMUNA 3;2;6;927;397;530;74,91%;455;455;100,00%;0;0,00%;367;33;8,99%;334;91,01%
MULTIPOLYGON (((-58.406943129131975 -34.601625875189114,-58.40592885661173 -34.601727312771274,-58.404982637277548 -34.601821942884271,-58.404802234741233 -34.601839534142727,-58.405155931360689 -34.603342997631422,-58.406318299494721 -34.60317226622503,-58.407273250400962 -34.60303206465192,-58.407407657073293 -34.603022618232089,-58.406943129131975 -34.601625875189114)));;2072;3_2_7;COMUNA 3;2;7;1021;456;565;80,71%;550;550;100,00%;0;0,00%;420;16;3,81%;404;96,19%
MULTIPOLYGON (((-58.405469462590318 -34.604563683844795,-58.405517373719633 -34.60474807940156,-58.405713220056256 -34.605572004593952,-58.406835486427376 -34.605423433528017,-58.406948858939842 -34.605414189262312,-58.406642394982306 -34.60441309594767,-58.406318299494721 -34.60317226622503,-58.405155931360689 -34.603342997631422,-58.405191513806493 -34.603494569402351,-58.405469462590318 -34.604563683844795)));;2073;3_2_8;COMUNA 3;2;8;866;391;475;82,32%;595;595;100,00%;0;0,00%;354;18;5,08%;336;94,92%
MULTIPOLYGON (((-58.407407657073293 -34.603022618232089,-58.407273250400962 -34.60303206465192,-58.406318299494721 -34.60317226622503,-58.406642394982306 -34.60441309594767,-58.407812004760153 -34.604257424662052,-58.407407657073293 -34.603022618232089)));;2074;3_2_9;COMUNA 3;2;9;836;378;458;82,53%;394;393;99,75%;1;0,25%;311;7;2,25%;304;97,75%
MULTIPOLYGON (((-58.396134961788363 -34.614136693117011,-58.395909747916761 -34.614125231594493,-58.394977050492621 -34.61405999678513,-58.394672030404543 -34.614036868516429,-58.394626319985932 -34.615144699472147,-58.396119672082989 -34.615256161352534,-58.396133448145505 -34.614325501861927,-58.396134961788363 -34.614136693117011)));;2075;3_20_1;COMUNA 3;20;1;603;272;331;82,18%;341;341;100,00%;0;0,00%;318;100;31,45%;218;68,55%
MULTIPOLYGON (((-58.394546542101835 -34.617076836104253,-58.393189957248055 -34.61697775736404,-58.393198876691422 -34.618234144692934,-58.394495961208378 -34.618302766472482,-58.394546542101835 -34.617076836104253)));;2076;3_20_10;COMUNA 3;20;10;626;270;356;75,84%;368;368;100,00%;0;0,00%;287;27;9,41%;260;90,59%
MULTIPOLYGON (((-58.396053125111692 -34.617197531853527,-58.394791862295236 -34.617094790438273,-58.394546542101835 -34.617076836104253,-58.394495961208378 -34.618302766472482,-58.395989736408048 -34.6183817642289,-58.39599995839302 -34.618169367995399,-58.396053125111692 -34.617197531853527)));;2077;3_20_11;COMUNA 3;20;11;479;195;284;68,66%;307;307;100,00%;0;0,00%;239;8;3,35%;231;96,65%
MULTIPOLYGON (((-58.394672030404543 -34.614036868516429,-58.393552801482194 -34.613952010924194,-58.393232191867213 -34.613931194245701,-58.393224702241675 -34.614127957585012,-58.393201800003219 -34.615033540243289,-58.394326832332368 -34.615122348104478,-58.394626319985932 -34.615144699472147,-58.394672030404543 -34.614036868516429)));;2078;3_20_2;COMUNA 3;20;2;880;375;505;74,26%;482;480;99,59%;2;0,42%;444;39;8,78%;405;91,22%
MULTIPOLYGON (((-58.393232191867213 -34.613931194245701,-58.392001543030545 -34.613851329532196,-58.391710241598254 -34.613825032680275,-58.391700488374958 -34.614074965525866,-58.39168369071065 -34.614694696191258,-58.391676771869633 -34.614917024031811,-58.391908799389988 -34.614931525598877,-58.393201800003219 -34.615033540243289,-58.393224702241675 -34.614127957585012,-58.393232191867213 -34.613931194245701)));;2079;3_20_3;COMUNA 3;20;3;613;267;346;77,17%;446;445;99,78%;1;0,22%;315;24;7,62%;291;92,38%
MULTIPOLYGON (((-58.393201800003219 -34.615033540243289,-58.391908799389988 -34.614931525598877,-58.391676771869633 -34.614917024031811,-58.391668625324591 -34.615180549798211,-58.391660336064028 -34.615511542655561,-58.391658642010597 -34.615700210340883,-58.391862562873797 -34.615712371598924,-58.393021950391933 -34.615779450096248,-58.393182598591302 -34.615790880174806,-58.393201800003219 -34.615033540243289)));;2080;3_20_4;COMUNA 3;20;4;616;269;347;77,52%;378;378;100,00%;0;0,00%;290;3;1,03%;287;98,97%
MULTIPOLYGON (((-58.394626319985932 -34.615144699472147,-58.394326832332368 -34.615122348104478,-58.393201800003219 -34.615033540243289,-58.393182598591302 -34.615790880174806,-58.394366337060788 -34.615875002628187,-58.394595555601065 -34.615890765162177,-58.394626319985932 -34.615144699472147)));;2081;3_20_5;COMUNA 3;20;5;482;205;277;74,01%;268;268;100,00%;0;0,00%;232;22;9,48%;210;90,52%
MULTIPOLYGON (((-58.396119672082989 -34.615256161352534,-58.394626319985932 -34.615144699472147,-58.394595555601065 -34.615890765162177,-58.395916608997069 -34.615981709955548,-58.396096421926963 -34.61599638623845,-58.396117329090856 -34.615416729168665,-58.396119672082989 -34.615256161352534)));;2082;3_20_6;COMUNA 3;20;6;485;247;238;103,78%;236;236;100,00%;0;0,00%;189;42;22,22%;147;77,78%
MULTIPOLYGON (((-58.396096421926963 -34.61599638623845,-58.395916608997069 -34.615981709955548,-58.394595555601065 -34.615890765162177,-58.394366337060788 -34.615875002628187,-58.393182598591302 -34.615790880174806,-58.39317801839492 -34.615971517776408,-58.393188510863041 -34.616771270374514,-58.393189957248055 -34.61697775736404,-58.394546542101835 -34.617076836104253,-58.394791862295236 -34.617094790438273,-58.396053125111692 -34.617197531853527,-58.396096421926963 -34.61599638623845)));;2083;3_20_7;COMUNA 3;20;7;802;366;436;83,94%;432;431;99,77%;1;0,23%;349;14;4,01%;335;95,99%
MULTIPOLYGON (((-58.393182598591302 -34.615790880174806,-58.393021950391933 -34.615779450096248,-58.391862562873797 -34.615712371598924,-58.391658642010597 -34.615700210340883,-58.391657419592356 -34.615835214419711,-58.391675186137675 -34.616878712396371,-58.391919143586954 -34.616894981513092,-58.393007160108766 -34.616964413169185,-58.393189957248055 -34.61697775736404,-58.393188510863041 -34.616771270374514,-58.39317801839492 -34.615971517776408,-58.393182598591302 -34.615790880174806)));;2084;3_20_8;COMUNA 3;20;8;803;381;422;90,28%;322;321;99,69%;1;0,31%;380;134;35,26%;246;64,74%
MULTIPOLYGON (((-58.393189957248055 -34.61697775736404,-58.393007160108766 -34.616964413169185,-58.391919143586954 -34.616894981513092,-58.391675186137675 -34.616878712396371,-58.391697010620504 -34.618159192705939,-58.392027947163378 -34.618175934747164,-58.393002614805269 -34.618223750670765,-58.393198876691422 -34.618234144692934,-58.393189957248055 -34.61697775736404)));;2085;3_20_9;COMUNA 3;20;9;974;425;549;77,41%;550;550;100,00%;0;0,00%;458;55;12,01%;403;87,99%
MULTIPOLYGON (((-58.394495961208378 -34.618302766472482,-58.393198876691422 -34.618234144692934,-58.393002614805269 -34.618223750670765,-58.392027947163378 -34.618175934747164,-58.391697010620504 -34.618159192705939,-58.39166595979377 -34.619109348745042,-58.391931895810487 -34.619133166104895,-58.393212096707749 -34.619237004235352,-58.393214679329795 -34.619409053966798,-58.393210429747533 -34.619499477236573,-58.394496661381055 -34.619529570353436,-58.394495961208378 -34.618302766472482)));;2086;3_21_1;COMUNA 3;21;1;959;444;515;86,21%;479;477;99,58%;2;0,42%;376;3;0,80%;373;99,20%
MULTIPOLYGON (((-58.393353261150331 -34.62619112631053,-58.392913768591193 -34.626157071704327,-58.393018557992562 -34.625648029879144,-58.39247574260272 -34.625596167546767,-58.39250577226607 -34.625446038897337,-58.392536394918757 -34.625299783948712,-58.391328999884912 -34.625228588131691,-58.391242262871657 -34.626332800070848,-58.391218662183149 -34.626632725935472,-58.391186275766749 -34.627044058828787,-58.391169824038741 -34.62725299986802,-58.392159452953692 -34.627263576524747,-58.393206102610634 -34.62744939480595,-58.393308899803593 -34.626570127961813,-58.393353261150331 -34.62619112631053)));;2087;3_21_10;COMUNA 3;21;10;972;438;534;82,02%;501;501;100,00%;0;0,00%;416;47;11,30%;369;88,70%
MULTIPOLYGON (((-58.393165328807754 -34.620462372376338,-58.39316530378342 -34.620462906834376,-58.393110598753886 -34.621631254886786,-58.393945261438269 -34.621670532333489,-58.394462348615555 -34.621693147394005,-58.394494449744251 -34.620671017285403,-58.394495744603645 -34.620546084095125,-58.394497226660015 -34.620400586912154,-58.394496661381055 -34.619529570353436,-58.393210429747533 -34.619499477236573,-58.393171834458599 -34.620322723345843,-58.393165328807754 -34.620462372376338)));;2088;3_21_2;COMUNA 3;21;2;912;419;493;84,99%;491;490;99,80%;1;0,20%;397;7;1,76%;390;98,24%
MULTIPOLYGON (((-58.3916226707086 -34.620224573659456,-58.391853009030896 -34.620239285620222,-58.39308965126957 -34.620318457549423,-58.39313163944793 -34.62034321270437,-58.39316530378342 -34.620462906834376,-58.393165328807754 -34.620462372376338,-58.393171834458599 -34.620322723345843,-58.393210429747533 -34.619499477236573,-58.393214679329795 -34.619409053966798,-58.393212096707749 -34.619237004235352,-58.391931895810487 -34.619133166104895,-58.39166595979377 -34.619109348745042,-58.3916226707086 -34.620224573659456)));;2089;3_21_3;COMUNA 3;21;3;739;328;411;79,81%;383;382;99,74%;1;0,26%;308;17;5,52%;291;94,48%
MULTIPOLYGON (((-58.39316530378342 -34.620462906834376,-58.39313163944793 -34.62034321270437,-58.39308965126957 -34.620318457549423,-58.391853009030896 -34.620239285620222,-58.3916226707086 -34.620224573659456,-58.391610475716341 -34.620539507068095,-58.391553720746721 -34.621559931842043,-58.393110598753886 -34.621631254886786,-58.39316530378342 -34.620462906834376)));;2090;3_21_4;COMUNA 3;21;4;768;353;415;85,06%;410;409;99,76%;1;0,24%;347;47;13,54%;300;86,46%
MULTIPOLYGON (((-58.393110598753886 -34.621631254886786,-58.391553720746721 -34.621559931842043,-58.391488484531997 -34.622733807443026,-58.391803335849005 -34.622753075999903,-58.392926953171333 -34.622823022013641,-58.392957953117048 -34.622631061314891,-58.393110598753886 -34.621631254886786)));;2091;3_21_5;COMUNA 3;21;5;507;234;273;85,71%;236;236;100,00%;0;0,00%;219;69;31,51%;150;68,49%
MULTIPOLYGON (((-58.392926953171333 -34.622823022013641,-58.392899036023742 -34.622995828875659,-58.392791245523696 -34.623632690376162,-58.392729173317413 -34.623999287034202,-58.39272112541196 -34.624046678401818,-58.393415317094643 -34.624202854631228,-58.393579121045917 -34.624229568185932,-58.393635864682288 -34.623812121282015,-58.393739836518918 -34.623046660931642,-58.393765536494023 -34.62287441602426,-58.393945261438269 -34.621670532333489,-58.393110598753886 -34.621631254886786,-58.392957953117048 -34.622631061314891,-58.392926953171333 -34.622823022013641)));;2092;3_21_6;COMUNA 3;21;6;797;349;448;77,90%;429;429;100,00%;0;0,00%;387;59;15,25%;328;84,75%
MULTIPOLYGON (((-58.391457394844188 -34.623425503145448,-58.391431355881416 -34.623988464924679,-58.392729173317413 -34.623999287034202,-58.392791245523696 -34.623632690376162,-58.392899036023742 -34.622995828875659,-58.392926953171333 -34.622823022013641,-58.391803335849005 -34.622753075999903,-58.391488484531997 -34.622733807443026,-58.391457394844188 -34.623425503145448)));;2093;3_21_7;COMUNA 3;21;7;405;173;232;74,57%;240;239;99,58%;1;0,42%;199;30;15,08%;169;84,92%
MULTIPOLYGON (((-58.393579121045917 -34.624229568185932,-58.393415317094643 -34.624202854631228,-58.39272112541196 -34.624046678401818,-58.392729173317413 -34.623999287034202,-58.391431355881416 -34.623988464924679,-58.391403158297372 -34.624285852957755,-58.391328999884912 -34.625228588131691,-58.392536394918757 -34.625299783948712,-58.393242193443122 -34.625341316037314,-58.393449540972931 -34.625359392283215,-58.39347117968979 -34.625154961006906,-58.393557606059666 -34.624388152949926,-58.393579121045917 -34.624229568185932)));;2094;3_21_8;COMUNA 3;21;8;690;298;392;76,02%;400;400;100,00%;0;0,00%;314;20;6,37%;294;93,63%
MULTIPOLYGON (((-58.393449540972931 -34.625359392283215,-58.393242193443122 -34.625341316037314,-58.392536394918757 -34.625299783948712,-58.39250577226607 -34.625446038897337,-58.39247574260272 -34.625596167546767,-58.393018557992562 -34.625648029879144,-58.392913768591193 -34.626157071704327,-58.393353261150331 -34.62619112631053,-58.393439666698512 -34.625451995451925,-58.393449540972931 -34.625359392283215)));;2095;3_21_9;COMUNA 3;21;9;416;177;239;74,06%;256;256;100,00%;0;0,00%;188;1;0,53%;187;99,47%
MULTIPOLYGON (((-58.395925240854083 -34.619562967459608,-58.395914769026525 -34.619661415866069,-58.3958052075469 -34.620628502167122,-58.395987333180955 -34.6206399403248,-58.397112030348154 -34.620713299213314,-58.397388675806887 -34.61979813410435,-58.397441051060412 -34.619600479181692,-58.397469930257763 -34.619491124612082,-58.397514521299563 -34.618462380043823,-58.395989736408048 -34.6183817642289,-58.395940863980961 -34.619414520123968,-58.395925240854083 -34.619562967459608)));;2096;3_22_1;COMUNA 3;22;1;787;345;442;78,05%;386;385;99,74%;1;0,26%;342;47;13,74%;295;86,26%
MULTIPOLYGON (((-58.395989736408048 -34.6183817642289,-58.394495961208378 -34.618302766472482,-58.394496661381055 -34.619529570353436,-58.395925240854083 -34.619562967459608,-58.395940863980961 -34.619414520123968,-58.395989736408048 -34.6183817642289)));;2097;3_22_2;COMUNA 3;22;2;658;305;353;86,40%;351;351;100,00%;0;0,00%;294;57;19,39%;237;80,61%
MULTIPOLYGON (((-58.395925240854083 -34.619562967459608,-58.394496661381055 -34.619529570353436,-58.394497226660015 -34.620400586912154,-58.394495744603645 -34.620546084095125,-58.3958052075469 -34.620628502167122,-58.395914769026525 -34.619661415866069,-58.395925240854083 -34.619562967459608)));;2098;3_22_3;COMUNA 3;22;3;407;193;214;90,19%;219;219;100,00%;0;0,00%;181;63;34,81%;118;65,19%
MULTIPOLYGON (((-58.3958052075469 -34.620628502167122,-58.394495744603645 -34.620546084095125,-58.394494449744251 -34.620671017285403,-58.394462348615555 -34.621693147394005,-58.395641766474718 -34.62174718356475,-58.395664453330944 -34.621608670121717,-58.395790965178236 -34.620754273369741,-58.3958052075469 -34.620628502167122)));;2099;3_22_4;COMUNA 3;22;4;513;252;261;96,55%;268;268;100,00%;0;0,00%;246;12;4,88%;234;95,12%
MULTIPOLYGON (((-58.397112030348154 -34.620713299213314,-58.395987333180955 -34.6206399403248,-58.3958052075469 -34.620628502167122,-58.395790965178236 -34.620754273369741,-58.395664453330944 -34.621608670121717,-58.395641766474718 -34.62174718356475,-58.3956246440722 -34.621851966501502,-58.3953646726725 -34.622974678830815,-58.396362285247889 -34.623059805798015,-58.396423081156989 -34.622884551135471,-58.396766665860717 -34.621798784429224,-58.396835586682251 -34.621580997233352,-58.397078805203286 -34.620823144312844,-58.397112030348154 -34.620713299213314)));;2100;3_22_5;COMUNA 3;22;5;809;365;444;82,21%;463;461;99,57%;2;0,43%;359;23;6,41%;336;93,59%
MULTIPOLYGON (((-58.394462348615555 -34.621693147394005,-58.393945261438269 -34.621670532333489,-58.393765536494023 -34.62287441602426,-58.394943763436231 -34.622946275783328,-58.3953646726725 -34.622974678830815,-58.3956246440722 -34.621851966501502,-58.395641766474718 -34.62174718356475,-58.394462348615555 -34.621693147394005)));;2101;3_22_6;COMUNA 3;22;6;753;351;402;87,31%;289;288;99,65%;1;0,35%;302;64;21,19%;238;78,81%
MULTIPOLYGON (((-58.394737813572782 -34.624488299835313,-58.394737790631616 -34.624488256202447,-58.394797082350138 -34.624017797440175,-58.394809263656626 -34.623970320582188,-58.394943763436231 -34.622946275783328,-58.393765536494023 -34.62287441602426,-58.393739836518918 -34.623046660931642,-58.393635864682288 -34.623812121282015,-58.393579121045917 -34.624229568185932,-58.393557606059666 -34.624388152949926,-58.39347117968979 -34.625154961006906,-58.393449540972931 -34.625359392283215,-58.393635250915182 -34.625375484029703,-58.394601273186296 -34.625473072703251,-58.394624408551827 -34.625310333616049,-58.394737813572782 -34.624488299835313)));;2102;3_22_7;COMUNA 3;22;7;737;328;409;80,20%;413;412;99,76%;1;0,24%;330;61;18,48%;269;81,52%
MULTIPOLYGON (((-58.394601273186296 -34.625473072703251,-58.39442972570599 -34.626679989458424,-58.395525849789529 -34.626787432608246,-58.395733327304605 -34.625588421645176,-58.395930185344426 -34.624451237371652,-58.395963364122736 -34.624296602366378,-58.395986195773467 -34.62419027319806,-58.396284582415902 -34.623283574011801,-58.396362285247889 -34.623059805798015,-58.3953646726725 -34.622974678830815,-58.394943763436231 -34.622946275783328,-58.394809263656626 -34.623970320582188,-58.394797082350138 -34.624017797440175,-58.394737790631616 -34.624488256202447,-58.394737813572782 -34.624488299835313,-58.394624408551827 -34.625310333616049,-58.394601273186296 -34.625473072703251)));;2103;3_22_8;COMUNA 3;22;8;931;443;488;90,78%;454;453;99,78%;1;0,22%;375;25;6,67%;350;93,33%
MULTIPOLYGON (((-58.395525849789529 -34.626787432608246,-58.39442972570599 -34.626679989458424,-58.394601273186296 -34.625473072703251,-58.393635250915182 -34.625375484029703,-58.393449540972931 -34.625359392283215,-58.393439666698512 -34.625451995451925,-58.393353261150331 -34.62619112631053,-58.393308899803593 -34.626570127961813,-58.393206102610634 -34.62744939480595,-58.394292878581851 -34.627642409953239,-58.39534550069434 -34.62782926959418,-58.395525849789529 -34.626787432608246)));;2104;3_22_9;COMUNA 3;22;9;939;441;498;88,55%;464;464;100,00%;0;0,00%;373;58;15,55%;315;84,45%
MULTIPOLYGON (((-58.400039276186313 -34.618603567059175,-58.399242898406023 -34.618553717050048,-58.398962899350892 -34.618538922679527,-58.398871934199398 -34.619521092598376,-58.39883588644912 -34.619649458495942,-58.398789417418556 -34.619814580766359,-58.398556741906667 -34.620623078339932,-58.398496201849262 -34.620805940166953,-58.39982763746589 -34.620907341369104,-58.399939041458055 -34.619694469199253,-58.400039276186313 -34.618603567059175)));;2105;3_23_1;COMUNA 3;23;1;799;356;443;80,36%;355;355;100,00%;0;0,00%;330;82;24,85%;248;75,15%
MULTIPOLYGON (((-58.395525849789529 -34.626787432608246,-58.39534550069434 -34.62782926959418,-58.396807016492083 -34.628087048315926,-58.396865708934776 -34.628097502892338,-58.397071182634782 -34.626934475948389,-58.397105070954886 -34.626742867998864,-58.397265935797741 -34.625746300985568,-58.397089342792455 -34.625726839274542,-58.395733327304605 -34.625588421645176,-58.395525849789529 -34.626787432608246)));;2106;3_23_10;COMUNA 3;23;10;1044;497;547;90,86%;428;428;100,00%;0;0,00%;397;55;13,85%;342;86,15%
MULTIPOLYGON (((-58.398962899350892 -34.618538922679527,-58.397514521299563 -34.618462380043823,-58.397469930257763 -34.619491124612082,-58.397441051060412 -34.619600479181692,-58.39883588644912 -34.619649458495942,-58.398871934199398 -34.619521092598376,-58.398962899350892 -34.618538922679527)));;2107;3_23_2;COMUNA 3;23;2;803;347;456;76,10%;408;408;100,00%;0;0,00%;347;12;3,46%;335;96,54%
MULTIPOLYGON (((-58.39883588644912 -34.619649458495942,-58.397441051060412 -34.619600479181692,-58.397388675806887 -34.61979813410435,-58.397112030348154 -34.620713299213314,-58.397078805203286 -34.620823144312844,-58.396835586682251 -34.621580997233352,-58.396766665860717 -34.621798784429224,-58.397011324124762 -34.621810113990108,-58.39819217041083 -34.621894056883654,-58.398458460294634 -34.620919867913265,-58.398496201849262 -34.620805940166953,-58.398556741906667 -34.620623078339932,-58.398789417418556 -34.619814580766359,-58.39883588644912 -34.619649458495942)));;2108;3_23_3;COMUNA 3;23;3;810;382;428;89,25%;427;427;100,00%;0;0,00%;367;45;12,26%;322;87,74%
MULTIPOLYGON (((-58.39982763746589 -34.620907341369104,-58.398496201849262 -34.620805940166953,-58.398458460294634 -34.620919867913265,-58.39819217041083 -34.621894056883654,-58.399572542030327 -34.622082179862794,-58.39982763746589 -34.620907341369104)));;2109;3_23_4;COMUNA 3;23;4;448;211;237;89,03%;213;213;100,00%;0;0,00%;191;41;21,47%;150;78,53%
MULTIPOLYGON (((-58.399572542030327 -34.622082179862794,-58.39819217041083 -34.621894056883654,-58.397825830110264 -34.623234190428079,-58.398027544562048 -34.623260213919458,-58.399067042221056 -34.623391962282398,-58.399275402111421 -34.623418409726192,-58.3993135427176 -34.6232278596339,-58.399572542030327 -34.622082179862794)));;2110;3_23_5;COMUNA 3;23;5;614;268;346;77,46%;363;363;100,00%;0;0,00%;291;21;7,22%;270;92,78%
MULTIPOLYGON (((-58.39819217041083 -34.621894056883654,-58.397011324124762 -34.621810113990108,-58.396766665860717 -34.621798784429224,-58.396423081156989 -34.622884551135471,-58.396362285247889 -34.623059805798015,-58.396688120041908 -34.623089983587533,-58.397576498281843 -34.62320201422034,-58.397825830110264 -34.623234190428079,-58.39819217041083 -34.621894056883654)));;2111;3_23_6;COMUNA 3;23;6;610;289;321;90,03%;263;263;100,00%;0;0,00%;242;39;16,12%;203;83,88%
MULTIPOLYGON (((-58.397825830110264 -34.623234190428079,-58.397576498281843 -34.62320201422034,-58.396688120041908 -34.623089983587533,-58.396362285247889 -34.623059805798015,-58.396284582415902 -34.623283574011801,-58.395986195773467 -34.62419027319806,-58.395963364122736 -34.624296602366378,-58.396114046929014 -34.624326333610327,-58.397357507369627 -34.624458207689564,-58.397503430997823 -34.624474060954974,-58.397526849927281 -34.624376887056073,-58.397778653484259 -34.623427622667215,-58.397825830110264 -34.623234190428079)));;2112;3_23_7;COMUNA 3;23;7;661;308;353;87,25%;315;315;100,00%;0;0,00%;274;43;15,69%;231;84,31%
MULTIPOLYGON (((-58.397503430997823 -34.624474060954974,-58.397357507369627 -34.624458207689564,-58.396114046929014 -34.624326333610327,-58.395963364122736 -34.624296602366378,-58.395930185344426 -34.624451237371652,-58.395733327304605 -34.625588421645176,-58.397089342792455 -34.625726839274542,-58.397265935797741 -34.625746300985568,-58.397459736750868 -34.625767602693607,-58.398661875609406 -34.625933034038766,-58.398914021795719 -34.62597260410692,-58.39909436815077 -34.624647301138367,-58.399232301353763 -34.623633676376414,-58.399275402111421 -34.623418409726192,-58.399067042221056 -34.623391962282398,-58.398027544562048 -34.623260213919458,-58.397825830110264 -34.623234190428079,-58.397778653484259 -34.623427622667215,-58.397526849927281 -34.624376887056073,-58.397503430997823 -34.624474060954974)));;2113;3_23_8;COMUNA 3;23;8;880;400;480;83,33%;403;400;99,26%;3;0,75%;336;41;12,20%;295;87,80%
MULTIPOLYGON (((-58.398914021795719 -34.62597260410692,-58.398661875609406 -34.625933034038766,-58.397459736750868 -34.625767602693607,-58.397265935797741 -34.625746300985568,-58.397105070954886 -34.626742867998864,-58.397071182634782 -34.626934475948389,-58.396865708934776 -34.628097502892338,-58.398594118081888 -34.628405969026034,-58.398756430981415 -34.627168688746885,-58.398897143712496 -34.626096331863216,-58.398914021795719 -34.62597260410692)));;2114;3_23_9;COMUNA 3;23;9;972;477;495;96,36%;374;374;100,00%;0;0,00%;342;42;12,28%;300;87,72%
MULTIPOLYGON (((-58.405035128208887 -34.619154500797571,-58.403512874432785 -34.618840239623196,-58.403206015372469 -34.61981442021753,-58.404782673805443 -34.620197234536846,-58.405035128208887 -34.619154500797571)));;2115;3_24_1;COMUNA 3;24;1;692;307;385;79,74%;368;367;99,73%;1;0,27%;303;12;3,96%;291;96,04%
MULTIPOLYGON (((-58.4021429679268 -34.619787065221033,-58.402115687901777 -34.619931422910092,-58.401765508239535 -34.621054879128806,-58.402801955425204 -34.621133845868428,-58.404316242129049 -34.62144578797971,-58.404486597626793 -34.621481363580855,-58.404510931142191 -34.621281509109345,-58.404782673805443 -34.620197234536846,-58.403206015372469 -34.61981442021753,-58.403512874432785 -34.618840239623196,-58.402246623363332 -34.618755812945373,-58.402166399555043 -34.619663128861298,-58.4021429679268 -34.619787065221033)));;2116;3_24_2;COMUNA 3;24;2;851;388;463;83,80%;337;337;100,00%;0;0,00%;336;55;16,37%;281;83,63%
MULTIPOLYGON (((-58.40098020747547 -34.618667358815657,-58.400293974198028 -34.618619472819042,-58.400039276186313 -34.618603567059175,-58.399939041458055 -34.619694469199253,-58.400884177069969 -34.619734178507272,-58.4021429679268 -34.619787065221033,-58.402166399555043 -34.619663128861298,-58.402246623363332 -34.618755812945373,-58.40098020747547 -34.618667358815657)));;2117;3_24_3;COMUNA 3;24;3;651;275;376;73,14%;363;362;99,72%;1;0,28%;276;4;1,45%;272;98,55%
MULTIPOLYGON (((-58.4021429679268 -34.619787065221033,-58.400884177069969 -34.619734178507272,-58.399939041458055 -34.619694469199253,-58.39982763746589 -34.620907341369104,-58.40077233686484 -34.620979305958976,-58.401765508239535 -34.621054879128806,-58.402115687901777 -34.619931422910092,-58.4021429679268 -34.619787065221033)));;2118;3_24_4;COMUNA 3;24;4;701;328;373;87,94%;375;374;99,73%;1;0,27%;311;41;13,18%;270;86,82%
MULTIPOLYGON (((-58.401765508239535 -34.621054879128806,-58.40077233686484 -34.620979305958976,-58.39982763746589 -34.620907341369104,-58.399572542030327 -34.622082179862794,-58.400452899555681 -34.622202143432354,-58.400608785594443 -34.62222011081905,-58.401374757655837 -34.622308529499954,-58.401765508239535 -34.621054879128806)));;2119;3_24_5;COMUNA 3;24;5;517;233;284;82,04%;277;277;100,00%;0;0,00%;225;3;1,33%;222;98,67%
MULTIPOLYGON (((-58.404486597626793 -34.621481363580855,-58.404316242129049 -34.62144578797971,-58.402801955425204 -34.621133845868428,-58.401765508239535 -34.621054879128806,-58.401374757655837 -34.622308529499954,-58.401559180663789 -34.62232981998816,-58.402478908718145 -34.622440492566035,-58.404297276428302 -34.622738147479033,-58.404458151288338 -34.621714949638964,-58.404486597626793 -34.621481363580855)));;2120;3_24_6;COMUNA 3;24;6;1074;476;598;79,60%;473;470;99,37%;3;0,64%;375;57;15,20%;318;84,80%
MULTIPOLYGON (((-58.404297276428302 -34.622738147479033,-58.402478908718145 -34.622440492566035,-58.402170395581692 -34.623780456335048,-58.402471268659397 -34.623817860057024,-58.403254546027256 -34.623913951782569,-58.403475090715872 -34.623940961389003,-58.404016102640703 -34.624007774432279,-58.404266983885194 -34.622930393109911,-58.404297276428302 -34.622738147479033)));;2121;3_24_7;COMUNA 3;24;7;674;323;351;92,02%;391;391;100,00%;0;0,00%;297;0;0,00%;297;100,00%
MULTIPOLYGON (((-58.402478908718145 -34.622440492566035,-58.401559180663789 -34.62232981998816,-58.401374757655837 -34.622308529499954,-58.400608785594443 -34.62222011081905,-58.400449574706947 -34.623346195175117,-58.400421214180923 -34.623562948694897,-58.400963073525183 -34.623629212313226,-58.401283708384824 -34.623669023412859,-58.40140168832226 -34.623684787519451,-58.402170395581692 -34.623780456335048,-58.402478908718145 -34.622440492566035)));;2122;3_24_8;COMUNA 3;24;8;753;337;416;81,01%;366;366;100,00%;0;0,00%;320;33;10,31%;287;89,69%
MULTIPOLYGON (((-58.400608785594443 -34.62222011081905,-58.400452899555681 -34.622202143432354,-58.399572542030327 -34.622082179862794,-58.3993135427176 -34.6232278596339,-58.399275402111421 -34.623418409726192,-58.399468599369463 -34.623442947481699,-58.400222479075381 -34.623538127912269,-58.400421214180923 -34.623562948694897,-58.400449574706947 -34.623346195175117,-58.400608785594443 -34.62222011081905)));;2123;3_24_9;COMUNA 3;24;9;458;215;243;88,48%;217;216;99,54%;1;0,46%;185;21;11,35%;164;88,65%
MULTIPOLYGON (((-58.410761395850066 -34.621572720775845,-58.410588440303599 -34.622693742105795,-58.411784132391048 -34.62292340986572,-58.412041891204559 -34.62297478655168,-58.412356405634505 -34.6218685405263,-58.412436816629587 -34.621883362929516,-58.412543881188107 -34.620642307566243,-58.41081183140075 -34.620336220381539,-58.410792249705977 -34.620590939236209,-58.410761395850066 -34.621572720775845)));;2124;3_25_1;COMUNA 3;25;1;1221;548;673;81,43%;656;654;99,70%;2;0,31%;510;13;2,55%;497;97,45%
MULTIPOLYGON (((-58.410079039996404 -34.620193788856142,-58.409252050252036 -34.620023423394201,-58.407780359348372 -34.619720153517093,-58.407572162250588 -34.62087453646479,-58.409175776673742 -34.621263855660814,-58.409998523641661 -34.621426966005409,-58.410761395850066 -34.621572720775845,-58.410792249705977 -34.620590939236209,-58.41081183140075 -34.620336220381539,-58.410519154249826 -34.620284474022149,-58.410079039996404 -34.620193788856142)));;2125;3_25_2;COMUNA 3;25;2;709;341;368;92,66%;337;337;100,00%;0;0,00%;295;38;12,88%;257;87,12%
MULTIPOLYGON (((-58.406387211635831 -34.619433099907553,-58.405035128208887 -34.619154500797571,-58.404782673805443 -34.620197234536846,-58.40624487112192 -34.620552298525041,-58.407572162250588 -34.62087453646479,-58.407780359348372 -34.619720153517093,-58.406387211635831 -34.619433099907553)));;2126;3_25_3;COMUNA 3;25;3;549;255;294;86,73%;247;245;99,19%;2;0,82%;207;50;24,15%;157;75,85%
MULTIPOLYGON (((-58.40624487112192 -34.620552298525041,-58.404782673805443 -34.620197234536846,-58.404510931142191 -34.621281509109345,-58.404486597626793 -34.621481363580855,-58.404793323138897 -34.621545314593739,-58.406151411246142 -34.621818918904914,-58.407360111616505 -34.622050255853182,-58.407572162250588 -34.62087453646479,-58.40624487112192 -34.620552298525041)));;2127;3_25_4;COMUNA 3;25;4;696;323;373;86,60%;328;327;99,70%;1;0,31%;272;30;11,03%;242;88,97%
MULTIPOLYGON (((-58.407360111616505 -34.622050255853182,-58.40733933365518 -34.62216560252395,-58.407216215253136 -34.623215934892954,-58.40882174391411 -34.623478635420717,-58.408994581017531 -34.623506529493781,-58.409097950649155 -34.622530273755942,-58.409105526396715 -34.622407526370289,-58.409220348996705 -34.622431028277049,-58.410588440303599 -34.622693742105795,-58.410761395850066 -34.621572720775845,-58.409998523641661 -34.621426966005409,-58.409175776673742 -34.621263855660814,-58.407572162250588 -34.62087453646479,-58.407360111616505 -34.622050255853182)));;2128;3_25_5;COMUNA 3;25;5;829;386;443;87,13%;204;202;99,02%;2;0,99%;296;74;25,00%;222;75,00%
MULTIPOLYGON (((-58.406151411246142 -34.621818918904914,-58.404793323138897 -34.621545314593739,-58.404486597626793 -34.621481363580855,-58.404458151288338 -34.621714949638964,-58.404297276428302 -34.622738147479033,-58.40598362458234 -34.62301416393165,-58.407216215253136 -34.623215934892954,-58.40733933365518 -34.62216560252395,-58.407360111616505 -34.622050255853182,-58.406151411246142 -34.621818918904914)));;2129;3_25_6;COMUNA 3;25;6;959;444;515;86,21%;350;348;99,43%;2;0,57%;337;61;18,10%;276;81,90%
MULTIPOLYGON (((-58.40598362458234 -34.62301416393165,-58.404297276428302 -34.622738147479033,-58.404266983885194 -34.622930393109911,-58.404016102640703 -34.624007774432279,-58.404707979147503 -34.624093037802034,-58.405812497292025 -34.624228844217235,-58.40598362458234 -34.62301416393165)));;2130;3_25_7;COMUNA 3;25;7;527;252;275;91,64%;269;269;100,00%;0;0,00%;228;42;18,42%;186;81,58%
MULTIPOLYGON (((-58.407216215253136 -34.623215934892954,-58.40598362458234 -34.62301416393165,-58.405812497292025 -34.624228844217235,-58.406209208105885 -34.624277621791187,-58.407078698642593 -34.624390137865156,-58.407216215253136 -34.623215934892954)));;2131;3_25_8;COMUNA 3;25;8;1553;665;888;74,89%;862;862;100,00%;0;0,00%;716;80;11,17%;636;88,83%
MULTIPOLYGON (((-58.408994581017531 -34.623506529493781,-58.40882174391411 -34.623478635420717,-58.407216215253136 -34.623215934892954,-58.407078698642593 -34.624390137865156,-58.407269855690551 -34.624414873608124,-58.408875457221463 -34.624600739812372,-58.408948810121402 -34.62393800300633,-58.408994581017531 -34.623506529493781)));;2132;3_25_9;COMUNA 3;25;9;746;331;415;79,76%;371;371;100,00%;0;0,00%;319;63;19,75%;256;80,25%
MULTIPOLYGON (((-58.410588440303599 -34.622693742105795,-58.409220348996705 -34.622431028277049,-58.409105526396715 -34.622407526370289,-58.409097950649155 -34.622530273755942,-58.408994581017531 -34.623506529493781,-58.408948810121402 -34.62393800300633,-58.408875457221463 -34.624600739812372,-58.40917165268872 -34.624634955819452,-58.409725201007987 -34.624695692494832,-58.409853747105409 -34.624712861512712,-58.410367342038356 -34.624771394785199,-58.410449027148601 -34.62398069853468,-58.410473032636325 -34.623738869537831,-58.410552850753824 -34.622933383041847,-58.410588440303599 -34.622693742105795)));;2133;3_26_1;COMUNA 3;26;1;900;384;516;74,42%;462;461;99,78%;1;0,22%;398;60;15,08%;338;84,92%
MULTIPOLYGON (((-58.410460281579589 -34.62478199836341,-58.411827287833347 -34.624937933547486,-58.412094095626728 -34.624969242775443,-58.412126670410778 -34.62477812300186,-58.412219751556101 -34.623992571304122,-58.41233346742591 -34.623032867031498,-58.412041891204559 -34.62297478655168,-58.411784132391048 -34.62292340986572,-58.410588440303599 -34.622693742105795,-58.410552850753824 -34.622933383041847,-58.410473032636325 -34.623738869537831,-58.410449027148601 -34.62398069853468,-58.410367342038356 -34.624771394785199,-58.410460281579589 -34.62478199836341)));;2134;3_26_2;COMUNA 3;26;2;1162;572;590;96,95%;466;466;100,00%;0;0,00%;440;98;22,27%;342;77,73%
MULTIPOLYGON (((-58.410460281579589 -34.62478199836341,-58.410367342038356 -34.624771394785199,-58.410356627792147 -34.624874985272619,-58.410208596328751 -34.626307294303324,-58.410453771767038 -34.626333104659118,-58.411990332719654 -34.626504533551334,-58.412065197551165 -34.625138109780949,-58.412094095626728 -34.624969242775443,-58.411827287833347 -34.624937933547486,-58.410460281579589 -34.62478199836341)));;2135;3_26_3;COMUNA 3;26;3;803;346;457;75,71%;410;408;99,51%;2;0,49%;334;54;16,17%;280;83,83%
MULTIPOLYGON (((-58.409725201007987 -34.624695692494832,-58.40917165268872 -34.624634955819452,-58.408875457221463 -34.624600739812372,-58.408768339618462 -34.625568049404421,-58.40874811514032 -34.625751286123908,-58.408684034588447 -34.62638019307159,-58.408914740371401 -34.626171162684464,-58.409554256366761 -34.626238417093823,-58.410208596328751 -34.626307294303324,-58.410356627792147 -34.624874985272619,-58.410367342038356 -34.624771394785199,-58.409853747105409 -34.624712861512712,-58.409725201007987 -34.624695692494832)));;2136;3_26_4;COMUNA 3;26;4;517;244;273;89,38%;295;295;100,00%;0;0,00%;227;3;1,32%;224;98,68%
MULTIPOLYGON (((-58.406901660934594 -34.625926729053376,-58.406755121064187 -34.627203324825246,-58.407693163518758 -34.627281077997928,-58.407850106187517 -34.627134312734057,-58.408684067441072 -34.626379870648137,-58.40874811514032 -34.625751286123908,-58.408768339618462 -34.625568049404421,-58.408875457221463 -34.624600739812372,-58.407269855690551 -34.624414873608124,-58.407078698642593 -34.624390137865156,-58.407050252450212 -34.624632879661661,-58.406965674205168 -34.625369204167306,-58.406901660934594 -34.625926729053376)));;2137;3_26_5;COMUNA 3;26;5;834;382;452;84,51%;397;396;99,75%;1;0,25%;341;48;14,08%;293;85,92%
MULTIPOLYGON (((-58.411990332719654 -34.626504533551334,-58.410453771767038 -34.626333104659118,-58.410208596328751 -34.626307294303324,-58.409554256366761 -34.626238417093823,-58.408914740371401 -34.626171162684464,-58.408684034588447 -34.62638019307159,-58.408684067444014 -34.626379870645458,-58.407850106187517 -34.627134312734057,-58.407693163518758 -34.627281077997928,-58.408585636504569 -34.627345352591263,-58.409482881640486 -34.627409974861322,-58.410092348060971 -34.627453832257416,-58.411037984939426 -34.627521914770078,-58.41193105944744 -34.627586235565673,-58.411990332719654 -34.626504533551334)));;2138;3_26_6;COMUNA 3;26;6;605;282;323;87,31%;292;292;100,00%;0;0,00%;246;5;2,03%;241;97,97%
MULTIPOLYGON (((-58.409973198222637 -34.628737626747395,-58.409888701528367 -34.62964825441648,-58.409868953631033 -34.629888394709269,-58.410033873454701 -34.629928044812331,-58.410827294455657 -34.630122475781334,-58.41158127784464 -34.630307236855025,-58.411779336357831 -34.63035584243908,-58.411842318993592 -34.629205548697641,-58.411874196991747 -34.628623922803776,-58.41193105944744 -34.627586235565673,-58.411037984939426 -34.627521914770078,-58.410092348060971 -34.627453832257416,-58.409973198222637 -34.628737626747395)));;2139;3_26_7;COMUNA 3;26;7;815;388;427;90,87%;406;405;99,75%;1;0,25%;312;17;5,45%;295;94,55%
MULTIPOLYGON (((-58.409482881640486 -34.627409974861322,-58.408585636504569 -34.627345352591263,-58.407693163518758 -34.627281077997928,-58.406755121064187 -34.627203324825246,-58.406650312682913 -34.628115772193411,-58.406631887507743 -34.628276050793176,-58.406787044499431 -34.628129708651542,-58.406977106099625 -34.628149021623038,-58.408485059001691 -34.628332876342334,-58.409973198222637 -34.628737626747395,-58.410092348060971 -34.627453832257416,-58.409482881640486 -34.627409974861322)));;2140;3_26_8;COMUNA 3;26;8;586;276;310;89,03%;288;288;100,00%;0;0,00%;246;17;6,91%;229;93,09%
MULTIPOLYGON (((-58.406787044499431 -34.628129708651542,-58.406631887507743 -34.628276050793176,-58.406595722220892 -34.628591115145056,-58.40651328161249 -34.629304058776086,-58.406751307352188 -34.629330929644539,-58.408364500415722 -34.629515960854462,-58.409426502981489 -34.629775874582862,-58.409868953631033 -34.629888394709269,-58.409888701528367 -34.62964825441648,-58.409973198222637 -34.628737626747395,-58.408485059001691 -34.628332876342334,-58.406977106099625 -34.628149021623038,-58.406787044499431 -34.628129708651542)));;2141;3_26_9;COMUNA 3;26;9;790;376;414;90,82%;316;315;99,68%;1;0,32%;292;42;14,38%;250;85,62%
MULTIPOLYGON (((-58.407078698642593 -34.624390137865156,-58.406209208105885 -34.624277621791187,-58.405812497292025 -34.624228844217235,-58.405781934949239 -34.62444623175697,-58.405601273091641 -34.625766121848145,-58.406901660934594 -34.625926729053376,-58.406965674205168 -34.625369204167306,-58.407050252450212 -34.624632879661661,-58.407078698642593 -34.624390137865156)));;2142;3_27_1;COMUNA 3;27;1;966;443;523;84,70%;466;465;99,79%;1;0,22%;400;35;8,75%;365;91,25%
MULTIPOLYGON (((-58.403475090715872 -34.623940961389003,-58.403254546027256 -34.623913951782569,-58.402471268659397 -34.623817860057024,-58.402170395581692 -34.623780456335048,-58.402098521961449 -34.624092262306569,-58.401845371100563 -34.625201188183311,-58.402096571473244 -34.625251737494402,-58.402923179172554 -34.625412714211592,-58.403136310334993 -34.625447397109923,-58.403354552729553 -34.625482927221697,-58.40415590366969 -34.625585148902495,-58.404764819294094 -34.625662766197891,-58.405601273091641 -34.625766121848145,-58.405781934949239 -34.62444623175697,-58.405812497292025 -34.624228844217235,-58.404707979147503 -34.624093037802034,-58.404016102640703 -34.624007774432279,-58.403475090715872 -34.623940961389003)));;2143;3_27_2;COMUNA 3;27;2;842;396;446;88,79%;319;318;99,69%;1;0,31%;330;26;7,88%;304;92,12%
MULTIPOLYGON (((-58.402170395581692 -34.623780456335048,-58.40140168832226 -34.623684787519451,-58.401283708384824 -34.623669023412859,-58.400963073525183 -34.623629212313226,-58.400421214180923 -34.623562948694897,-58.400222479075381 -34.623538127912269,-58.399468599369463 -34.623442947481699,-58.399275402111421 -34.623418409726192,-58.399232301353763 -34.623633676376414,-58.39909436815077 -34.624647301138367,-58.398914021795719 -34.62597260410692,-58.400181145107446 -34.626171576702902,-58.400193541402317 -34.625886995953834,-58.400195014902501 -34.62585340402115,-58.400199088703282 -34.625760515635612,-58.400206370552588 -34.62559311932182,-58.400224517430843 -34.625365163130674,-58.400232859479033 -34.625260797659138,-58.400237676046743 -34.62519981213682,-58.400241718316082 -34.625148896982317,-58.400262960721285 -34.624882560765123,-58.401041344940381 -34.625038877501822,-58.401845371100563 -34.625201188183311,-58.402098521961449 -34.624092262306569,-58.402170395581692 -34.623780456335048)));;2144;3_27_3;COMUNA 3;27;3;906;445;461;96,53%;387;387;100,00%;0;0,00%;355;76;21,41%;279;78,59%
MULTIPOLYGON (((-58.405432935629086 -34.626995873283875,-58.403941491853701 -34.626761775798862,-58.40415590366969 -34.625585148902495,-58.403354552729553 -34.625482927221697,-58.403136310334993 -34.625447397109923,-58.402923179172554 -34.625412714211592,-58.402096571473244 -34.625251737494402,-58.401845371100563 -34.625201188183311,-58.401041344940381 -34.625038877501822,-58.400262960721285 -34.624882560765123,-58.400241718316082 -34.625148896982317,-58.400237676046743 -34.62519981213682,-58.400232859479033 -34.625260797659138,-58.400224517430843 -34.625365163130674,-58.400206370552588 -34.62559311932182,-58.400199088703282 -34.625760515635612,-58.400195014902501 -34.62585340402115,-58.400193541402317 -34.625886995953834,-58.400181145107446 -34.626171576702902,-58.398914021795719 -34.62597260410692,-58.398897143712496 -34.626096331863216,-58.398756430981415 -34.627168688746885,-58.398910448176117 -34.627191164508673,-58.400089038527419 -34.627320089345808,-58.401328713446837 -34.627455583059479,-58.402647347372955 -34.627621808330126,-58.403759232754197 -34.627761932827632,-58.404301205832382 -34.627830223965233,-58.404659170936718 -34.627875325908768,-58.405301755524938 -34.62795436501785,-58.405432935629086 -34.626995873283875)));;2145;3_27_4;COMUNA 3;27;4;834;402;432;93,06%;391;391;100,00%;0;0,00%;313;30;9,58%;283;90,42%
MULTIPOLYGON (((-58.406901660934594 -34.625926729053376,-58.405601273091641 -34.625766121848145,-58.404764819294094 -34.625662766197891,-58.40415590366969 -34.625585148902495,-58.403941491853701 -34.626761775798862,-58.405432935629086 -34.626995873283875,-58.405301755524938 -34.62795436501785,-58.406443298184428 -34.628094760697472,-58.406650312682913 -34.628115772193411,-58.406755121064187 -34.627203324825246,-58.406901660934594 -34.625926729053376)));;2146;3_27_5;COMUNA 3;27;5;781;358;423;84,63%;380;380;100,00%;0;0,00%;317;28;8,83%;289;91,17%
MULTIPOLYGON (((-58.406650312682913 -34.628115772193411,-58.406443298184428 -34.628094760697472,-58.405301755524938 -34.62795436501785,-58.404659170936718 -34.627875325908768,-58.404301205832382 -34.627830223965233,-58.403759232754197 -34.627761932827632,-58.403582015454617 -34.628734555729203,-58.403542913797459 -34.628968910802186,-58.405454009253027 -34.629184548176191,-58.405645775316991 -34.62920618804106,-58.40651328161249 -34.629304058776086,-58.406595722220892 -34.628591115145056,-58.406631887507743 -34.628276050793176,-58.406650312682913 -34.628115772193411)));;2147;3_27_6;COMUNA 3;27;6;838;410;428;95,79%;303;303;100,00%;0;0,00%;306;66;21,57%;240;78,43%
MULTIPOLYGON (((-58.401328713446837 -34.627455583059479,-58.400089038527419 -34.627320089345808,-58.398910448176117 -34.627191164508673,-58.398756430981415 -34.627168688746885,-58.398594118081888 -34.628405969026034,-58.399906550778134 -34.628560741389123,-58.40084287911575 -34.62866411058269,-58.401100920939598 -34.628693256223784,-58.402385765833174 -34.62883826933912,-58.403542913797459 -34.628968910802186,-58.403582015454617 -34.628734555729203,-58.403759232754197 -34.627761932827632,-58.402647347372955 -34.627621808330126,-58.401328713446837 -34.627455583059479)));;2148;3_27_7;COMUNA 3;27;7;932;426;506;84,19%;405;405;100,00%;0;0,00%;367;25;6,81%;342;93,19%
MULTIPOLYGON (((-58.404731971115886 -34.598036961258522,-58.404506707064108 -34.598035938510762,-58.403721518526567 -34.598455084702366,-58.404136046721561 -34.599758573714539,-58.404179982201761 -34.599895994406502,-58.404348287285202 -34.599877694023554,-58.405297304689753 -34.599770182288339,-58.404731971115886 -34.598036961258522)));;2149;3_3_1;COMUNA 3;3;1;1101;485;616;78,73%;657;657;100,00%;0;0,00%;476;0;0,00%;476;100,00%
MULTIPOLYGON (((-58.403588817050178 -34.601957830083855,-58.40345832714813 -34.601970584185509,-58.402303586671721 -34.602090797295844,-58.402217790776 -34.603423481092555,-58.402146206239969 -34.604534966136896,-58.402137048150031 -34.604713700668704,-58.403630787439141 -34.604750631492102,-58.403641121690363 -34.604590348811243,-58.403622798014723 -34.603403886996709,-58.403588817050178 -34.601957830083855)));;2150;3_3_10;COMUNA 3;3;10;950;470;480;97,92%;338;338;100,00%;0;0,00%;393;114;29,01%;279;70,99%
MULTIPOLYGON (((-58.405155931360689 -34.603342997631422,-58.403771338972724 -34.603401846070412,-58.403622798014723 -34.603403886996709,-58.403641121690363 -34.604590348811243,-58.403630787439141 -34.604750631492102,-58.404480023677991 -34.604664275858674,-58.405469462590318 -34.604563683844795,-58.405191513806493 -34.603494569402351,-58.405155931360689 -34.603342997631422)));;2151;3_3_11;COMUNA 3;3;11;869;345;524;65,84%;405;405;100,00%;0;0,00%;305;0;0,00%;305;100,00%
MULTIPOLYGON (((-58.403721518526567 -34.598455084702366,-58.403082780232545 -34.598796055010837,-58.403281728930736 -34.599994085198297,-58.404179982201761 -34.599895994406502,-58.404136046721561 -34.599758573714539,-58.403721518526567 -34.598455084702366)));;2152;3_3_2;COMUNA 3;3;2;860;398;462;86,15%;529;528;99,81%;1;0,19%;373;44;11,80%;329;88,20%
MULTIPOLYGON (((-58.403082780232545 -34.598796055010837,-58.402536819719863 -34.599087488369427,-58.402474367990948 -34.599120839121952,-58.402429127444726 -34.600087121316648,-58.402575458196608 -34.60007113655638,-58.403281728930736 -34.599994085198297,-58.403082780232545 -34.598796055010837)));;2153;3_3_3;COMUNA 3;3;3;614;271;343;79,01%;348;348;100,00%;0;0,00%;260;2;0,77%;258;99,23%
MULTIPOLYGON (((-58.403281728930736 -34.599994085198297,-58.402575458196608 -34.60007113655638,-58.402429127444726 -34.600087121316648,-58.402377147599239 -34.600949241123345,-58.402370601254503 -34.601050861465289,-58.403434425803077 -34.600967083827712,-58.403298180819093 -34.600093463196288,-58.403281728930736 -34.599994085198297)));;2154;3_3_4;COMUNA 3;3;4;516;230;286;80,42%;273;273;100,00%;0;0,00%;213;8;3,76%;205;96,24%
MULTIPOLYGON (((-58.404179982201761 -34.599895994406502,-58.403281728930736 -34.599994085198297,-58.403298180819093 -34.600093463196288,-58.403434425803077 -34.600967083827712,-58.404496118951165 -34.600883366321511,-58.404179982201761 -34.599895994406502)));;2155;3_3_5;COMUNA 3;3;5;579;275;304;90,46%;355;354;99,72%;1;0,28%;245;1;0,41%;244;99,59%
MULTIPOLYGON (((-58.405297304689753 -34.599770182288339,-58.404348287285202 -34.599877694023554,-58.404179982201761 -34.599895994406502,-58.404496118951165 -34.600883366321511,-58.405631229658461 -34.600793899067028,-58.405297304689753 -34.599770182288339)));;2156;3_3_6;COMUNA 3;3;6;823;363;460;78,91%;389;388;99,74%;1;0,26%;302;1;0,33%;301;99,67%
MULTIPOLYGON (((-58.405631229658461 -34.600793899067028,-58.404496118951165 -34.600883366321511,-58.404802234741233 -34.601839534142727,-58.404982637277548 -34.601821942884271,-58.40592885661173 -34.601727312771274,-58.405895128802577 -34.6016029261637,-58.405631229658461 -34.600793899067028)));;2157;3_3_7;COMUNA 3;3;7;802;355;447;79,42%;390;390;100,00%;0;0,00%;308;18;5,84%;290;94,16%
MULTIPOLYGON (((-58.403588817050178 -34.601957830083855,-58.403622798014723 -34.603403886996709,-58.403771338972724 -34.603401846070412,-58.405155931360689 -34.603342997631422,-58.404802234741233 -34.601839534142727,-58.404496118951165 -34.600883366321511,-58.403434425803077 -34.600967083827712,-58.403588817050178 -34.601957830083855)));;2158;3_3_8;COMUNA 3;3;8;726;319;407;78,38%;359;358;99,72%;1;0,28%;263;6;2,28%;257;97,72%
MULTIPOLYGON (((-58.403434425803077 -34.600967083827712,-58.402370601254503 -34.601050861465289,-58.402303586671721 -34.602090797295844,-58.40345832714813 -34.601970584185509,-58.403588817050178 -34.601957830083855,-58.403434425803077 -34.600967083827712)));;2159;3_3_9;COMUNA 3;3;9;285;136;149;91,28%;190;190;100,00%;0;0,00%;159;22;13,84%;137;86,16%
MULTIPOLYGON (((-58.402474367990948 -34.599120839121952,-58.402008236296744 -34.599369702208541,-58.401208184302661 -34.599468108251116,-58.40106943391087 -34.599484588179223,-58.401029360615176 -34.600236075485334,-58.402429127444726 -34.600087121316648,-58.402474367990948 -34.599120839121952)));;2160;3_4_1;COMUNA 3;4;1;736;317;419;75,66%;449;449;100,00%;0;0,00%;354;12;3,39%;342;96,61%
MULTIPOLYGON (((-58.402429127444726 -34.600087121316648,-58.401029360615176 -34.600236075485334,-58.400977233316588 -34.601162704082661,-58.402370601254503 -34.601050861465289,-58.402377147599239 -34.600949241123345,-58.402429127444726 -34.600087121316648)));;2161;3_4_2;COMUNA 3;4;2;499;224;275;81,45%;269;269;100,00%;0;0,00%;216;17;7,87%;199;92,13%
MULTIPOLYGON (((-58.40106943391087 -34.599484588179223,-58.399920929080487 -34.599621543160424,-58.399815203724245 -34.601019992677813,-58.399807380800731 -34.601116189480436,-58.399922952509733 -34.601120404081826,-58.400977233316588 -34.601162704082661,-58.401029360615176 -34.600236075485334,-58.40106943391087 -34.599484588179223)));;2162;3_4_3;COMUNA 3;4;3;681;293;388;75,52%;421;416;98,81%;5;1,20%;279;5;1,79%;274;98,21%
MULTIPOLYGON (((-58.400977233316588 -34.601162704082661,-58.399922952509733 -34.601120404081826,-58.399807380800731 -34.601116189480436,-58.399717629063154 -34.602222100547991,-58.400901166995489 -34.602211015133335,-58.402143283870913 -34.602107479041379,-58.402303586671721 -34.602090797295844,-58.402370601254503 -34.601050861465289,-58.400977233316588 -34.601162704082661)));;2163;3_4_4;COMUNA 3;4;4;772;359;413;86,92%;404;404;100,00%;0;0,00%;326;67;20,55%;259;79,45%
MULTIPOLYGON (((-58.400901166995489 -34.602211015133335,-58.399717629063154 -34.602222100547991,-58.399709547688538 -34.602321888876709,-58.399550952095055 -34.603344944028414,-58.399709791098275 -34.603353125027184,-58.400897186277902 -34.603445566670977,-58.402217790776 -34.603423481092555,-58.402303586671721 -34.602090797295844,-58.402143283870913 -34.602107479041379,-58.400901166995489 -34.602211015133335)));;2164;3_4_5;COMUNA 3;4;5;683;327;356;91,85%;407;407;100,00%;0;0,00%;288;44;15,28%;244;84,72%
MULTIPOLYGON (((-58.399717629063154 -34.602222100547991,-58.399594386978336 -34.602222529848142,-58.398497149651263 -34.602203506043644,-58.398486084493278 -34.602305053350605,-58.398370248225675 -34.603304607446674,-58.399438018873042 -34.603339110663271,-58.399550952095055 -34.603344944028414,-58.399709547688538 -34.602321888876709,-58.399717629063154 -34.602222100547991)));;2165;3_4_6;COMUNA 3;4;6;655;303;352;86,08%;424;424;100,00%;0;0,00%;308;13;4,22%;295;95,78%
MULTIPOLYGON (((-58.399550952095055 -34.603344944028414,-58.399438018873042 -34.603339110663271,-58.398370248225675 -34.603304607446674,-58.398238889030793 -34.604438594715717,-58.39821884902333 -34.604580349989497,-58.399479622341701 -34.604635377986284,-58.399550952095055 -34.603344944028414)));;2166;3_4_7;COMUNA 3;4;7;674;315;359;87,74%;422;422;100,00%;0;0,00%;270;1;0,37%;269;99,63%
MULTIPOLYGON (((-58.400897186277902 -34.603445566670977,-58.399709791098275 -34.603353125027184,-58.399550952095055 -34.603344944028414,-58.399479622341701 -34.604635377986284,-58.399624071000346 -34.604641650159785,-58.400630794076761 -34.604670970329579,-58.400835887216047 -34.604675722549807,-58.401198633027029 -34.604684075250276,-58.402137048150031 -34.604713700668704,-58.402146206239969 -34.604534966136896,-58.402217790776 -34.603423481092555,-58.400897186277902 -34.603445566670977)));;2167;3_4_8;COMUNA 3;4;8;724;353;371;95,15%;371;371;100,00%;0;0,00%;271;10;3,69%;261;96,31%
MULTIPOLYGON (((-58.39872302166269 -34.599760292490146,-58.397185677358515 -34.599730250300937,-58.397099501838923 -34.601011661214621,-58.398490783518312 -34.601068741428882,-58.398620492876333 -34.60107338725377,-58.399807380800731 -34.601116189480436,-58.399815203724245 -34.601019992677813,-58.399920929080487 -34.599621543160424,-58.39872302166269 -34.599760292490146)));;2168;3_5_1;COMUNA 3;5;1;802;380;422;90,05%;583;583;100,00%;0;0,00%;373;40;10,72%;333;89,28%
MULTIPOLYGON (((-58.399807380800731 -34.601116189480436,-58.398620492876333 -34.60107338725377,-58.398497149651263 -34.602203506043644,-58.399594386978336 -34.602222529848142,-58.399717629063154 -34.602222100547991,-58.399807380800731 -34.601116189480436)));;2169;3_5_2;COMUNA 3;5;2;648;281;367;76,57%;418;418;100,00%;0;0,00%;291;1;0,34%;290;99,66%
MULTIPOLYGON (((-58.398620492876333 -34.60107338725377,-58.398490783518312 -34.601068741428882,-58.397099501838923 -34.601011661214621,-58.397028147161897 -34.602071803814532,-58.397018688658392 -34.602185817113622,-58.398354746459034 -34.60220103657521,-58.398497149651263 -34.602203506043644,-58.398620492876333 -34.60107338725377)));;2170;3_5_3;COMUNA 3;5;3;970;432;538;80,30%;672;672;100,00%;0;0,00%;469;7;1,49%;462;98,51%
MULTIPOLYGON (((-58.397099501838923 -34.601011661214621,-58.396961872700487 -34.601006023553552,-58.395781309180833 -34.600939745524173,-58.395664035233281 -34.600934680962496,-58.395652512370631 -34.601071792509437,-58.395544055925036 -34.602068601577734,-58.395534527232932 -34.602161487163983,-58.39567104830315 -34.6021704358104,-58.397018688658392 -34.602185817113622,-58.397028147161897 -34.602071803814532,-58.397099501838923 -34.601011661214621)));;2171;3_5_4;COMUNA 3;5;4;542;232;310;74,84%;374;374;100,00%;0;0,00%;262;23;8,78%;239;91,22%
MULTIPOLYGON (((-58.397185677358515 -34.599730250300937,-58.395816368011872 -34.599703379673151,-58.395672118140702 -34.600838836694336,-58.395664035233281 -34.600934680962496,-58.395781309180833 -34.600939745524173,-58.396961872700487 -34.601006023553552,-58.397099501838923 -34.601011661214621,-58.397185677358515 -34.599730250300937)));;2172;3_5_5;COMUNA 3;5;5;610;256;354;72,32%;524;524;100,00%;0;0,00%;330;3;0,91%;327;99,09%
MULTIPOLYGON (((-58.394210844397293 -34.600871970193978,-58.394057545385884 -34.600865334507908,-58.392765578327278 -34.600807063480339,-58.39274741490452 -34.600935367795941,-58.392592289973102 -34.601986727003279,-58.392806653394864 -34.601998892688812,-58.393962963081165 -34.602056523535474,-58.394101868287713 -34.602065827406548,-58.395402605110938 -34.602152893027323,-58.395534527232932 -34.602161487163983,-58.395544055925036 -34.602068601577734,-58.395652512370631 -34.601071792509437,-58.395664035233281 -34.600934680962496,-58.395672118140702 -34.600838836694336,-58.395816368011872 -34.599703379673151,-58.394711757134132 -34.599681852917257,-58.394396131192302 -34.599674000300134,-58.394372084070625 -34.599814344302153,-58.394221931501676 -34.600749788679948,-58.394210844397293 -34.600871970193978)));;2173;3_5_6;COMUNA 3;5;6;441;198;243;81,48%;377;377;100,00%;0;0,00%;215;0;0,00%;215;100,00%
MULTIPOLYGON (((-58.394396131192302 -34.599674000300134,-58.392930847848312 -34.59963711357576,-58.392765578327278 -34.600807063480339,-58.394057545385884 -34.600865334507908,-58.394210844397293 -34.600871970193978,-58.394221931501676 -34.600749788679948,-58.394372084070625 -34.599814344302153,-58.394396131192302 -34.599674000300134)));;2174;3_5_7;COMUNA 3;5;7;768;332;436;76,15%;608;608;100,00%;0;0,00%;368;4;1,09%;364;98,91%
MULTIPOLYGON (((-58.398497149651263 -34.602203506043644,-58.398354746459034 -34.60220103657521,-58.397018688658392 -34.602185817113622,-58.3969356205575 -34.603192289159466,-58.396925158007051 -34.603283132004449,-58.397133742592338 -34.603284018943604,-58.398229718565901 -34.603300026063984,-58.398370248225675 -34.603304607446674,-58.398486084493278 -34.602305053350605,-58.398497149651263 -34.602203506043644)));;2175;3_6_1;COMUNA 3;6;1;716;310;406;76,35%;624;624;100,00%;0;0,00%;354;3;0,85%;351;99,15%
MULTIPOLYGON (((-58.397018688658392 -34.602185817113622,-58.39567104830315 -34.6021704358104,-58.395534527232932 -34.602161487163983,-58.395435802923139 -34.603126750831322,-58.395421385815489 -34.603261043703945,-58.39559513142089 -34.603266562120439,-58.396797315803092 -34.603282640471249,-58.396925158007051 -34.603283132004449,-58.3969356205575 -34.603192289159466,-58.397018688658392 -34.602185817113622)));;2176;3_6_2;COMUNA 3;6;2;351;169;182;92,86%;224;224;100,00%;0;0,00%;175;16;9,14%;159;90,86%
MULTIPOLYGON (((-58.395534527232932 -34.602161487163983,-58.395402605110938 -34.602152893027323,-58.394101868287713 -34.602065827406548,-58.393962963081165 -34.602056523535474,-58.392806653394864 -34.601998892688812,-58.392592289973102 -34.601986727003279,-58.392572931270642 -34.602117847588659,-58.392387066654969 -34.603155385322069,-58.39247010940111 -34.603154728895831,-58.392747685069438 -34.60315256431474,-58.393983904526742 -34.603206649064028,-58.394116000825022 -34.603212427824658,-58.395282900400069 -34.603256600904913,-58.395421385815489 -34.603261043703945,-58.395435802923139 -34.603126750831322,-58.395534527232932 -34.602161487163983)));;2177;3_6_3;COMUNA 3;6;3;617;288;329;87,54%;503;503;100,00%;0;0,00%;312;7;2,24%;305;97,76%
MULTIPOLYGON (((-58.39247010940111 -34.603154728895831,-58.392387066654969 -34.603155385322069,-58.392286335032786 -34.604436079428034,-58.393576259729372 -34.604456817760315,-58.393687238450617 -34.60445857078539,-58.393857580682322 -34.604462681248123,-58.393983904526742 -34.603206649064028,-58.392747685069438 -34.60315256431474,-58.39247010940111 -34.603154728895831)));;2178;3_6_4;COMUNA 3;6;4;610;274;336;81,55%;445;445;100,00%;0;0,00%;320;4;1,25%;316;98,75%
MULTIPOLYGON (((-58.395421385815489 -34.603261043703945,-58.395282900400069 -34.603256600904913,-58.394116000825022 -34.603212427824658,-58.393983904526742 -34.603206649064028,-58.393857580682322 -34.604462681248123,-58.395288456380733 -34.604496861706352,-58.395421385815489 -34.603261043703945)));;2179;3_6_5;COMUNA 3;6;5;866;376;490;76,73%;476;474;99,58%;2;0,42%;329;59;17,93%;270;82,07%
MULTIPOLYGON (((-58.396925158007051 -34.603283132004449,-58.396797315803092 -34.603282640471249,-58.39559513142089 -34.603266562120439,-58.395421385815489 -34.603261043703945,-58.395288456380733 -34.604496861706352,-58.396612358187447 -34.604528432185077,-58.396779548482499 -34.604533593238884,-58.396801579215094 -34.60435472521317,-58.396925158007051 -34.603283132004449)));;2180;3_6_6;COMUNA 3;6;6;522;226;296;76,35%;414;413;99,76%;1;0,24%;255;2;0,78%;253;99,22%
MULTIPOLYGON (((-58.398370248225675 -34.603304607446674,-58.398229718565901 -34.603300026063984,-58.397133742592338 -34.603284018943604,-58.396925158007051 -34.603283132004449,-58.396801579215094 -34.60435472521317,-58.396779548482499 -34.604533593238884,-58.398045016912064 -34.604572792932856,-58.39821884902333 -34.604580349989497,-58.398238889030793 -34.604438594715717,-58.398370248225675 -34.603304607446674)));;2181;3_6_7;COMUNA 3;6;7;683;300;383;78,33%;435;435;100,00%;0;0,00%;312;2;0,64%;310;99,36%
MULTIPOLYGON (((-58.399479622341701 -34.604635377986284,-58.39821884902333 -34.604580349989497,-58.398197010130104 -34.604735273811571,-58.397991002812006 -34.605909011269411,-58.397977461728502 -34.60601668414283,-58.399210496588715 -34.60606268578357,-58.399333994093766 -34.60606986292359,-58.399471332091217 -34.604785308868998,-58.399479622341701 -34.604635377986284)));;2182;3_7_1;COMUNA 3;7;1;310;138;172;80,23%;177;177;100,00%;0;0,00%;136;0;0,00%;136;100,00%
MULTIPOLYGON (((-58.39821884902333 -34.604580349989497,-58.398045016912064 -34.604572792932856,-58.396779548482499 -34.604533593238884,-58.396636561568464 -34.605693418288887,-58.396591297377526 -34.605954741510473,-58.397977461728502 -34.60601668414283,-58.397991002812006 -34.605909011269411,-58.398197010130104 -34.604735273811571,-58.39821884902333 -34.604580349989497)));;2183;3_7_2;COMUNA 3;7;2;864;388;476;81,51%;616;616;100,00%;0;0,00%;415;17;4,10%;398;95,90%
MULTIPOLYGON (((-58.396779548482499 -34.604533593238884,-58.396612358187447 -34.604528432185077,-58.395288456380733 -34.604496861706352,-58.395142134750621 -34.605857465264741,-58.396431858800163 -34.605944936348685,-58.396591297377526 -34.605954741510473,-58.396636561568464 -34.605693418288887,-58.396779548482499 -34.604533593238884)));;2184;3_7_3;COMUNA 3;7;3;967;450;517;87,04%;624;622;99,68%;2;0,32%;453;37;8,17%;416;91,83%
MULTIPOLYGON (((-58.393576259729372 -34.604456817760315,-58.392286335032786 -34.604436079428034,-58.392205640693057 -34.60548621281054,-58.392193921096819 -34.605647057086962,-58.392389129121625 -34.605659916685596,-58.393534560523122 -34.605749447913759,-58.393694253144695 -34.605760172532079,-58.394984571108189 -34.60584674372295,-58.395142134750621 -34.605857465264741,-58.395288456380733 -34.604496861706352,-58.393857580682322 -34.604462681248123,-58.393687238450617 -34.60445857078539,-58.393576259729372 -34.604456817760315)));;2185;3_7_4;COMUNA 3;7;4;914;412;502;82,07%;664;658;99,10%;6;0,91%;369;18;4,88%;351;95,12%
MULTIPOLYGON (((-58.393694253144695 -34.605760172532079,-58.393534560523122 -34.605749447913759,-58.392389129121625 -34.605659916685596,-58.392193921096819 -34.605647057086962,-58.392121960875414 -34.606639728336887,-58.392112124877315 -34.60678867181602,-58.392315080438898 -34.606808719378535,-58.393564505339988 -34.606923874590386,-58.393573187419591 -34.606828101321923,-58.393694253144695 -34.605760172532079)));;2186;3_7_5;COMUNA 3;7;5;579;271;308;87,99%;500;495;99,00%;5;1,01%;268;14;5,22%;254;94,78%
MULTIPOLYGON (((-58.395142134750621 -34.605857465264741,-58.394984571108189 -34.60584674372295,-58.393694253144695 -34.605760172532079,-58.393573187419591 -34.606828101321923,-58.393564505339988 -34.606923874590386,-58.39489050073751 -34.607046031675679,-58.395031799040297 -34.607055617516217,-58.395035809659902 -34.606941531017945,-58.395129862022763 -34.605972040187716,-58.395142134750621 -34.605857465264741)));;2187;3_7_6;COMUNA 3;7;6;584;263;321;81,93%;469;466;99,36%;3;0,64%;283;12;4,24%;271;95,76%
MULTIPOLYGON (((-58.396591297377526 -34.605954741510473,-58.396431858800163 -34.605944936348685,-58.395142134750621 -34.605857465264741,-58.395129862022763 -34.605972040187716,-58.395035809659902 -34.606941531017945,-58.395031799040297 -34.607055617516217,-58.396469994539196 -34.607153100388629,-58.396570504549167 -34.606075157248419,-58.396591297377526 -34.605954741510473)));;2188;3_7_7;COMUNA 3;7;7;922;416;506;82,21%;668;668;100,00%;0;0,00%;504;29;5,75%;475;94,25%
MULTIPOLYGON (((-58.397977461728502 -34.60601668414283,-58.396591297377526 -34.605954741510473,-58.396570504549167 -34.606075157248419,-58.396469994539196 -34.607153100388629,-58.397721753793817 -34.607237861062814,-58.397849857045891 -34.607239056020809,-58.397961521130789 -34.606143159254401,-58.397977461728502 -34.60601668414283)));;2189;3_7_8;COMUNA 3;7;8;395;162;233;69,53%;204;202;99,02%;2;0,99%;159;13;8,18%;146;91,82%
MULTIPOLYGON (((-58.399333994093766 -34.60606986292359,-58.399210496588715 -34.60606268578357,-58.397977461728502 -34.60601668414283,-58.397961521130789 -34.606143159254401,-58.397849857045891 -34.607239056020809,-58.398007686374719 -34.607240548309818,-58.39911712770477 -34.607315007481176,-58.399256384293324 -34.607322545036482,-58.399260562177673 -34.607204937231003,-58.39932481515207 -34.606155776838953,-58.399333994093766 -34.60606986292359)));;2190;3_7_9;COMUNA 3;7;9;931;397;534;74,34%;665;664;99,85%;1;0,15%;404;16;3,96%;388;96,04%
MULTIPOLYGON (((-58.405469462590318 -34.604563683844795,-58.404480023677991 -34.604664275858674,-58.404573398806427 -34.605605552687777,-58.405535189364407 -34.605596992670527,-58.405713220056256 -34.605572004593952,-58.405517373719633 -34.60474807940156,-58.405469462590318 -34.604563683844795)));;2191;3_8_1;COMUNA 3;8;1;647;294;353;83,29%;482;482;100,00%;0;0,00%;321;3;0,93%;318;99,07%
MULTIPOLYGON (((-58.40594482633216 -34.606546585395009,-58.404658149538207 -34.60645865291383,-58.404672105547199 -34.60659929857146,-58.404753123702783 -34.607556062618769,-58.404748476739066 -34.607624372792834,-58.40487078277004 -34.607634149492377,-58.406119815313758 -34.607743823639126,-58.40613020569171 -34.607619880219865,-58.405984319567651 -34.606712947956282,-58.40594482633216 -34.606546585395009)));;2192;3_8_10;COMUNA 3;8;10;547;252;295;85,42%;272;272;100,00%;0;0,00%;256;34;13,28%;222;86,72%
MULTIPOLYGON (((-58.405713220056256 -34.605572004593952,-58.405535189364407 -34.605596992670527,-58.404573398806427 -34.605605552687777,-58.404658149538207 -34.60645865291383,-58.40594482633216 -34.606546585395009,-58.405713220056256 -34.605572004593952)));;2193;3_8_2;COMUNA 3;8;2;552;245;307;79,80%;290;290;100,00%;0;0,00%;212;7;3,30%;205;96,70%
MULTIPOLYGON (((-58.404480023677991 -34.604664275858674,-58.403630787439141 -34.604750631492102,-58.402137048150031 -34.604713700668704,-58.402125731591163 -34.604932506041841,-58.402042744926632 -34.606259274773144,-58.40217186219693 -34.606269620966209,-58.40337403903392 -34.606359017537251,-58.403534155635327 -34.606375856471303,-58.403697338393926 -34.606392978378572,-58.404658149538207 -34.60645865291383,-58.404573398806427 -34.605605552687777,-58.404480023677991 -34.604664275858674)));;2194;3_8_3;COMUNA 3;8;3;839;384;455;84,40%;445;445;100,00%;0;0,00%;341;4;1,17%;337;98,83%
MULTIPOLYGON (((-58.402137048150031 -34.604713700668704,-58.401198633027029 -34.604684075250276,-58.400835887216047 -34.604675722549807,-58.400824837761647 -34.604874315914948,-58.400722020113854 -34.606153536714707,-58.402042744926632 -34.606259274773144,-58.402125731591163 -34.604932506041841,-58.402137048150031 -34.604713700668704)));;2195;3_8_4;COMUNA 3;8;4;538;242;296;81,76%;369;369;100,00%;0;0,00%;217;3;1,38%;214;98,62%
MULTIPOLYGON (((-58.400835887216047 -34.604675722549807,-58.400630794076761 -34.604670970329579,-58.399624071000346 -34.604641650159785,-58.399479622341701 -34.604635377986284,-58.399471332091217 -34.604785308868998,-58.399333994093766 -34.60606986292359,-58.400584471453975 -34.6061424804438,-58.400722020113854 -34.606153536714707,-58.400824837761647 -34.604874315914948,-58.400835887216047 -34.604675722549807)));;2196;3_8_5;COMUNA 3;8;5;496;237;259;91,51%;349;349;100,00%;0;0,00%;216;8;3,70%;208;96,30%
MULTIPOLYGON (((-58.400722020113854 -34.606153536714707,-58.400584471453975 -34.6061424804438,-58.399333994093766 -34.60606986292359,-58.39932481515207 -34.606155776838953,-58.399260562177673 -34.607204937231003,-58.399256384293324 -34.607322545036482,-58.40049589715111 -34.607389171621833,-58.400633791073211 -34.607396847760626,-58.400714541217333 -34.606246001136668,-58.400722020113854 -34.606153536714707)));;2197;3_8_6;COMUNA 3;8;6;478;215;263;81,75%;264;264;100,00%;0;0,00%;203;19;9,36%;184;90,64%
MULTIPOLYGON (((-58.402042744926632 -34.606259274773144,-58.400722020113854 -34.606153536714707,-58.400714541217333 -34.606246001136668,-58.400633791073211 -34.607396847760626,-58.401968101447473 -34.607470972640911,-58.401973543923283 -34.607366041897286,-58.402042744926632 -34.606259274773144)));;2198;3_8_7;COMUNA 3;8;7;427;194;233;83,26%;226;226;100,00%;0;0,00%;166;42;25,30%;124;74,70%
MULTIPOLYGON (((-58.403534155635327 -34.606375856471303,-58.40337403903392 -34.606359017537251,-58.40217186219693 -34.606269620966209,-58.402042744926632 -34.606259274773144,-58.401973543923283 -34.607366041897286,-58.401968101447473 -34.607470972640911,-58.402106421471025 -34.607478717752642,-58.403316656346504 -34.607520159365379,-58.403466390652895 -34.607527204238927,-58.403534155635327 -34.606375856471303)));;2199;3_8_8;COMUNA 3;8;8;524;246;278;88,49%;280;280;100,00%;0;0,00%;207;26;12,56%;181;87,44%
MULTIPOLYGON (((-58.404658149538207 -34.60645865291383,-58.403697338393926 -34.606392978378572,-58.403534155635327 -34.606375856471303,-58.403466390652895 -34.607527204238927,-58.403633244847882 -34.607534961469277,-58.404748476739066 -34.607624372792834,-58.404753123702783 -34.607556062618769,-58.404672105547199 -34.60659929857146,-58.404658149538207 -34.60645865291383)));;2200;3_8_9;COMUNA 3;8;9;718;333;385;86,49%;377;377;100,00%;0;0,00%;304;8;2,63%;296;97,37%
MULTIPOLYGON (((-58.412036475979733 -34.605107663935904,-58.410883658810022 -34.605098094961797,-58.41077079705925 -34.605109174156226,-58.410821225559566 -34.605236806008499,-58.411346289529199 -34.606532921456527,-58.412270946763762 -34.606395203411964,-58.412398980126753 -34.606369269381418,-58.413644894834412 -34.606116809510524,-58.413412361717995 -34.60511907295993,-58.412036475979733 -34.605107663935904)));;2201;3_9_1;COMUNA 3;9;1;860;375;485;77,32%;486;486;100,00%;0;0,00%;388;20;5,15%;368;94,85%
MULTIPOLYGON (((-58.405985424253423 -34.609723129737858,-58.405965903508431 -34.610120740826467,-58.406416988422997 -34.610151795948916,-58.407665054284024 -34.610237650119927,-58.408581870251091 -34.610311302347526,-58.408882280286178 -34.610335450191876,-58.409164120834816 -34.610360645526242,-58.409994238988453 -34.610415868114266,-58.410346438898301 -34.610439541739687,-58.411733261053264 -34.610539639628378,-58.4117791243822 -34.609223413441363,-58.41163151536842 -34.609217013485321,-58.410534802022795 -34.609161899613227,-58.410384295807717 -34.609157680088231,-58.408834858277366 -34.609113483140554,-58.408666387669562 -34.609097070018322,-58.406029464894416 -34.608840441795166,-58.40600624018839 -34.609299461929048,-58.405985424253423 -34.609723129737858)));;2202;3_9_10;COMUNA 3;9;10;787;360;427;84,31%;378;376;99,47%;2;0,53%;326;68;20,86%;258;79,14%
MULTIPOLYGON (((-58.41077079705925 -34.605109174156226,-58.40937752686753 -34.605246043146558,-58.409975282127526 -34.60671762527339,-58.410084474612589 -34.606720841541502,-58.411346289529199 -34.606532921456527,-58.410821225559566 -34.605236806008499,-58.41077079705925 -34.605109174156226)));;2203;3_9_2;COMUNA 3;9;2;486;221;265;83,40%;273;272;99,63%;1;0,37%;206;3;1,46%;203;98,54%
MULTIPOLYGON (((-58.40937752686753 -34.605246043146558,-58.408344304649297 -34.605347562868808,-58.408226335667166 -34.605352721719889,-58.408522584220954 -34.606117529990854,-58.408738392147271 -34.60668173108283,-58.409975282127526 -34.60671762527339,-58.40937752686753 -34.605246043146558)));;2204;3_9_3;COMUNA 3;9;3;762;341;421;81,00%;435;435;100,00%;0;0,00%;342;3;0,88%;339;99,12%
MULTIPOLYGON (((-58.408226335667166 -34.605352721719889,-58.407100476510969 -34.605401863617786,-58.406948858939842 -34.605414189262312,-58.407322812773728 -34.606635602161617,-58.407462749404047 -34.606644609587981,-58.408738392147271 -34.60668173108283,-58.408522584220954 -34.606117529990854,-58.408226335667166 -34.605352721719889)));;2205;3_9_4;COMUNA 3;9;4;1026;482;544;88,60%;468;468;100,00%;0;0,00%;414;45;10,87%;369;89,13%
MULTIPOLYGON (((-58.406948858939842 -34.605414189262312,-58.406835486427376 -34.605423433528017,-58.405713220056256 -34.605572004593952,-58.40594482633216 -34.606546585395009,-58.407322812773728 -34.606635602161617,-58.406948858939842 -34.605414189262312)));;2206;3_9_5;COMUNA 3;9;5;594;284;310;91,61%;270;270;100,00%;0;0,00%;222;23;10,36%;199;89,64%
MULTIPOLYGON (((-58.410470153292664 -34.607935981776897,-58.410201760799318 -34.607938754018477,-58.409272166134429 -34.607907081731419,-58.409113998010106 -34.607900321979457,-58.409126468037705 -34.607581724143266,-58.408804461643058 -34.606854372319297,-58.408738392147271 -34.60668173108283,-58.407462749404047 -34.606644609587981,-58.407322812773728 -34.606635602161617,-58.40594482633216 -34.606546585395009,-58.405984319567651 -34.606712947956282,-58.40613020569171 -34.607619880219865,-58.406119815313758 -34.607743823639126,-58.406036862241024 -34.608734314572082,-58.406029464894416 -34.608840441795166,-58.408666387669562 -34.609097070018322,-58.408834858277366 -34.609113483140554,-58.410384295807717 -34.609157680088231,-58.410534802022795 -34.609161899613227,-58.41163151536842 -34.609217013485321,-58.4117791243822 -34.609223413441363,-58.411782938237245 -34.609115242048858,-58.411801862530595 -34.608811717667884,-58.411829561024376 -34.608366712844521,-58.411860269924397 -34.607873256744028,-58.410635907567737 -34.60793429199218,-58.410470153292664 -34.607935981776897)));;2207;3_9_6;COMUNA 3;9;6;497;238;259;91,89%;267;266;99,63%;1;0,38%;196;7;3,57%;189;96,43%
MULTIPOLYGON (((-58.409975282127526 -34.60671762527339,-58.408738392147271 -34.60668173108283,-58.408804461643058 -34.606854372319297,-58.409126468037705 -34.607581724143266,-58.409113998010106 -34.607900321979457,-58.409272166134429 -34.607907081731419,-58.410201760799318 -34.607938754018477,-58.410470153292664 -34.607935981776897,-58.410635907567737 -34.60793429199218,-58.411860269924397 -34.607873256744028,-58.411864140543393 -34.60781142508803,-58.411346289529199 -34.606532921456527,-58.410084474612589 -34.606720841541502,-58.409975282127526 -34.60671762527339)));;2208;3_9_7;COMUNA 3;9;7;776;393;383;102,61%;270;268;99,26%;2;0,75%;292;83;28,42%;209;71,58%
MULTIPOLYGON (((-58.413644894834412 -34.606116809510524,-58.412398980126753 -34.606369269381418,-58.412270946763762 -34.606395203411964,-58.411346289529199 -34.606532921456527,-58.411864140543393 -34.60781142508803,-58.411860269924397 -34.607873256744028,-58.411829561024376 -34.608366712844521,-58.411801862530595 -34.608811717667884,-58.411782938237245 -34.609115242048858,-58.4117791243822 -34.609223413441363,-58.411902543560338 -34.609228817198172,-58.413159896415195 -34.609296590204515,-58.413100496324169 -34.610638094014448,-58.414467053489723 -34.61073639196033,-58.41458300044718 -34.609376388004797,-58.414616610131489 -34.608847086040726,-58.41465245491414 -34.608281445533834,-58.414660003114641 -34.608190036685038,-58.414098939207328 -34.607906987143565,-58.413937006205018 -34.607346056728353,-58.413908275134354 -34.607246323240624,-58.413644894834412 -34.606116809510524)));;2209;3_9_8;COMUNA 3;9;8;740;365;375;97,33%;300;299;99,67%;1;0,33%;312;80;25,64%;232;74,36%
MULTIPOLYGON (((-58.413159896415195 -34.609296590204515,-58.411902543560338 -34.609228817198172,-58.4117791243822 -34.609223413441363,-58.411733261053264 -34.610539639628378,-58.413100496324169 -34.610638094014448,-58.413159896415195 -34.609296590204515)));;2210;3_9_9;COMUNA 3;9;9;803;368;435;84,60%;460;459;99,78%;1;0,22%;371;10;2,70%;361;97,30%
MULTIPOLYGON (((-58.432618146857898 -34.645215985186645,-58.432107560872296 -34.645163673459251,-58.431096034846497 -34.645918368356604,-58.429797499779312 -34.64684650410431,-58.429971624071676 -34.646992893465111,-58.430172753512494 -34.647162529926774,-58.430404381362742 -34.647357879142959,-58.430487525728608 -34.647427973694846,-58.430828708681574 -34.647715748168636,-58.431964895772509 -34.646823899904476,-58.432070267506248 -34.646934352331058,-58.432305629937439 -34.647181108904078,-58.432624304201006 -34.647515212196787,-58.432967003287978 -34.647874462109733,-58.433765108725268 -34.647250620978404,-58.434502426825965 -34.646675283130037,-58.434605548408939 -34.646573622552424,-58.434817221599097 -34.6463460108993,-58.434923113905626 -34.646236845097015,-58.433536447859325 -34.645617910783002,-58.433481578067358 -34.645593389851271,-58.432618146857898 -34.645215985186645)));;2211;4_1_1;COMUNA 4;1;1;770;360;410;87,80%;231;231;100,00%;0;0,00%;247;14;5,67%;233;94,33%
MULTIPOLYGON (((-58.422242303191808 -34.652320945862527,-58.421417231898936 -34.652916320768085,-58.420577314634855 -34.653522319016929,-58.419706693201114 -34.654150484343148,-58.418991225846426 -34.654666160594189,-58.418276576551875 -34.655229299071841,-58.418078750902765 -34.655423880401969,-58.418840697835769 -34.655678953007659,-58.419113370644268 -34.655770250620101,-58.419711371787947 -34.65598307473357,-58.420372333368135 -34.65624394734342,-58.421464375946087 -34.656669685990053,-58.421905756595784 -34.656333768381721,-58.420702653429977 -34.655090999822391,-58.421584019830931 -34.654453887182278,-58.422407741606186 -34.653858510857695,-58.423235202703729 -34.653260383556422,-58.422242303191808 -34.652320945862527)));;2212;4_1_10;COMUNA 4;1;10;491;243;248;97,98%;201;201;100,00%;0;0,00%;157;31;19,75%;126;80,25%
MULTIPOLYGON (((-58.422407741606186 -34.653858510857695,-58.421584019830931 -34.654453887182278,-58.420702653429977 -34.655090999822391,-58.421905756595784 -34.656333768381721,-58.421464375946087 -34.656669685990053,-58.421495733154075 -34.656681880041972,-58.422001701344115 -34.656896844921967,-58.423052341246454 -34.657321146989183,-58.42321849611443 -34.65740028769256,-58.423467377855914 -34.657179023610908,-58.422827490477665 -34.656833806067837,-58.423545335250601 -34.656326207078379,-58.424256095293806 -34.655823531304826,-58.424376644554293 -34.655735256822695,-58.424521831860901 -34.655629031667139,-58.425204959228239 -34.6551442294925,-58.424623981891656 -34.654587202174305,-58.424502763654289 -34.654465963525119,-58.424385038358281 -34.654348176656249,-58.423235202703729 -34.653260383556422,-58.422407741606186 -34.653858510857695)));;2213;4_1_11;COMUNA 4;1;11;593;275;318;86,48%;206;206;100,00%;0;0,00%;200;4;2,00%;196;98,00%
MULTIPOLYGON (((-58.425204959228239 -34.6551442294925,-58.424521831860901 -34.655629031667139,-58.424376644554293 -34.655735256822695,-58.424256095293806 -34.655823531304826,-58.423545335250601 -34.656326207078379,-58.422827490477665 -34.656833806067837,-58.423467377855914 -34.657179023610908,-58.42321849611443 -34.65740028769256,-58.423364286632442 -34.657469703010534,-58.423506243003843 -34.657537356306946,-58.424346056987893 -34.657937282762717,-58.424480516061479 -34.658002467702033,-58.425224547751995 -34.658392216882412,-58.42538252079737 -34.658480577726046,-58.425452361071962 -34.658394540275047,-58.425704119916453 -34.658213062417012,-58.425334049376552 -34.658048789921914,-58.424967389741241 -34.657695709103372,-58.425800917319485 -34.657107496516005,-58.425966905264367 -34.656990430572797,-58.426634945514586 -34.656516883882276,-58.427334009631288 -34.656021299600098,-58.427465722715588 -34.655927673034888,-58.427358808258752 -34.655825244746538,-58.426750721866796 -34.655241387987594,-58.427484130426727 -34.654721023399389,-58.427596660397398 -34.654640349256596,-58.426989006254502 -34.654058465588079,-58.426879283712609 -34.653953007768251,-58.426035818430712 -34.654554183183663,-58.425917319697795 -34.654638657014623,-58.425204959228239 -34.6551442294925)));;2214;4_1_12;COMUNA 4;1;12;529;251;278;90,29%;214;214;100,00%;0;0,00%;183;4;2,19%;179;97,81%
MULTIPOLYGON (((-58.426779995742379 -34.658691640279422,-58.426878329999568 -34.658577516252393,-58.427137320432472 -34.65838898685417,-58.427280547801267 -34.658284659351736,-58.427828896213448 -34.657895932990961,-58.427969478468398 -34.657794843443646,-58.42866547929173 -34.657294180191094,-58.428794720860587 -34.657201678313228,-58.428070156229438 -34.656507158804239,-58.427465722715588 -34.655927673034888,-58.427334009631288 -34.656021299600098,-58.426634945514586 -34.656516883882276,-58.425966905264367 -34.656990430572797,-58.425800917319485 -34.657107496516005,-58.424967389741241 -34.657695709103372,-58.425334049376552 -34.658048789921914,-58.425704119916453 -34.658213062417012,-58.425452361071962 -34.658394540275047,-58.42538252079737 -34.658480577726046,-58.426362233829678 -34.659028565379607,-58.426440334231032 -34.659072295966489,-58.426781388943631 -34.658692255661244,-58.426779995742379 -34.658691640279422)));;2215;4_1_13;COMUNA 4;1;13;405;190;215;88,37%;168;168;100,00%;0;0,00%;136;11;8,09%;125;91,91%
MULTIPOLYGON (((-58.416800542789161 -34.659142456834651,-58.416806424590227 -34.659295209883162,-58.41682237465421 -34.659427614024075,-58.416908963645774 -34.659434336905655,-58.417006632076287 -34.659441697699236,-58.417110189349195 -34.659434412312145,-58.417187129742345 -34.659473597101346,-58.417247797487583 -34.659501719123888,-58.417348354493619 -34.659526193883714,-58.417463821338046 -34.659560463104157,-58.417573244946475 -34.659580081674399,-58.417626519808998 -34.659567847510651,-58.417685743483233 -34.65958744741183,-58.417733109752405 -34.659626620933587,-58.417827791511527 -34.659641304119788,-58.41789875982856 -34.659692669705905,-58.418024549704604 -34.659708631807412,-58.41812808233518 -34.659747825742201,-58.418202048337101 -34.659772290073583,-58.418296815574365 -34.659786972926497,-58.418329353639962 -34.659823675955671,-58.418347070927254 -34.659843260423166,-58.418391470252523 -34.659853065576726,-58.418424031795922 -34.65984575325357,-58.418601532332509 -34.659906946078905,-58.418714023663092 -34.659928959168234,-58.418817562053029 -34.659958363508018,-58.418947778671246 -34.659985312477232,-58.419029159436263 -34.660011046608197,-58.419144555202983 -34.660020876895793,-58.419265912000263 -34.660040427783613,-58.419416853688801 -34.660040481460605,-58.41950564901267 -34.660067415122363,-58.419606204815736 -34.660096817735287,-58.419700879838842 -34.660126218191365,-58.419845930790359 -34.660145776855451,-58.420062128716737 -34.660215328810629,-58.420078228858117 -34.660220508286713,-58.420240994149083 -34.660266974843182,-58.420457009666222 -34.660350221248571,-58.420607930909206 -34.660391823917607,-58.42075586059353 -34.660450608955927,-58.420888956802806 -34.660516642455015,-58.421094667483857 -34.660586433108534,-58.421239613606595 -34.660647610974152,-58.421281009969178 -34.660698964524776,-58.421387623376063 -34.660718578714352,-58.421494132255461 -34.660777278387854,-58.421615395781728 -34.660816475346728,-58.421751567549762 -34.66087032549401,-58.421866944450095 -34.660921703667931,-58.421973457511008 -34.660973078771818,-58.422078523535092 -34.661020861649419,-58.422149503989246 -34.66105511159595,-58.422182052579437 -34.661074700434447,-58.42223531108592 -34.661096690573025,-58.422256016197849 -34.661108951310005,-58.422300415497872 -34.661121149472294,-58.422386229832135 -34.661148080044448,-58.422469051681844 -34.661194587585925,-58.422543099566802 -34.661231303172826,-58.422622937352443 -34.66128020406007,-58.422708743733665 -34.661324247560586,-58.422767961646869 -34.661360958145067,-58.422818231534997 -34.661395200915763,-58.422886308895897 -34.661441703348231,-58.423121499554362 -34.661540867220253,-58.423213266874519 -34.661597095740497,-58.423310914078236 -34.661655861373539,-58.423509113730539 -34.661758604188989,-58.423677826048916 -34.661856477955126,-58.423760642473155 -34.661917632911624,-58.423834600618399 -34.661966601546972,-58.423911544256157 -34.66201064137104,-58.42393223619797 -34.662052198414905,-58.424011149990648 -34.662087324029592,-58.424124693195161 -34.661944027136144,-58.424612375626381 -34.661334200698526,-58.424697935964574 -34.66122118094772,-58.424941978750454 -34.66091945520369,-58.425028706592421 -34.660812577599188,-58.42571808680583 -34.659963327936673,-58.426441136289668 -34.659072745060918,-58.426440334231032 -34.659072295966489,-58.426362233829678 -34.659028565379607,-58.42538252079737 -34.658480577726046,-58.425224547751995 -34.658392216882412,-58.424480516061479 -34.658002467702033,-58.424346056987893 -34.657937282762717,-58.423506243003843 -34.657537356306946,-58.423364286632442 -34.657469703010534,-58.42321849611443 -34.65740028769256,-58.423052341246454 -34.657321146989183,-58.422001701344115 -34.656896844921967,-58.421495733154075 -34.656681880041972,-58.421464375946087 -34.656669685990053,-58.420372333368135 -34.65624394734342,-58.419711371787947 -34.65598307473357,-58.419113370644268 -34.655770250620101,-58.418840697835769 -34.655678953007659,-58.418078750902765 -34.655423880401969,-58.417597402286013 -34.655892590188749,-58.4167297672644 -34.656737501937201,-58.416709850476757 -34.65715299938703,-58.416706143205523 -34.657229972040085,-58.41677448688786 -34.658480808394614,-58.416800542789161 -34.659142456834651)));;2216;4_1_14;COMUNA 4;1;14;749;352;397;88,66%;221;221;100,00%;0;0,00%;236;26;11,02%;210;88,98%
MULTIPOLYGON (((-58.432967003287978 -34.647874462109733,-58.432624304201006 -34.647515212196787,-58.432305629937439 -34.647181108904078,-58.432070267506248 -34.646934352331058,-58.431964895772509 -34.646823899904476,-58.430828708681574 -34.647715748168636,-58.429705113447795 -34.648597659238398,-58.429464895671266 -34.64878210663769,-58.429854800764573 -34.649132786267337,-58.430210808773843 -34.649440566986605,-58.430589484358855 -34.649757014855581,-58.430816231128055 -34.649590167913843,-58.431961911720485 -34.648675082300052,-58.43284016457055 -34.647973518640399,-58.432967003287978 -34.647874462109733)));;2217;4_1_2;COMUNA 4;1;2;795;393;402;97,76%;241;241;100,00%;0;0,00%;263;37;14,07%;226;85,93%
MULTIPOLYGON (((-58.428251475545224 -34.647955899758529,-58.428067094842547 -34.648089865691979,-58.42781954810998 -34.648269730179386,-58.427056016570148 -34.648824455791207,-58.426036054780951 -34.649565654660123,-58.426667436121072 -34.650169804697057,-58.427010452960452 -34.650548508485215,-58.428070250462277 -34.651567576918168,-58.428202560269419 -34.651660222815885,-58.429004434889499 -34.652429765692467,-58.429569610050237 -34.652024416071761,-58.429687075790127 -34.651941134905726,-58.42968682993218 -34.651940430758621,-58.430095325439773 -34.651647433345353,-58.431266154968327 -34.650809285427712,-58.430931960743877 -34.650495652751232,-58.430983059440102 -34.650341290359705,-58.430846751902024 -34.650226180950597,-58.430429908696411 -34.649874300207941,-58.430517283241144 -34.649810096012821,-58.430589484358855 -34.649757014855581,-58.430210808773843 -34.649440566986605,-58.429854800764573 -34.649132786267337,-58.429464895671266 -34.64878210663769,-58.429705113447795 -34.648597659238398,-58.430828708681574 -34.647715748168636,-58.430487525728608 -34.647427973694846,-58.430404381362742 -34.647357879142959,-58.430172753512494 -34.647162529926774,-58.429971624071676 -34.646992893465111,-58.429797499779312 -34.64684650410431,-58.428616910728174 -34.647690360555387,-58.428426905188687 -34.647828410098199,-58.428251475545224 -34.647955899758529)));;2218;4_1_3;COMUNA 4;1;3;635;304;331;91,84%;183;183;100,00%;0;0,00%;215;24;11,16%;191;88,84%
MULTIPOLYGON (((-58.430095325439773 -34.651647433345353,-58.42968682993218 -34.651940430758621,-58.429687075790127 -34.651941134905726,-58.429569610050237 -34.652024416071761,-58.429004434889499 -34.652429765692467,-58.429718578310812 -34.653115192512224,-58.429627875550771 -34.653180521990201,-58.429627830099228 -34.653180516875082,-58.42962434448237 -34.653183061610541,-58.429508182812818 -34.653266807986249,-58.429506692591886 -34.653267871758672,-58.429570887827673 -34.653328820762063,-58.429480953269866 -34.653390276983295,-58.429756454574587 -34.65366676833257,-58.430025289362604 -34.653996568689365,-58.430070942175284 -34.654065385755558,-58.430118128178819 -34.654136527225603,-58.430248683110911 -34.654374808478522,-58.430958445587606 -34.65566841343697,-58.431288272677932 -34.65542757632884,-58.431388787826165 -34.655334641720081,-58.431992596945562 -34.654896543020783,-58.431107147379635 -34.654363343440622,-58.431075366163668 -34.654344179709888,-58.432234623105963 -34.653529380436538,-58.431884185049185 -34.65330210256986,-58.431770019888717 -34.653212352703065,-58.431552268140805 -34.65300546017076,-58.432990679599328 -34.651974802594076,-58.432030771937733 -34.651209471698095,-58.431797850395832 -34.651016449375888,-58.430983059440102 -34.650341290359705,-58.430931960743877 -34.650495652751232,-58.431266154968327 -34.650809285427712,-58.430095325439773 -34.651647433345353)));;2219;4_1_4;COMUNA 4;1;4;801;399;402;99,25%;196;196;100,00%;0;0,00%;236;29;12,29%;207;87,71%
MULTIPOLYGON (((-58.433678142924109 -34.652514702505371,-58.432990679599328 -34.651974802594076,-58.431552268140805 -34.65300546017076,-58.431770019888717 -34.653212352703065,-58.431884185049185 -34.65330210256986,-58.432234623105963 -34.653529380436538,-58.433082729650025 -34.654100451276065,-58.434433517654433 -34.653113066690914,-58.433678142924109 -34.652514702505371)));;2220;4_1_5;COMUNA 4;1;5;824;408;416;98,08%;170;170;100,00%;0;0,00%;234;13;5,56%;221;94,44%
MULTIPOLYGON (((-58.433082729650025 -34.654100451276065,-58.432234623105963 -34.653529380436538,-58.431075366163668 -34.654344179709888,-58.431107147379635 -34.654363343440622,-58.431992596945562 -34.654896543020783,-58.432117739710115 -34.654805726740179,-58.433082729650025 -34.654100451276065)));;2221;4_1_6;COMUNA 4;1;6;725;354;371;95,42%;126;126;100,00%;0;0,00%;206;50;24,27%;156;75,73%
MULTIPOLYGON (((-58.430248683110911 -34.654374808478522,-58.430118128178819 -34.654136527225603,-58.430070942175284 -34.654065385755558,-58.430025289362604 -34.653996568689365,-58.429756454574587 -34.65366676833257,-58.429480953269866 -34.653390276983295,-58.429570887827673 -34.653328820762063,-58.429506692591886 -34.653267871758672,-58.428827741360422 -34.653757079934394,-58.428676170052476 -34.653865773332654,-58.427596660397398 -34.654640349256596,-58.427484130426727 -34.654721023399389,-58.426750721866796 -34.655241387987594,-58.427358808258752 -34.655825244746538,-58.427465722715588 -34.655927673034888,-58.428070156229438 -34.656507158804239,-58.428794720860587 -34.657201678313228,-58.428905888833398 -34.657122129410091,-58.429483806809237 -34.656705093040124,-58.429633509778313 -34.656590059971201,-58.429784917327019 -34.6564738299585,-58.430958445587606 -34.65566841343697,-58.430248683110911 -34.654374808478522)));;2222;4_1_7;COMUNA 4;1;7;518;233;285;81,75%;162;162;100,00%;0;0,00%;168;12;7,14%;156;92,86%
MULTIPOLYGON (((-58.427010452960452 -34.650548508485215,-58.426667436121072 -34.650169804697057,-58.426036054780951 -34.649565654660123,-58.425951405229434 -34.649627180330185,-58.425823620868115 -34.64971996145146,-58.425692085326538 -34.649815558285148,-58.42529329743477 -34.650110586326974,-58.424984017502076 -34.650339371172748,-58.424812582920659 -34.65046622324359,-58.423909119218806 -34.651118141807842,-58.424900657662427 -34.65206200244625,-58.425964286476045 -34.653074540625425,-58.426164475396938 -34.653266014878334,-58.426879283712609 -34.653953007768251,-58.426989006254502 -34.654058465588079,-58.427596660397398 -34.654640349256596,-58.428676170052476 -34.653865773332654,-58.428827741360422 -34.653757079934394,-58.429506692591886 -34.653267871758672,-58.429508182812818 -34.653266807986249,-58.42962434448237 -34.653183061610541,-58.429627830099228 -34.653180516875082,-58.429627875550771 -34.653180521990201,-58.429718578310812 -34.653115192512224,-58.429004434889499 -34.652429765692467,-58.428202560269419 -34.651660222815885,-58.428070250462277 -34.651567576918168,-58.427010452960452 -34.650548508485215)));;2223;4_1_8;COMUNA 4;1;8;685;337;348;96,84%;252;252;100,00%;0;0,00%;225;13;5,78%;212;94,22%
MULTIPOLYGON (((-58.424502763654289 -34.654465963525119,-58.424623981891656 -34.654587202174305,-58.425204959228239 -34.6551442294925,-58.425917319697795 -34.654638657014623,-58.426035818430712 -34.654554183183663,-58.426879283712609 -34.653953007768251,-58.426164475396938 -34.653266014878334,-58.425964286476045 -34.653074540625425,-58.424900657662427 -34.65206200244625,-58.423909119218806 -34.651118141807842,-58.423787553768236 -34.651205852175458,-58.423462326548481 -34.651440543697106,-58.423068044691306 -34.651725072557163,-58.422729258519674 -34.651969546718021,-58.422242303191808 -34.652320945862527,-58.423235202703729 -34.653260383556422,-58.424385038358281 -34.654348176656249,-58.424502763654289 -34.654465963525119)));;2224;4_1_9;COMUNA 4;1;9;650;316;334;94,61%;220;220;100,00%;0;0,00%;224;5;2,23%;219;97,77%
MULTIPOLYGON (((-58.389401565365382 -34.646232211915724,-58.389354017727122 -34.646828744718107,-58.389238894332188 -34.648274634106059,-58.389543191416649 -34.648291649082175,-58.39014812276433 -34.6483251089793,-58.391660066258851 -34.648408608921862,-58.392461161504286 -34.648452875462183,-58.39250427874871 -34.647875021936279,-58.392535374423709 -34.64741977352449,-58.392551809744468 -34.647326726132377,-58.391974793675708 -34.647082484149472,-58.391649119267747 -34.646950657915056,-58.391608045018756 -34.64693586295158,-58.391711797727979 -34.64660941643843,-58.392523168575096 -34.646961368462236,-58.392523212344322 -34.64690942258725,-58.392573481703586 -34.646930229535393,-58.395608425683932 -34.648199420420752,-58.395665119362697 -34.648048808844756,-58.395797043897559 -34.648142383788816,-58.39578442775084 -34.648199517126457,-58.396067143914095 -34.648376288181396,-58.396067094039758 -34.648438624431357,-58.397367793963646 -34.649015929546259,-58.398713397484812 -34.649613417123668,-58.398739323042875 -34.649566152128315,-58.39884870968185 -34.649610224858527,-58.398992513217216 -34.649672203336117,-58.399177951956361 -34.649669413765324,-58.399221160423735 -34.649667112252402,-58.399962802540543 -34.647427287644227,-58.399967674379702 -34.647409824281496,-58.400036166031221 -34.647325701461341,-58.40011472096289 -34.647233768278191,-58.400436172067167 -34.647097942230126,-58.400618100714674 -34.646996623448629,-58.401206893948853 -34.646948963670226,-58.401304218011184 -34.646941125144124,-58.401363958306675 -34.646936083529255,-58.401502506409116 -34.646952633061602,-58.401524478388247 -34.646858141318717,-58.40154114818224 -34.646786449652758,-58.401399621972558 -34.646767830492209,-58.401302764845056 -34.646757563034392,-58.401135910479418 -34.646736859337089,-58.401083420985117 -34.646731121275202,-58.400847206400641 -34.646637571799474,-58.400689820419473 -34.646576078796301,-58.400634341720938 -34.646543705286177,-58.400436173215617 -34.646425827786082,-58.400446646064751 -34.646406270475929,-58.400332104468418 -34.646357894563621,-58.400352398000912 -34.646309566646998,-58.40049244503841 -34.645918427374824,-58.400379801176108 -34.645902454431848,-58.397276533434407 -34.644583745837636,-58.39350732358124 -34.642981828981831,-58.391400197095791 -34.642086220701287,-58.391471232004271 -34.640826504509803,-58.390244024179054 -34.640353230434464,-58.389881501736518 -34.64020547466658,-58.389860135557456 -34.640471879834479,-58.389847557732949 -34.640629553329887,-58.389757062502724 -34.641801648045892,-58.389673345688799 -34.642818108446455,-58.389664987692655 -34.642923529797308,-58.389573539542511 -34.644104497424927,-58.38946594890681 -34.645422923507297,-58.389461899233567 -34.645473626852123,-58.389461498012501 -34.645478676281506,-58.389412180341736 -34.646098687046845,-58.38940287601816 -34.646215797700691,-58.389401565365382 -34.646232211915724)));;2225;4_10_1;COMUNA 4;10;1;73;29;44;65,91%;11;11;100,00%;0;0,00%;23;1;4,35%;22;95,65%
MULTIPOLYGON (((-58.397765419043651 -34.651363966171878,-58.397507131227037 -34.65143725498757,-58.397362742447697 -34.651439472289454,-58.396640816642552 -34.651427610422104,-58.396633306297744 -34.651427883909768,-58.396541324300799 -34.651431233377565,-58.395425718824917 -34.651511470468087,-58.395418538120531 -34.651644357768731,-58.395380639390645 -34.652035545612257,-58.395321490298358 -34.652779478552311,-58.395282917737411 -34.653264894038955,-58.395424638367565 -34.653270747129291,-58.39560905041683 -34.653283032190522,-58.395699995716605 -34.653267307084654,-58.395784875176069 -34.653270241102113,-58.395987013879221 -34.653282183195294,-58.396044107385052 -34.65328932730332,-58.396096077793352 -34.653308652042689,-58.396183063011271 -34.653342714607511,-58.396213431438078 -34.653306251225665,-58.396269704103894 -34.65327409785202,-58.396329442956137 -34.653276947366805,-58.396360449188784 -34.6535095062751,-58.396367734151298 -34.653565004823243,-58.396375464100139 -34.653703815912877,-58.396716594107119 -34.653726888980479,-58.396779822319417 -34.653736219225806,-58.396806766145254 -34.653611723098187,-58.396838975160556 -34.653510681198135,-58.396895904640239 -34.65318647706318,-58.396922297730782 -34.653003528178147,-58.396916742820707 -34.652915212724068,-58.396956139994394 -34.652884247144371,-58.397581624670664 -34.652944514118261,-58.397624112605634 -34.652556990172201,-58.397674230890466 -34.65211052485121,-58.397765419043651 -34.651363966171878)));;2226;4_10_6;COMUNA 4;10;6;1004;479;525;91,24%;277;277;100,00%;0;0,00%;306;29;9,48%;277;90,52%
MULTIPOLYGON (((-58.395210764970344 -34.654173120159832,-58.395208957065122 -34.654195584604061,-58.395200519342708 -34.654301428094406,-58.395151039492582 -34.654888389629697,-58.395239584717253 -34.654891959878888,-58.395571696163906 -34.654901791336101,-58.395576002238521 -34.654951865585709,-58.395672052455595 -34.654949031015008,-58.395830990460176 -34.654955949465233,-58.395989412292529 -34.654968923940068,-58.396110183564865 -34.654958637540872,-58.396151185508536 -34.654947391992273,-58.396318037909708 -34.654968751166564,-58.396320534173682 -34.655044599801649,-58.396595024087247 -34.655067636911269,-58.396602771891899 -34.654969891789889,-58.396655012614666 -34.654972244108272,-58.396664331799848 -34.654827315360428,-58.396695652021819 -34.654343163273985,-58.39670186460863 -34.654246684946209,-58.396705313856366 -34.654195840257302,-58.396712528843288 -34.654124926596673,-58.396736773363521 -34.653965568857153,-58.396761960153619 -34.653800014253562,-58.396779822319417 -34.653736219225806,-58.396716594107119 -34.653726888980479,-58.396375464100139 -34.653703815912877,-58.396367734151298 -34.653565004823243,-58.396360449188784 -34.6535095062751,-58.396329442956137 -34.653276947366805,-58.396269704103894 -34.65327409785202,-58.396213431438078 -34.653306251225665,-58.396183063011271 -34.653342714607511,-58.396096077793352 -34.653308652042689,-58.396044107385052 -34.65328932730332,-58.395987013879221 -34.653282183195294,-58.395784875176069 -34.653270241102113,-58.395699995716605 -34.653267307084654,-58.39560905041683 -34.653283032190522,-58.395424638367565 -34.653270747129291,-58.395282917737411 -34.653264894038955,-58.395210764970344 -34.654173120159832)));;2227;4_24_1;COMUNA 4;24;1;1396;684;712;96,07%;375;375;100,00%;0;0,00%;415;92;22,17%;323;77,83%
MULTIPOLYGON (((-58.398651023102282 -34.652575703440043,-58.398364714182918 -34.652527804830271,-58.398339574261392 -34.652527087317559,-58.398250424395805 -34.652537040525559,-58.398195006848148 -34.65256708253191,-58.3981698353167 -34.652607140817913,-58.398141184990685 -34.652737340758598,-58.398106404089333 -34.652860424556827,-58.398090855333223 -34.652909783969889,-58.398040012764667 -34.653083987498604,-58.398030953912141 -34.653116518862625,-58.398010130455567 -34.653154044132016,-58.397637837520762 -34.652987925682943,-58.397581624670664 -34.652944514118261,-58.396956139994394 -34.652884247144371,-58.396916742820707 -34.652915212724068,-58.396922297730782 -34.653003528178147,-58.396895904640239 -34.65318647706318,-58.396838975160556 -34.653510681198135,-58.396806766145254 -34.653611723098187,-58.396779822319417 -34.653736219225806,-58.396761960153619 -34.653800014253562,-58.396736773363521 -34.653965568857153,-58.396712528843288 -34.654124926596673,-58.396705313856366 -34.654195840257302,-58.39670186460863 -34.654246684946209,-58.396695652021819 -34.654343163273985,-58.396664331799848 -34.654827315360428,-58.397040236780448 -34.65485195569007,-58.397470243594498 -34.654896835671067,-58.397557451924925 -34.65464856520056,-58.397697709056054 -34.654676457763308,-58.39779587763109 -34.654688834359469,-58.39790997706713 -34.654709036471729,-58.397958638852039 -34.654710611659432,-58.397966943756927 -34.65466153013098,-58.397984973061128 -34.654601044979678,-58.398016206694003 -34.654547468440185,-58.39805468278972 -34.654495867620618,-58.398076372029209 -34.654441300060014,-58.398082878501995 -34.654403344653694,-58.398175891478836 -34.654139865082989,-58.39831974241276 -34.653707393246023,-58.398446109188995 -34.653290475833387,-58.398651023102282 -34.652575703440043)));;2228;4_24_2;COMUNA 4;24;2;1852;949;903;105,09%;537;537;100,00%;0;0,00%;538;92;17,10%;446;82,90%
MULTIPOLYGON (((-58.396595024087247 -34.655067636911269,-58.396320534173682 -34.655044599801649,-58.396318037909708 -34.654968751166564,-58.396151185508536 -34.654947391992273,-58.396110183564865 -34.654958637540872,-58.395989412292529 -34.654968923940068,-58.395830990460176 -34.654955949465233,-58.395672052455595 -34.654949031015008,-58.395576002238521 -34.654951865585709,-58.395571696163906 -34.654901791336101,-58.395239584717253 -34.654891959878888,-58.395151039492582 -34.654888389629697,-58.395062317920484 -34.655941187886512,-58.395160666668268 -34.655942932591991,-58.395564020980004 -34.655964916538444,-58.396120690074191 -34.655994518391331,-58.396152227266796 -34.655989817161327,-58.396175760296963 -34.655976308485009,-58.396302485309405 -34.65598292704329,-58.396322927346446 -34.655998079456111,-58.396344568833889 -34.656005344966175,-58.396453226382434 -34.656011601411322,-58.396548431022147 -34.65600186408404,-58.39677264111311 -34.656024873503604,-58.3968199370834 -34.656030180909653,-58.396912739362058 -34.656040724276565,-58.397001358500574 -34.656060279664125,-58.397080100786177 -34.656068068768839,-58.397379430755826 -34.6561540770428,-58.397447930359242 -34.656181931424925,-58.397498636260813 -34.656186254448457,-58.397515744193754 -34.656106050009484,-58.397572720930441 -34.655938258700253,-58.397663524030619 -34.655671398028687,-58.397816144306482 -34.655585138806472,-58.39787807458174 -34.655402631238353,-58.39794187257138 -34.655229068546959,-58.397806227371831 -34.655187305078975,-58.397822460276828 -34.655135692498384,-58.397850154936386 -34.655030563328225,-58.397839346130219 -34.655011683790697,-58.397840557815186 -34.654987880925802,-58.397865832121703 -34.654926413704814,-58.397913353826226 -34.654859958154987,-58.397958638852039 -34.654710611659432,-58.39790997706713 -34.654709036471729,-58.39779587763109 -34.654688834359469,-58.397697709056054 -34.654676457763308,-58.397557451924925 -34.65464856520056,-58.397470243594498 -34.654896835671067,-58.397040236780448 -34.65485195569007,-58.396664331799848 -34.654827315360428,-58.396655012614666 -34.654972244108272,-58.396602771891899 -34.654969891789889,-58.396595024087247 -34.655067636911269)));;2229;4_24_3;COMUNA 4;24;3;1220;598;622;96,14%;329;329;100,00%;0;0,00%;373;45;12,06%;328;87,94%
MULTIPOLYGON (((-58.395366417527356 -34.661167562317964,-58.395321183902688 -34.660769158405024,-58.395236304097345 -34.660780799308775,-58.395255571361929 -34.660278232825888,-58.395401783318015 -34.660219874411524,-58.395405483141246 -34.660218717147437,-58.395396284389228 -34.660197761901493,-58.395386340011925 -34.660163741367178,-58.395378297151105 -34.659991619389615,-58.395365790496037 -34.65985893267667,-58.395351677913204 -34.659709695308379,-58.395343542358745 -34.6595469397271,-58.395343626291918 -34.659443204439562,-58.395347596908771 -34.659381303469537,-58.395350168248356 -34.659363417058735,-58.395359751484605 -34.659316942160373,-58.395398382251571 -34.659184213244004,-58.395455626816428 -34.659114806237078,-58.39554006289724 -34.659040836588218,-58.395586047260011 -34.658983606760337,-58.395654156720198 -34.658863077423163,-58.395714845626429 -34.658749375149284,-58.395768211425604 -34.658627358727365,-58.395814569924163 -34.658528296836643,-58.395901745366636 -34.658331930575073,-58.395991561269462 -34.658137044604743,-58.396099566312152 -34.657897026362221,-58.396150514288983 -34.657919590036286,-58.396502403130576 -34.658046123231387,-58.396562941408092 -34.658119820160685,-58.396828722060469 -34.658176021975883,-58.39683572605356 -34.658156659009123,-58.396859094811788 -34.658135966813475,-58.396899387056138 -34.658054014390721,-58.396924606029565 -34.657956771695886,-58.396945397583686 -34.657961783053224,-58.396964043568659 -34.657877706194746,-58.397015754882986 -34.657689207538688,-58.397032250615588 -34.657629778101231,-58.397056479333109 -34.657599086042381,-58.397083826161861 -34.657505013557689,-58.39713893650616 -34.657328629690426,-58.397087049739703 -34.657307826535977,-58.397094408824294 -34.657270294206803,-58.397123563844403 -34.657152630453751,-58.39716741211339 -34.656991311361807,-58.397212119233359 -34.65682140091436,-58.39726467881983 -34.656636423803164,-58.397319797162204 -34.656448631052868,-58.397379024434493 -34.656237459516021,-58.397379430755826 -34.6561540770428,-58.39708010078617 -34.656068068768839,-58.397001358500574 -34.656060279664125,-58.396912739362058 -34.656040724276565,-58.3968199370834 -34.656030180909653,-58.396772641113124 -34.656024873503604,-58.39654843102214 -34.656001864084018,-58.396453226382405 -34.656011601411294,-58.396344568833889 -34.656005344966168,-58.396322927346418 -34.65599807945609,-58.396302485309405 -34.65598292704329,-58.396175760296963 -34.655976308484995,-58.396152227266782 -34.655989817161327,-58.396120690074191 -34.655994518391331,-58.395564020979982 -34.655964916538437,-58.395160666668268 -34.655942932591991,-58.395062317920484 -34.655941187886512,-58.395018555404363 -34.656516884449815,-58.394961444121442 -34.657262226286313,-58.394952314037802 -34.65738025276918,-58.394875033895538 -34.658401013645559,-58.394857017864489 -34.65854600775527,-58.394765992118394 -34.659279710326793,-58.394724976217084 -34.659827097337562,-58.394706708105716 -34.660071319405127,-58.39462542255572 -34.660876296726627,-58.394614064631511 -34.661111930805497,-58.395167762494467 -34.661168930480478,-58.395366417527356 -34.661167562317964)));;2230;4_24_4;COMUNA 4;24;4;1929;974;955;101,99%;483;483;100,00%;0;0,00%;534;84;15,73%;450;84,27%
MULTIPOLYGON (((-58.397498636260799 -34.656186254448443,-58.397447930359242 -34.656181931424925,-58.397379430755826 -34.6561540770428,-58.397379024434493 -34.656237459516021,-58.397319797162204 -34.656448631052868,-58.39726467881983 -34.656636423803164,-58.397212119233359 -34.65682140091436,-58.39716741211339 -34.656991311361807,-58.397123563844403 -34.657152630453751,-58.397094408824294 -34.657270294206803,-58.397087049739703 -34.657307826535977,-58.39713893650616 -34.657328629690426,-58.397083826161861 -34.657505013557689,-58.397056479333109 -34.657599086042381,-58.397032250615588 -34.657629778101231,-58.397015754882986 -34.657689207538688,-58.396964043568659 -34.657877706194746,-58.396945397583686 -34.657961783053224,-58.396924606029565 -34.657956771695886,-58.396899387056138 -34.658054014390721,-58.396859094811788 -34.658135966813475,-58.39683572605356 -34.658156659009123,-58.396828722060469 -34.658176021975883,-58.396804459645217 -34.658248968695958,-58.396779691173592 -34.658315154380347,-58.396753649655167 -34.658374508189631,-58.396692208826614 -34.658363770412507,-58.396640655406344 -34.658459238174125,-58.396619783698519 -34.65855507466722,-58.396631390922259 -34.658642055266469,-58.396692255759191 -34.658971999175165,-58.396946212577468 -34.658884935305061,-58.397120923317622 -34.658828706501446,-58.397253051697028 -34.658747813329541,-58.397491686184544 -34.658663456838951,-58.397798493403648 -34.658565055461729,-58.398049888084849 -34.658505345936121,-58.398325351300713 -34.658383802126032,-58.398420932532098 -34.658352268780554,-58.39851653195354 -34.658297047540238,-58.398731549800011 -34.65827742067848,-58.398836619796647 -34.658332747358628,-58.398941656673621 -34.65843150161691,-58.399018056895088 -34.658490761115708,-58.399235807456691 -34.657395374819984,-58.399446649136586 -34.656398624691874,-58.399276537632915 -34.656399381420975,-58.399152195005776 -34.656396781395685,-58.399100368902189 -34.656408233578865,-58.398589282034301 -34.656391345726732,-58.398346770897 -34.656337272755806,-58.398091815146877 -34.656285727993335,-58.397989213343841 -34.656272785888298,-58.397544052554892 -34.656197757930599,-58.397498636260799 -34.656186254448443)));;2231;4_24_5;COMUNA 4;24;5;1350;654;696;93,97%;207;207;100,00%;0;0,00%;406;77;18,97%;329;81,03%
MULTIPOLYGON (((-58.402418333942251 -34.652122821881427,-58.402469393744909 -34.652339894685859,-58.402688771142948 -34.652436063676099,-58.402510891363697 -34.652702883641695,-58.402391643751578 -34.652851633577718,-58.402201166964446 -34.653416645496229,-58.40211069832975 -34.653508837035801,-58.402105877770559 -34.653690177991301,-58.402062722306582 -34.653736707199549,-58.401955752545447 -34.653756795393633,-58.401896544565929 -34.653959870428046,-58.401883354528856 -34.654049725636511,-58.401731989374376 -34.654410998643677,-58.401594948762323 -34.654410014526093,-58.401033899603014 -34.656164430970058,-58.402745441095234 -34.655872952144975,-58.403239165300526 -34.654421884064611,-58.403580537459995 -34.653270537418258,-58.403833666400523 -34.652401972293895,-58.403928027605858 -34.652131235152503,-58.403999075534884 -34.651927530946033,-58.404166935670986 -34.651479429323217,-58.404317612657643 -34.651105546772435,-58.4044265180883 -34.650871084835707,-58.404663802430633 -34.650459565993764,-58.404141667822195 -34.650570305604404,-58.403480268666428 -34.650700130924442,-58.403433220629729 -34.650709333694195,-58.403230453578999 -34.650749165743619,-58.403369168946298 -34.651140301305247,-58.403518098239957 -34.651311153405516,-58.403323550327386 -34.651415287279598,-58.403292587850174 -34.651453583196606,-58.403265122516395 -34.651487514483179,-58.403115506448557 -34.651681250037605,-58.4030124902024 -34.651777751816162,-58.402960221390082 -34.651817093584668,-58.402861917017468 -34.651878737353947,-58.402770006125998 -34.651937567200783,-58.402585537973827 -34.65200564743315,-58.402522286856154 -34.652028926784141,-58.402418333942251 -34.652122821881427)));;2232;4_25_3;COMUNA 4;25;3;3945;2012;1933;104,09%;841;841;100,00%;0;0,00%;1093;244;22,32%;849;77,68%
MULTIPOLYGON (((-58.395901744701227 -34.658331930024502,-58.395814568593352 -34.658528295735529,-58.395768210094815 -34.658627357626258,-58.395714844294744 -34.658749375148545,-58.395654156054341 -34.658863077422801,-58.395586046594168 -34.658983606759982,-58.395540061566436 -34.65904083548709,-58.395455627482711 -34.659114805687253,-58.395398382917428 -34.65918421324438,-58.395359750152437 -34.659316942709857,-58.395350166916671 -34.659363417058003,-58.3953475955771 -34.659381303468813,-58.395343626957761 -34.659443204439931,-58.395343543024602 -34.65954693972747,-58.395351677913659 -34.659709694758199,-58.395365789829725 -34.659858933226495,-58.395378295820286 -34.659991618288501,-58.39538633868063 -34.660163740816259,-58.395396284390102 -34.660197760801125,-58.395405481591247 -34.660218715522582,-58.395401782479084 -34.660219874385135,-58.395255570709807 -34.660278231642614,-58.395236303639962 -34.660780799509773,-58.395321184562022 -34.660769158177793,-58.395366415947471 -34.661167560885261,-58.395167762495369 -34.661168929380089,-58.394614065297823 -34.661111930255693,-58.394608689424906 -34.661223058232451,-58.394554904005325 -34.66185353769189,-58.394515932941161 -34.662300992630307,-58.394606447562374 -34.662291693813927,-58.394776157789124 -34.662279324993158,-58.395062824652967 -34.662201586061364,-58.395168442829373 -34.662170485618077,-58.3952892047067 -34.662061493505568,-58.39543637866656 -34.661936937175213,-58.395689096264803 -34.661871641517848,-58.395873899455772 -34.661846814324811,-58.396119038567534 -34.661825137750164,-58.396273612596204 -34.661875076560186,-58.396465948021252 -34.661862718260636,-58.396654476146622 -34.661897094707264,-58.396982559053967 -34.661900388822303,-58.397280504531807 -34.661863158042884,-58.397653947722681 -34.661729370273711,-58.397691825836084 -34.661514389406314,-58.397758583816859 -34.661185464016491,-58.397919990526667 -34.661164494042701,-58.399075441242857 -34.660856283502767,-58.39916857281797 -34.660820635838434,-58.399122064381537 -34.660719938361247,-58.399125695351799 -34.660657759726782,-58.399140090312308 -34.660577820837958,-58.399150894991031 -34.660506763007959,-58.399140201091576 -34.660432732993158,-58.399143834296069 -34.66036759337873,-58.399276616590342 -34.660113018436718,-58.399330469863031 -34.659979802435871,-58.399391525881363 -34.659799214501277,-58.399492039886098 -34.659565349387407,-58.399518972509192 -34.659379120947072,-58.399571120150938 -34.659242643739674,-58.399553283913122 -34.65913603928648,-58.399552753683338 -34.659047703159274,-58.399438249557249 -34.658830505389105,-58.399295030785282 -34.65867646011683,-58.39914222670177 -34.658561889390612,-58.399018056895088 -34.658490761115708,-58.398941656673621 -34.65843150161691,-58.398836619796647 -34.658332747358628,-58.398731549800011 -34.65827742067848,-58.39851653195354 -34.658297047540238,-58.398420932532098 -34.658352268780554,-58.398325351300713 -34.658383802126032,-58.398049888084849 -34.658505345936121,-58.397798493403648 -34.658565055461729,-58.397491686184544 -34.658663456838951,-58.397253051697028 -34.658747813329541,-58.397120923317622 -34.658828706501446,-58.396946212577468 -34.658884935305061,-58.396692255759191 -34.658971999175165,-58.396631389590993 -34.658642054715557,-58.396619783698519 -34.65855507466722,-58.396640654740501 -34.658459238173755,-58.396692208827048 -34.658363769862298,-58.396753648988863 -34.658374508739456,-58.396779690507749 -34.658315154379984,-58.396804458979815 -34.658248968145408,-58.39682872206135 -34.658176020875501,-58.396562940741816 -34.658119820710496,-58.396502403796866 -34.658046122681569,-58.396150512957732 -34.657919589485374,-58.396099565646743 -34.65789702581165,-58.395991560604052 -34.658137044054186,-58.395901744701227 -34.658331930024502)));;2233;4_24_6;COMUNA 4;24;6;1417;691;726;95,18%;347;347;100,00%;0;0,00%;377;44;11,67%;333;88,33%
MULTIPOLYGON (((-58.391608045291321 -34.64693586400908,-58.391649117270475 -34.646950657913912,-58.391974793675693 -34.647082484149465,-58.392551809744468 -34.64732672613237,-58.392535374423709 -34.647419773524476,-58.39250427874871 -34.647875021936272,-58.392461161504258 -34.648452875462183,-58.393460039070263 -34.64850809679902,-58.394059262960994 -34.64854118303122,-58.395584170212764 -34.648625414639284,-58.395522004848267 -34.648569533105672,-58.395531066025256 -34.648536368633607,-58.395575134254017 -34.648416671530143,-58.395572704392016 -34.648415628127729,-58.395748104383678 -34.648107671682546,-58.395665119362697 -34.648048808844749,-58.395608425683918 -34.648199420420767,-58.392573481703572 -34.646930229535393,-58.392523212344322 -34.64690942258725,-58.392523168575096 -34.646961368462222,-58.391711798020701 -34.646609417482374,-58.391608045291321 -34.64693586400908)));;2234;4_10_2;COMUNA 4;10;2;1935;927;1008;91,96%;551;551;100,00%;0;0,00%;661;218;32,98%;443;67,02%
MULTIPOLYGON (((-58.395642278259643 -34.648636925826054,-58.395545154675894 -34.65003190488541,-58.396533584783555 -34.65009439909587,-58.396616740195192 -34.65004088074717,-58.396887057097636 -34.650038843774858,-58.396968634702134 -34.649795076563251,-58.397090898005899 -34.649826622222051,-58.397136395164246 -34.649840873020757,-58.397240006392124 -34.649860365885985,-58.397288487697246 -34.649869406256002,-58.39741194784748 -34.64989982544035,-58.397487186108407 -34.649912190012316,-58.397565320358709 -34.649926458100296,-58.397630165950211 -34.649936210220233,-58.397735483714079 -34.649952394717126,-58.397793508776076 -34.649965171926162,-58.397882110586181 -34.649998953008087,-58.397925131321074 -34.650016582578672,-58.397939174138216 -34.650042787453785,-58.398056733186912 -34.650098273472665,-58.398135531240044 -34.650136907922331,-58.398262641580935 -34.650184934887314,-58.398352349983277 -34.650220898824969,-58.398405179286073 -34.650228039029535,-58.398483572122437 -34.650240826647192,-58.398552424535815 -34.65024649685769,-58.398579866966735 -34.650246865064517,-58.398627405089613 -34.650263016744248,-58.398723026671718 -34.650258911345936,-58.398831068520764 -34.650279743801256,-58.398936544658739 -34.649978662135624,-58.398639645232414 -34.649750894076796,-58.398709624590794 -34.64962029310098,-58.398713397484812 -34.649613417123668,-58.397367793963646 -34.649015929546259,-58.396067094039758 -34.648438624431357,-58.396067143914095 -34.648376288181396,-58.39578442775084 -34.648199517126457,-58.395797043897559 -34.648142383788816,-58.395748104383678 -34.648107671682553,-58.395572704392045 -34.648415628127729,-58.395575134254017 -34.648416671530171,-58.395531066025292 -34.648536368633607,-58.395522004848267 -34.648569533105672,-58.395584170212764 -34.648625414639284,-58.395642278259643 -34.648636925826054)));;2235;4_10_3;COMUNA 4;10;3;1653;812;841;96,55%;491;491;100,00%;0;0,00%;507;114;22,49%;393;77,51%
MULTIPOLYGON (((-58.396640816642545 -34.651427610422097,-58.396644085085391 -34.651283626886986,-58.396699985913273 -34.650759633067231,-58.396644604674989 -34.650628597050527,-58.397302499052728 -34.650628951656842,-58.397361218852573 -34.650664755671869,-58.397577954193054 -34.650445705715534,-58.397965281735573 -34.650441263924343,-58.398784584351198 -34.650442189085759,-58.398831068520749 -34.650279743801249,-58.398723026005506 -34.65025891189579,-58.398627406421156 -34.650263016744951,-58.398579866301375 -34.65024686451396,-58.398552425866519 -34.650246497958776,-58.398483572787363 -34.650240827747936,-58.398405180617196 -34.650228039580433,-58.398352349983277 -34.650220898824969,-58.398262641580921 -34.650184934887314,-58.39813553123961 -34.65013690847254,-58.398056733186458 -34.650098274022852,-58.397939173472416 -34.65004278745343,-58.397925132653072 -34.650016582029195,-58.39788211058616 -34.649998953008087,-58.397793508775628 -34.649965172476364,-58.397735484379844 -34.649952394717488,-58.397630165949344 -34.649936211320622,-58.397565321690237 -34.649926458101,-58.397487186773752 -34.649912190562873,-58.397411947847033 -34.649899825990538,-58.397288489028341 -34.649869406806886,-58.397240006391677 -34.649860366436187,-58.397136395163812 -34.649840873570945,-58.397090899336582 -34.649826623323158,-58.396968634701267 -34.649795077663647,-58.396887057763415 -34.650038843775206,-58.396616740195185 -34.65004088074717,-58.396533585693192 -34.650094399886022,-58.395545156151954 -34.650031905819553,-58.395464427654353 -34.650960771239468,-58.395436445151212 -34.651314709985016,-58.395425718824917 -34.651511470468087,-58.396541324300813 -34.651431233377558,-58.396633306297744 -34.651427883909747,-58.396640816642545 -34.651427610422097)));;2236;4_10_4;COMUNA 4;10;4;464;229;235;97,45%;117;117;100,00%;0;0,00%;124;32;25,81%;92;74,19%
MULTIPOLYGON (((-58.399177951956361 -34.649669413765324,-58.398992513217216 -34.649672203336117,-58.39884870968185 -34.649610224858527,-58.398739323042875 -34.649566152128315,-58.398709624590794 -34.64962029310098,-58.398639645232414 -34.649750894076796,-58.398936544658739 -34.649978662135624,-58.398831068520764 -34.650279743801256,-58.398784584351198 -34.650442189085759,-58.397965281070654 -34.650441262823634,-58.397577954192627 -34.650445706265728,-58.397361218119698 -34.650664754542206,-58.397302499664235 -34.650628952302981,-58.396644604806845 -34.650628597696397,-58.396699986503329 -34.65075963290731,-58.396644085217829 -34.651283626803959,-58.396640815835944 -34.651427609830456,-58.397362742107028 -34.651439471948805,-58.397507129914537 -34.651437254376177,-58.397765418846916 -34.6513639668172,-58.398761267218809 -34.65106416722589,-58.399163160620894 -34.650961557883363,-58.399205260800549 -34.65095981809614,-58.399399823711178 -34.650951680118652,-58.399752024868661 -34.650972637156244,-58.399902540192507 -34.651289343897723,-58.400105980725563 -34.651945523746633,-58.400290797881922 -34.65232485559752,-58.400322348809794 -34.652072118338936,-58.400354660842289 -34.651939032882439,-58.400565037066222 -34.651072635667276,-58.400759037197943 -34.650219961901023,-58.400857787383799 -34.649786055920011,-58.401502506409116 -34.646952633061602,-58.401363958306675 -34.646936083529255,-58.401304218011184 -34.646941125144124,-58.401206893948853 -34.646948963670226,-58.400618100714674 -34.646996623448629,-58.400436172067167 -34.647097942230126,-58.40011472096289 -34.647233768278191,-58.400036166031221 -34.647325701461341,-58.399967674379702 -34.647409824281496,-58.399962802540543 -34.647427287644227,-58.399221160423735 -34.649667112252402,-58.399177951956361 -34.649669413765324)));;2237;4_10_5;COMUNA 4;10;5;1659;796;863;92,24%;459;459;100,00%;0;0,00%;519;93;17,92%;426;82,08%
MULTIPOLYGON (((-58.400858940448153 -34.649780990972715,-58.403516832209988 -34.650249933407345,-58.403427325820459 -34.650710491690077,-58.403433220629729 -34.650709333694195,-58.403480268666428 -34.650700130924442,-58.404141667822195 -34.650570305604404,-58.404663802430633 -34.650459565993764,-58.404747077534275 -34.650315094236362,-58.404933592192002 -34.649991581498632,-58.405045022526885 -34.649798248155371,-58.404606142018118 -34.649434366970731,-58.404501639082341 -34.649347765243199,-58.40443284748406 -34.649254701425761,-58.403926429900778 -34.648599086537395,-58.40361005072161 -34.64818941422525,-58.403480980843398 -34.648020825387711,-58.403126978063668 -34.647558174155641,-58.40279809438848 -34.64712842252883,-58.402747624054918 -34.647062456899221,-58.402746646198572 -34.647061178822248,-58.401524478284095 -34.646858141713118,-58.401502507740624 -34.646952633062277,-58.400858940448153 -34.649780990972715)));;2238;4_26_3;COMUNA 4;26;3;1219;592;627;94,42%;210;210;100,00%;0;0,00%;340;45;13,24%;295;86,76%
MULTIPOLYGON (((-58.402869665870412 -34.650819977288961,-58.402560613565015 -34.650880672144545,-58.402315740888838 -34.650928721580314,-58.402038138601725 -34.650983233312367,-58.401727977119045 -34.65104406635286,-58.401522992399691 -34.651084316998869,-58.401476967145705 -34.651092744855205,-58.401365824682586 -34.651113041721139,-58.401199394140015 -34.65110612670626,-58.400947660503547 -34.651095717488431,-58.400631587489038 -34.65108259888278,-58.400565037732434 -34.651072635117423,-58.400354661508487 -34.651939032332578,-58.400322348144009 -34.652072118338602,-58.40029079721571 -34.652324856147366,-58.400286424357169 -34.652360277491063,-58.400268488770962 -34.652525977428105,-58.400398170081424 -34.652561396911246,-58.400450333973502 -34.652550648586356,-58.400495679097851 -34.652541234828483,-58.40066981657602 -34.652502308300839,-58.400928934188002 -34.652444409956708,-58.400995844445674 -34.652429443390524,-58.401195957403594 -34.652413135553715,-58.40147722726438 -34.652361726279274,-58.401726960520925 -34.65231607540877,-58.402004476381727 -34.65226959276302,-58.40228565401047 -34.652226491681105,-58.402418333942251 -34.652122821881449,-58.402522286856154 -34.652028926784155,-58.402585537973827 -34.65200564743315,-58.402770006125998 -34.651937567200783,-58.402861917017468 -34.651878737353947,-58.40296022139011 -34.651817093584668,-58.403012490202414 -34.651777751816162,-58.403115506448572 -34.651681250037612,-58.403265122516395 -34.651487514483186,-58.403292587850174 -34.65145358319662,-58.403323550327386 -34.651415287279612,-58.403518098239964 -34.651311153405516,-58.403369168946298 -34.651140301305247,-58.403230453579006 -34.650749165743626,-58.403132180943878 -34.650768484552067,-58.402869665870412 -34.650819977288961)));;2239;4_26_1;COMUNA 4;26;1;1008;503;505;99,60%;131;131;100,00%;0;0,00%;261;41;15,71%;220;84,29%
MULTIPOLYGON (((-58.398648885952007 -34.652583154817755,-58.398866271258846 -34.652649555208377,-58.398508551950634 -34.653821411283538,-58.39857469677488 -34.653872967396474,-58.398275408528846 -34.654310608644877,-58.398510679220841 -34.654379956221291,-58.398532936398439 -34.654541137145415,-58.398605829799365 -34.654549101837581,-58.399050925939846 -34.654516044297992,-58.39982073903662 -34.654635611885801,-58.400268487440208 -34.652525976327041,-58.400286423026401 -34.652360276389992,-58.400290797881922 -34.652324855597499,-58.400105980725563 -34.651945523746633,-58.399902540192507 -34.651289343897716,-58.399752024868661 -34.650972637156244,-58.399399823711164 -34.650951680118645,-58.399205260800549 -34.65095981809614,-58.399163160620894 -34.650961557883356,-58.399074816467213 -34.651368424775995,-58.399005196070604 -34.651583887233357,-58.398870732817649 -34.652010167031619,-58.39869305285216 -34.652555795343908,-58.398651022437313 -34.652575702339306,-58.398648885952007 -34.652583154817755)));;2240;4_10_8;COMUNA 4;10;8;1602;794;808;98,27%;430;430;100,00%;0;0,00%;492;99;20,12%;393;79,88%
MULTIPOLYGON (((-58.399163160621299 -34.65096155733319,-58.398761267884588 -34.651064167226231,-58.397765419043651 -34.651363966171878,-58.397674230890466 -34.65211052485121,-58.397624112605634 -34.652556990172201,-58.397581624670664 -34.652944514118261,-58.397637837520762 -34.652987925682943,-58.398010130455567 -34.653154044132016,-58.398030953912141 -34.653116518862625,-58.398040012764667 -34.653083987498604,-58.398090855333223 -34.652909783969889,-58.398106404089333 -34.652860424556827,-58.398141184990685 -34.652737340758598,-58.3981698353167 -34.652607140817913,-58.398195006848148 -34.65256708253191,-58.398250424395805 -34.652537040525559,-58.398339574261392 -34.652527087317559,-58.398364714182918 -34.652527804830271,-58.398651023102282 -34.652575703440043,-58.39869305285216 -34.652555795343929,-58.39887073281681 -34.652010168132001,-58.399005197401756 -34.65158388778427,-58.399074817133005 -34.651368424776351,-58.399163160621299 -34.65096155733319)));;2241;4_10_7;COMUNA 4;10;7;901;433;468;92,52%;249;249;100,00%;0;0,00%;273;49;17,95%;224;82,05%
MULTIPOLYGON (((-58.389412181673229 -34.646098687047648,-58.387779623813756 -34.646006002057696,-58.387215186887609 -34.645973962876077,-58.386539381479253 -34.646679409236881,-58.386429884256472 -34.646673636404046,-58.386101022561299 -34.646595470164442,-58.385024728883515 -34.646339781610635,-58.384465272972065 -34.647898414851213,-58.385128284766004 -34.648057857286155,-58.385576847217465 -34.648081381937665,-58.386160302549314 -34.648112032146095,-58.386880781435195 -34.648149877724769,-58.38759921589201 -34.64818757693854,-58.388397751684693 -34.648229546232159,-58.38896356989904 -34.64825925676049,-58.389238894331704 -34.648274634656239,-58.389354018392865 -34.646828744718526,-58.389402875352424 -34.646215797700293,-58.389412181673229 -34.646098687047648)));;2242;4_11_1;COMUNA 4;11;1;862;408;454;89,87%;255;255;100,00%;0;0,00%;293;26;8,87%;267;91,13%
MULTIPOLYGON (((-58.383936614586148 -34.649399387226865,-58.383874151543615 -34.649577028232756,-58.383677864580399 -34.650145157576745,-58.385683487764865 -34.650533072016479,-58.385738385639236 -34.65033105841259,-58.385895269065493 -34.64950599186254,-58.38669577523801 -34.64954952288349,-58.38748298874588 -34.649592336204776,-58.387398464572307 -34.650614638466308,-58.38737838563631 -34.650860830563929,-58.388615485487016 -34.651100046216214,-58.388825370111888 -34.651138248068015,-58.389005521167704 -34.651175437475246,-58.389007858679449 -34.651175920016506,-58.389007976198563 -34.651174443198329,-58.38903198869226 -34.650872686159865,-58.389126783423464 -34.64968144028191,-58.389238894331704 -34.648274634656239,-58.38896356989904 -34.64825925676049,-58.388397751684693 -34.648229546232159,-58.38759921589201 -34.64818757693854,-58.386880781435195 -34.648149877724769,-58.386160302549314 -34.648112032146095,-58.385576847217465 -34.648081381937665,-58.385128284766004 -34.648057857286155,-58.384465272972065 -34.647898414851213,-58.384419134903851 -34.648026910243303,-58.383936614586148 -34.649399387226865)));;2243;4_11_2;COMUNA 4;11;2;847;384;463;82,94%;384;384;100,00%;0;0,00%;327;1;0,31%;326;99,69%
MULTIPOLYGON (((-58.3834624327733 -34.650768839140426,-58.383407997570501 -34.650926343640208,-58.383132909975131 -34.651725343023557,-58.383060441258856 -34.651935724457417,-58.382721596103366 -34.652828345837641,-58.383766842336016 -34.653102978624624,-58.384611528384696 -34.653327050159412,-58.385876437568712 -34.653660821133684,-58.387160239666002 -34.65375338645547,-58.387177557441099 -34.653546208027265,-58.387259935640607 -34.65254728605651,-58.387268375116982 -34.652356370165641,-58.387008716244317 -34.652343321559457,-58.386507381938635 -34.652315684585226,-58.386320841243389 -34.652305145041289,-58.386068768511826 -34.652290901966836,-58.385052409002753 -34.652205397354059,-58.38513293543091 -34.65203100684473,-58.38546525540022 -34.65115922018164,-58.385632779614284 -34.650719735668126,-58.385683487764865 -34.650533072016479,-58.383677864580399 -34.650145157576745,-58.3834624327733 -34.650768839140426)));;2244;4_11_3;COMUNA 4;11;3;785;370;415;89,16%;346;346;100,00%;0;0,00%;282;3;1,06%;279;98,94%
MULTIPOLYGON (((-58.38737838563631 -34.650860830563929,-58.387398464572307 -34.650614638466308,-58.38748298874588 -34.649592336204776,-58.38669577523801 -34.64954952288349,-58.385895269065493 -34.64950599186254,-58.385738385639236 -34.65033105841259,-58.385683487764865 -34.650533072016479,-58.385632779614284 -34.650719735668126,-58.38546525540022 -34.65115922018164,-58.38513293543091 -34.65203100684473,-58.385052409002753 -34.652205397354059,-58.386068768511826 -34.652290901966836,-58.386320841243389 -34.652305145041289,-58.386507381938635 -34.652315684585226,-58.387008716244317 -34.652343321559457,-58.387268375116982 -34.652356370165641,-58.387884756380558 -34.652387314184715,-58.388064991745964 -34.65239707280643,-58.388906942921942 -34.652442586560035,-58.389007858679449 -34.651175920016506,-58.389005521167704 -34.651175437475246,-58.388825370111888 -34.651138248068015,-58.388615485487016 -34.651100046216214,-58.38737838563631 -34.650860830563929)));;2245;4_11_4;COMUNA 4;11;4;643;283;360;78,61%;317;317;100,00%;0;0,00%;250;0;0,00%;250;100,00%
MULTIPOLYGON (((-58.390148122097607 -34.648325110079305,-58.389543191416649 -34.648291649082175,-58.389238894331704 -34.648274634656239,-58.389126783423464 -34.64968144028191,-58.38903198869226 -34.650872686159865,-58.389007976198563 -34.651174443198329,-58.389007858679449 -34.651175920016506,-58.388906942921942 -34.652442586560035,-58.389243808850054 -34.652460818655115,-58.389740798828747 -34.652488230506314,-58.390544402980332 -34.652532583210238,-58.392139172124196 -34.652620490862752,-58.392240463554657 -34.651355582481983,-58.393281472886677 -34.65141237840605,-58.393838028701467 -34.651438117264021,-58.394303739930884 -34.651463239263791,-58.394839068957424 -34.651498116846014,-58.395276573573348 -34.651522163060548,-58.395425718824917 -34.651511470468087,-58.395436445151219 -34.651314709985044,-58.395464427654353 -34.650960771239475,-58.395545156151954 -34.650031905819567,-58.395642278924974 -34.648636926376625,-58.395584169546552 -34.648625415189123,-58.394059263626303 -34.648541183581798,-58.393460039069815 -34.648508097349236,-58.392461162169113 -34.648452876562949,-58.391660067590848 -34.648408608372442,-58.390148122097607 -34.648325110079305)));;2246;4_11_5;COMUNA 4;11;5;456;215;241;89,21%;211;210;99,53%;1;0,48%;185;9;4,86%;176;95,14%
MULTIPOLYGON (((-58.393281472886677 -34.65141237840605,-58.392240463554657 -34.651355582481983,-58.392139172124196 -34.652620490862752,-58.392719592551465 -34.652652516422663,-58.393179855838802 -34.652677850860961,-58.393645658553034 -34.652703538822195,-58.39360501291852 -34.653210643381719,-58.393574098492842 -34.653595496301108,-58.393533279717104 -34.654104783826121,-58.39407791917494 -34.654134317757027,-58.394622644304491 -34.654163778878569,-58.395208957065122 -34.654195584604061,-58.395210764970344 -34.654173120159832,-58.395282917737411 -34.653264894038955,-58.395321490298358 -34.652779478552311,-58.395380639390645 -34.652035545612257,-58.395418538120531 -34.651644357768731,-58.395425718824917 -34.651511470468087,-58.395276573573348 -34.651522163060548,-58.394839068957424 -34.651498116846014,-58.394303739930884 -34.651463239263791,-58.393838028701467 -34.651438117264021,-58.393281472886677 -34.65141237840605)));;2247;4_11_6;COMUNA 4;11;6;964;467;497;93,96%;326;325;99,69%;1;0,31%;320;29;9,06%;291;90,94%
MULTIPOLYGON (((-58.39461406463154 -34.661111930805518,-58.394625422555748 -34.660876296726627,-58.39470670810573 -34.660071319405141,-58.394724976217084 -34.659827097337562,-58.394765992118394 -34.659279710326807,-58.394857017864503 -34.658546007755277,-58.394875033895538 -34.658401013645559,-58.394952314037823 -34.657380252769208,-58.394961444121442 -34.657262226286313,-58.395018555404363 -34.656516884449815,-58.395062317920484 -34.655941187886512,-58.395151039492582 -34.654888389629697,-58.395200519342708 -34.654301428094406,-58.395208957065122 -34.654195584604061,-58.394622644304491 -34.654163778878569,-58.39407791917494 -34.654134317757027,-58.393533279717104 -34.654104783826121,-58.393574098492842 -34.653595496301108,-58.39360501291852 -34.653210643381719,-58.393645658553034 -34.652703538822195,-58.393179855838802 -34.652677850860961,-58.392719592551465 -34.652652516422663,-58.392139172124196 -34.652620490862752,-58.390544402980332 -34.652532583210238,-58.389740798828747 -34.652488230506314,-58.389243808850054 -34.652460818655115,-58.388906942921942 -34.652442586560035,-58.388851096483762 -34.6531446860606,-58.388795422352118 -34.653843616451816,-58.388711564760868 -34.654896201891802,-58.388653474838826 -34.655625624389494,-58.388607363892994 -34.656204908879985,-58.388551340576129 -34.656908486614491,-58.388449117775693 -34.658191489276859,-58.388260576013565 -34.660117907783189,-58.388262372518376 -34.660388985758722,-58.388340158574579 -34.660398772754661,-58.388567474125544 -34.660595649701342,-58.388740692776743 -34.660654192082184,-58.38893279093115 -34.660690344720209,-58.389082406911797 -34.660781499759651,-58.3892722460184 -34.6607066198507,-58.389480842659708 -34.660747164348798,-58.389576208945293 -34.660871887571176,-58.389620986446204 -34.660887497666607,-58.389814241534701 -34.660949581107843,-58.39007203370177 -34.661009389564427,-58.390319539450438 -34.661038146617258,-58.390513956076973 -34.661121047883427,-58.39065384991396 -34.66121243872152,-58.390921893798421 -34.661345906630658,-58.391147221311606 -34.661465957033826,-58.39131659290247 -34.661547624873684,-58.391481482627569 -34.661701727608076,-58.391562454568898 -34.661778473670658,-58.391672862168683 -34.661893586225133,-58.39182222645038 -34.662036492465894,-58.391957688618746 -34.662102629319591,-58.392120551887118 -34.662162291967476,-58.392276624914494 -34.662291430967315,-58.392543541879881 -34.662418279678896,-58.392709460607804 -34.662430838855592,-58.392882926852302 -34.662437170220365,-58.393026234600015 -34.66243102029101,-58.393331635512986 -34.662502861378876,-58.393531507582111 -34.662499858979388,-58.39370497920055 -34.662499957269404,-58.393840801462538 -34.662425251154573,-58.394082183888656 -34.66238799579299,-58.394308509799515 -34.662316456011482,-58.394515933825659 -34.662300992416682,-58.39455490400487 -34.661853538242099,-58.394608689425375 -34.661223057682264,-58.39461406463154 -34.661111930805518)));;2248;4_11_7;COMUNA 4;11;7;1049;506;543;93,19%;361;361;100,00%;0;0,00%;328;61;18,60%;267;81,40%
MULTIPOLYGON (((-58.383766842336016 -34.653102978624624,-58.382721596103366 -34.652828345837641,-58.382348994772627 -34.653809819733169,-58.38227216946332 -34.654026817664068,-58.383343937170942 -34.654297950293319,-58.384164275757207 -34.654505459265465,-58.385487152745142 -34.654840116641978,-58.387037623094628 -34.655232367548123,-58.388653474838826 -34.655625624389494,-58.388711564760868 -34.654896201891802,-58.388795422352118 -34.653843616451816,-58.388851096483762 -34.6531446860606,-58.388906942921942 -34.652442586560035,-58.388064991745964 -34.65239707280643,-58.387884756380558 -34.652387314184715,-58.387268375116982 -34.652356370165641,-58.387259935640607 -34.65254728605651,-58.387177557441099 -34.653546208027265,-58.387160239666002 -34.65375338645547,-58.385876437568712 -34.653660821133684,-58.384611528384696 -34.653327050159412,-58.383766842336016 -34.653102978624624)));;2249;4_11_8;COMUNA 4;11;8;922;466;456;102,19%;349;349;100,00%;0;0,00%;313;17;5,43%;296;94,57%
MULTIPOLYGON (((-58.381986700023646 -34.654963768936639,-58.381924120375963 -34.65516514177942,-58.381453456892118 -34.656529516299493,-58.381181895593549 -34.657344710515027,-58.381107410876453 -34.657341069042594,-58.38101102467288 -34.657335581815204,-58.380732768096095 -34.657326310309053,-58.380466529394162 -34.657316201179157,-58.380056776979735 -34.657297825032707,-58.379741274723287 -34.657290357051785,-58.379647871888032 -34.657284589078444,-58.379246594817381 -34.65722875012284,-58.378896172927085 -34.657198438496657,-58.378669223356219 -34.65718933838361,-58.378491294398344 -34.657165200859822,-58.378355205669671 -34.657147148537398,-58.378335251966419 -34.657294409783603,-58.378403335994598 -34.657295178322691,-58.378414699431453 -34.657302232972974,-58.378421813172295 -34.657295191095507,-58.378457342641141 -34.657298739045608,-58.378477230447942 -34.657309322976644,-58.378490010462919 -34.657321076461457,-58.378514168183209 -34.657325791006443,-58.378538321157201 -34.657335203406468,-58.378605133970474 -34.657324679313362,-58.378619338886338 -34.65733291037003,-58.378636391192842 -34.65733644552509,-58.378643497803218 -34.657336450424459,-58.378661979732257 -34.657331765301059,-58.378687565898495 -34.657329434001575,-58.378714563907003 -34.657336499395413,-58.378733038724981 -34.657338861050995,-58.378767150455829 -34.657338884537154,-58.378818299119146 -34.657357711187878,-58.378858093782071 -34.657360087489593,-58.378883665762885 -34.657371849728456,-58.378926298352766 -34.657378925821781,-58.378997360950947 -34.65738249802282,-58.379052784282969 -34.657390757317607,-58.379086907830654 -34.657379036064746,-58.379128127371324 -34.657377889858132,-58.379142329990614 -34.657388469783804,-58.379162206710703 -34.657410211020213,-58.379196300801389 -34.657427851360701,-58.379221863429891 -34.657449009248232,-58.379237495639273 -34.657451368881176,-58.379248874472452 -34.657443155409268,-58.379244619919149 -34.657433756771205,-58.379233259926295 -34.657423178803462,-58.37922190111393 -34.65741142636967,-58.379226175682135 -34.657400859104214,-58.37926738463895 -34.657410283035176,-58.379291548312672 -34.657409125101388,-58.379339883889877 -34.657398587964686,-58.379406669628217 -34.657415076126604,-58.379466345838992 -34.657434495563322,-58.379494772314558 -34.657434514964883,-58.379534571726822 -34.657432193186018,-58.37955731642537 -34.657428685300161,-58.379594267323995 -34.657432233888237,-58.37962126309921 -34.657441648011265,-58.379651111087632 -34.657443995312214,-58.379675276921347 -34.657438161405047,-58.379696587411644 -34.657447571640041,-58.379716481265177 -34.657452283044137,-58.379736384483927 -34.657447598725241,-58.379749172889454 -34.65745113082334,-58.379769066746853 -34.657455842218852,-58.379777592352184 -34.65745819694876,-58.379794649412048 -34.657457034082007,-58.379834452333895 -34.657451188810356,-58.379878513380284 -34.657451218746942,-58.379888459144155 -34.657454748899525,-58.379908358850052 -34.657453587947472,-58.379926844237374 -34.657445379237437,-58.379938213661703 -34.657446561420905,-58.379975159916732 -34.657454807753439,-58.379986530509882 -34.657454815467425,-58.380002159242359 -34.65746069839728,-58.380034839204569 -34.657471290749619,-58.38004621213198 -34.657468949528074,-58.380074650275695 -34.657457224144721,-58.380090280180269 -34.657461932598316,-58.380117285341377 -34.657461950891786,-58.380144295160974 -34.657457271319359,-58.380162779361591 -34.657450237038532,-58.380206856700084 -34.657433824346718,-58.380231026184916 -34.657426793901799,-58.380258034823747 -34.657423288769124,-58.380302088881521 -34.657430365342549,-58.380370317066692 -34.657425713567569,-58.380428099600806 -34.657430900432033,-58.380491289288955 -34.657428332419478,-58.380545006059641 -34.657420536725496,-58.380586085400971 -34.657412732497804,-58.380636655664681 -34.657391881478439,-58.380680884049482 -34.657394521870856,-58.380715629232718 -34.657402377137593,-58.380740901498321 -34.657405004760911,-58.380763027257515 -34.657394577098692,-58.380800936939316 -34.657397213201229,-58.380841998277354 -34.657407683307447,-58.380911504080011 -34.657407729950464,-58.380943074553571 -34.657431246821872,-58.380999945515718 -34.657428674308676,-58.381044199536987 -34.657405208254694,-58.381094751769311 -34.657402631465509,-58.381161070088361 -34.657431392797911,-58.381208429757834 -34.657462752057839,-58.382165687098883 -34.657492105044824,-58.382250984718851 -34.657497382620072,-58.382781744367058 -34.657510784824112,-58.38296749931316 -34.657517172994474,-58.383031045523019 -34.657517214532078,-58.383102531871558 -34.657520543053749,-58.383279268210394 -34.657522299218165,-58.383332885328656 -34.657522334130597,-58.383517589924523 -34.657497840467649,-58.383724136854163 -34.657475001591052,-58.383857202205967 -34.657458678538866,-58.384023995386634 -34.657475195444995,-58.384230500364254 -34.657496660436763,-58.384677226516537 -34.657585556620404,-58.384697166207637 -34.657498600788713,-58.384726266931388 -34.657505895202952,-58.384741607519949 -34.657518591024186,-58.384803903031155 -34.657537286738048,-58.384825575715318 -34.657538793053902,-58.384855976469225 -34.657557775286016,-58.384917678008506 -34.657552284091047,-58.384982686328819 -34.657567250264094,-58.385063036020142 -34.657594165947643,-58.385109962481515 -34.657630761381697,-58.385139757423424 -34.657638242697921,-58.385169541251685 -34.657657663775531,-58.385205381529751 -34.657664657446901,-58.385220091261026 -34.657682321695219,-58.385254996568101 -34.657697507305549,-58.385282376593672 -34.657712210697476,-58.385300415470994 -34.657736847936853,-58.385303101150264 -34.657762221664726,-58.385557635374695 -34.657910137689612,-58.385582810073565 -34.657903218387617,-58.385612527515107 -34.657909604792621,-58.385667537069338 -34.6579460259195,-58.385682907101845 -34.657991518579443,-58.385696104867378 -34.658005171800198,-58.385733535142379 -34.658004285774375,-58.385794058386516 -34.658030704075017,-58.385920579122221 -34.65811629175689,-58.38600419223264 -34.65817365289589,-58.386082306137823 -34.658225552567785,-58.386174720571439 -34.658289286731993,-58.386314442523343 -34.658385798194168,-58.386362852476793 -34.658416756916573,-58.386377146288844 -34.658435868702654,-58.38638263063239 -34.658457703950162,-58.386388129987893 -34.658463165345836,-58.386398032831544 -34.658468629496987,-58.386418930226206 -34.658489564728214,-58.386418912722633 -34.658508667554891,-58.386423303710338 -34.658522315185898,-58.386447504576516 -34.658542342819672,-58.386451894737533 -34.658556900107989,-58.386452978947872 -34.658575093964494,-58.386463965189144 -34.658599661625082,-58.386467251150329 -34.658617856857951,-58.38647714568885 -34.658632417586546,-58.386494732194777 -34.658662447323529,-58.386512322875809 -34.658687928765914,-58.386525509234886 -34.658714317113052,-58.386525489258602 -34.658736148914201,-58.386539774840827 -34.658764357264133,-58.38655627050511 -34.658783470403534,-58.386546312693689 -34.65883804371785,-58.38652317846703 -34.658855312785285,-58.386586971113807 -34.658919028745771,-58.386681553988694 -34.659020514715742,-58.38669948733078 -34.659006955936178,-58.386734835552957 -34.659020613310801,-58.386789005513677 -34.659075188433576,-58.386805494739896 -34.659088834044688,-58.386824336913399 -34.659107350884284,-58.386840822601776 -34.659124892301534,-58.38684787699637 -34.659144375756128,-58.38686200797676 -34.659158993845651,-58.386892641525534 -34.659172648241658,-58.38691267306875 -34.659179478367442,-58.386925621828972 -34.659197991527797,-58.386950371692379 -34.65920092876646,-58.386972760630471 -34.659207760346916,-58.387039944285149 -34.659209749961718,-58.387063509270106 -34.659219504115107,-58.387072925532969 -34.659234119255203,-58.387079968489942 -34.659266264081545,-58.387087022952436 -34.659285747521963,-58.387111754276631 -34.659309137734951,-58.387137659887983 -34.659337398436897,-58.387149412351071 -34.659375389896773,-58.387171781912492 -34.659403648400058,-58.387182350404366 -34.65944748284241,-58.387158759269141 -34.65946646031675,-58.387328320326588 -34.659655512178283,-58.387413100703569 -34.659750524995111,-58.387434325217299 -34.659741772520164,-58.387450804116689 -34.65976710547465,-58.387470836728966 -34.65977296155566,-58.387488516344263 -34.659773946415982,-58.387502661620388 -34.659772981187615,-58.38753093106498 -34.659794425589567,-58.387562740141277 -34.659811976353495,-58.38759453692915 -34.659843162446109,-58.38760747628001 -34.659872389011383,-58.387623974581871 -34.659876294984024,-58.387641656855422 -34.659874357964227,-58.387651076805909 -34.659885077247786,-58.387653414892064 -34.659906505656778,-58.387659297864559 -34.659918196715722,-58.387676975757472 -34.659921129453998,-58.387688756632102 -34.659927954374574,-58.387686388696736 -34.659939640355788,-58.387665163281063 -34.65994936682695,-58.387658079654393 -34.65996202385854,-58.387665131677274 -34.659984429121387,-58.387685162601663 -34.659992233072323,-58.387696936466902 -34.660006849613005,-58.387706361703891 -34.660011725176368,-58.387726400533253 -34.660010763546957,-58.387744080202133 -34.660011748370238,-58.38775114452865 -34.660020518291354,-58.387757007356257 -34.660054610255507,-58.387767612182614 -34.660058512585998,-58.387778199478674 -34.660081893967778,-58.38778288887616 -34.660110141490442,-58.38779818924958 -34.660135473672419,-58.38785471366522 -34.660194919524713,-58.387871211167152 -34.660199799416397,-58.387888886501571 -34.660205653981649,-58.387893593447885 -34.660214422447794,-58.387930113211972 -34.660236845770555,-58.387934810542291 -34.660256327713505,-58.387958376802906 -34.660265107740194,-58.387961901555421 -34.660277771291391,-58.387978400828537 -34.660280703263368,-58.387997261012728 -34.660279740867175,-58.388016116827536 -34.660283648230973,-58.388046735257923 -34.660314833481671,-58.388066754946109 -34.660335298753111,-58.388089140789383 -34.66034602593809,-58.388120947576525 -34.660366498412948,-58.388137447745251 -34.660368456410801,-58.388152761356857 -34.660379179258911,-58.388262372518376 -34.660388985758722,-58.388260576013565 -34.660117907783189,-58.388449117775693 -34.658191489276859,-58.388551340576129 -34.656908486614491,-58.388607363892994 -34.656204908879985,-58.388653474838826 -34.655625624389494,-58.387037623094628 -34.655232367548123,-58.385487152745142 -34.654840116641978,-58.384164275757207 -34.654505459265465,-58.383343937170942 -34.654297950293319,-58.38227216946332 -34.654026817664068,-58.382202522215117 -34.654223467572592,-58.382047740420951 -34.654767465606362,-58.381986700023646 -34.654963768936639)));;2250;4_11_9;COMUNA 4;11;9;885;435;450;96,67%;277;277;100,00%;0;0,00%;269;32;11,90%;237;88,10%
MULTIPOLYGON (((-58.381097010154463 -34.63707925221901,-58.381022147505696 -34.637131950268113,-58.381020841521483 -34.637160401005012,-58.380996863437815 -34.637196231157688,-58.380681378600599 -34.63846007365391,-58.381354020094875 -34.638446650472801,-58.381401563615015 -34.638274352769081,-58.381760375592208 -34.636954831120605,-58.382427004265807 -34.634502516828036,-58.382444874421935 -34.634083641789317,-58.382503984916561 -34.634104878539951,-58.382549261533931 -34.633183962899153,-58.38256134146993 -34.632937695209201,-58.38261487831879 -34.631842553733939,-58.382621294005105 -34.631757952539374,-58.382218009548609 -34.631489531420456,-58.381545250806475 -34.6310417799532,-58.3813263761351 -34.630900099655953,-58.381324172984634 -34.63111733714134,-58.381280643015607 -34.63235661681513,-58.381250380819708 -34.633070070587017,-58.381226047114318 -34.633645213879817,-58.381216711170836 -34.633869440270878,-58.381097010154463 -34.63707925221901)));;2251;4_12_1;COMUNA 4;12;1;604;304;300;101,33%;171;171;100,00%;0;0,00%;229;71;31,00%;158;69,00%
MULTIPOLYGON (((-58.381092678201711 -34.642110604930508,-58.380912280089085 -34.642116540607823,-58.380796328188829 -34.642128479853135,-58.380582422668013 -34.642153729202839,-58.380430975074702 -34.642171506073907,-58.379947153200447 -34.642226315499947,-58.379701308531203 -34.642065087092782,-58.379588051653933 -34.64199085272692,-58.378361825072339 -34.641186746443999,-58.377089639972482 -34.640352524126378,-58.375840981918927 -34.639533657797386,-58.375795205131219 -34.639715954861664,-58.375695929553551 -34.640620419474097,-58.375525074785827 -34.642176331838478,-58.375486618378282 -34.64252680816098,-58.376008864034283 -34.642543026079323,-58.376153697658459 -34.642568340996647,-58.376318705513874 -34.64261395235112,-58.376493058859239 -34.642686613178903,-58.376732656827912 -34.642786433281017,-58.377540334812117 -34.643165110229468,-58.377842767713943 -34.643318424359549,-58.377797415825199 -34.64350410274546,-58.3775329137789 -34.644589303774964,-58.377592548439893 -34.644603993743729,-58.378884154045075 -34.644923278326267,-58.379607188367238 -34.645101947585239,-58.380559908167371 -34.645337388925135,-58.38090141916414 -34.645387866310983,-58.381063787496394 -34.645410079546821,-58.381180609358914 -34.645426329254278,-58.381092678201711 -34.642110604930508)));;2252;4_12_10;COMUNA 4;12;10;884;427;457;93,44%;299;299;100,00%;0;0,00%;284;25;8,80%;259;91,20%
MULTIPOLYGON (((-58.374292259780795 -34.640308203100176,-58.374240170861441 -34.640573384894665,-58.37404199284898 -34.641595667231648,-58.373887342730853 -34.642387973660746,-58.375416878305479 -34.643131283992744,-58.375444289997922 -34.642912705310295,-58.375486618378282 -34.64252680816098,-58.375525074785827 -34.642176331838478,-58.375695929553551 -34.640620419474097,-58.374292259780795 -34.640308203100176)));;2253;4_12_11;COMUNA 4;12;11;632;277;355;78,03%;296;296;100,00%;0;0,00%;260;7;2,69%;253;97,31%
MULTIPOLYGON (((-58.375416878305479 -34.643131283992744,-58.373887342730853 -34.642387973660746,-58.373819398362585 -34.642736244795557,-58.373701379640138 -34.643374488278205,-58.373650901351205 -34.643643966766682,-58.373962974616482 -34.643701590373666,-58.3752378700542 -34.644002238895112,-58.375166668025287 -34.644292126283766,-58.375136621143817 -34.644422390396798,-58.37600191538278 -34.644552590061913,-58.37677434355691 -34.644668844524958,-58.376853251127557 -34.644421286877325,-58.3775329137789 -34.644589303774964,-58.377797415825199 -34.64350410274546,-58.377842767713943 -34.643318424359549,-58.377540334812117 -34.643165110229468,-58.376732656827912 -34.642786433281017,-58.376493058859239 -34.642686613178903,-58.376318705513874 -34.64261395235112,-58.376153697658459 -34.642568340996647,-58.376008864034283 -34.642543026079323,-58.375486618378282 -34.64252680816098,-58.375444289997922 -34.642912705310295,-58.375416878305479 -34.643131283992744)));;2254;4_12_12;COMUNA 4;12;12;573;274;299;91,64%;270;270;100,00%;0;0,00%;223;2;0,90%;221;99,10%
MULTIPOLYGON (((-58.387321497201569 -34.635845824042185,-58.387879903925693 -34.635020859590647,-58.388763651750587 -34.633759526645477,-58.388556821763942 -34.633712005183661,-58.387652452916228 -34.633458626947942,-58.387267771803288 -34.633355780671501,-58.386519891402756 -34.63314129479091,-58.385416906410221 -34.632820872158078,-58.383990006691008 -34.63239677685474,-58.3833915497326 -34.632220538367747,-58.382620555968629 -34.63173165189778,-58.382621294005105 -34.631757952539374,-58.38261487831879 -34.631842553733939,-58.38256134146993 -34.632937695209201,-58.382549261533931 -34.633183962899153,-58.382503984916561 -34.634104878539951,-58.382444874421935 -34.634083641789317,-58.382427004265807 -34.634502516828036,-58.381760375592208 -34.636954831120605,-58.381401563615015 -34.638274352769081,-58.381354020094875 -34.638446650472801,-58.381524608900314 -34.638443242895626,-58.386656939712921 -34.639535599459407,-58.386523101502519 -34.637178962271271,-58.386471281420398 -34.637101885179739,-58.386546278912945 -34.636991083419041,-58.387321497201569 -34.635845824042185)));;2255;4_12_2;COMUNA 4;12;2;540;239;301;79,40%;205;205;100,00%;0;0,00%;216;90;41,67%;126;58,33%
MULTIPOLYGON (((-58.390248758162322 -34.635399485037823,-58.390282371457708 -34.634958152721303,-58.390330949497837 -34.634355978959718,-58.390352621841565 -34.634124364583819,-58.389515414431784 -34.633932098313664,-58.388763651750587 -34.633759526645477,-58.387879903925693 -34.635020859590647,-58.388653033661129 -34.635225774637583,-58.388870170246506 -34.635281119319956,-58.388470157812115 -34.636117452747939,-58.389419659515809 -34.636339160798983,-58.389862211131309 -34.636442527797129,-58.390164119153077 -34.636511724023876,-58.390231348056503 -34.63562807361243,-58.390248758162322 -34.635399485037823)));;2256;4_12_3;COMUNA 4;12;3;721;341;380;89,74%;337;337;100,00%;0;0,00%;302;58;19,21%;244;80,79%
MULTIPOLYGON (((-58.388870170246506 -34.635281119319956,-58.388653033661129 -34.635225774637583,-58.387879903925693 -34.635020859590647,-58.387321497201569 -34.635845824042185,-58.386546278912945 -34.636991083419041,-58.387899826326368 -34.637315804651294,-58.388102233200335 -34.637364380871354,-58.388865522849038 -34.637544921514255,-58.389765799923161 -34.637757934772225,-58.390064049347799 -34.637826424799108,-58.390164119153077 -34.636511724023876,-58.389862211131309 -34.636442527797129,-58.389419659515809 -34.636339160798983,-58.388470157812115 -34.636117452747939,-58.388870170246506 -34.635281119319956)));;2257;4_12_4;COMUNA 4;12;4;975;459;516;88,95%;266;266;100,00%;0;0,00%;371;52;14,02%;319;85,98%
MULTIPOLYGON (((-58.386523101502519 -34.637178962271271,-58.386656939712921 -34.639535599459407,-58.388099899958682 -34.639494376625002,-58.38857188248457 -34.639480861162681,-58.388611043220465 -34.639520463672952,-58.38902701310942 -34.639830655015381,-58.38950867404828 -34.640053416824735,-58.389881501735559 -34.640205475766969,-58.389966907732877 -34.639101829934823,-58.390064049347799 -34.637826424799108,-58.389765799923161 -34.637757934772225,-58.388865522849038 -34.637544921514255,-58.388102233200335 -34.637364380871354,-58.387899826326368 -34.637315804651294,-58.386546278912945 -34.636991083419041,-58.386471281420398 -34.637101885179739,-58.386523101502519 -34.637178962271271)));;2258;4_12_5;COMUNA 4;12;5;615;292;323;90,40%;256;256;100,00%;0;0,00%;231;28;12,12%;203;87,88%
MULTIPOLYGON (((-58.389465950237813 -34.645422924058288,-58.389573540873968 -34.644104497425722,-58.389664987692655 -34.642923529797308,-58.389673345688315 -34.642818108996657,-58.389757061836534 -34.64180164859566,-58.38984755839865 -34.640629553330271,-58.389860136888863 -34.640471879835275,-58.389881501735559 -34.640205475766969,-58.38950867404828 -34.640053416824735,-58.38902701310942 -34.639830655015381,-58.388611043220465 -34.639520463672952,-58.38857188248457 -34.639480861162681,-58.388099899958682 -34.639494376625002,-58.386656939712921 -34.639535599459407,-58.381524608900314 -34.638443242895626,-58.381354020094875 -34.638446650472801,-58.380681378600599 -34.63846007365391,-58.380650618071854 -34.638460686786395,-58.380604689914975 -34.638461993949946,-58.380479255727401 -34.63847078297227,-58.380356825702044 -34.638457390092832,-58.380389409930373 -34.639456950702133,-58.380440946129163 -34.639472126795333,-58.380476969607024 -34.640269147973534,-58.380420399928134 -34.640345943217291,-58.380457557532033 -34.640857463172068,-58.380416889850054 -34.640966523658456,-58.380504993760816 -34.640883552304778,-58.380747088278852 -34.640264188780407,-58.380864507091673 -34.640263915503141,-58.380912280089085 -34.642116540607823,-58.381092678201711 -34.642110604930508,-58.381180609358914 -34.645426329254278,-58.381784045556437 -34.645569763675105,-58.382856315999099 -34.645823576748327,-58.383921008700192 -34.646077516341762,-58.385024728883515 -34.646339781610635,-58.386101022561299 -34.646595470164442,-58.386429884256472 -34.646673636404046,-58.386539381479253 -34.646679409236881,-58.387215186887609 -34.645973962876077,-58.387779623813756 -34.646006002057696,-58.389412181673229 -34.646098687047648,-58.389461900564569 -34.645473627403121,-58.389465950237813 -34.645422924058288)));;2259;4_12_6;COMUNA 4;12;6;796;379;417;90,89%;238;238;100,00%;0;0,00%;249;42;16,87%;207;83,13%
MULTIPOLYGON (((-58.380430975074702 -34.642171506073907,-58.380582422668013 -34.642153729202839,-58.380796328188829 -34.642128479853135,-58.380912280089085 -34.642116540607823,-58.380864507091673 -34.640263915503141,-58.380747088278852 -34.640264188780407,-58.380504993760816 -34.640883552304778,-58.380416889850054 -34.640966523658456,-58.380457557532033 -34.640857463172068,-58.380420399928134 -34.640345943217291,-58.380476969607024 -34.640269147973534,-58.380440946129163 -34.639472126795333,-58.380389409930373 -34.639456950702133,-58.380356825702044 -34.638457390092832,-58.378948499647834 -34.63830353894614,-58.377669083042449 -34.638163705584439,-58.376351757862537 -34.638019747331398,-58.376269797903198 -34.638010815755614,-58.376207353754637 -34.638244863411344,-58.375905582344004 -34.639276512595913,-58.375840981918927 -34.639533657797386,-58.377089639972482 -34.640352524126378,-58.378361825072339 -34.641186746443999,-58.379588051653933 -34.64199085272692,-58.379701308531203 -34.642065087092782,-58.379947153200447 -34.642226315499947,-58.380430975074702 -34.642171506073907)));;2260;4_12_7;COMUNA 4;12;7;484;248;236;105,08%;145;145;100,00%;0;0,00%;157;13;8,28%;144;91,72%
MULTIPOLYGON (((-58.376269797903198 -34.638010815755614,-58.374950603262484 -34.63786662976942,-58.374728999894081 -34.637847807564029,-58.374680762897924 -34.638099118755612,-58.374580120072494 -34.638675472760944,-58.375840981918927 -34.639533657797386,-58.375905582344004 -34.639276512595913,-58.376207353754637 -34.638244863411344,-58.376269797903198 -34.638010815755614)));;2261;4_12_8;COMUNA 4;12;8;403;183;220;83,18%;255;255;100,00%;0;0,00%;184;27;14,67%;157;85,33%
MULTIPOLYGON (((-58.375840981918927 -34.639533657797386,-58.374580120072494 -34.638675472760944,-58.374520882350168 -34.63901480685012,-58.374407713767248 -34.639669534312247,-58.374338697526248 -34.640068510934327,-58.374292259780795 -34.640308203100176,-58.375695929553551 -34.640620419474097,-58.375795205131219 -34.639715954861664,-58.375840981918927 -34.639533657797386)));;2262;4_12_9;COMUNA 4;12;9;739;316;423;74,70%;388;388;100,00%;0;0,00%;312;3;0,96%;309;99,04%
MULTIPOLYGON (((-58.377338761298589 -34.629570802122416,-58.377238488024297 -34.629731793573875,-58.377106126841362 -34.629944172574497,-58.376816108356451 -34.630607159597488,-58.376718314625194 -34.63084005611146,-58.376233522970487 -34.631994539999518,-58.376159192117015 -34.632192944471406,-58.377765992815675 -34.632534718872414,-58.378184051111774 -34.631467650417271,-58.378290052428369 -34.631371664331951,-58.378391114030016 -34.631273561993069,-58.378489173537488 -34.631195106028734,-58.378602047778038 -34.631126449253856,-58.378705926296696 -34.631106942724209,-58.378789076573369 -34.631111859270504,-58.378863251176902 -34.631146277602866,-58.378943375051783 -34.631195418768748,-58.379014545654726 -34.631251877923305,-58.379042573186865 -34.631275391240862,-58.378622778457583 -34.630485931126259,-58.378660221890051 -34.630383436722404,-58.378735575078565 -34.630177566330183,-58.378762059762209 -34.630105117377397,-58.378981208065689 -34.629559683281265,-58.379082390227921 -34.629318134052262,-58.377926501399621 -34.628620292444865,-58.377338761298589 -34.629570802122416)));;2263;4_13_1;COMUNA 4;13;1;907;428;479;89,35%;499;499;100,00%;0;0,00%;357;0;0,00%;357;100,00%
MULTIPOLYGON (((-58.373685062532466 -34.63703364397621,-58.373545335740857 -34.637739831967714,-58.374340491230186 -34.637814920045223,-58.374728999894081 -34.637847807564029,-58.374766184071952 -34.637654166262053,-58.374855029357377 -34.6371933001423,-58.375033573980083 -34.636266849754861,-58.373867107140526 -34.636112902244498,-58.373685062532466 -34.63703364397621)));;2264;4_13_10;COMUNA 4;13;10;491;224;267;83,90%;255;255;100,00%;0;0,00%;202;0;0,00%;202;100,00%
MULTIPOLYGON (((-58.376781171268327 -34.636231402074692,-58.375063902408478 -34.636109260874861,-58.375033573980083 -34.636266849754861,-58.374855029357377 -34.6371933001423,-58.374766184071952 -34.637654166262053,-58.374728999894081 -34.637847807564029,-58.374950603262484 -34.63786662976942,-58.376269797903198 -34.638010815755614,-58.376324458166565 -34.637805425427793,-58.376692289828163 -34.636573533467939,-58.376781171268327 -34.636231402074692)));;2265;4_13_11;COMUNA 4;13;11;1139;507;632;80,22%;545;545;100,00%;0;0,00%;448;3;0,67%;445;99,33%
MULTIPOLYGON (((-58.377765992815675 -34.632534718872414,-58.376159192117015 -34.632192944471406,-58.375789504953602 -34.633254406327566,-58.377454848772956 -34.633356077844553,-58.377492207536626 -34.633233494331982,-58.377765992815675 -34.632534718872414)));;2266;4_13_2;COMUNA 4;13;2;618;294;324;90,74%;300;300;100,00%;0;0,00%;240;25;10,42%;215;89,58%
MULTIPOLYGON (((-58.374284997240849 -34.631815461238602,-58.373439633536883 -34.632374018702592,-58.373570958288951 -34.632505738746381,-58.374348919157555 -34.633322176361283,-58.3752020401339 -34.632763266125792,-58.375621295381109 -34.633192382932265,-58.375789504953602 -34.633254406327566,-58.376159192117015 -34.632192944471406,-58.376006132751741 -34.632147693456858,-58.375138278851502 -34.631251551251403,-58.374284997240849 -34.631815461238602)));;2267;4_13_3;COMUNA 4;13;3;638;289;349;82,81%;298;298;100,00%;0;0,00%;253;40;15,81%;213;84,19%
MULTIPOLYGON (((-58.375789504953602 -34.633254406327566,-58.375621295381109 -34.633192382932265,-58.3752020401339 -34.632763266125792,-58.374348919157555 -34.633322176361283,-58.374407388464761 -34.633383206595553,-58.375393891114463 -34.634411907755066,-58.375789504953602 -34.633254406327566)));;2268;4_13_4;COMUNA 4;13;4;486;227;259;87,64%;274;274;100,00%;0;0,00%;226;1;0,44%;225;99,56%
MULTIPOLYGON (((-58.377454848772956 -34.633356077844553,-58.375789504953602 -34.633254406327566,-58.375393891114463 -34.634411907755066,-58.375355012505622 -34.634599139482908,-58.377133520359195 -34.63471329114018,-58.377180153095338 -34.634521627520115,-58.377387397787423 -34.633577164622217,-58.377454848772956 -34.633356077844553)));;2269;4_13_5;COMUNA 4;13;5;956;419;537;78,03%;462;462;100,00%;0;0,00%;391;0;0,00%;391;100,00%
MULTIPOLYGON (((-58.377133520359195 -34.63471329114018,-58.377088084964761 -34.634900377964421,-58.376825141162463 -34.636062202271795,-58.376781171268327 -34.636231402074692,-58.376692289828163 -34.636573533467939,-58.376324458166565 -34.637805425427793,-58.376269797903198 -34.638010815755614,-58.376351757862537 -34.638019747331398,-58.377669083042449 -34.638163705584439,-58.378948499647834 -34.63830353894614,-58.380356825702044 -34.638457390092832,-58.380479255727401 -34.63847078297227,-58.380604689914975 -34.638461993949946,-58.380650618071854 -34.638460686786395,-58.380681378600599 -34.63846007365391,-58.380996863437815 -34.637196231157688,-58.381020841521483 -34.637160401005012,-58.381022147505696 -34.637131950268113,-58.381097010154463 -34.63707925221901,-58.381216711170836 -34.633869440270878,-58.381226047114318 -34.633645213879817,-58.381250380819708 -34.633070070587017,-58.381068396908155 -34.633062272618069,-58.380292232922834 -34.633035482215632,-58.380143303553474 -34.633031719410312,-58.380113352033064 -34.632733872528689,-58.380092152435019 -34.632632164715034,-58.379635741163874 -34.632362057203714,-58.379577618533446 -34.632292015320331,-58.379510049223057 -34.632211403240269,-58.379525691563458 -34.632160778450043,-58.379470863213008 -34.632034258039404,-58.379042573186865 -34.631275391240862,-58.379014545654726 -34.631251877923305,-58.378943375051783 -34.631195418768748,-58.378863251176902 -34.631146277602866,-58.378789076573369 -34.631111859270504,-58.378705926296696 -34.631106942724209,-58.378602047778038 -34.631126449253856,-58.378489173537488 -34.631195106028734,-58.378391114030016 -34.631273561993069,-58.378290052428369 -34.631371664331951,-58.378184051111774 -34.631467650417271,-58.377765992815675 -34.632534718872414,-58.377492207536626 -34.633233494331982,-58.377454848772956 -34.633356077844553,-58.377387397787423 -34.633577164622217,-58.377180153095338 -34.634521627520115,-58.377133520359195 -34.63471329114018)));;2270;4_13_6;COMUNA 4;13;6;576;285;291;97,94%;201;201;100,00%;0;0,00%;204;41;20,10%;163;79,90%
MULTIPOLYGON (((-58.377133520359195 -34.63471329114018,-58.375355012505622 -34.634599139482908,-58.375226678890783 -34.635264632322297,-58.375063902408478 -34.636109260874861,-58.376781171268327 -34.636231402074692,-58.376825141162463 -34.636062202271795,-58.377088084964761 -34.634900377964421,-58.377133520359195 -34.63471329114018)));;2271;4_13_7;COMUNA 4;13;7;898;387;511;75,73%;530;530;100,00%;0;0,00%;400;0;0,00%;400;100,00%
MULTIPOLYGON (((-58.374407388464761 -34.633383206595553,-58.374241462133305 -34.634221000820723,-58.374066194794743 -34.635106183805078,-58.375226678890783 -34.635264632322297,-58.375355012505622 -34.634599139482908,-58.375393891114463 -34.634411907755066,-58.374407388464761 -34.633383206595553)));;2272;4_13_8;COMUNA 4;13;8;409;180;229;78,60%;196;196;100,00%;0;0,00%;174;30;17,24%;144;82,76%
MULTIPOLYGON (((-58.375226678890783 -34.635264632322297,-58.374066194794743 -34.635106183805078,-58.373867107140526 -34.636112902244498,-58.375033573980083 -34.636266849754861,-58.375063902408478 -34.636109260874861,-58.375226678890783 -34.635264632322297)));;2273;4_13_9;COMUNA 4;13;9;407;175;232;75,43%;209;209;100,00%;0;0,00%;170;0;0,00%;170;100,00%
MULTIPOLYGON (((-58.376589835416624 -34.627873640941829,-58.375572924785551 -34.627301590783361,-58.375451345960215 -34.627468129171213,-58.374692339725947 -34.628429094836207,-58.374558917811484 -34.628593018035076,-58.37475957122777 -34.628661052443839,-58.375619234825237 -34.62896752442834,-58.374917468234983 -34.62976880851452,-58.374790028285616 -34.629914003220897,-58.376718314625194 -34.63084005611146,-58.376816108356451 -34.630607159597488,-58.377106126841362 -34.629944172574497,-58.377238488024297 -34.629731793573875,-58.377338761298589 -34.629570802122416,-58.377926501399621 -34.628620292444865,-58.377703724730537 -34.628493244154939,-58.376589835416624 -34.627873640941829)));;2274;4_14_1;COMUNA 4;14;1;635;320;315;101,59%;340;340;100,00%;0;0,00%;272;127;46,69%;145;53,31%
MULTIPOLYGON (((-58.374560559030471 -34.626799367799578,-58.373865893691324 -34.626780835097897,-58.373496369744778 -34.628242304386795,-58.373680920999739 -34.628308638598597,-58.374320621025277 -34.628512209123969,-58.374558917811484 -34.628593018035076,-58.374692339725947 -34.628429094836207,-58.375451345960215 -34.627468129171213,-58.375572924785551 -34.627301590783361,-58.374560559030471 -34.626799367799578)));;2275;4_14_2;COMUNA 4;14;2;588;269;319;84,33%;313;313;100,00%;0;0,00%;259;73;28,19%;186;71,81%
MULTIPOLYGON (((-58.373865893691324 -34.626780835097897,-58.372785303778635 -34.626752014238313,-58.372547282168405 -34.626738316972819,-58.370963682331364 -34.626647133265458,-58.370947387365987 -34.626822478997092,-58.370793632074012 -34.628115223303105,-58.372311570822291 -34.628208121201901,-58.372373332246987 -34.627978229720405,-58.372408806186229 -34.627791348346705,-58.373306623657911 -34.628174205466287,-58.373496369744778 -34.628242304386795,-58.373865893691324 -34.626780835097897)));;2276;4_14_3;COMUNA 4;14;3;645;318;327;97,25%;360;360;100,00%;0;0,00%;277;72;25,99%;205;74,01%
MULTIPOLYGON (((-58.372311570822291 -34.628208121201901,-58.370793632074012 -34.628115223303105,-58.37070918426825 -34.628825887477063,-58.370710598819315 -34.628933709019329,-58.370711862099711 -34.629024205928083,-58.370693021383801 -34.629189408455886,-58.372026539662428 -34.629269353326343,-58.372085907555444 -34.629048263360971,-58.372311570822291 -34.628208121201901)));;2277;4_14_4;COMUNA 4;14;4;1110;502;608;82,57%;654;654;100,00%;0;0,00%;495;8;1,62%;487;98,38%
MULTIPOLYGON (((-58.372774028613804 -34.630253530734265,-58.371982056440871 -34.629434889108282,-58.372026539662428 -34.629269353326343,-58.370693021383801 -34.629189408455886,-58.370688892227655 -34.629225322022762,-58.370658180047961 -34.62949375843327,-58.371049577053007 -34.629885051978199,-58.371662737337793 -34.630522996948741,-58.371933279816311 -34.630804404999616,-58.372688425678099 -34.630311849797422,-58.372774028613804 -34.630253530734265)));;2278;4_14_5;COMUNA 4;14;5;669;294;375;78,40%;344;344;100,00%;0;0,00%;302;2;0,66%;300;99,34%
MULTIPOLYGON (((-58.372774028613804 -34.630253530734265,-58.372688425678099 -34.630311849797422,-58.371933279816311 -34.630804404999616,-58.372607473715654 -34.631505772896411,-58.372727556694876 -34.631630654351376,-58.372978787318822 -34.631892045137448,-58.373325506229946 -34.63225498758748,-58.373439633536883 -34.632374018702592,-58.374284997240849 -34.631815461238602,-58.373459378710599 -34.630962015121909,-58.372774028613804 -34.630253530734265)));;2279;4_14_6;COMUNA 4;14;6;497;231;266;86,84%;297;297;100,00%;0;0,00%;208;0;0,00%;208;100,00%
MULTIPOLYGON (((-58.372774028613804 -34.630253530734265,-58.373459378710599 -34.630962015121909,-58.374284997240849 -34.631815461238602,-58.375138278851502 -34.631251551251403,-58.374333354060965 -34.630404252785219,-58.373661291089562 -34.629696698464429,-58.373694988802754 -34.629655242814351,-58.373187496316717 -34.629463808785616,-58.373496369744778 -34.628242304386795,-58.373306623657911 -34.628174205466287,-58.372408806186229 -34.627791348346705,-58.372373332246987 -34.627978229720405,-58.372311570822291 -34.628208121201901,-58.372085907555444 -34.629048263360971,-58.372026539662428 -34.629269353326343,-58.371982056440871 -34.629434889108282,-58.372774028613804 -34.630253530734265)));;2280;4_14_7;COMUNA 4;14;7;757;351;406;86,45%;335;335;100,00%;0;0,00%;289;33;11,42%;256;88,58%
MULTIPOLYGON (((-58.374558917811484 -34.628593018035076,-58.374320621025277 -34.628512209123969,-58.373680920999739 -34.628308638598597,-58.373496369744778 -34.628242304386795,-58.373187496316717 -34.629463808785616,-58.373694988802754 -34.629655242814351,-58.373661291089562 -34.629696698464429,-58.374333354060965 -34.630404252785219,-58.374644930366429 -34.630079396978388,-58.374790028285616 -34.629914003220897,-58.374917468234983 -34.62976880851452,-58.375619234825237 -34.62896752442834,-58.37475957122777 -34.628661052443839,-58.374558917811484 -34.628593018035076)));;2281;4_14_8;COMUNA 4;14;8;992;460;532;86,47%;440;440;100,00%;0;0,00%;410;72;17,56%;338;82,44%
MULTIPOLYGON (((-58.374790028285616 -34.629914003220897,-58.374644930366429 -34.630079396978388,-58.374333354060965 -34.630404252785219,-58.375138278851502 -34.631251551251403,-58.376006132751741 -34.632147693456858,-58.376159192117015 -34.632192944471406,-58.376233522970487 -34.631994539999518,-58.376718314625194 -34.63084005611146,-58.374790028285616 -34.629914003220897)));;2282;4_14_9;COMUNA 4;14;9;664;326;338;96,45%;363;363;100,00%;0;0,00%;262;18;6,87%;244;93,13%
MULTIPOLYGON (((-58.370658180047961 -34.62949375843327,-58.370631252738612 -34.629729309271546,-58.370614562211223 -34.629875921228361,-58.370533186938196 -34.630809834161852,-58.370452326165832 -34.63173909924631,-58.370435671147249 -34.631929937952592,-58.370359256411362 -34.632689411914257,-58.370566608295505 -34.632715555480509,-58.371290288393688 -34.632814060918953,-58.371375112061273 -34.63199290052458,-58.371397864127886 -34.631834250404481,-58.371420186633259 -34.631678769072167,-58.371574535503512 -34.631087104542999,-58.371583029586837 -34.631032883757925,-58.371933279816311 -34.630804404999616,-58.371662737337793 -34.630522996948741,-58.371049577053007 -34.629885051978199,-58.370658180047961 -34.62949375843327)));;2283;4_15_1;COMUNA 4;15;1;639;295;344;85,76%;328;328;100,00%;0;0,00%;259;3;1,16%;256;98,84%
MULTIPOLYGON (((-58.371545312562596 -34.637551023653813,-58.370642387182215 -34.637465694888689,-58.370785852937551 -34.636636058390586,-58.370130037150027 -34.636548306088081,-58.36980425398577 -34.636509747303684,-58.369670282155198 -34.637374883982986,-58.369570553026364 -34.638018349391885,-58.370525159891301 -34.638143585574667,-58.37140062342889 -34.638258402624693,-58.371545312562596 -34.637551023653813)));;2284;4_15_10;COMUNA 4;15;10;527;246;281;87,54%;204;204;100,00%;0;0,00%;188;2;1,06%;186;98,94%
MULTIPOLYGON (((-58.371933279816311 -34.630804404999616,-58.371583029586837 -34.631032883757925,-58.371574535503512 -34.631087104542999,-58.371420186633259 -34.631678769072167,-58.371397864127886 -34.631834250404481,-58.371375112061273 -34.63199290052458,-58.371290288393688 -34.632814060918953,-58.371485286171108 -34.632840616212931,-58.372468022295315 -34.632980788344483,-58.372510341903784 -34.632768418373423,-58.372727556694876 -34.631630654351376,-58.372607473715654 -34.631505772896411,-58.371933279816311 -34.630804404999616)));;2285;4_15_2;COMUNA 4;15;2;1292;580;712;81,46%;793;793;100,00%;0;0,00%;624;9;1,44%;615;98,56%
MULTIPOLYGON (((-58.373439633536883 -34.632374018702592,-58.373325506229946 -34.63225498758748,-58.372978787318822 -34.631892045137448,-58.372727556694876 -34.631630654351376,-58.372510341903784 -34.632768418373423,-58.372468022295315 -34.632980788344483,-58.373450080202453 -34.633120881636223,-58.373266488904122 -34.634055636602483,-58.374241462133305 -34.634221000820723,-58.374407388464761 -34.633383206595553,-58.374348919157555 -34.633322176361283,-58.373570958288951 -34.632505738746381,-58.373439633536883 -34.632374018702592)));;2286;4_15_3;COMUNA 4;15;3;1064;476;588;80,95%;579;579;100,00%;0;0,00%;483;0;0,00%;483;100,00%
MULTIPOLYGON (((-58.373450080202453 -34.633120881636223,-58.372468022295315 -34.632980788344483,-58.371485286171108 -34.632840616212931,-58.371290288393688 -34.632814060918953,-58.370566608295505 -34.632715555480509,-58.370359256411362 -34.632689411914257,-58.370335393531974 -34.632925809980016,-58.370279072475505 -34.633389092206642,-58.370247800528993 -34.633621892947815,-58.370524076469522 -34.63365449746756,-58.371194439947153 -34.633741906465417,-58.371993016866099 -34.633846027453856,-58.372286831573703 -34.63389195131257,-58.372468879381167 -34.633920326476456,-58.373266488904122 -34.634055636602483,-58.373450080202453 -34.633120881636223)));;2287;4_15_4;COMUNA 4;15;4;732;335;397;84,38%;352;352;100,00%;0;0,00%;297;4;1,35%;293;98,65%
MULTIPOLYGON (((-58.373266488904122 -34.634055636602483,-58.372468879381167 -34.633920326476456,-58.372286831573703 -34.63389195131257,-58.371993016866099 -34.633846027453856,-58.371194439947153 -34.633741906465417,-58.371096091495296 -34.634694257747299,-58.372099894448134 -34.634834166941239,-58.373084447584752 -34.63497137758835,-58.373341810298463 -34.635007271790329,-58.374066194794743 -34.635106183805078,-58.374241462133305 -34.634221000820723,-58.373266488904122 -34.634055636602483)));;2288;4_15_5;COMUNA 4;15;5;542;251;291;86,25%;258;258;100,00%;0;0,00%;219;4;1,83%;215;98,17%
MULTIPOLYGON (((-58.371194439947153 -34.633741906465417,-58.370524076469522 -34.63365449746756,-58.370247800528993 -34.633621892947815,-58.37023010321456 -34.633753080959963,-58.370105920496663 -34.634557942306259,-58.369950581528485 -34.635564617185672,-58.369917625304645 -34.635778049659734,-58.36980425398577 -34.636509747303684,-58.370130037150027 -34.636548306088081,-58.370785852937551 -34.636636058390586,-58.371708831645321 -34.636763867202426,-58.37174334984266 -34.63659874684037,-58.371898406332505 -34.635833204107946,-58.371946036240324 -34.635598161604555,-58.372051231705264 -34.63507956121272,-58.372099894448134 -34.634834166941239,-58.371096091495296 -34.634694257747299,-58.371194439947153 -34.633741906465417)));;2289;4_15_6;COMUNA 4;15;6;594;273;321;85,05%;315;315;100,00%;0;0,00%;240;13;5,42%;227;94,58%
MULTIPOLYGON (((-58.373084447584752 -34.63497137758835,-58.372099894448134 -34.634834166941239,-58.372051231705264 -34.63507956121272,-58.371946036240324 -34.635598161604555,-58.371898406332505 -34.635833204107946,-58.372149890374153 -34.635870645790341,-58.372637102321846 -34.635939881982296,-58.37288100651454 -34.635974781267173,-58.37357898402481 -34.636074873937694,-58.373867107140526 -34.636112902244498,-58.374066194794743 -34.635106183805078,-58.373341810298463 -34.635007271790329,-58.373084447584752 -34.63497137758835)));;2290;4_15_7;COMUNA 4;15;7;644;292;352;82,95%;317;317;100,00%;0;0,00%;274;2;0,73%;272;99,27%
MULTIPOLYGON (((-58.37288100651454 -34.635974781267173,-58.372637102321846 -34.635939881982296,-58.372149890374153 -34.635870645790341,-58.371898406332505 -34.635833204107946,-58.37174334984266 -34.63659874684037,-58.371708831645321 -34.636763867202426,-58.372692472856478 -34.636898122467393,-58.373685062532466 -34.63703364397621,-58.373867107140526 -34.636112902244498,-58.37357898402481 -34.636074873937694,-58.37288100651454 -34.635974781267173)));;2291;4_15_8;COMUNA 4;15;8;671;298;373;79,89%;340;340;100,00%;0;0,00%;270;0;0,00%;270;100,00%
MULTIPOLYGON (((-58.372692472856478 -34.636898122467393,-58.371708831645321 -34.636763867202426,-58.370785852937551 -34.636636058390586,-58.370642387182215 -34.637465694888689,-58.371545312562596 -34.637551023653813,-58.37140062342889 -34.638258402624693,-58.372397748210958 -34.638389289952308,-58.373377751920764 -34.638517832572234,-58.373436961816957 -34.638288009500897,-58.373545335740857 -34.637739831967714,-58.373685062532466 -34.63703364397621,-58.372692472856478 -34.636898122467393)));;2292;4_15_9;COMUNA 4;15;9;663;316;347;91,07%;290;290;100,00%;0;0,00%;254;8;3,15%;246;96,85%
MULTIPOLYGON (((-58.367971222901353 -34.625195431129946,-58.366487910717062 -34.625195326570669,-58.36646877790627 -34.625385670004825,-58.366335296560486 -34.626475530814474,-58.366302242122849 -34.626695371212683,-58.36624097957138 -34.626848637769946,-58.366110920330449 -34.627039386300218,-58.366959478046461 -34.627255837134811,-58.367369685970125 -34.627638072561361,-58.367568017250832 -34.627494138093972,-58.367976864869448 -34.626902816796914,-58.367965794790607 -34.625473887003309,-58.367971222901353 -34.625195431129946)));;2293;4_16_1;COMUNA 4;16;1;681;309;372;83,06%;290;290;100,00%;0;0,00%;259;0;0,00%;259;100,00%
MULTIPOLYGON (((-58.360042421840106 -34.631049210399247,-58.359431805393626 -34.631452370094728,-58.360522921233425 -34.631906191096171,-58.360814846016751 -34.632023692633616,-58.360939550003508 -34.631978654424564,-58.362354069076972 -34.631047471993604,-58.361618770928246 -34.630293389463993,-58.361451652176918 -34.630118526809049,-58.360042421840106 -34.631049210399247)));;2294;4_16_10;COMUNA 4;16;10;786;361;425;84,94%;317;317;100,00%;0;0,00%;280;17;6,07%;263;93,93%
MULTIPOLYGON (((-58.368305448133 -34.627368861726751,-58.368091298214246 -34.627189394055243,-58.368023336653827 -34.627167509608974,-58.367945155304767 -34.627142377641498,-58.3679784282022 -34.627101486623936,-58.367977609819718 -34.626996975453352,-58.367976864869448 -34.626902816796914,-58.367568017250832 -34.627494138093972,-58.367369685970125 -34.627638072561361,-58.366886824515163 -34.627980663392712,-58.366986063634322 -34.628068068152096,-58.366610991035294 -34.628320809834868,-58.366077921864161 -34.628680048550997,-58.36556206848433 -34.629030354665893,-58.365842905104444 -34.62937594151844,-58.365982901910371 -34.629582327018852,-58.366188470464785 -34.629963417893265,-58.366313391173286 -34.63024148356471,-58.366450742260376 -34.630601603852661,-58.366463947328874 -34.630676123759464,-58.366518122418675 -34.630981669465136,-58.366574572396686 -34.632122173756997,-58.366593889147069 -34.632512272095695,-58.366578057220735 -34.632868116248794,-58.366541015520149 -34.633219013922037,-58.36648945974504 -34.633521518269156,-58.366349841492976 -34.633938886332587,-58.366243144022192 -34.634179936536405,-58.365710270084016 -34.633971831200142,-58.365239938135936 -34.633763280548372,-58.364824608218846 -34.634387686414577,-58.364682046587554 -34.634618917398086,-58.364563642862286 -34.634811081883768,-58.364186061577797 -34.635424177435688,-58.364041618059147 -34.635658645648235,-58.363768521368861 -34.636102452693493,-58.363685612613708 -34.636249361930012,-58.36393064000567 -34.636340619844603,-58.364692693241331 -34.636650399366161,-58.364943572449206 -34.636766942438065,-58.36511987027184 -34.636833705453967,-58.365224511045767 -34.636754068285619,-58.365600653325536 -34.636058360235666,-58.365640700117353 -34.635984868637607,-58.365770155727091 -34.635740034186114,-58.365761317628184 -34.635720096947153,-58.366099936395834 -34.635119078750762,-58.366922728322926 -34.635214308146999,-58.367219714712647 -34.634278665844498,-58.367509853452709 -34.6333647081686,-58.367806056912691 -34.63243159882574,-58.368095327623983 -34.631520385362386,-58.368386472989876 -34.630603327258484,-58.367162121428812 -34.630336309325799,-58.367467743331794 -34.629356304753848,-58.367577730690833 -34.629359418846249,-58.368350887725974 -34.629524883943795,-58.368615449095415 -34.629582343710261,-58.368716259276894 -34.629564251814159,-58.369444475918961 -34.628323149896886,-58.368634590613595 -34.627644618140785,-58.368305448133 -34.627368861726751)));;2295;4_16_2;COMUNA 4;16;2;1933;866;1067;81,16%;1405;1405;100,00%;0;0,00%;929;48;5,17%;881;94,83%
MULTIPOLYGON (((-58.368716259276894 -34.629564251814159,-58.368615449095415 -34.629582343710261,-58.368350887725974 -34.629524883943795,-58.367577730690833 -34.629359418846249,-58.367467743331794 -34.629356304753848,-58.367162121428812 -34.630336309325799,-58.368386472989876 -34.630603327258484,-58.368716259276894 -34.629564251814159)));;2296;4_16_3;COMUNA 4;16;3;1245;557;688;80,96%;470;470;100,00%;0;0,00%;438;5;1,14%;433;98,86%
MULTIPOLYGON (((-58.370248054350348 -34.629092378660282,-58.369630093562272 -34.628499917251823,-58.369444475918961 -34.628323149896886,-58.368716259276894 -34.629564251814159,-58.368386472989876 -34.630603327258484,-58.368095327623983 -34.631520385362386,-58.369110045601282 -34.631613424723689,-58.369371102808124 -34.630698031380199,-58.370533186938196 -34.630809834161852,-58.370614562211223 -34.629875921228361,-58.370631252738612 -34.629729309271546,-58.370658180047961 -34.62949375843327,-58.370459206459707 -34.62929479873624,-58.370248054350348 -34.629092378660282)));;2297;4_16_4;COMUNA 4;16;4;646;277;369;75,07%;299;299;100,00%;0;0,00%;267;16;5,99%;251;94,01%
MULTIPOLYGON (((-58.369110045601282 -34.631613424723689,-58.368847443459401 -34.632533745915154,-58.370095509143027 -34.632656112283414,-58.370359256411362 -34.632689411914257,-58.370435671147249 -34.631929937952592,-58.370452326165832 -34.63173909924631,-58.370533186938196 -34.630809834161852,-58.369371102808124 -34.630698031380199,-58.369110045601282 -34.631613424723689)));;2298;4_16_5;COMUNA 4;16;5;970;432;538;80,30%;462;462;100,00%;0;0,00%;412;18;4,37%;394;95,63%
MULTIPOLYGON (((-58.370359256411362 -34.632689411914257,-58.370095509143027 -34.632656112283414,-58.368847443459401 -34.632533745915154,-58.368582440124378 -34.633462656371883,-58.368583820741094 -34.633673579755097,-58.368472155516841 -34.634395699949103,-58.369869856732691 -34.634526282976779,-58.370105920496663 -34.634557942306259,-58.37023010321456 -34.633753080959963,-58.370247800528993 -34.633621892947815,-58.370279072475505 -34.633389092206642,-58.370335393531974 -34.632925809980016,-58.370359256411362 -34.632689411914257)));;2299;4_16_6;COMUNA 4;16;6;557;256;301;85,05%;289;289;100,00%;0;0,00%;248;37;14,92%;211;85,08%
MULTIPOLYGON (((-58.367806056912691 -34.63243159882574,-58.367509853452709 -34.6333647081686,-58.367219714712647 -34.634278665844498,-58.368472155516841 -34.634395699949103,-58.368583820741094 -34.633673579755097,-58.368582440124378 -34.633462656371883,-58.368847443459401 -34.632533745915154,-58.369110045601282 -34.631613424723689,-58.368095327623983 -34.631520385362386,-58.367806056912691 -34.63243159882574)));;2300;4_16_7;COMUNA 4;16;7;401;188;213;88,26%;186;186;100,00%;0;0,00%;156;5;3,21%;151;96,79%
MULTIPOLYGON (((-58.364079860660112 -34.62991130704161,-58.363178293533089 -34.628978360921991,-58.362449102395409 -34.629459892373397,-58.361451652176918 -34.630118526809049,-58.361618770928246 -34.630293389463993,-58.362354069076972 -34.631047471993604,-58.363302326655685 -34.631991096108152,-58.363080886995547 -34.632135708894076,-58.36235233278282 -34.632630902427323,-58.36378680035304 -34.633193430390349,-58.364500123889044 -34.633473170750776,-58.365239938135936 -34.633763280548372,-58.365710270084016 -34.633971831200142,-58.366243144022192 -34.634179936536405,-58.366349841492976 -34.633938886332587,-58.36648945974504 -34.633521518269156,-58.366541015520149 -34.633219013922037,-58.366578057220735 -34.632868116248794,-58.366593889147069 -34.632512272095695,-58.366574572396686 -34.632122173756997,-58.366518122418675 -34.630981669465136,-58.366463947328874 -34.630676123759464,-58.366450742260376 -34.630601603852661,-58.366313391173286 -34.63024148356471,-58.366188470464785 -34.629963417893265,-58.365982901910371 -34.629582327018852,-58.365842905104444 -34.62937594151844,-58.36556206848433 -34.629030354665893,-58.36551119311806 -34.628967776859838,-58.365310993264629 -34.629100720171358,-58.364806571967804 -34.629432862575463,-58.364079860660112 -34.62991130704161)));;2301;4_16_8;COMUNA 4;16;8;611;297;314;94,59%;258;258;100,00%;0;0,00%;219;65;29,68%;154;70,32%
MULTIPOLYGON (((-58.362354069076972 -34.631047471993604,-58.360939550003508 -34.631978654424564,-58.360814846016751 -34.632023692633616,-58.361230422997778 -34.632190945903567,-58.36235233278282 -34.632630902427323,-58.363080886995547 -34.632135708894076,-58.363302326655685 -34.631991096108152,-58.362354069076972 -34.631047471993604)));;2302;4_16_9;COMUNA 4;16;9;1064;491;573;85,69%;514;514;100,00%;0;0,00%;431;25;5,80%;406;94,20%
MULTIPOLYGON (((-58.360679055202837 -34.627623082294875,-58.361417275227495 -34.627138258802404,-58.361417373058579 -34.627138204886492,-58.361599313631757 -34.62701868751666,-58.362140741155784 -34.626658982199636,-58.362140844211801 -34.626658929441014,-58.362754552338025 -34.626251163156212,-58.364053458985637 -34.626591738922706,-58.364237168549224 -34.626639917128792,-58.365226693028703 -34.626876142276593,-58.365345652295439 -34.626999692107923,-58.365666112054242 -34.627332705039606,-58.366110920330449 -34.627039386300218,-58.36624097957138 -34.626848637769946,-58.366302242122849 -34.626695371212683,-58.366335296560486 -34.626475530814474,-58.36646877790627 -34.625385670004825,-58.366487910717062 -34.625195326570669,-58.363727109594358 -34.625127974727064,-58.363455008161374 -34.625121344980691,-58.363090985265309 -34.625112456427779,-58.362999010546346 -34.625012237068148,-58.362206646785374 -34.624144656181819,-58.361947229277746 -34.623866968007469,-58.361897116709493 -34.623812488142342,-58.36179025920238 -34.623904374739389,-58.361026927168695 -34.624398123810501,-58.361262308015881 -34.624684597044507,-58.36119963858502 -34.624727504109586,-58.359779271440495 -34.625641696870723,-58.359550773531303 -34.625784607255312,-58.359471268328463 -34.625799681351097,-58.35944526237148 -34.625817124714594,-58.359319081902946 -34.625891668229315,-58.359334562602832 -34.625911611593992,-58.355828186512383 -34.628184651597913,-58.35580362640399 -34.628202870117086,-58.355775145417653 -34.628222493691581,-58.355748711224052 -34.628240499282121,-58.355724150720278 -34.628258999484196,-58.355695667978146 -34.628279961110827,-58.355663263806179 -34.62830275033614,-58.355640151886568 -34.628321040517633,-58.355614399571159 -34.628338764977755,-58.355581138676371 -34.628365215521768,-58.355552910276408 -34.628387092861196,-58.355531929686805 -34.628404258096275,-58.355505749253567 -34.628423601928873,-58.355484768101505 -34.628441189704404,-58.355465238011391 -34.628456666006066,-58.355448521959737 -34.628470172882778,-58.355424129449965 -34.628490433792891,-58.355395046545667 -34.62851421181503,-58.35537304225457 -34.628532362069834,-58.355350099422978 -34.628551567867554,-58.355334235941797 -34.628564582504644,-58.355312913293552 -34.62858266292357,-58.355288605552182 -34.62860320558022,-58.355257642780352 -34.628631207405306,-58.355236916571016 -34.628649217911224,-58.355210392114557 -34.628670955821669,-58.355182418197536 -34.628693537546916,-58.355162881449637 -34.628714084383461,-58.355135667193132 -34.628742159906587,-58.355118436118616 -34.628758553702369,-58.355103251959974 -34.628773259104683,-58.355081501219871 -34.628792888451684,-58.355059918863631 -34.628814067290243,-58.355034158448483 -34.628837848156799,-58.354992445131863 -34.628877812649328,-58.354969837901294 -34.628900892037763,-58.354948852691855 -34.628921437559903,-58.354934518538208 -34.628937622613627,-58.354920014803255 -34.628953173692068,-58.354903209540176 -34.628969638257907,-58.354877784538814 -34.628997504028838,-58.354855093230896 -34.629019667798033,-58.354829327406932 -34.62904753325725,-58.354810556631172 -34.629068573687377,-58.354792894876844 -34.629088488297967,-58.354770884283717 -34.629111286477013,-58.354755439206592 -34.629130005820876,-58.354734704918712 -34.629154072770085,-58.354714825700682 -34.629175746027613,-58.354695457568766 -34.629197490159221,-58.354671392948795 -34.629227399411263,-58.354659019977277 -34.629242248096418,-58.354646647001353 -34.629257096780272,-58.354634273929676 -34.629272015887587,-58.354621900944906 -34.62928686456884,-58.354609613245131 -34.629301642899527,-58.354597240251536 -34.629316491578201,-58.354584867253564 -34.629331340255561,-58.354572494159797 -34.629346259356389,-58.354560121152979 -34.629361108031148,-58.354547748141734 -34.629375956704621,-58.35453546032425 -34.629390805452346,-58.35452308739562 -34.629405583698443,-58.354510629081574 -34.629420502717203,-58.354498341250881 -34.629435351461062,-58.354485968217595 -34.629450200128026,-58.35447359517989 -34.629465048793712,-58.354451067721961 -34.629492071945847,-58.354439971731097 -34.629507625989831,-58.354428875827573 -34.629523109607973,-58.354417865118222 -34.629538593300737,-58.354406683825111 -34.629554217690689,-58.354395587909167 -34.629569701305662,-58.354384491989101 -34.629585184919605,-58.354373310866549 -34.62960066845681,-58.354362214938213 -34.629616152068635,-58.354351118914195 -34.629631706104142,-58.354340022886035 -34.629647260138611,-58.354328841746849 -34.629662743671567,-58.354317745801964 -34.62967822727915,-58.354306734959842 -34.629693781386145,-58.354295639006715 -34.629709264991611,-58.354284457850952 -34.629724748520317,-58.354273361706291 -34.629740372973195,-58.354262265740758 -34.629755856575493,-58.354244426805437 -34.629780771110752,-58.354226503027512 -34.629805403868424,-58.354210282202594 -34.629830812811392,-58.354198670070453 -34.629850098890216,-58.354184160353782 -34.629870016213644,-58.354169902007463 -34.629893173301802,-58.35415564227737 -34.629917386759658,-58.354139679115065 -34.629941176150595,-58.354123880927837 -34.629969120751994,-58.354106207255818 -34.629997908779593,-58.354090752228025 -34.630024022636007,-58.354075807190213 -34.630051052467465,-58.354059153850713 -34.630081390743058,-58.354043951359273 -34.630109828837874,-58.354024308871111 -34.630145657583249,-58.354005516151197 -34.630183177278703,-58.353984508240295 -34.63022069499663,-58.353964009850721 -34.630259480812043,-58.353942142282911 -34.630302843017525,-58.353927703102073 -34.630333887496441,-58.353909766056809 -34.630368520520548,-58.353893961642711 -34.630401113123881,-58.35387678556836 -34.63044018358638,-58.353858756841369 -34.630479746259191,-58.353831422973002 -34.630533385591555,-58.35380903109322 -34.630586677205137,-58.353784341285191 -34.630638065291606,-58.353763653981026 -34.63069086544413,-58.35374579158573 -34.630733456514982,-58.353725357621876 -34.630787947082467,-58.353707493712413 -34.630831664942995,-58.353690824145524 -34.630874186645819,-58.353677141710818 -34.630912767225411,-58.353660381844371 -34.630959162208562,-58.353641822717762 -34.631013231886968,-58.353627801097112 -34.631050544509883,-58.353609148892851 -34.631110600209823,-58.353586996178365 -34.631176216336456,-58.353795067936119 -34.631231333661837,-58.354088563658664 -34.630657351273399,-58.354258092905667 -34.630343689034461,-58.35451044215975 -34.630023902644837,-58.354870338921117 -34.629550121268288,-58.355286330637966 -34.629178433815028,-58.355650337807447 -34.628881067955298,-58.355975403567157 -34.628653035414729,-58.356842845411727 -34.628080110359413,-58.357046211325489 -34.627945000506081,-58.357301845967974 -34.627775216023657,-58.358464949577304 -34.627026190545955,-58.359678377220483 -34.628280361663229,-58.359949012090837 -34.628102555871223,-58.360433832581485 -34.627784149911733,-58.360634802586446 -34.627652201173291,-58.360679055202837 -34.627623082294875)));;2303;4_17_1;COMUNA 4;17;1;577;273;304;89,80%;249;249;100,00%;0;0,00%;221;1;0,45%;220;99,55%
MULTIPOLYGON (((-58.358464949577304 -34.627026190545955,-58.357301845967974 -34.627775216023657,-58.357046211325489 -34.627945000506081,-58.356842845411727 -34.628080110359413,-58.355975403567157 -34.628653035414729,-58.355650337807447 -34.628881067955298,-58.355286330637966 -34.629178433815028,-58.354870338921117 -34.629550121268288,-58.35451044215975 -34.630023902644837,-58.354258092905667 -34.630343689034461,-58.356401604020462 -34.6312247595773,-58.356570126904536 -34.631293993088015,-58.357528129586385 -34.631689835769912,-58.358019665375792 -34.630865161278805,-58.358170831544776 -34.63091571510359,-58.359235508590309 -34.63021321955673,-58.360646011724711 -34.629282546221802,-58.359938577703616 -34.628549885842709,-58.359838432150099 -34.628443107759928,-58.359678377220483 -34.628280361663229,-58.358464949577304 -34.627026190545955)));;2304;4_17_10;COMUNA 4;17;10;881;425;456;93,20%;301;301;100,00%;0;0,00%;280;47;16,79%;233;83,21%
MULTIPOLYGON (((-58.36661099103528 -34.628320809834861,-58.366986063634322 -34.628068068152096,-58.366886824515163 -34.627980663392712,-58.367369685970097 -34.627638072561361,-58.366959478046432 -34.627255837134811,-58.366110920330449 -34.627039386300225,-58.365666112054235 -34.627332705039585,-58.365345652295439 -34.626999692107923,-58.365226693028703 -34.626876142276579,-58.364237168549224 -34.62663991712877,-58.364053458985637 -34.626591738922706,-58.363522022344441 -34.626935874869467,-58.363591733992678 -34.627022497268534,-58.363700678011803 -34.627141613625533,-58.363992625767494 -34.627480899348868,-58.364228968031021 -34.627728252141303,-58.36455481721157 -34.628069278559309,-58.364667686438636 -34.627994675243059,-58.365573788343653 -34.628916275717629,-58.365541547079737 -34.628947589105501,-58.36551119311806 -34.628967776859838,-58.36556206848433 -34.629030354665872,-58.366077921864161 -34.628680048550997,-58.36661099103528 -34.628320809834861)));;2305;4_17_2;COMUNA 4;17;2;590;268;322;83,23%;297;297;100,00%;0;0,00%;240;8;3,33%;232;96,67%
MULTIPOLYGON (((-58.363905856331847 -34.628497809694984,-58.363178293533089 -34.628978360921991,-58.364079860660112 -34.62991130704161,-58.364806571967804 -34.629432862575463,-58.365310993264629 -34.629100720171358,-58.36551119311806 -34.628967776859838,-58.365541547079751 -34.628947589105515,-58.365573788343667 -34.628916275717629,-58.364667686438636 -34.627994675243073,-58.36455481721157 -34.628069278559323,-58.364185777720834 -34.628312959535442,-58.363905856331847 -34.628497809694984)));;2306;4_17_3;COMUNA 4;17;3;584;273;311;87,78%;261;261;100,00%;0;0,00%;217;30;13,82%;187;86,18%
MULTIPOLYGON (((-58.36214084421178 -34.626658929441014,-58.362226251781401 -34.62668352229457,-58.3628885940809 -34.62736447911329,-58.362954077280605 -34.627320587552674,-58.363673565634947 -34.628031831230118,-58.363809732782912 -34.627941023187169,-58.363845159317655 -34.627976584134778,-58.364185777720834 -34.628312959535421,-58.36455481721157 -34.628069278559309,-58.364228968031021 -34.627728252141303,-58.363992625767494 -34.627480899348868,-58.363700678011803 -34.627141613625533,-58.363591733992678 -34.627022497268534,-58.363522022344441 -34.626935874869467,-58.364053458985637 -34.626591738922706,-58.362754552338025 -34.626251163156205,-58.36214084421178 -34.626658929441014)));;2307;4_17_4;COMUNA 4;17;4;675;286;389;73,52%;340;340;100,00%;0;0,00%;296;1;0,34%;295;99,66%
MULTIPOLYGON (((-58.362156755938003 -34.627848826182458,-58.362364135775941 -34.628064353812412,-58.362856982758665 -34.62857646533088,-58.363673565634976 -34.628031831230132,-58.362954077280619 -34.627320587552674,-58.362888594080914 -34.627364479113311,-58.362226251781401 -34.62668352229457,-58.362140844211801 -34.626658929441014,-58.362140741155784 -34.626658982199636,-58.361599313631757 -34.62701868751666,-58.361417373058579 -34.627138204886492,-58.361637931282843 -34.627370897916542,-58.361729303023061 -34.627319464810519,-58.362133546519566 -34.627716569323802,-58.362068094830803 -34.627761394274053,-58.362156683526806 -34.627848754775293,-58.362156755938003 -34.627848826182458)));;2308;4_17_5;COMUNA 4;17;5;759;343;416;82,45%;394;394;100,00%;0;0,00%;328;0;0,00%;328;100,00%
MULTIPOLYGON (((-58.362156683526806 -34.627848754775293,-58.362068094830803 -34.627761394274053,-58.362133546519566 -34.627716569323802,-58.361729303023061 -34.627319464810519,-58.361637931282843 -34.627370897916542,-58.361417373058579 -34.627138204886492,-58.361417275227495 -34.627138258802404,-58.360679055202837 -34.627623082294875,-58.360634802586446 -34.627652201173291,-58.360883607129303 -34.627905938657825,-58.361310274986884 -34.628394056715635,-58.361526163193943 -34.628255006009397,-58.361865341634605 -34.628036476794044,-58.362156683526806 -34.627848754775293)));;2309;4_17_6;COMUNA 4;17;6;607;271;336;80,65%;342;342;100,00%;0;0,00%;280;1;0,36%;279;99,64%
MULTIPOLYGON (((-58.362080568099316 -34.629079153831626,-58.362346991530934 -34.629354311969486,-58.362449102395409 -34.629459892373397,-58.363178293533089 -34.628978360921991,-58.363905856331847 -34.628497809694984,-58.364185777720834 -34.628312959535442,-58.363848281030371 -34.62797971768974,-58.363845159317655 -34.627976584134778,-58.363809732782926 -34.627941023187184,-58.363673565634976 -34.628031831230132,-58.362856982758665 -34.62857646533088,-58.362364135775941 -34.628064353812412,-58.36215668581309 -34.627848753302146,-58.361865341634605 -34.628036476794044,-58.361526163193943 -34.628255006009397,-58.361310274986884 -34.628394056715635,-58.361572175659163 -34.628671325558905,-58.361641581964548 -34.62862553649498,-58.362080568099316 -34.629079153831626)));;2310;4_17_7;COMUNA 4;17;7;609;281;328;85,67%;303;303;100,00%;0;0,00%;255;14;5,49%;241;94,51%
MULTIPOLYGON (((-58.359235508590309 -34.63021321955673,-58.358170831544776 -34.63091571510359,-58.358019665375792 -34.630865161278805,-58.357528129586385 -34.631689835769912,-58.357789474312654 -34.631797810824189,-58.358981071697855 -34.632292930495382,-58.359067905518621 -34.632144830478474,-58.359431805393626 -34.631452370094728,-58.360042421840106 -34.631049210399247,-58.361451652176918 -34.630118526809049,-58.362449102395409 -34.629459892373397,-58.362346991530934 -34.629354311969486,-58.362080568099316 -34.629079153831626,-58.361641581964548 -34.62862553649498,-58.361572175659163 -34.628671325558905,-58.360646011724711 -34.629282546221802,-58.359235508590309 -34.63021321955673)));;2311;4_17_8;COMUNA 4;17;8;994;496;498;99,60%;409;409;100,00%;0;0,00%;358;87;24,30%;271;75,70%
MULTIPOLYGON (((-58.360433832581485 -34.627784149911733,-58.359949012090837 -34.628102555871223,-58.359678377220483 -34.628280361663229,-58.359838432150099 -34.628443107759928,-58.359938577703616 -34.628549885842709,-58.360646011724711 -34.629282546221802,-58.361572175659163 -34.628671325558905,-58.361310274986884 -34.628394056715635,-58.360883607129303 -34.627905938657825,-58.360634802586446 -34.627652201173291,-58.360433832581485 -34.627784149911733)));;2312;4_17_9;COMUNA 4;17;9;757;332;425;78,12%;438;438;100,00%;0;0,00%;337;1;0,30%;336;99,70%
MULTIPOLYGON (((-58.351239078147749 -34.619306794037136,-58.350856962271081 -34.61946954852263,-58.350874481971772 -34.619618231678515,-58.350785307285101 -34.619668715023685,-58.350678289178177 -34.619557979183888,-58.350160362057949 -34.619734621256427,-58.349579979576681 -34.619793030146049,-58.349091107615138 -34.619650035725613,-58.348320111184627 -34.619059999183229,-58.347842935489091 -34.618964970118292,-58.347301698410938 -34.618932556824348,-58.347224665259191 -34.618949597196981,-58.346556828436803 -34.619108827873532,-58.346340827548005 -34.619022562730734,-58.345968029368194 -34.61885220070986,-58.345915049144878 -34.618847642804589,-58.345198583587312 -34.618814841030556,-58.344582417887544 -34.618998759394181,-58.344528846968885 -34.619050329010129,-58.344572971301616 -34.619352987799637,-58.344660485648134 -34.61963526531391,-58.345205997544866 -34.619840587707081,-58.345438487792151 -34.619893418847326,-58.345902614214893 -34.619575613726859,-58.34624216306257 -34.619339803461116,-58.346336139879462 -34.619207353362341,-58.346554704135883 -34.619288409504769,-58.346670650752742 -34.619406622499177,-58.346891410463094 -34.619624938368666,-58.347151750987692 -34.619989986509324,-58.347100184243835 -34.620562844625141,-58.346962922432581 -34.621008222672621,-58.346453316313749 -34.621620223799617,-58.346509368168931 -34.62198937426993,-58.346184158118575 -34.622564576576487,-58.346059017548185 -34.622682489152766,-58.346023126252291 -34.622822600420918,-58.346040817525918 -34.622903887698065,-58.345929488769407 -34.622952796922604,-58.345943049078095 -34.622638080934387,-58.345952283434315 -34.622431533472913,-58.346095373380862 -34.622210183942954,-58.346113542076978 -34.622010969186853,-58.345837008515602 -34.621892672399277,-58.34574887087264 -34.622110905212182,-58.34574491300377 -34.62195660039869,-58.345718909327324 -34.621849811270579,-58.345622980163085 -34.621671121613112,-58.345480419276619 -34.621515979428352,-58.345284116466757 -34.621412477260492,-58.345034358351406 -34.621338501699135,-58.344864670531734 -34.621330943287106,-58.344695121722197 -34.621345568628357,-58.34451649060783 -34.621396946751283,-58.344337912767713 -34.621470649367808,-58.344192933546545 -34.621580371506994,-58.344105550769484 -34.621684374635308,-58.344087545286406 -34.621765557074497,-58.344042989553728 -34.621706497651303,-58.34408777634863 -34.621603157407598,-58.344078936298651 -34.621529413907311,-58.344159312610223 -34.621499913567078,-58.344230827677897 -34.6214114588984,-58.344239992879785 -34.621256462515895,-58.344275834068284 -34.62115325435763,-58.344231404424448 -34.62100560054698,-58.344231582760166 -34.620880103477084,-58.344276368674421 -34.620776903998419,-58.344321269976561 -34.620592363803489,-58.344339348163174 -34.620459630324149,-58.344312723241266 -34.620311993800392,-58.344271166026942 -34.62012152440267,-58.34419706311138 -34.620053633213573,-58.344197199449901 -34.619957714563036,-58.344127728111438 -34.619807994034439,-58.344090568989238 -34.619640276095417,-58.344028399130764 -34.619448378052702,-58.343903511486715 -34.619330153845105,-58.34385015025731 -34.619234183075577,-58.343689623195573 -34.619138037356201,-58.343479609195711 -34.618977615506623,-58.343341767594239 -34.618923746472142,-58.343224244070626 -34.618899123541929,-58.343072953875556 -34.618837775985249,-58.343056966859052 -34.618758743497793,-58.34299662748662 -34.618658680855418,-58.342931609451497 -34.618613404211992,-58.342852524891804 -34.61857557876165,-58.342671899394361 -34.618536315321656,-58.342413980719591 -34.618516905692061,-58.342044550060905 -34.618499005052364,-58.341609351033298 -34.618483925453113,-58.341441102777075 -34.618486504905974,-58.34096795187935 -34.618559768620209,-58.340530397328841 -34.618640601621934,-58.340396407444736 -34.618692088861096,-58.340307196207476 -34.618647772512809,-58.340159915108842 -34.618584594316928,-58.339905756285752 -34.618499758370262,-58.339603863823768 -34.618492552473072,-58.339203136768759 -34.618554755254131,-58.338914727402504 -34.618646367521997,-58.33858410848341 -34.618822868670229,-58.338423376101822 -34.618926229722177,-58.33831730840604 -34.618989504083267,-58.338202527660407 -34.619125729713758,-58.33812830985952 -34.619309674354064,-58.338117875644713 -34.61950833248828,-58.338133251742804 -34.619537081569973,-58.3381290995369 -34.619636376509476,-58.338108621700059 -34.619715231539551,-58.33806845722156 -34.619799489174738,-58.338019320091853 -34.619845356029337,-58.33796636823903 -34.619935586679283,-58.337933691637559 -34.619968582562834,-58.337870768122606 -34.620061760817869,-58.337832860610881 -34.620174542781697,-58.337787001808984 -34.62042013802828,-58.337746819783725 -34.620572496444773,-58.337643896578811 -34.620866203811957,-58.337634976171216 -34.620963451500984,-58.33758730652832 -34.621052631009903,-58.33752418206798 -34.621108624498234,-58.337463601999481 -34.621172085608194,-58.337361683899324 -34.621306070000536,-58.337250441612738 -34.621465397689882,-58.337162620680623 -34.621628411474504,-58.337158689129467 -34.621693480059257,-58.337133500517815 -34.621731624443221,-58.337126739093414 -34.621809014474465,-58.337127190511914 -34.621848664170862,-58.337066421887521 -34.621980155355168,-58.337044997364089 -34.622233874274386,-58.337114858363961 -34.622400571571177,-58.337137177040944 -34.622514612485091,-58.337193822314354 -34.622632350810512,-58.33724425876526 -34.62268684115039,-58.337328390261611 -34.622768479695402,-58.337451131728109 -34.622838115170602,-58.337567400764016 -34.622849713755514,-58.337798293494913 -34.622890796835769,-58.338004274329805 -34.62289910643225,-58.338247929681678 -34.622837099635952,-58.338533564808664 -34.622788022848688,-58.338692934350917 -34.622746704689369,-58.338797309098936 -34.622736458286852,-58.338871974446434 -34.622711110708764,-58.339013165862873 -34.622691394125091,-58.33908268621235 -34.622688577173683,-58.339202322906615 -34.622669683624956,-58.339298198390182 -34.622645906604816,-58.339444396822159 -34.622639082346261,-58.339588886414489 -34.622635636583844,-58.339640762555923 -34.6226392805983,-58.339971726945997 -34.622699827329896,-58.340021565290584 -34.622698891512684,-58.34012276185387 -34.622706247008416,-58.340308372866886 -34.622720588786692,-58.34060867372537 -34.622719833343993,-58.340747576332575 -34.622692084021139,-58.340866425044517 -34.622687484310276,-58.341009315257729 -34.622670865808551,-58.341065960037085 -34.622675992897271,-58.341193924576046 -34.622729572937864,-58.341354466826658 -34.62281804558846,-58.341526089921523 -34.622844062134753,-58.341667413802249 -34.622850188554573,-58.341783556791881 -34.6228316411325,-58.341836575665006 -34.62281112959981,-58.34189862214388 -34.622792458032087,-58.341943650727643 -34.622759684604112,-58.342003432514069 -34.622657627638446,-58.342024285273503 -34.622553137689607,-58.341899491417962 -34.622486533047976,-58.341873154151941 -34.622436857394987,-58.341871391986636 -34.622418333895425,-58.341906507018798 -34.622348295875589,-58.341935442953613 -34.622309520393252,-58.34201432138979 -34.62225649806475,-58.342054208531785 -34.622244213158602,-58.342104817069952 -34.62224067152944,-58.342236670257051 -34.62225615444099,-58.342319178165788 -34.622285321384126,-58.342417925583192 -34.622336688135633,-58.342483154804064 -34.622355485465526,-58.342543855433831 -34.622383644814541,-58.342676722723475 -34.622464200876678,-58.342701096216402 -34.622517254820906,-58.342726542609483 -34.622535167779937,-58.342843968804061 -34.62257169289618,-58.342929465405426 -34.622596355167218,-58.342987509455384 -34.622635638823603,-58.343057821606202 -34.622674582360624,-58.342496425984557 -34.623254613457576,-58.342391759494944 -34.623348809230322,-58.342326564038203 -34.623424099567053,-58.342219253640835 -34.623578998850419,-58.34187989783603 -34.62336795187835,-58.34188167568373 -34.623140551601125,-58.340673579150952 -34.623134348906177,-58.340086048935319 -34.623340245595877,-58.338488515836758 -34.62466311044021,-58.33823148259593 -34.62472334342057,-58.338224782504973 -34.624703124640057,-58.337796455608704 -34.624799661881127,-58.3377764413652 -34.624738653431379,-58.337757286795906 -34.624729337727935,-58.337502985362484 -34.624785346476465,-58.337251667818016 -34.624783116379668,-58.3371639913032 -34.624791336317216,-58.33704361456671 -34.624846707186144,-58.337017902634649 -34.624892245599476,-58.336061608098717 -34.625674662938501,-58.336028388422662 -34.625670614227829,-58.335951018188844 -34.625679618666936,-58.335811340091354 -34.625764757974707,-58.335740988988185 -34.625863772572828,-58.335697317902422 -34.625897531051464,-58.335704782078928 -34.625975076609336,-58.335142197696207 -34.626448871526286,-58.33514405989704 -34.62712481131755,-58.336246727916233 -34.628038243003665,-58.336188653041894 -34.628187272190381,-58.336333671126518 -34.628235029711128,-58.336409983965517 -34.62808200512405,-58.336972048233989 -34.628237942986701,-58.336913636915519 -34.628384859422844,-58.338140389882476 -34.62872796052892,-58.338213988065483 -34.628565213421297,-58.338782449426184 -34.62872072691632,-58.338726056469547 -34.628887294793699,-58.338863425457006 -34.628924266528763,-58.338935400828575 -34.62876341881293,-58.339100109644534 -34.628806122432188,-58.33917121520129 -34.628771897564434,-58.339218760394452 -34.628653561540261,-58.339340642263181 -34.628677699737885,-58.339386927884703 -34.628661900949304,-58.339444683674465 -34.628609774513109,-58.339727101131992 -34.627867288656262,-58.339735487486728 -34.627842155437186,-58.340253193766181 -34.627981131501386,-58.340536904001922 -34.627745281429917,-58.340636378986737 -34.627827073850575,-58.340766199740635 -34.627723538303314,-58.340665446497148 -34.627641955982838,-58.341062176946338 -34.627311848377829,-58.341165907422578 -34.627396602460266,-58.34129921690829 -34.627295112133943,-58.341190463561034 -34.627207817864857,-58.341513487733216 -34.626941721949308,-58.341589587209981 -34.626869541615527,-58.341697137164338 -34.626964158526121,-58.341775408470298 -34.626921699525582,-58.341803168236318 -34.626872640908594,-58.341803380610976 -34.626843696497758,-58.341714708192157 -34.626773817533739,-58.341966232425747 -34.626578778580395,-58.34211169419163 -34.626438002297704,-58.342226655861339 -34.626532837349721,-58.342322679428278 -34.626468000416018,-58.34235476485847 -34.626431974539969,-58.342240145793397 -34.626335872297702,-58.342434441714289 -34.626182396936485,-58.342731557320285 -34.626213253911381,-58.342713675494167 -34.626325282302567,-58.342890186242862 -34.626334681459852,-58.342908136935733 -34.626233850665926,-58.343314619180227 -34.626281574697479,-58.343298801972011 -34.626380224468214,-58.343468597071926 -34.626438984052918,-58.343491201202177 -34.626300691687973,-58.344275630948097 -34.626393430666006,-58.344364807787954 -34.62646929437841,-58.343821306359807 -34.626916104698637,-58.343701148435052 -34.626819153337621,-58.343571332024972 -34.626923185007776,-58.343692254497022 -34.627021686588051,-58.343320797324736 -34.627321474396489,-58.343204725977081 -34.627226498448586,-58.343078573055543 -34.627329617651618,-58.343195829877637 -34.627429665469606,-58.342812846210528 -34.627744300059391,-58.342705709318366 -34.627657079158936,-58.34267928263062 -34.62766803943736,-58.342579561522008 -34.627755761076081,-58.342684900965587 -34.627848755155831,-58.342319732709989 -34.628154320892804,-58.342194979833067 -34.628053419740901,-58.342141841646246 -34.628095270021525,-58.342076312764561 -34.628162742673169,-58.342188126617891 -34.628256095702355,-58.341803173564358 -34.6285722744719,-58.341694585965897 -34.628486671028874,-58.341635922832367 -34.628519289949097,-58.341563671628997 -34.62858055826085,-58.341677015848475 -34.62867609644227,-58.341390236284603 -34.628913495423696,-58.341392119771122 -34.628965752531897,-58.341542824063019 -34.629090272592933,-58.341854952105543 -34.62917466949088,-58.341818170635115 -34.629275551843378,-58.341978945703666 -34.629330079049119,-58.342022637929418 -34.629222372276551,-58.342372923269366 -34.629315397424349,-58.342329401131103 -34.629423597462903,-58.342340691497817 -34.629451989814825,-58.342488534285629 -34.629494601788451,-58.342541376965251 -34.629362748129694,-58.34283783767188 -34.629442197337021,-58.34318167780566 -34.629159215595941,-58.343275123763064 -34.629230013667055,-58.343314034916339 -34.629247024145691,-58.343399352047726 -34.629163865456654,-58.343404333948349 -34.629135629966598,-58.343309027557432 -34.629055111543707,-58.343675894569387 -34.628753417914879,-58.343789586360472 -34.628846067053793,-58.343917869236819 -34.628743935164664,-58.343804861130451 -34.62864980788833,-58.344188444316316 -34.628333269342427,-58.344310139735931 -34.628429376596365,-58.344404986210968 -34.6283539027487,-58.344416629082133 -34.628314405696081,-58.344313577728649 -34.628228246548055,-58.344567855339463 -34.628012922587772,-58.344996234050704 -34.628368489264773,-58.346454325708109 -34.627188651338663,-58.346708086779522 -34.627399463267501,-58.345265141372664 -34.62859262906656,-58.345353463836645 -34.628672505426273,-58.347054493248841 -34.627277605034998,-58.348757866137674 -34.628676155658653,-58.348776073645467 -34.628756597849126,-58.348442495646488 -34.628778047115006,-58.348430460106655 -34.628794585680907,-58.348440966174628 -34.628961502422214,-58.348776938433339 -34.628934210135448,-58.348782698005699 -34.629083657048206,-58.348723407528084 -34.629265227345584,-58.348682901312827 -34.629354629044869,-58.348498898688582 -34.629398190737625,-58.34847920073711 -34.62941070791608,-58.348481042034997 -34.629559165213784,-58.348460921841728 -34.62981753511928,-58.348432560889115 -34.629872228654939,-58.347959276183396 -34.629938265404107,-58.347902606686667 -34.630070892477946,-58.347886076574802 -34.630133836723942,-58.348257332838607 -34.630101649347878,-58.348294134087901 -34.630291267531817,-58.348258971344329 -34.630335461342199,-58.348134723854344 -34.630417107937014,-58.348083201092706 -34.630772211960007,-58.347975694992286 -34.631008245339657,-58.34792213295637 -34.631172989041652,-58.34783818673278 -34.631190516224073,-58.347734751845309 -34.630883155256782,-58.347661453695757 -34.630902241700774,-58.347757736976227 -34.631205652199597,-58.347723468204137 -34.631280692763582,-58.347690858701732 -34.631326367730317,-58.347619910842447 -34.631370738874985,-58.347575065302451 -34.631392598674815,-58.347472621675827 -34.631416375953357,-58.347333002710698 -34.631460329912755,-58.347224093762954 -34.6314768471102,-58.347164716598691 -34.631471438594325,-58.347118015330835 -34.631479704477307,-58.346948350785389 -34.631501727401179,-58.346885479822774 -34.631496737982616,-58.346849511008941 -34.631506985847942,-58.346767992549808 -34.631493809376543,-58.346751223674239 -34.631482595890375,-58.346733670029217 -34.631423070228657,-58.346137692595718 -34.631545745572971,-58.346093145850105 -34.631658171428803,-58.347786636200468 -34.632120568257783,-58.347718120664283 -34.632130644860446,-58.347686199625535 -34.632171109032051,-58.347695950308953 -34.63220548553506,-58.347725275087313 -34.632255937347331,-58.347776601019021 -34.632292465771457,-58.347793605114887 -34.632318679821999,-58.347729868130997 -34.632508625898645,-58.347707806625273 -34.632504520462277,-58.347690591837335 -34.632569224630721,-58.347705165521035 -34.632627902237296,-58.347746813675457 -34.632577306059424,-58.347763997532851 -34.632534996943313,-58.347754227354734 -34.632514705391074,-58.347805812808424 -34.632363129378156,-58.347849804373134 -34.63234302931361,-58.347949998213423 -34.632345095512278,-58.348172551014784 -34.632401926236255,-58.34837790457442 -34.632450641581151,-58.348546443207049 -34.632505308238862,-58.348698107049785 -34.632501435875,-58.348861927055623 -34.632517786589482,-58.348984204713297 -34.632507829905627,-58.349033014121204 -34.632515903830601,-58.349072058154142 -34.632562420585366,-58.350116065380931 -34.632348522620056,-58.350915689026102 -34.631579092271835,-58.351138361261022 -34.631355767750264,-58.351251069773085 -34.631173188786164,-58.351345085218583 -34.630952140690077,-58.351949761184954 -34.629532151796987,-58.351847143425381 -34.629497339129266,-58.351854268645219 -34.629456921741806,-58.351788947295191 -34.629437565954426,-58.351849138987639 -34.629278108387503,-58.351901428295641 -34.62929491701118,-58.351996725644618 -34.629260424937719,-58.352185619042523 -34.629189255854726,-58.352385250037003 -34.628987105962203,-58.352641678583716 -34.629064452821986,-58.352955242381285 -34.629166921809428,-58.352988135731636 -34.629161669536174,-58.353388308811688 -34.628708492749062,-58.35392543175972 -34.628092191978233,-58.35414710659029 -34.627967174045232,-58.354532180073974 -34.627716944446689,-58.356286987445138 -34.6265714075356,-58.357177834705254 -34.625997936896404,-58.357311378084674 -34.62589642922724,-58.357651937815589 -34.625664602532538,-58.357676449999076 -34.625615889610721,-58.359957293775743 -34.624148698053695,-58.360014302601229 -34.62420586066402,-58.360494836799639 -34.623890478900478,-58.36081832683147 -34.624227873593227,-58.360835175660753 -34.624243733270482,-58.360854760134934 -34.624251848488711,-58.360877075948125 -34.624255740488792,-58.360897870417823 -34.624249701302013,-58.361770687397225 -34.623674702877018,-58.361446192673817 -34.62332139381023,-58.360343538486916 -34.622152828176183,-58.359805144984492 -34.621601772343972,-58.359285873815715 -34.6210702793935,-58.358885311022654 -34.620660277209339,-58.358764756868602 -34.620532634959993,-58.357789447201874 -34.619500074394658,-58.357680806831681 -34.619385047367686,-58.357256291650209 -34.618931919029777,-58.35669906931534 -34.61833711973653,-58.356454914883926 -34.618076475759224,-58.356386472094968 -34.618039372590914,-58.356339311263469 -34.618013837638223,-58.356235282808285 -34.617892615921761,-58.356233716732831 -34.617894613155713,-58.356002638823419 -34.617639336988944,-58.355797665725369 -34.61814305742233,-58.3555371757176 -34.618726894590488,-58.355394019676616 -34.619034932955635,-58.355392105670219 -34.619034609355765,-58.355247522056644 -34.619335210213237,-58.355142849674088 -34.619552830966796,-58.354249159634051 -34.619464301233776,-58.354071829635714 -34.619701546011548,-58.353517471852761 -34.619404702866461,-58.353081729594628 -34.61953840122915,-58.352930153871078 -34.619752215968546,-58.352690239742472 -34.619770099066997,-58.352563272618831 -34.619539694876707,-58.352215579357107 -34.619634383748092,-58.351919653977525 -34.619620312082709,-58.351463311578094 -34.619356577884361,-58.351552110970722 -34.619331446685813,-58.351613326823596 -34.619229315819972,-58.351518850209246 -34.619167889605883,-58.351501298532121 -34.619234002651822,-58.351467837560982 -34.619284466846977,-58.351341211593379 -34.619311957909353,-58.351239078147749 -34.619306794037136)));;2313;4_18_1;COMUNA 4;18;1;74;70;4;1750,00%;45;45;100,00%;0;0,00%;45;40;88,89%;5;11,11%
MULTIPOLYGON (((-58.36235233278282 -34.632630902427323,-58.361230422997778 -34.632190945903567,-58.360814846016751 -34.632023692633616,-58.360429348576517 -34.632687898627722,-58.360336025963541 -34.632848459349262,-58.361868732303748 -34.633472854809142,-58.36197262744421 -34.633304273232419,-58.36235233278282 -34.632630902427323)));;2314;4_19_1;COMUNA 4;19;1;674;295;379;77,84%;287;287;100,00%;0;0,00%;255;48;18,82%;207;81,18%
MULTIPOLYGON (((-58.357907383639422 -34.636953500261995,-58.357714404782584 -34.636875796629923,-58.357250264208993 -34.63669278479103,-58.357174809663469 -34.636663000276805,-58.357117665265918 -34.636640414894607,-58.356621250706908 -34.636444625830293,-58.356180404354014 -34.637239125944902,-58.35610289800799 -34.637422246344514,-58.356014692654377 -34.637541118967924,-58.356631233621187 -34.638240818046796,-58.356874342845117 -34.638515339910036,-58.356938561855991 -34.638587856406119,-58.358022537621252 -34.639226910198687,-58.358322587255927 -34.639225023414504,-58.358476996489678 -34.638949264612293,-58.358473978225263 -34.638948907827221,-58.358850813099956 -34.638365971524991,-58.358978188035159 -34.638168820186586,-58.359257847152833 -34.637749819129041,-58.35938258541546 -34.637547312828374,-58.359510652658159 -34.637339527352218,-58.359745802215357 -34.63694203742638,-58.359872762378743 -34.636732278719514,-58.35971180426256 -34.636666929571341,-58.358390488820696 -34.636146987362977,-58.358289906680035 -34.63631493481288,-58.357991742127162 -34.636814272524866,-58.357907383639422 -34.636953500261995)));;2315;4_19_10;COMUNA 4;19;10;644;313;331;94,56%;290;290;100,00%;0;0,00%;263;68;25,86%;195;74,14%
MULTIPOLYGON (((-58.361868732303748 -34.633472854809142,-58.360336025963541 -34.632848459349262,-58.360261999561807 -34.632975725265446,-58.359866219889966 -34.633679710747131,-58.360091642823534 -34.633767790755201,-58.361368970166332 -34.634284579482845,-58.361432743437604 -34.634180544593633,-58.361868732303748 -34.633472854809142)));;2316;4_19_2;COMUNA 4;19;2;735;357;378;94,44%;295;295;100,00%;0;0,00%;259;19;7,34%;240;92,66%
MULTIPOLYGON (((-58.360814846016751 -34.632023692633616,-58.360522921233425 -34.631906191096171,-58.359431805393626 -34.631452370094728,-58.359067905518621 -34.632144830478474,-58.358981071697855 -34.632292930495382,-58.358602312046081 -34.632938966798314,-58.358497291390037 -34.633116770197084,-58.359003328145917 -34.633304742745146,-58.359202454978174 -34.633365970188436,-58.359255175138621 -34.633382142194527,-58.359700116280159 -34.63357717291985,-58.359779464508598 -34.633626185142987,-58.359866219889966 -34.633679710747131,-58.360261999561807 -34.632975725265446,-58.360336025963541 -34.632848459349262,-58.360429348576517 -34.632687898627722,-58.360814846016751 -34.632023692633616)));;2317;4_19_3;COMUNA 4;19;3;904;425;479;88,73%;351;351;100,00%;0;0,00%;323;72;22,29%;251;77,71%
MULTIPOLYGON (((-58.358981071697855 -34.632292930495382,-58.357789474312654 -34.631797810824189,-58.357528129586385 -34.631689835769912,-58.356570126904536 -34.631293993088015,-58.356401604020462 -34.6312247595773,-58.354258092905667 -34.630343689034461,-58.354088563658664 -34.630657351273399,-58.353795067936119 -34.631231333661837,-58.353494012157995 -34.632109895867465,-58.355401944526264 -34.632884008591176,-58.356550127267752 -34.633349887429503,-58.358012731400962 -34.633943212907951,-58.358132363025653 -34.633734153866946,-58.358497291390037 -34.633116770197084,-58.358602312046081 -34.632938966798314,-58.358981071697855 -34.632292930495382)));;2318;4_19_4;COMUNA 4;19;4;1134;526;608;86,51%;375;375;100,00%;0;0,00%;375;152;40,53%;223;59,47%
MULTIPOLYGON (((-58.359003328145917 -34.633304742745146,-58.358497291390037 -34.633116770197084,-58.358132363025653 -34.633734153866946,-58.358012731400962 -34.633943212907951,-58.358500441007713 -34.634141101685472,-58.358570953466987 -34.634169683949409,-58.35937086419046 -34.634494177468994,-58.359266097852903 -34.634672756372275,-58.358998671979286 -34.635129163634822,-58.35888468470192 -34.635321608032832,-58.35908132466934 -34.635399453790654,-58.360365651707234 -34.635920977311855,-58.360867231441127 -34.635102145599028,-58.360985048014491 -34.634909702530223,-58.361368970166332 -34.634284579482845,-58.360091642823534 -34.633767790755201,-58.359866219889966 -34.633679710747131,-58.359779464508598 -34.633626185142987,-58.359700116280159 -34.63357717291985,-58.359255175138621 -34.633382142194527,-58.359202454978174 -34.633365970188436,-58.359003328145917 -34.633304742745146)));;2319;4_19_5;COMUNA 4;19;5;805;369;436;84,63%;312;312;100,00%;0;0,00%;286;28;9,79%;258;90,21%
MULTIPOLYGON (((-58.357542115986291 -34.634784877351159,-58.357073361439419 -34.635629781004724,-58.357573436375361 -34.635825289707384,-58.357639352078124 -34.635851333248773,-58.358390488820696 -34.636146987362977,-58.35971180426256 -34.636666929571341,-58.359872762378743 -34.636732278719514,-58.360223158553588 -34.636153611564701,-58.360365651707234 -34.635920977311855,-58.35908132466934 -34.635399453790654,-58.35888468470192 -34.635321608032832,-58.358998671979286 -34.635129163634822,-58.359266097852903 -34.634672756372275,-58.35937086419046 -34.634494177468994,-58.358570953466987 -34.634169683949409,-58.358500441007713 -34.634141101685472,-58.358012731400962 -34.633943212907951,-58.357891732826083 -34.6341547355172,-58.357542115986291 -34.634784877351159)));;2320;4_19_6;COMUNA 4;19;6;1147;573;574;99,83%;377;377;100,00%;0;0,00%;363;174;47,93%;189;52,07%
MULTIPOLYGON (((-58.358012731400962 -34.633943212907951,-58.356550127267752 -34.633349887429503,-58.356077182947416 -34.634204854550951,-58.355609438472804 -34.635050387353509,-58.355716823499044 -34.6350949900595,-58.356930544140155 -34.635573951233212,-58.357073361439419 -34.635629781004724,-58.357542115986291 -34.634784877351159,-58.357891732826083 -34.6341547355172,-58.358012731400962 -34.633943212907951)));;2321;4_19_7;COMUNA 4;19;7;933;456;477;95,60%;272;272;100,00%;0;0,00%;287;202;70,38%;85;29,62%
MULTIPOLYGON (((-58.353795067936119 -34.631231333661837,-58.353586996178365 -34.631176216336456,-58.353558868081265 -34.631250489365655,-58.353539961104374 -34.631309840576719,-58.353007391724191 -34.632850257824906,-58.352980134788233 -34.632844458474018,-58.352956694091411 -34.632916904514431,-58.352982584112247 -34.632925519633289,-58.352958036698141 -34.63299726042932,-58.352929586335343 -34.632991882542292,-58.352906407653762 -34.63305939907049,-58.352932980071046 -34.633067451415528,-58.352914758766055 -34.633123070613429,-58.352885798079456 -34.633116988008823,-58.352861588455667 -34.63319091225619,-58.352887649326981 -34.633199245849511,-58.352753888313558 -34.633581884154729,-58.352802168156089 -34.633733833961116,-58.352970149442555 -34.63428062247516,-58.35324367451188 -34.635171460127239,-58.353471285793489 -34.635667806762186,-58.353496774247049 -34.635723465160694,-58.354131094898449 -34.636530042990209,-58.354237526722201 -34.63658774514726,-58.354634716104073 -34.636800531552957,-58.354731753307419 -34.636633293380491,-58.354733277916075 -34.636634242811446,-58.355157569575915 -34.635867269350896,-58.355609438472804 -34.635050387353509,-58.356077182947416 -34.634204854550951,-58.356550127267752 -34.633349887429503,-58.355401944526264 -34.632884008591176,-58.353494012157995 -34.632109895867465,-58.353795067936119 -34.631231333661837)));;2322;4_19_8;COMUNA 4;19;8;1520;768;752;102,13%;277;277;100,00%;0;0,00%;459;184;40,09%;275;59,91%
MULTIPOLYGON (((-58.357073361439419 -34.635629781004724,-58.356930544140155 -34.635573951233212,-58.355716823499044 -34.6350949900595,-58.355609438472804 -34.635050387353509,-58.355157569575915 -34.635867269350896,-58.354733277916075 -34.636634242811446,-58.354731753307419 -34.636633293380491,-58.354634716104073 -34.636800531552957,-58.356012505285882 -34.637538636543901,-58.356014692654377 -34.637541118967924,-58.35610289800799 -34.637422246344514,-58.356180404354014 -34.637239125944902,-58.356621250706908 -34.636444625830293,-58.357117665265918 -34.636640414894607,-58.357174809663469 -34.636663000276805,-58.357250264208993 -34.63669278479103,-58.357714404782584 -34.636875796629923,-58.357907383639422 -34.636953500261995,-58.357991742127162 -34.636814272524866,-58.358289906680035 -34.63631493481288,-58.358390488820696 -34.636146987362977,-58.357639352078124 -34.635851333248773,-58.357573436375361 -34.635825289707384,-58.357073361439419 -34.635629781004724)));;2323;4_19_9;COMUNA 4;19;9;1129;570;559;101,97%;339;339;100,00%;0;0,00%;339;159;46,90%;180;53,10%
MULTIPOLYGON (((-58.423737464847704 -34.651161398234372,-58.423787553768236 -34.651205852175458,-58.423909119218806 -34.651118141807842,-58.424812582920659 -34.65046622324359,-58.424984017502076 -34.650339371172748,-58.42529329743477 -34.650110586326974,-58.42472855975975 -34.650084495509546,-58.424094710956169 -34.650055211107251,-58.422559346556476 -34.649984361137513,-58.422482020671481 -34.650050464406831,-58.422398711663988 -34.649976913565794,-58.421025007420447 -34.649913492186634,-58.419929455318261 -34.649860787332557,-58.419419088508981 -34.649839268586632,-58.418425883571246 -34.649792290904244,-58.418277169150407 -34.650284645971688,-58.41823474158263 -34.65042209941771,-58.418157569318176 -34.650671797040587,-58.418066823084061 -34.650965293762304,-58.417800628245892 -34.651851349207078,-58.418682810366704 -34.651743991586599,-58.41886118912285 -34.651723351005259,-58.419582544002743 -34.651640014170844,-58.420014384641114 -34.651590164614923,-58.420783463691755 -34.65150134424885,-58.421142946249368 -34.651459775906986,-58.421650635742616 -34.651401424999001,-58.422282327673663 -34.651328746515027,-58.422616837591228 -34.651290264230504,-58.423737464847704 -34.651161398234372)));;2324;4_2_1;COMUNA 4;2;1;753;344;409;84,11%;316;316;100,00%;0;0,00%;274;41;14,96%;233;85,04%
MULTIPOLYGON (((-58.407296261893563 -34.649278783172761,-58.40755351676988 -34.64930925280882,-58.408440875108241 -34.649345497020391,-58.408700443710245 -34.649357161883621,-58.410100378284341 -34.649418057279391,-58.411888644233365 -34.649500156004322,-58.41194854190816 -34.649238835051747,-58.412014505950125 -34.648950825633797,-58.41208174938815 -34.648660210984865,-58.412081765665413 -34.64866013000595,-58.412101046456215 -34.648580899647655,-58.410460315618124 -34.648317885207256,-58.410369509674638 -34.648303617851731,-58.409099616744697 -34.648098125965248,-58.409007997565297 -34.648083435000665,-58.406365449202987 -34.647659675433772,-58.404999203078582 -34.647440559786503,-58.40495961143138 -34.647434209916888,-58.403644912078633 -34.64721480988495,-58.403576840434233 -34.647203449515864,-58.402747624054918 -34.647062456899228,-58.402798094388494 -34.64712842252883,-58.403126978063682 -34.647558174155662,-58.403480980843398 -34.648020825387711,-58.40361005072161 -34.648189414225236,-58.403926429900778 -34.648599086537416,-58.404432847484088 -34.649254701425761,-58.404501639082341 -34.649347765243213,-58.404606142018125 -34.649434366970738,-58.405045022526906 -34.649798248155371,-58.405222858397927 -34.649945660468497,-58.405335709821237 -34.650038814989827,-58.4054891471594 -34.650101142459555,-58.405829233302704 -34.649887844440869,-58.405910313191654 -34.64983450034493,-58.405967434074306 -34.64979924418477,-58.406069396582453 -34.649739853176058,-58.406128645943163 -34.649707344489521,-58.406264787860891 -34.649637898443132,-58.406327102904797 -34.649608419338293,-58.406436812609343 -34.649559736148404,-58.406516429196259 -34.649526954969289,-58.406597067160398 -34.649495934824181,-58.406662616503951 -34.649472091007226,-58.406760981379023 -34.649438825309424,-58.406828062725531 -34.649417728667487,-58.406928469984173 -34.649388548399862,-58.407296261893563 -34.649278783172761)));;2325;4_2_10;COMUNA 4;2;10;1051;513;538;95,35%;310;310;100,00%;0;0,00%;316;37;11,71%;279;88,29%
MULTIPOLYGON (((-58.419582544002743 -34.651640014170844,-58.41886118912285 -34.651723351005259,-58.418682810366704 -34.651743991586599,-58.417800628245892 -34.651851349207078,-58.417862582700721 -34.653278386091038,-58.418928173394697 -34.653505822210732,-58.418991225846426 -34.654666160594189,-58.419706693201114 -34.654150484343148,-58.420577314634855 -34.653522319016929,-58.421417231898936 -34.652916320768085,-58.422242303191808 -34.652320945862527,-58.422729258519674 -34.651969546718021,-58.423068044691306 -34.651725072557163,-58.423462326548481 -34.651440543697106,-58.423787553768236 -34.651205852175458,-58.423737464847704 -34.651161398234372,-58.422616837591228 -34.651290264230504,-58.422282327673663 -34.651328746515027,-58.421650635742616 -34.651401424999001,-58.421142946249368 -34.651459775906986,-58.420783463691755 -34.65150134424885,-58.420014384641114 -34.651590164614923,-58.419582544002743 -34.651640014170844)));;2326;4_2_2;COMUNA 4;2;2;826;363;463;78,40%;342;341;99,71%;1;0,29%;282;25;8,87%;257;91,13%
MULTIPOLYGON (((-58.41649103050645 -34.649705725407578,-58.416342326546641 -34.649699753296083,-58.416350137471916 -34.650058499438082,-58.416357892771892 -34.650823595724923,-58.416367674148532 -34.651776656023301,-58.416370096466913 -34.652018072567799,-58.416372523069214 -34.652251812820296,-58.416376159568706 -34.652608585335095,-58.416388417986752 -34.653399106294991,-58.416395454840384 -34.654231246107649,-58.416409238489216 -34.654731758958739,-58.416414106521863 -34.654866623904752,-58.41644651095546 -34.655752577522911,-58.416479922791076 -34.656667335036062,-58.416481156263181 -34.656748253337121,-58.416487409275845 -34.65715214061288,-58.416488150164611 -34.657199254928884,-58.416709850476757 -34.65715299938703,-58.4167297672644 -34.656737501937201,-58.417597402286013 -34.655892590188749,-58.418078750902765 -34.655423880401969,-58.418276576551875 -34.655229299071841,-58.418991225846426 -34.654666160594189,-58.418928173394697 -34.653505822210732,-58.417862582700721 -34.653278386091038,-58.417800628245892 -34.651851349207078,-58.418066823084061 -34.650965293762304,-58.418157569318176 -34.650671797040587,-58.41823474158263 -34.65042209941771,-58.418277169150407 -34.650284645971688,-58.418425883571246 -34.649792290904244,-58.417647936689782 -34.649757427465879,-58.416775996817336 -34.649717101004413,-58.41649103050645 -34.649705725407578)));;2327;4_2_3;COMUNA 4;2;3;1049;478;571;83,71%;457;455;99,56%;2;0,44%;383;37;9,66%;346;90,34%
MULTIPOLYGON (((-58.416409238489216 -34.654731758958739,-58.416395454840384 -34.654231246107649,-58.416388417986752 -34.653399106294991,-58.416250800274753 -34.653368278395263,-58.415211555587945 -34.653135336020391,-58.41391975084327 -34.652845803466725,-58.413756152936919 -34.653521602911951,-58.413675459566626 -34.653499879716577,-58.413419423110078 -34.653976973634833,-58.414792940300089 -34.654323728348295,-58.414434017011715 -34.654990930266884,-58.414262700985731 -34.655309392751406,-58.414178834318449 -34.655464997743621,-58.415066254580971 -34.655959657796828,-58.416270371955541 -34.656630775493646,-58.416309904603999 -34.656652833431998,-58.416481156263181 -34.656748253337121,-58.416479922791076 -34.656667335036062,-58.41644651095546 -34.655752577522911,-58.416414106521863 -34.654866623904752,-58.416409238489216 -34.654731758958739)));;2328;4_2_4;COMUNA 4;2;4;796;376;420;89,52%;263;263;100,00%;0;0,00%;273;14;5,13%;259;94,87%
MULTIPOLYGON (((-58.41391975084327 -34.652845803466725,-58.412525106058268 -34.652533186094367,-58.412113710428095 -34.652440971142283,-58.41197984513304 -34.652410985070986,-58.411461683839505 -34.652292807201349,-58.411329917155214 -34.652591633847678,-58.411323206138626 -34.652694873509233,-58.411362688888666 -34.652792709930175,-58.411428436940724 -34.65286337348229,-58.411451865136236 -34.652876271035467,-58.411527090973799 -34.652917712301651,-58.41187013815356 -34.653012788163515,-58.411704273336362 -34.653326883100782,-58.411603081556201 -34.653518466098355,-58.411423392548905 -34.65385854151144,-58.411332350889943 -34.654034212575105,-58.411257179373969 -34.654179255561253,-58.412983099878318 -34.654798510719992,-58.414178834318449 -34.655464997743621,-58.414262700985731 -34.655309392751406,-58.414434017011715 -34.654990930266884,-58.414792940300089 -34.654323728348295,-58.413419423110078 -34.653976973634833,-58.413675459566626 -34.653499879716577,-58.413756152936919 -34.653521602911951,-58.41391975084327 -34.652845803466725)));;2329;4_2_5;COMUNA 4;2;5;738;343;395;86,84%;275;274;99,64%;1;0,36%;231;45;19,48%;186;80,52%
MULTIPOLYGON (((-58.411071480975572 -34.651698822179092,-58.410883450784311 -34.652161784334822,-58.411461683839505 -34.652292807201349,-58.41197984513304 -34.652410985070986,-58.412113710428095 -34.652440971142283,-58.412525106058268 -34.652533186094367,-58.41391975084327 -34.652845803466725,-58.415211555587945 -34.653135336020391,-58.416250800274753 -34.653368278395263,-58.416388417986752 -34.653399106294991,-58.416376159568706 -34.652608585335095,-58.416372523069214 -34.652251812820296,-58.416370096466913 -34.652018072567799,-58.416367674148532 -34.651776656023301,-58.416220238606542 -34.651781811336768,-58.41554578466981 -34.651805426338015,-58.415175844771071 -34.651795916244481,-58.414424432391925 -34.651678152795377,-58.414336918285819 -34.651664455739144,-58.414210803463583 -34.651643207841225,-58.413676861149376 -34.651553484645071,-58.412724447612057 -34.65110090145977,-58.411517346518352 -34.650746657818466,-58.411460593431663 -34.650740929588309,-58.411071480975572 -34.651698822179092)));;2330;4_2_6;COMUNA 4;2;6;683;313;370;84,59%;292;292;100,00%;0;0,00%;257;10;3,89%;247;96,11%
MULTIPOLYGON (((-58.411888644233365 -34.649500156004322,-58.411790551035139 -34.649928649094605,-58.411719370893117 -34.650103835880714,-58.411460593431663 -34.650740929588309,-58.411517346518352 -34.650746657818466,-58.412724447612057 -34.65110090145977,-58.413676861149376 -34.651553484645071,-58.414210803463583 -34.651643207841225,-58.414336918285819 -34.651664455739144,-58.414424432391925 -34.651678152795377,-58.415175844771071 -34.651795916244481,-58.41554578466981 -34.651805426338015,-58.416220238606542 -34.651781811336768,-58.416367674148532 -34.651776656023301,-58.416357892771892 -34.650823595724923,-58.416350137471916 -34.650058499438082,-58.416342326546641 -34.649699753296083,-58.416174704846277 -34.649692224444571,-58.416204246817479 -34.649133697761854,-58.416330027868398 -34.649136280943729,-58.416328783785239 -34.649074870167077,-58.416206751847263 -34.649073344783325,-58.416080544409105 -34.649071465557881,-58.416077580413166 -34.649038153560269,-58.415858059668402 -34.649034900324075,-58.415698617849124 -34.649031740288713,-58.41551480973547 -34.649017725221206,-58.415385363940757 -34.64901612572185,-58.414961608374696 -34.64895440941298,-58.41494990552728 -34.649003138696415,-58.414854384310495 -34.648988241651857,-58.414853804836753 -34.648988144333373,-58.414760653198805 -34.64897250014026,-58.414288927492457 -34.648898649584069,-58.414291583451487 -34.64888815958281,-58.414005695623061 -34.648841211138702,-58.413561837400167 -34.648767791441649,-58.413467170382425 -34.648750358366421,-58.413467088288435 -34.648750407575051,-58.413370798334135 -34.648734121747239,-58.413368152783647 -34.64874572837364,-58.413171656255656 -34.648712984052707,-58.4130605434381 -34.648693642515141,-58.412939886677464 -34.648673592735548,-58.412793729594888 -34.648648728644737,-58.412790650908413 -34.648659789157037,-58.412712200383524 -34.648646526967845,-58.412628865086766 -34.648633393790753,-58.412514002785656 -34.648614261489406,-58.412389000626661 -34.648593434704878,-58.412297826410438 -34.648578607875166,-58.412200602483075 -34.648562581252797,-58.412204275540809 -34.64854964226253,-58.412112248352273 -34.648534867738398,-58.412101046456215 -34.648580899647655,-58.412081765665413 -34.64866013000595,-58.41208174938815 -34.648660210984865,-58.412014505950125 -34.648950825633797,-58.41194854190816 -34.649238835051747,-58.411888644233365 -34.649500156004322)));;2331;4_2_7;COMUNA 4;2;7;899;438;461;95,01%;375;375;100,00%;0;0,00%;314;17;5,41%;297;94,59%
MULTIPOLYGON (((-58.409687792400419 -34.650554673271763,-58.409609268763234 -34.650744926485785,-58.409184380610739 -34.651775546102172,-58.408789185992909 -34.652733991960098,-58.408929987483816 -34.652843564405408,-58.409245415499214 -34.653077371954993,-58.410218542970838 -34.653798660953854,-58.411257179373969 -34.654179255561253,-58.411332350889943 -34.654034212575105,-58.411423392548905 -34.65385854151144,-58.411603081556201 -34.653518466098355,-58.411704273336362 -34.653326883100782,-58.41187013815356 -34.653012788163515,-58.411527090973799 -34.652917712301651,-58.411451865136236 -34.652876271035467,-58.411428436940724 -34.65286337348229,-58.411362688888666 -34.652792709930175,-58.411323206138626 -34.652694873509233,-58.411329917155214 -34.652591633847678,-58.411461683839505 -34.652292807201349,-58.410883450784311 -34.652161784334822,-58.411071480975572 -34.651698822179092,-58.411460593431663 -34.650740929588309,-58.411719370893117 -34.650103835880714,-58.411790551035139 -34.649928649094605,-58.411888644233365 -34.649500156004322,-58.410100378284341 -34.649418057279391,-58.410026221234226 -34.649713949658683,-58.409983711663386 -34.649825272660635,-58.409923276204616 -34.649983490704059,-58.409687792400419 -34.650554673271763)));;2332;4_2_8;COMUNA 4;2;8;520;258;262;98,47%;209;209;100,00%;0;0,00%;189;29;15,34%;160;84,66%
MULTIPOLYGON (((-58.406237092918921 -34.650767285629129,-58.406807413990734 -34.651233759454165,-58.407217272344901 -34.651568956593266,-58.407405518148167 -34.651708342012974,-58.408552553453603 -34.652557684721444,-58.408789185992909 -34.652733991960098,-58.409184380610739 -34.651775546102172,-58.409609268763234 -34.650744926485785,-58.409687792400419 -34.650554673271763,-58.409923276204616 -34.649983490704059,-58.409983711663386 -34.649825272660635,-58.410026221234226 -34.649713949658683,-58.410100378284341 -34.649418057279391,-58.408700443710245 -34.649357161883621,-58.408440875108241 -34.649345497020391,-58.40755351676988 -34.64930925280882,-58.407296261893563 -34.649278783172761,-58.406928469984173 -34.649388548399862,-58.406828062725531 -34.649417728667487,-58.406760981379023 -34.649438825309424,-58.406662616503951 -34.649472091007226,-58.406597067160398 -34.649495934824181,-58.406516429196259 -34.649526954969289,-58.406436812609343 -34.649559736148404,-58.406327102904797 -34.649608419338293,-58.406264787860891 -34.649637898443132,-58.406128645943163 -34.649707344489521,-58.406069396582453 -34.649739853176058,-58.405967434074306 -34.64979924418477,-58.405910313191654 -34.64983450034493,-58.405829233302704 -34.649887844440869,-58.4054891471594 -34.650101142459555,-58.405689348812366 -34.650319270917798,-58.406237092918921 -34.650767285629129)));;2333;4_2_9;COMUNA 4;2;9;621;295;326;90,49%;218;218;100,00%;0;0,00%;209;13;6,22%;196;93,78%
MULTIPOLYGON (((-58.36672218862175 -34.636370877627115,-58.366619710141094 -34.637015394918585,-58.368039733615205 -34.63718362330966,-58.368071570738735 -34.63698497973111,-58.368177319855995 -34.63630158926199,-58.369595698375889 -34.63648508045145,-58.36980425398577 -34.636509747303684,-58.369917625304645 -34.635778049659734,-58.369950581528485 -34.635564617185672,-58.370105920496663 -34.634557942306259,-58.369869856732691 -34.634526282976779,-58.368472155516841 -34.634395699949103,-58.367219714712647 -34.634278665844498,-58.366922728322926 -34.635214308146999,-58.366762264132447 -34.636123718173728,-58.36672218862175 -34.636370877627115)));;2334;4_20_1;COMUNA 4;20;1;931;467;464;100,65%;321;321;100,00%;0;0,00%;324;75;23,15%;249;76,85%
MULTIPOLYGON (((-58.362972360619132 -34.635963490016913,-58.362271810201072 -34.635676638436088,-58.362174568948227 -34.635836704285609,-58.361776292416415 -34.636493790679353,-58.361648654734992 -34.636704395916631,-58.361291078884214 -34.637307639395175,-58.361436709958667 -34.637366705925643,-58.362702599898839 -34.637881780748231,-58.363195388286066 -34.637066312894554,-58.363294764544847 -34.63690174081772,-58.36359023719799 -34.636418444781306,-58.363685612613708 -34.636249361930012,-58.363517321599993 -34.636186687985358,-58.362972360619132 -34.635963490016913)));;2335;4_20_10;COMUNA 4;20;10;1125;513;612;83,82%;390;390;100,00%;0;0,00%;364;69;18,96%;295;81,04%
MULTIPOLYGON (((-58.362702599898839 -34.637881780748231,-58.361436709958667 -34.637366705925643,-58.361291078884214 -34.637307639395175,-58.359872762378743 -34.636732278719514,-58.359745802215357 -34.63694203742638,-58.359510652658159 -34.637339527352218,-58.35938258541546 -34.637547312828374,-58.360810887382343 -34.638117969021074,-58.360298155047232 -34.63898298934906,-58.360298040675396 -34.638982980620433,-58.360179007648782 -34.63921333338245,-58.360348572172398 -34.639212264212084,-58.361110507940431 -34.639419316187677,-58.361110622299321 -34.639419489748114,-58.361422526239458 -34.639892857600138,-58.361620909820047 -34.639712115942174,-58.361619787673561 -34.639709748422199,-58.36181812561 -34.639384882602613,-58.362229840009952 -34.638685361211202,-58.362583499207695 -34.638079013211517,-58.362702599898839 -34.637881780748231)));;2336;4_20_11;COMUNA 4;20;11;913;418;495;84,44%;376;376;100,00%;0;0,00%;323;81;25,08%;242;74,92%
MULTIPOLYGON (((-58.360810887382343 -34.638117969021074,-58.35938258541546 -34.637547312828374,-58.359257847152833 -34.637749819129041,-58.358978188035159 -34.638168820186586,-58.358850813099956 -34.638365971524991,-58.358473978225263 -34.638948907827221,-58.358476996489678 -34.638949264612293,-58.358322587255927 -34.639225023414504,-58.360179007648782 -34.63921333338245,-58.360298040675396 -34.638982980620433,-58.360298155047232 -34.63898298934906,-58.360810887382343 -34.638117969021074)));;2337;4_20_12;COMUNA 4;20;12;1169;521;648;80,40%;548;548;100,00%;0;0,00%;471;13;2,76%;458;97,24%
MULTIPOLYGON (((-58.367895646905566 -34.638084807554193,-58.367841407944773 -34.638425621215241,-58.367761129002325 -34.638960857305648,-58.369391859840569 -34.639171981596029,-58.369531244382038 -34.638272130210851,-58.369570553026364 -34.638018349391885,-58.369670282155198 -34.637374883982986,-58.36980425398577 -34.636509747303684,-58.369595698375889 -34.63648508045145,-58.368177319855995 -34.63630158926199,-58.368071570738735 -34.63698497973111,-58.368039733615205 -34.63718362330966,-58.367949026704459 -34.637749838437607,-58.367895646905566 -34.638084807554193)));;2338;4_20_2;COMUNA 4;20;2;705;337;368;91,58%;286;286;100,00%;0;0,00%;257;23;8,95%;234;91,05%
MULTIPOLYGON (((-58.368039733615205 -34.63718362330966,-58.366619710141094 -34.637015394918585,-58.366475087938561 -34.637924535072969,-58.365081987716167 -34.637750042225051,-58.364637966780734 -34.638553373361873,-58.365305974712705 -34.638643277655781,-58.365634741862465 -34.638685724184185,-58.366045807762973 -34.638738798789319,-58.366339560321052 -34.638776849328728,-58.367761129002325 -34.638960857305648,-58.367841407944773 -34.638425621215241,-58.367895646905566 -34.638084807554193,-58.367949026704459 -34.637749838437607,-58.368039733615205 -34.63718362330966)));;2339;4_20_3;COMUNA 4;20;3;849;423;426;99,30%;285;285;100,00%;0;0,00%;281;120;42,70%;161;57,30%
MULTIPOLYGON (((-58.36511987027184 -34.636833705453967,-58.365029896843858 -34.636903001836494,-58.36464578097916 -34.637560953937978,-58.364629957670665 -34.637611999169771,-58.364583781570218 -34.637751684761383,-58.364205261463717 -34.638426964368485,-58.364156285106972 -34.638411783483306,-58.364119026588675 -34.638478700448225,-58.364134622585873 -34.638485599278631,-58.364637966780734 -34.638553373361873,-58.365081987716167 -34.637750042225051,-58.366475087938561 -34.637924535072969,-58.366619710141094 -34.637015394918585,-58.36672218862175 -34.636370877627115,-58.366762264132447 -34.636123718173728,-58.366922728322926 -34.635214308146999,-58.366099936395834 -34.635119078750762,-58.365761317628184 -34.635720096947153,-58.365770155727091 -34.635740034186114,-58.365640700117353 -34.635984868637607,-58.365600653325536 -34.636058360235666,-58.365224511045767 -34.636754068285619,-58.36511987027184 -34.636833705453967)));;2340;4_20_4;COMUNA 4;20;4;603;296;307;96,42%;239;239;100,00%;0;0,00%;221;96;43,44%;125;56,56%
MULTIPOLYGON (((-58.363760602181877 -34.638322657514763,-58.364005344337045 -34.638428939300979,-58.364005196588408 -34.63842938567366,-58.364116361157507 -34.638477879055294,-58.364119026588675 -34.638478700448225,-58.364156285106972 -34.638411783483306,-58.364205261463717 -34.638426964368485,-58.364583781570218 -34.637751684761383,-58.364629957670665 -34.637611999169771,-58.36464578097916 -34.637560953937978,-58.365029896843858 -34.636903001836494,-58.36511987027184 -34.636833705453967,-58.364943572449206 -34.636766942438065,-58.364692693241331 -34.636650399366161,-58.36393064000567 -34.636340619844603,-58.363685612613708 -34.636249361930012,-58.36359023719799 -34.636418444781306,-58.363294764544847 -34.63690174081772,-58.363195388286066 -34.637066312894554,-58.362702599898839 -34.637881780748231,-58.362845677786098 -34.637939998402018,-58.363760602181877 -34.638322657514763)));;2341;4_20_5;COMUNA 4;20;5;756;346;410;84,39%;250;250;100,00%;0;0,00%;211;75;35,55%;136;64,45%
MULTIPOLYGON (((-58.363271504913889 -34.634044306508663,-58.362891172126545 -34.634673241459822,-58.362774227441946 -34.634853081057763,-58.363479631072138 -34.635138454814445,-58.362972360619132 -34.635963490016913,-58.363517321599993 -34.636186687985358,-58.363685612613708 -34.636249361930012,-58.363768521368861 -34.636102452693493,-58.364041618059147 -34.635658645648235,-58.364186061577797 -34.635424177435688,-58.364563642862286 -34.634811081883768,-58.364682046587554 -34.634618917398086,-58.364824608218846 -34.634387686414577,-58.365239938135936 -34.633763280548372,-58.364500123889044 -34.633473170750776,-58.36378680035304 -34.633193430390349,-58.363271504913889 -34.634044306508663)));;2342;4_20_6;COMUNA 4;20;6;868;413;455;90,77%;332;332;100,00%;0;0,00%;305;99;32,46%;206;67,54%
MULTIPOLYGON (((-58.36378680035304 -34.633193430390349,-58.36235233278282 -34.632630902427323,-58.36197262744421 -34.633304273232419,-58.361868732303748 -34.633472854809142,-58.361432743437604 -34.634180544593633,-58.361368970166332 -34.634284579482845,-58.362774227441946 -34.634853081057763,-58.362891172126545 -34.634673241459822,-58.363271504913889 -34.634044306508663,-58.36378680035304 -34.633193430390349)));;2343;4_20_7;COMUNA 4;20;7;849;399;450;88,67%;324;324;100,00%;0;0,00%;290;46;15,86%;244;84,14%
MULTIPOLYGON (((-58.362774227441946 -34.634853081057763,-58.361368970166332 -34.634284579482845,-58.360985048014491 -34.634909702530223,-58.360867231441127 -34.635102145599028,-58.361943423490509 -34.635542208377821,-58.362271810201072 -34.635676638436088,-58.362972360619132 -34.635963490016913,-58.363479631072138 -34.635138454814445,-58.362774227441946 -34.634853081057763)));;2344;4_20_8;COMUNA 4;20;8;797;376;421;89,31%;266;266;100,00%;0;0,00%;243;80;32,92%;163;67,08%
MULTIPOLYGON (((-58.360365651707234 -34.635920977311855,-58.360223158553588 -34.636153611564701,-58.359872762378743 -34.636732278719514,-58.361291078884214 -34.637307639395175,-58.361648654734992 -34.636704395916631,-58.361776292416415 -34.636493790679353,-58.362174568948227 -34.635836704285609,-58.362271810201072 -34.635676638436088,-58.361943423490509 -34.635542208377821,-58.360867231441127 -34.635102145599028,-58.360365651707234 -34.635920977311855)));;2345;4_20_9;COMUNA 4;20;9;849;406;443;91,65%;320;320;100,00%;0;0,00%;293;49;16,72%;244;83,28%
MULTIPOLYGON (((-58.367761129002325 -34.638960857305648,-58.366339560321052 -34.638776849328728,-58.366192871366607 -34.639699438372986,-58.366063260854055 -34.640514290793377,-58.366418671301389 -34.64058710937033,-58.367192623618088 -34.640742300210704,-58.367484570939077 -34.640800840168893,-58.369090927484983 -34.641122938788044,-58.369245691369358 -34.640115842950138,-58.369290411698771 -34.639824811757947,-58.369355983372081 -34.639403510715347,-58.369391859840569 -34.639171981596029,-58.367761129002325 -34.638960857305648)));;2346;4_21_1;COMUNA 4;21;1;703;337;366;92,08%;259;259;100,00%;0;0,00%;245;107;43,67%;138;56,33%
MULTIPOLYGON (((-58.363367438243351 -34.645940980932224,-58.36336774421774 -34.645939913357516,-58.363367440434203 -34.645940775115108,-58.363369692581031 -34.645729199804492,-58.363131656770051 -34.645063254946145,-58.363130242128037 -34.645062574990099,-58.363088967212448 -34.645018700931367,-58.363056313869443 -34.644986558648561,-58.3626862575221 -34.643926411098953,-58.362816709172947 -34.64369501285789,-58.362624235099325 -34.643605908675219,-58.362452275821539 -34.643521642749278,-58.362208120794122 -34.643410771791125,-58.361650440680897 -34.644364213393565,-58.360988395402316 -34.644032526149481,-58.359767193807016 -34.64342063775166,-58.358060947949724 -34.642565779196097,-58.358060397179791 -34.642568480133562,-58.357876385124072 -34.642478906533,-58.35776588361211 -34.642749756684481,-58.357474413131364 -34.643460513265914,-58.357317309307312 -34.64404433911924,-58.357590597391493 -34.644982420422814,-58.358385156392643 -34.64526047856554,-58.358745938200904 -34.645386732843264,-58.359796664850421 -34.645982853282696,-58.359904945512319 -34.646074496667239,-58.360883661825852 -34.646895976289457,-58.360975979523829 -34.646990342882518,-58.361239592591808 -34.647259805000395,-58.361620476704843 -34.647708937585818,-58.361520169904466 -34.647784349620515,-58.361708731160611 -34.64794479241543,-58.361768795554866 -34.647885826293205,-58.362362967620236 -34.648208016392225,-58.362943188241772 -34.648229197265657,-58.363568453193977 -34.648209072740173,-58.363935523729744 -34.648176411854941,-58.364254562105977 -34.648287588503052,-58.364332139717668 -34.648130156447863,-58.36450406146934 -34.648052577433582,-58.364521194276151 -34.64805272525507,-58.3644493289463 -34.647964059052747,-58.364290846523943 -34.647841336183859,-58.364037696299107 -34.647506840029443,-58.363788072408326 -34.64706473410245,-58.363367144356879 -34.645941615012148,-58.363367391151336 -34.645940914918256,-58.363367438243351 -34.645940980932224)));;2347;4_21_10;COMUNA 4;21;10;733;371;362;102,49%;231;230;99,57%;1;0,43%;234;134;57,26%;100;42,74%
MULTIPOLYGON (((-58.365158109586339 -34.639541990538945,-58.363673883475741 -34.639307406834114,-58.36367384374082 -34.639307344728351,-58.363645534444579 -34.639357737504227,-58.363335824068372 -34.639910531048862,-58.363301675374409 -34.639965082392507,-58.364760876782952 -34.640258384745849,-58.365701035911741 -34.640440057265963,-58.366063260854055 -34.640514290793377,-58.366192871366607 -34.639699438372986,-58.366339560321052 -34.638776849328728,-58.366045807762973 -34.638738798789319,-58.365634741862465 -34.638685724184185,-58.365158109586339 -34.639541990538945)));;2348;4_21_2;COMUNA 4;21;2;799;381;418;91,15%;273;273;100,00%;0;0,00%;263;161;61,22%;102;38,78%
MULTIPOLYGON (((-58.36367384374082 -34.639307344728351,-58.363673883475741 -34.639307406834114,-58.365158109586339 -34.639541990538945,-58.365634741862465 -34.638685724184185,-58.365305974712705 -34.638643277655781,-58.364637966780734 -34.638553373361873,-58.364134622585873 -34.638485599278631,-58.364119026588675 -34.638478700448225,-58.364116361157507 -34.638477879055294,-58.364005196588408 -34.63842938567366,-58.364005344337045 -34.638428939300979,-58.363760602181877 -34.638322657514763,-58.362845677786098 -34.637939998402018,-58.362702599898839 -34.637881780748231,-58.362583499207695 -34.638079013211517,-58.362229840009952 -34.638685361211202,-58.36181812561 -34.639384882602613,-58.36192502846631 -34.6394296292493,-58.363113793152799 -34.639892062278442,-58.363227067028063 -34.63993593614623,-58.363301675374409 -34.639965082392507,-58.363335824068372 -34.639910531048862,-58.363645534444579 -34.639357737504227,-58.36367384374082 -34.639307344728351)));;2349;4_21_3;COMUNA 4;21;3;561;251;310;80,97%;232;232;100,00%;0;0,00%;207;41;19,81%;166;80,19%
MULTIPOLYGON (((-58.363301675374409 -34.639965082392507,-58.363227067028063 -34.63993593614623,-58.363113793152799 -34.639892062278442,-58.36192502846631 -34.6394296292493,-58.36181812561 -34.639384882602613,-58.361619787673561 -34.639709748422199,-58.361620909820047 -34.639712115942174,-58.361422526239458 -34.639892857600138,-58.361422647287363 -34.639893041309925,-58.360902795730979 -34.64072284564881,-58.358481028652264 -34.641554628827684,-58.358479076637281 -34.641556352677334,-58.358648499271752 -34.641728968270073,-58.358649785415111 -34.641727595170764,-58.360414754891238 -34.642563057643734,-58.36075146082608 -34.642117199064195,-58.361768418474014 -34.642641582227412,-58.361974564943075 -34.642273431450512,-58.362088074010572 -34.642337822906526,-58.362329408891114 -34.642466053886196,-58.362330079607027 -34.642466123441586,-58.362471096148113 -34.642542958233172,-58.362471108795269 -34.642542722081352,-58.362469053328439 -34.642480535376563,-58.362512684328216 -34.641769845048934,-58.3625154806954 -34.641711958230395,-58.362516230148657 -34.6417122268087,-58.363702218196394 -34.642137236245546,-58.365217814610119 -34.642404310412005,-58.365746181040549 -34.641405545745002,-58.365491280788554 -34.641362947152651,-58.364262879848425 -34.641151955309205,-58.364382336863116 -34.640941974717663,-58.364760876782952 -34.640258384745849,-58.363301675374409 -34.639965082392507)));;2350;4_21_4;COMUNA 4;21;4;767;386;381;101,31%;257;257;100,00%;0;0,00%;249;122;49,00%;127;51,00%
MULTIPOLYGON (((-58.366063260854055 -34.640514290793377,-58.365701035911741 -34.640440057265963,-58.364760876782952 -34.640258384745849,-58.364382336863116 -34.640941974717663,-58.364262879848425 -34.641151955309205,-58.365491280788554 -34.641362947152651,-58.365746181040549 -34.641405545745002,-58.365916994977709 -34.641434133008545,-58.366200520780964 -34.641481612670553,-58.36735191559147 -34.641679777938684,-58.367484570939077 -34.640800840168893,-58.367192623618088 -34.640742300210704,-58.366418671301389 -34.64058710937033,-58.366063260854055 -34.640514290793377)));;2351;4_21_5;COMUNA 4;21;5;655;304;351;86,61%;271;271;100,00%;0;0,00%;238;76;31,93%;162;68,07%
MULTIPOLYGON (((-58.36735191559147 -34.641679777938684,-58.366200520780964 -34.641481612670553,-58.365916994977709 -34.641434133008545,-58.365746181040549 -34.641405545745002,-58.365217814610119 -34.642404310412005,-58.365757522614267 -34.642496504021494,-58.367194761765397 -34.642742152616435,-58.368575109810415 -34.642892807871526,-58.368822618284049 -34.642921731930208,-58.368966180361106 -34.641955333613254,-58.369060455265327 -34.641320949724012,-58.369090927484983 -34.641122938788044,-58.367484570939077 -34.640800840168893,-58.36735191559147 -34.641679777938684)));;2352;4_21_6;COMUNA 4;21;6;732;351;381;92,13%;309;309;100,00%;0;0,00%;270;40;14,81%;230;85,19%
MULTIPOLYGON (((-58.366943073557671 -34.64457109588691,-58.36855394588229 -34.644729960568625,-58.368581767886987 -34.644541736858258,-58.36864630773416 -34.64413515449381,-58.368691831772715 -34.643815320636101,-58.36873512285046 -34.643510626334177,-58.368822618284049 -34.642921731930208,-58.368575109810415 -34.642892807871526,-58.367194761765397 -34.642742152616435,-58.365757522614267 -34.642496504021494,-58.365217814610119 -34.642404310412005,-58.36466731613038 -34.643444957520785,-58.365598995475736 -34.643548593384068,-58.365561900679268 -34.643791176917098,-58.365461346602423 -34.644450483151488,-58.366943073557671 -34.64457109588691)));;2353;4_21_7;COMUNA 4;21;7;838;396;442;89,59%;282;282;100,00%;0;0,00%;275;39;14,18%;236;85,82%
MULTIPOLYGON (((-58.362816709172947 -34.64369501285789,-58.364197084227527 -34.644333831192704,-58.365461346602423 -34.644450483151488,-58.365561900679268 -34.643791176917098,-58.365598995475736 -34.643548593384068,-58.36466731613038 -34.643444957520785,-58.365217814610119 -34.642404310412005,-58.363702218196394 -34.642137236245546,-58.362516230148657 -34.6417122268087,-58.3625154806954 -34.641711958230395,-58.362512684328216 -34.641769845048934,-58.362469053328439 -34.642480535376563,-58.362471108795269 -34.642542722081352,-58.362471096148113 -34.642542958233172,-58.362461868739103 -34.64271525501352,-58.362505983187177 -34.643090514074807,-58.362624235099325 -34.643605908675219,-58.362816709172947 -34.64369501285789)));;2354;4_21_8;COMUNA 4;21;8;981;470;511;91,98%;300;300;100,00%;0;0,00%;294;73;24,83%;221;75,17%
MULTIPOLYGON (((-58.36075146082608 -34.642117199064195,-58.360414754891238 -34.642563057643734,-58.358649785415111 -34.641727595170764,-58.358648499271752 -34.641728968270073,-58.358479076637281 -34.641556352677334,-58.358125305699524 -34.641868770658824,-58.357876385124072 -34.642478906533,-58.358060397179791 -34.642568480133562,-58.358060947949724 -34.642565779196097,-58.359767193807016 -34.64342063775166,-58.360988395402316 -34.644032526149481,-58.361650440680897 -34.644364213393565,-58.362208120794122 -34.643410771791125,-58.362452275821539 -34.643521642749278,-58.362624235099325 -34.643605908675219,-58.362505983187177 -34.643090514074807,-58.362461868739103 -34.64271525501352,-58.362471096148113 -34.642542958233172,-58.362330079607027 -34.642466123441586,-58.362329408891114 -34.642466053886196,-58.362088074010572 -34.642337822906526,-58.361974564943075 -34.642273431450512,-58.361768418474014 -34.642641582227412,-58.36075146082608 -34.642117199064195)));;2355;4_21_9;COMUNA 4;21;9;835;416;419;99,28%;250;250;100,00%;0;0,00%;253;131;51,78%;122;48,22%
MULTIPOLYGON (((-58.374580120072494 -34.638675472760944,-58.374680762897924 -34.638099118755612,-58.374728999894081 -34.637847807564029,-58.374340491230186 -34.637814920045223,-58.373545335740857 -34.637739831967714,-58.373436961816957 -34.638288009500897,-58.373377751920764 -34.638517832572234,-58.372397748210958 -34.638389289952308,-58.37220347947963 -34.63940509347163,-58.372460350200321 -34.639435496022891,-58.372919649874049 -34.63949076630665,-58.373170812377083 -34.639520951885039,-58.374407713767248 -34.639669534312247,-58.374520882350168 -34.63901480685012,-58.374580120072494 -34.638675472760944)));;2356;4_22_1;COMUNA 4;22;1;589;284;305;93,11%;317;317;100,00%;0;0,00%;257;18;7,00%;239;93,00%
MULTIPOLYGON (((-58.373089421803265 -34.646665056093283,-58.372762031143061 -34.646577840614633,-58.371890733486389 -34.646390006142603,-58.370842148567199 -34.646163932282896,-58.369830288280383 -34.645945764939519,-58.369671425922242 -34.646727709783733,-58.370683300108908 -34.646941512106402,-58.371744678835171 -34.647165765812844,-58.372955499384489 -34.64742152974604,-58.372998197969025 -34.647179511611135,-58.373057701754703 -34.646841728264121,-58.373089421803265 -34.646665056093283)));;2357;4_22_10;COMUNA 4;22;10;563;252;311;81,03%;294;294;100,00%;0;0,00%;229;6;2,62%;223;97,38%
MULTIPOLYGON (((-58.372955499384489 -34.64742152974604,-58.371744678835171 -34.647165765812844,-58.370683300108908 -34.646941512106402,-58.369671425922242 -34.646727709783733,-58.368305314583878 -34.646439045655711,-58.368272161300844 -34.646668393118205,-58.368172981574624 -34.647333899726597,-58.369499535984872 -34.647573660371854,-58.37051656622701 -34.647757467095744,-58.371601250083557 -34.647953499359318,-58.372523290799485 -34.648120105154902,-58.372823708145006 -34.648175046891382,-58.372861439459029 -34.647956617431859,-58.372929260874997 -34.647572007923351,-58.372955499384489 -34.64742152974604)));;2358;4_22_11;COMUNA 4;22;11;728;348;380;91,58%;353;353;100,00%;0;0,00%;290;34;11,72%;256;88,28%
MULTIPOLYGON (((-58.367645644112763 -34.650144190593601,-58.368637649698471 -34.650669710623731,-58.369404143037535 -34.651169533763152,-58.369526891136971 -34.650834021178611,-58.369527759073449 -34.650834412915252,-58.369897045922023 -34.650941707465428,-58.370062172652531 -34.650989683805641,-58.370065138334944 -34.650990197647268,-58.371173848669571 -34.651182290101801,-58.371344495318901 -34.651211854950965,-58.371423419166511 -34.651203110977356,-58.37153341784596 -34.651144529563474,-58.371685407904288 -34.650950271166558,-58.371849310158346 -34.650772430384968,-58.372206467411736 -34.64998851778968,-58.372509723629044 -34.649238015890212,-58.372678994573135 -34.648818973520541,-58.372823708145006 -34.648175046891382,-58.372523290799485 -34.648120105154902,-58.371601250083557 -34.647953499359318,-58.37051656622701 -34.647757467095744,-58.369499535984872 -34.647573660371854,-58.368172981574624 -34.647333899726597,-58.368119827699893 -34.647690348103524,-58.368076772449008 -34.647933561440212,-58.367680677044454 -34.649955215160688,-58.367680599140989 -34.649955176407495,-58.367645644112763 -34.650144190593601)));;2359;4_22_12;COMUNA 4;22;12;605;300;305;98,36%;255;255;100,00%;0;0,00%;218;45;20,64%;173;79,36%
MULTIPOLYGON (((-58.370786136556696 -34.641321910395511,-58.371012689918928 -34.641341236455908,-58.371808571356425 -34.641405144037464,-58.371866145491147 -34.641118417442932,-58.37196449943665 -34.640629461319456,-58.372015816942621 -34.640375125341293,-58.372990520026768 -34.640462046088317,-58.373028312181795 -34.640262560597257,-58.373170812377083 -34.639520951885039,-58.372919649874049 -34.63949076630665,-58.372460350200321 -34.639435496022891,-58.37220347947963 -34.63940509347163,-58.372397748210958 -34.638389289952308,-58.37140062342889 -34.638258402624693,-58.370525159891301 -34.638143585574667,-58.369570553026364 -34.638018349391885,-58.369531244382038 -34.638272130210851,-58.369391859840569 -34.639171981596029,-58.369355983372081 -34.639403510715347,-58.369290411698771 -34.639824811757947,-58.369245691369358 -34.640115842950138,-58.369090927484983 -34.641122938788044,-58.370628171270894 -34.641308410542351,-58.370786136556696 -34.641321910395511)));;2360;4_22_2;COMUNA 4;22;2;745;345;400;86,25%;350;350;100,00%;0;0,00%;297;30;10,10%;267;89,90%
MULTIPOLYGON (((-58.372990520026768 -34.640462046088317,-58.372836009213721 -34.641275901394494,-58.372796416982865 -34.641484399829928,-58.373034474918576 -34.641503519341015,-58.37404199284898 -34.641595667231648,-58.374240170861441 -34.640573384894665,-58.374292259780795 -34.640308203100176,-58.374338697526248 -34.640068510934327,-58.374407713767248 -34.639669534312247,-58.373170812377083 -34.639520951885039,-58.373028312181795 -34.640262560597257,-58.372990520026768 -34.640462046088317)));;2361;4_22_3;COMUNA 4;22;3;886;407;479;84,97%;410;410;100,00%;0;0,00%;352;3;0,85%;349;99,15%
MULTIPOLYGON (((-58.37404199284898 -34.641595667231648,-58.373034474918576 -34.641503519341015,-58.372796416982865 -34.641484399829928,-58.372679011301713 -34.642101726760046,-58.37263897760495 -34.642323746335002,-58.373887342730853 -34.642387973660746,-58.37404199284898 -34.641595667231648)));;2362;4_22_4;COMUNA 4;22;4;1305;583;722;80,75%;566;566;100,00%;0;0,00%;495;1;0,20%;494;99,80%
MULTIPOLYGON (((-58.372796416982865 -34.641484399829928,-58.372836009213721 -34.641275901394494,-58.372990520026768 -34.640462046088317,-58.372015816942621 -34.640375125341293,-58.37196449943665 -34.640629461319456,-58.371866145491147 -34.641118417442932,-58.371808571356425 -34.641405144037464,-58.371012689918928 -34.641341236455908,-58.370786136556696 -34.641321910395511,-58.370628171270894 -34.641308410542351,-58.369090927484983 -34.641122938788044,-58.369060455265327 -34.641320949724012,-58.368966180361106 -34.641955333613254,-58.368822618284049 -34.642921731930208,-58.369009719502287 -34.642943566623202,-58.370400154303034 -34.643148506418015,-58.37123143651494 -34.643271037902629,-58.371423314679767 -34.643289562514312,-58.371610506708997 -34.643307660775776,-58.372442582037394 -34.643409127610511,-58.372495301191506 -34.643119721080488,-58.37263897760495 -34.642323746335002,-58.372679011301713 -34.642101726760046,-58.372796416982865 -34.641484399829928)));;2363;4_22_5;COMUNA 4;22;5;765;355;410;86,59%;331;331;100,00%;0;0,00%;284;23;8,10%;261;91,90%
MULTIPOLYGON (((-58.373887342730853 -34.642387973660746,-58.37263897760495 -34.642323746335002,-58.372495301191506 -34.643119721080488,-58.372442582037394 -34.643409127610511,-58.373329371796565 -34.64358457481385,-58.373650901351205 -34.643643966766682,-58.373701379640138 -34.643374488278205,-58.373819398362585 -34.642736244795557,-58.373887342730853 -34.642387973660746)));;2364;4_22_6;COMUNA 4;22;6;599;267;332;80,42%;293;293;100,00%;0;0,00%;255;1;0,39%;254;99,61%
MULTIPOLYGON (((-58.373650901351205 -34.643643966766682,-58.373329371796565 -34.64358457481385,-58.372442582037394 -34.643409127610511,-58.372110226407933 -34.645235556846124,-58.372071659161847 -34.645438421694827,-58.371890733486389 -34.646390006142603,-58.372762031143061 -34.646577840614633,-58.373089421803265 -34.646665056093283,-58.373133486539622 -34.646419799349438,-58.373226054585601 -34.645921683175622,-58.373271223894974 -34.645678680751558,-58.373316907476614 -34.645432650416552,-58.373595623455955 -34.643939005880625,-58.373650901351205 -34.643643966766682)));;2365;4_22_7;COMUNA 4;22;7;903;411;492;83,54%;483;483;100,00%;0;0,00%;402;11;2,74%;391;97,26%
MULTIPOLYGON (((-58.370400154303034 -34.643148506418015,-58.369009719502287 -34.642943566623202,-58.368822618284049 -34.642921731930208,-58.36873512285046 -34.643510626334177,-58.368691831772715 -34.643815320636101,-58.36864630773416 -34.64413515449381,-58.368581767886987 -34.644541736858258,-58.36855394588229 -34.644729960568625,-58.37001690942089 -34.645026935304237,-58.369830288280383 -34.645945764939519,-58.370842148567199 -34.646163932282896,-58.371890733486389 -34.646390006142603,-58.372071659161847 -34.645438421694827,-58.372110226407933 -34.645235556846124,-58.372442582037394 -34.643409127610511,-58.371610506708997 -34.643307660775776,-58.371423314679767 -34.643289562514312,-58.37123143651494 -34.643271037902629,-58.370400154303034 -34.643148506418015)));;2366;4_22_8;COMUNA 4;22;8;987;463;524;88,36%;426;426;100,00%;0;0,00%;363;37;10,19%;326;89,81%
MULTIPOLYGON (((-58.36842159877267 -34.645642069199226,-58.368391537796143 -34.645850291713806,-58.368336834946625 -34.646221739530041,-58.368305314583878 -34.646439045655711,-58.369671425922242 -34.646727709783733,-58.369830288280383 -34.645945764939519,-58.37001690942089 -34.645026935304237,-58.36855394588229 -34.644729960568625,-58.368521916887985 -34.644945928342814,-58.36842159877267 -34.645642069199226)));;2367;4_22_9;COMUNA 4;22;9;685;311;374;83,16%;268;268;100,00%;0;0,00%;259;40;15,44%;219;84,56%
MULTIPOLYGON (((-58.385024728883515 -34.646339781610635,-58.383921008700192 -34.646077516341762,-58.382856315999099 -34.645823576748327,-58.381784045556437 -34.645569763675105,-58.381180609358914 -34.645426329254278,-58.381063787496394 -34.645410079546821,-58.38090141916414 -34.645387866310983,-58.380559908167371 -34.645337388925135,-58.379607188367238 -34.645101947585239,-58.379086299192444 -34.646603890810667,-58.37997395024707 -34.646818516772768,-58.380150901874131 -34.646861102759296,-58.380365851095114 -34.646912798931531,-58.38040913066456 -34.646923180570802,-58.38040914329612 -34.64692311363175,-58.380583254543438 -34.646965129434754,-58.380583271297709 -34.646965059785948,-58.38123834499789 -34.647122546147685,-58.38230611441346 -34.647379318836514,-58.383378405919046 -34.647637141481269,-58.384465272972065 -34.647898414851213,-58.385024728883515 -34.646339781610635)));;2368;4_23_1;COMUNA 4;23;1;834;401;433;92,61%;295;295;100,00%;0;0,00%;272;27;9,93%;245;90,07%
MULTIPOLYGON (((-58.376035929329404 -34.651909806964746,-58.376003881252075 -34.651996336024986,-58.375850482341548 -34.65232356042489,-58.375826054502205 -34.65237572765394,-58.376890359448915 -34.652652827398349,-58.376832589387135 -34.652807932120709,-58.376540741305625 -34.653594791500808,-58.377482383743867 -34.653831727712685,-58.377930884235958 -34.653944508395512,-58.378570578544029 -34.654105730755994,-58.378566543391877 -34.654050726371977,-58.378549189682474 -34.653766199070787,-58.378617188402224 -34.653437926544107,-58.378779266710112 -34.653199721377931,-58.378882748796997 -34.653166150680065,-58.378841592397769 -34.653155636595024,-58.378961590578136 -34.652658774541692,-58.378992262645149 -34.652666612731934,-58.379006641101931 -34.652605775746594,-58.378980484615752 -34.652599137878511,-58.379133219410733 -34.651987816228527,-58.379178971326681 -34.651999749333299,-58.379193052995504 -34.651940863307381,-58.379193025952588 -34.651940840922776,-58.379208664582571 -34.651878639340573,-58.379167939155096 -34.651868329456178,-58.379199687007301 -34.651737924821795,-58.379295867956507 -34.651346148096053,-58.379372544204777 -34.651027881244907,-58.379414736033574 -34.650849735779182,-58.379460147047588 -34.650861105150447,-58.379474620946105 -34.65080204444584,-58.379474693810323 -34.650801747123381,-58.379131513973888 -34.650715030981694,-58.377944277347147 -34.650415118187453,-58.377740987003634 -34.650371947274039,-58.377543320142699 -34.650329977167438,-58.376669956177842 -34.650196543288573,-58.376569628069838 -34.650467607274777,-58.376035929329404 -34.651909806964746)));;2369;4_23_10;COMUNA 4;23;10;804;385;419;91,89%;253;253;100,00%;0;0,00%;259;47;18,15%;212;81,85%
MULTIPOLYGON (((-58.371849310158346 -34.650772430384968,-58.371685407904288 -34.650950271166558,-58.37153341784596 -34.651144529563474,-58.371423419166511 -34.651203110977356,-58.371344495318901 -34.651211854950965,-58.371173848669571 -34.651182290101801,-58.370065138334944 -34.650990197647268,-58.370062172652531 -34.650989683805641,-58.369897045922023 -34.650941707465428,-58.369527759073449 -34.650834412915252,-58.369526891136971 -34.650834021178611,-58.369404143037535 -34.651169533763152,-58.36965673530694 -34.651334244443966,-58.36986009478381 -34.651772370074042,-58.370012017224283 -34.652102777034095,-58.369670977556176 -34.653231986965032,-58.369786919592094 -34.653578705175526,-58.370302574792809 -34.653989038493741,-58.37059806275898 -34.654121704917358,-58.372535450978205 -34.654991513658977,-58.373658959028475 -34.656446700206146,-58.373849034521356 -34.656678116361256,-58.37409073379807 -34.656492626535695,-58.374313454950588 -34.656307923732086,-58.374605427559608 -34.655593396174666,-58.375066676225721 -34.654368763558594,-58.375474778584774 -34.65326275637247,-58.375713225303194 -34.652616217651577,-58.375826054502205 -34.65237572765394,-58.375850482341548 -34.65232356042489,-58.376003881252075 -34.651996336024986,-58.376035929329404 -34.651909806964746,-58.376569628069838 -34.650467607274777,-58.374544395371224 -34.649807971420287,-58.374003526607282 -34.649631799331935,-58.373268599644952 -34.64939238220375,-58.373122924142613 -34.64934727393873,-58.372822373204421 -34.649254092270866,-58.372779122727721 -34.649216524054715,-58.372753283853882 -34.649153967921251,-58.372751160821167 -34.649068189147066,-58.372678994573135 -34.648818973520541,-58.372509723629044 -34.649238015890212,-58.372206467411736 -34.64998851778968,-58.371849310158346 -34.650772430384968)));;2370;4_23_11;COMUNA 4;23;11;573;291;282;103,19%;197;197;100,00%;0;0,00%;206;110;53,40%;96;46,60%
MULTIPOLYGON (((-58.37409073379807 -34.656492626535695,-58.373849034521356 -34.656678116361256,-58.373932901845691 -34.656770688443885,-58.374061521753177 -34.656891046307521,-58.374996164880443 -34.657062867510021,-58.375242427300151 -34.657100048793332,-58.376028735014636 -34.656922676439343,-58.376078893077207 -34.656938857884818,-58.376100356256416 -34.656949887263146,-58.376138865685881 -34.65694685512657,-58.376153043668481 -34.65695403526361,-58.376138106731432 -34.656964599579034,-58.376137359228309 -34.656971329907094,-58.376149200310564 -34.656978069171615,-58.376191403375081 -34.656983606187758,-58.376220272268135 -34.656994028902716,-58.376258028502278 -34.657003234119273,-58.37629946060099 -34.657038141571157,-58.376337212420779 -34.657051630033706,-58.376224643480704 -34.657063176278449,-58.376229046476979 -34.657101728864049,-58.37649342364054 -34.657086006766569,-58.376566022981905 -34.657057298950285,-58.376588979292841 -34.657056703268616,-58.376621578626782 -34.657040205088265,-58.376626757737661 -34.657044492018123,-58.376637119756246 -34.657049394502387,-58.376705244382265 -34.657051278256752,-58.376730430421659 -34.657042729469829,-58.376742289251411 -34.657032335594373,-58.376751915823235 -34.657032342380447,-58.37675709304542 -34.657038464992176,-58.376757084202318 -34.657047031533381,-58.376764487364099 -34.657048872440008,-58.376814842381073 -34.657048296023042,-58.376848909743167 -34.657044342688934,-58.376874846363847 -34.657026004060683,-58.376909660209428 -34.657016238220649,-58.376922989306358 -34.657016247598271,-58.376940008954442 -34.657027885598929,-58.376953314735587 -34.657050535117953,-58.377005874894145 -34.657065869475183,-58.377040674890686 -34.65706956530547,-58.377068803414339 -34.657079987299333,-58.377115457176565 -34.657078184366348,-58.377133232463571 -34.657075137360501,-58.377140640038 -34.657072694973685,-58.377145846215775 -34.657050670361933,-58.377165124509879 -34.65702620803733,-58.377172538364995 -34.657017646690456,-58.377174771824201 -34.657006022228302,-58.377215505898469 -34.656999931830853,-58.377271799365936 -34.656985285774567,-58.377294752513777 -34.656987749439061,-58.377318432990165 -34.657003063429826,-58.377334719087017 -34.657007970003036,-58.377359895013427 -34.657009211418924,-58.377386561356658 -34.657001275428641,-58.377410999283967 -34.657000068732593,-58.377432465162642 -34.657008650293349,-58.377453939190609 -34.657009277204736,-58.377471710692227 -34.657009901524361,-58.377486513909858 -34.657016642729516,-58.377502790626778 -34.657030727717469,-58.377510195682035 -34.657030732891414,-58.377516111587312 -34.657038691675822,-58.377520532709561 -34.657060111133156,-58.377530151773165 -34.6570674606075,-58.377534589174871 -34.657072970773235,-58.377539762075912 -34.657083376622431,-58.377559749480241 -34.657089509543091,-58.377571584438087 -34.657102367627601,-58.377568605519912 -34.657118886746332,-58.377572283650721 -34.657142753267749,-58.377561897787302 -34.657161102903402,-58.377547816269313 -34.657172719098661,-58.377533416438901 -34.657180099384654,-58.377532806463108 -34.65719304928821,-58.377703954974862 -34.657225772681635,-58.378080281264552 -34.657298300401749,-58.37810635779136 -34.657301135477908,-58.378132263508739 -34.657304322552797,-58.378154936904245 -34.657301310020877,-58.378149926691286 -34.657283418711984,-58.37815182034614 -34.657265039218437,-58.378174315769314 -34.657269421136867,-58.378198423640832 -34.657280564925117,-58.378335251966419 -34.657294409783603,-58.378355205669671 -34.657147148537398,-58.378308634308056 -34.657137556391312,-58.378429613727008 -34.656655374499046,-58.378193851325804 -34.656363505977261,-58.378410455581971 -34.656282584504574,-58.378610410839492 -34.65542333162103,-58.37863571169742 -34.655349755392528,-58.378663659735935 -34.655270969564121,-58.378782930207187 -34.654807446744186,-58.378788895987825 -34.654722800509518,-58.378806606566258 -34.654654148733627,-58.378886274329204 -34.654670823720799,-58.379043705886076 -34.654224228722839,-58.378940269210318 -34.654199509110178,-58.378939196969242 -34.65419918827866,-58.378884123735574 -34.654182709479173,-58.378625700438967 -34.654123304496153,-58.378570578544029 -34.654105730755994,-58.377930884235958 -34.653944508395512,-58.377482383743867 -34.653831727712685,-58.376540741305625 -34.653594791500808,-58.376832589387135 -34.652807932120709,-58.376890359448915 -34.652652827398349,-58.375826054502205 -34.65237572765394,-58.375713225303194 -34.652616217651577,-58.375474778584774 -34.65326275637247,-58.375066676225721 -34.654368763558594,-58.374605427559608 -34.655593396174666,-58.374313454950588 -34.656307923732086,-58.37409073379807 -34.656492626535695)));;2371;4_23_12;COMUNA 4;23;12;780;377;403;93,55%;225;224;99,56%;1;0,45%;232;33;14,22%;199;85,78%
MULTIPOLYGON (((-58.380397053389238 -34.64698570952487,-58.380349342894483 -34.646974972765932,-58.38031761030642 -34.647093616895475,-58.380298118484674 -34.647156774650703,-58.380282809905324 -34.647212188516377,-58.380266988542758 -34.647269080950913,-58.380252535154987 -34.647321396704655,-58.38023746905565 -34.64739005056353,-58.380219755215798 -34.647464759149806,-58.380200243071563 -34.647548269598516,-58.380184938261962 -34.647599739669865,-58.380173821203421 -34.647638958682244,-58.380164318230889 -34.647683249361265,-58.380153709730997 -34.647725215277134,-58.380143274167544 -34.647764646021194,-58.380132923601749 -34.647804288095621,-58.380120776274822 -34.647851182691831,-58.380115472982148 -34.647871179702904,-58.380111681666712 -34.647913291079675,-58.380109021148058 -34.647932233510232,-58.380096200572716 -34.647970535839058,-58.380064544702904 -34.648096997071349,-58.380060180029865 -34.64811572707147,-58.380040686514 -34.648180152417218,-58.38002845015729 -34.648230779447488,-58.380013217327523 -34.648295348525316,-58.379996960533838 -34.648361254974461,-58.379991310992729 -34.648386604017013,-58.380048903723335 -34.64840115054357,-58.380035380125662 -34.648460791055356,-58.380035307195165 -34.648461111552045,-58.380021856718294 -34.648520220291232,-58.379960343822901 -34.648505741516999,-58.379763226061471 -34.649284856303055,-58.379837437065802 -34.649299343804522,-58.3798162952776 -34.649392571658808,-58.379793120285271 -34.649388048727864,-58.379766612019189 -34.649393312550387,-58.379750915649566 -34.64940949954115,-58.379749531246773 -34.64943048514165,-58.379761275788596 -34.649446197824503,-58.37980029397869 -34.64945826696934,-58.379793498689097 -34.64948274256146,-58.379963880973243 -34.649514244731961,-58.380364569663662 -34.649588160180436,-58.380384481697845 -34.649531481790497,-58.381488551082839 -34.649733284415404,-58.381754813377903 -34.649781984024564,-58.382319203264828 -34.649887290066154,-58.38257609269661 -34.649935700004299,-58.382649833551881 -34.649731164868804,-58.382853984466088 -34.649144450188906,-58.383378405919046 -34.647637141481269,-58.38230611441346 -34.647379318836514,-58.38123834499789 -34.647122546147685,-58.380583271297709 -34.646965059785948,-58.380583254543438 -34.646965129434754,-58.38040914329612 -34.64692311363175,-58.38040913066456 -34.646923180570802,-58.380397053389238 -34.64698570952487)));;2372;4_23_2;COMUNA 4;23;2;873;429;444;96,62%;340;339;99,71%;1;0,29%;288;48;16,67%;240;83,33%
MULTIPOLYGON (((-58.378565818759057 -34.648104352790988,-58.378288648799369 -34.648903410576715,-58.378238489243529 -34.6490379573371,-58.378173033822527 -34.649213480612623,-58.379266120771113 -34.649394943029186,-58.379606090305465 -34.649448275341044,-58.379793504376586 -34.649482854102764,-58.379793498689097 -34.64948274256146,-58.37980029397869 -34.64945826696934,-58.379761275788596 -34.649446197824503,-58.379749531246773 -34.64943048514165,-58.379750915649566 -34.64940949954115,-58.379766612019189 -34.649393312550387,-58.379793120285271 -34.649388048727864,-58.3798162952776 -34.649392571658808,-58.379837437065802 -34.649299343804522,-58.379763226061471 -34.649284856303055,-58.379960343822901 -34.648505741516999,-58.380021856718294 -34.648520220291232,-58.380035307195165 -34.648461111552045,-58.380035380125662 -34.648460791055356,-58.380048903723335 -34.64840115054357,-58.379991310992729 -34.648386604017013,-58.379996960533838 -34.648361254974461,-58.380013217327523 -34.648295348525316,-58.38002845015729 -34.648230779447488,-58.380040686514 -34.648180152417218,-58.380060180029865 -34.64811572707147,-58.380064544702904 -34.648096997071349,-58.380096200572716 -34.647970535839058,-58.380109021148058 -34.647932233510232,-58.380111681666712 -34.647913291079675,-58.380115472982148 -34.647871179702904,-58.380120776274822 -34.647851182691831,-58.380132923601749 -34.647804288095621,-58.380143274167544 -34.647764646021194,-58.380153709730997 -34.647725215277134,-58.380164318230889 -34.647683249361265,-58.380173821203421 -34.647638958682244,-58.380184938261962 -34.647599739669865,-58.380200243071563 -34.647548269598516,-58.380219755215798 -34.647464759149806,-58.38023746905565 -34.64739005056353,-58.380252535154987 -34.647321396704655,-58.380266988542758 -34.647269080950913,-58.380282809905324 -34.647212188516377,-58.380298118484674 -34.647156774650703,-58.38031761030642 -34.647093616895475,-58.380349342894483 -34.646974972765932,-58.380397053389238 -34.64698570952487,-58.38040913066456 -34.646923180570802,-58.380365851095114 -34.646912798931531,-58.380150901874131 -34.646861102759296,-58.37997395024707 -34.646818516772768,-58.379086299192444 -34.646603890810667,-58.379607188367238 -34.645101947585239,-58.378884154045075 -34.644923278326267,-58.378800698833579 -34.645122804506606,-58.378219440259251 -34.646394272940711,-58.378124383900591 -34.646602382380081,-58.377628929832419 -34.647695732775453,-58.377560429266374 -34.64784885859595,-58.377826825668329 -34.647925032499543,-58.378565818759057 -34.648104352790988)));;2373;4_23_3;COMUNA 4;23;3;819;390;429;90,91%;300;300;100,00%;0;0,00%;258;44;17,05%;214;82,95%
MULTIPOLYGON (((-58.3775329137789 -34.644589303774964,-58.376853251127557 -34.644421286877325,-58.37677434355691 -34.644668844524958,-58.37600191538278 -34.644552590061913,-58.375919528435624 -34.644865569211326,-58.375822325400911 -34.645248891994072,-58.375400131632333 -34.646914204456614,-58.375309191156802 -34.647253163644876,-58.37522355431436 -34.647572196372693,-58.374927583742974 -34.648554266732845,-58.377129888590851 -34.648950069168414,-58.37716996883605 -34.648840164419539,-58.377241411997502 -34.648644504420808,-58.377470233755012 -34.648050350949468,-58.377560429266374 -34.64784885859595,-58.377628929832419 -34.647695732775453,-58.378124383900591 -34.646602382380081,-58.378219440259251 -34.646394272940711,-58.378800698833579 -34.645122804506606,-58.378884154045075 -34.644923278326267,-58.377592548439893 -34.644603993743729,-58.3775329137789 -34.644589303774964)));;2374;4_23_4;COMUNA 4;23;4;827;385;442;87,10%;312;312;100,00%;0;0,00%;265;11;4,15%;254;95,85%
MULTIPOLYGON (((-58.3752378700542 -34.644002238895112,-58.373962974616482 -34.643701590373666,-58.373650901351205 -34.643643966766682,-58.373595623455955 -34.643939005880625,-58.373316907476614 -34.645432650416552,-58.373271223894974 -34.645678680751558,-58.373226054585601 -34.645921683175622,-58.373133486539622 -34.646419799349438,-58.373089421803265 -34.646665056093283,-58.374299231295915 -34.646987286842005,-58.374583858601625 -34.647063128927421,-58.375138719932174 -34.647208392125584,-58.375309191156802 -34.647253163644876,-58.375400131632333 -34.646914204456614,-58.375822325400911 -34.645248891994072,-58.375919528435624 -34.644865569211326,-58.37600191538278 -34.644552590061913,-58.375136621143817 -34.644422390396798,-58.375166668025287 -34.644292126283766,-58.3752378700542 -34.644002238895112)));;2375;4_23_5;COMUNA 4;23;5;543;247;296;83,45%;244;244;100,00%;0;0,00%;227;11;4,85%;216;95,15%
MULTIPOLYGON (((-58.377129888590851 -34.648950069168414,-58.374927583742974 -34.648554266732845,-58.37522355431436 -34.647572196372693,-58.375309191156802 -34.647253163644876,-58.375138719932174 -34.647208392125584,-58.374583858601625 -34.647063128927421,-58.374299231295915 -34.646987286842005,-58.373089421803265 -34.646665056093283,-58.373057701754703 -34.646841728264121,-58.372998197969025 -34.647179511611135,-58.372955499384489 -34.64742152974604,-58.372929260874997 -34.647572007923351,-58.372861439459029 -34.647956617431859,-58.372823708145006 -34.648175046891382,-58.372678994573135 -34.648818973520541,-58.372751160821167 -34.649068189147066,-58.372753283853882 -34.649153967921251,-58.372779122727721 -34.649216524054715,-58.372822373204421 -34.649254092270866,-58.373122924142613 -34.64934727393873,-58.373268599644952 -34.64939238220375,-58.374003526607282 -34.649631799331935,-58.374544395371224 -34.649807971420287,-58.376569628069838 -34.650467607274777,-58.376669956177842 -34.650196543288573,-58.376737638950033 -34.650013557410681,-58.377051180551732 -34.649165935860765,-58.377099123313847 -34.649034416296573,-58.377129888590851 -34.648950069168414)));;2376;4_23_6;COMUNA 4;23;6;695;319;376;84,84%;413;412;99,76%;1;0,24%;304;18;5,92%;286;94,08%
MULTIPOLYGON (((-58.37716996883605 -34.648840164419539,-58.377129888590851 -34.648950069168414,-58.377099123313847 -34.649034416296573,-58.377051180551732 -34.649165935860765,-58.376737638950033 -34.650013557410681,-58.376669956177842 -34.650196543288573,-58.377543320142699 -34.650329977167438,-58.377740987003634 -34.650371947274039,-58.377944277347147 -34.650415118187453,-58.379131513973888 -34.650715030981694,-58.379474693810323 -34.650801747123381,-58.379490266500255 -34.650739079836747,-58.379450564024019 -34.650728982017114,-58.379482889659677 -34.650616465533005,-58.379513871388397 -34.650484229226166,-58.379533811013232 -34.650400719220109,-58.379554178032002 -34.650315871433094,-58.379564034673464 -34.65025939760163,-58.379571485401272 -34.650222711449523,-58.379575262335209 -34.650195389268127,-58.37958142245953 -34.650171026545408,-58.379588773122215 -34.650149199920378,-58.379591178945873 -34.650129482663708,-58.379603657734549 -34.650092659086312,-58.379612150314578 -34.650036677291723,-58.379622670371056 -34.649998514309154,-58.379658893202695 -34.649822970372774,-58.379666358384426 -34.649771706322738,-58.379673211717581 -34.649735794425602,-58.379683997052751 -34.649687913016777,-58.379690762976267 -34.649654184222342,-58.379713122317398 -34.649536590298247,-58.379775831939554 -34.649548112174323,-58.379793504376586 -34.649482854102764,-58.379606090305465 -34.649448275341044,-58.379266120771113 -34.649394943029186,-58.378173033822527 -34.649213480612623,-58.378238489243529 -34.6490379573371,-58.378288648799369 -34.648903410576715,-58.378565818759057 -34.648104352790988,-58.377826825668329 -34.647925032499543,-58.377560429266374 -34.64784885859595,-58.377470233755012 -34.648050350949468,-58.377241411997502 -34.648644504420808,-58.37716996883605 -34.648840164419539)));;2377;4_23_7;COMUNA 4;23;7;653;297;356;83,43%;267;266;99,63%;1;0,38%;233;20;8,58%;213;91,42%
MULTIPOLYGON (((-58.379793498689097 -34.64948274256146,-58.379793504376586 -34.649482854102764,-58.379775831939554 -34.649548112174323,-58.379713122317398 -34.649536590298247,-58.379690762976267 -34.649654184222342,-58.379683997052751 -34.649687913016777,-58.379673211717581 -34.649735794425602,-58.379666358384426 -34.649771706322738,-58.379658893202695 -34.649822970372774,-58.379622670371056 -34.649998514309154,-58.379612150314578 -34.650036677291723,-58.379603657734549 -34.650092659086312,-58.379591178945873 -34.650129482663708,-58.379588773122215 -34.650149199920378,-58.37958142245953 -34.650171026545408,-58.379575262335209 -34.650195389268127,-58.379571485401272 -34.650222711449523,-58.379564034673464 -34.65025939760163,-58.379554178032002 -34.650315871433094,-58.379533811013232 -34.650400719220109,-58.379513871388397 -34.650484229226166,-58.379482889659677 -34.650616465533005,-58.379450564024019 -34.650728982017114,-58.379490266500255 -34.650739079836747,-58.379474693810323 -34.650801747123381,-58.379474620946105 -34.65080204444584,-58.379631901818961 -34.650841365719387,-58.379631885443189 -34.650841432943906,-58.379879728753181 -34.650904068166625,-58.380985699011731 -34.651183484532915,-58.382041323566312 -34.651450110713959,-58.382921186223832 -34.651672386226544,-58.383132909975131 -34.651725343023557,-58.383407997570501 -34.650926343640208,-58.3834624327733 -34.650768839140426,-58.383677864580399 -34.650145157576745,-58.383874151543615 -34.649577028232756,-58.383936614586148 -34.649399387226865,-58.384419134903851 -34.648026910243303,-58.384465272972065 -34.647898414851213,-58.383378405919046 -34.647637141481269,-58.382853984466088 -34.649144450188906,-58.382649833551881 -34.649731164868804,-58.38257609269661 -34.649935700004299,-58.382319203264828 -34.649887290066154,-58.381754813377903 -34.649781984024564,-58.381488551082839 -34.649733284415404,-58.380384481697845 -34.649531481790497,-58.380364569663662 -34.649588160180436,-58.379963880973243 -34.649514244731961,-58.379793498689097 -34.64948274256146)));;2378;4_23_8;COMUNA 4;23;8;845;392;453;86,53%;347;346;99,71%;1;0,29%;288;16;5,56%;272;94,44%
MULTIPOLYGON (((-58.379474620946105 -34.65080204444584,-58.379460147047588 -34.650861105150447,-58.379414736033574 -34.650849735779182,-58.379372544204777 -34.651027881244907,-58.379295867956507 -34.651346148096053,-58.379199687007301 -34.651737924821795,-58.379167939155096 -34.651868329456178,-58.379208664582571 -34.651878639340573,-58.379193025952588 -34.651940840922776,-58.379193052995504 -34.651940863307381,-58.379178971326681 -34.651999749333299,-58.379133219410733 -34.651987816228527,-58.378980484615752 -34.652599137878511,-58.379006641101931 -34.652605775746594,-58.378992262645149 -34.652666612731934,-58.378961590578136 -34.652658774541692,-58.378841592397769 -34.653155636595024,-58.378882748796997 -34.653166150680065,-58.378779266710112 -34.653199721377931,-58.378617188402224 -34.653437926544107,-58.378549189682474 -34.653766199070787,-58.378566543391877 -34.654050726371977,-58.378570578544029 -34.654105730755994,-58.378625700438967 -34.654123304496153,-58.378884123735574 -34.654182709479173,-58.378939196969242 -34.65419918827866,-58.378940269210318 -34.654199509110178,-58.379043705886076 -34.654224228722839,-58.378886274329204 -34.654670823720799,-58.378806606566258 -34.654654148733627,-58.378788895987825 -34.654722800509518,-58.378782930207187 -34.654807446744186,-58.378663659735935 -34.655270969564121,-58.37863571169742 -34.655349755392528,-58.378610410839492 -34.65542333162103,-58.378410455581971 -34.656282584504574,-58.378193851325804 -34.656363505977261,-58.378429613727008 -34.656655374499046,-58.378308634308056 -34.657137556391312,-58.378355205669671 -34.657147148537398,-58.378491294398344 -34.657165200859822,-58.378669223356219 -34.65718933838361,-58.378896172927085 -34.657198438496657,-58.379246594817381 -34.65722875012284,-58.379647871888032 -34.657284589078444,-58.379741274723287 -34.657290357051785,-58.380056776979735 -34.657297825032707,-58.380466529394162 -34.657316201179157,-58.380732768096095 -34.657326310309053,-58.38101102467288 -34.657335581815204,-58.381107410876453 -34.657341069042594,-58.381181895593549 -34.657344710515027,-58.381453456892118 -34.656529516299493,-58.381924120375963 -34.65516514177942,-58.381986700023646 -34.654963768936639,-58.382047740420951 -34.654767465606362,-58.382202522215117 -34.654223467572592,-58.38227216946332 -34.654026817664068,-58.382348994772627 -34.653809819733169,-58.382721596103366 -34.652828345837641,-58.383060441258856 -34.651935724457417,-58.383132909975131 -34.651725343023557,-58.382921186223832 -34.651672386226544,-58.382041323566312 -34.651450110713959,-58.380985699011731 -34.651183484532915,-58.379879728753181 -34.650904068166625,-58.379631885443189 -34.650841432943906,-58.379631901818961 -34.650841365719387,-58.379474620946105 -34.65080204444584)));;2379;4_23_9;COMUNA 4;23;9;471;226;245;92,24%;129;129;100,00%;0;0,00%;150;22;14,67%;128;85,33%
MULTIPOLYGON (((-58.43065546528571 -34.643942981043907,-58.431263677245049 -34.644048283455803,-58.432174976968511 -34.644202252131905,-58.432216183552278 -34.643604074826072,-58.432252795288797 -34.642986177374432,-58.432306134206357 -34.642296309931538,-58.432344426019498 -34.641741231615342,-58.432113777348796 -34.641694059829234,-58.431421663171996 -34.641550710765152,-58.431158298038241 -34.641494584831946,-58.43092364689911 -34.641444592768117,-58.430123827699965 -34.641309166220452,-58.429922401016206 -34.641281435321666,-58.42988133546725 -34.641482768647847,-58.429657550006802 -34.642398159506619,-58.429620338631118 -34.642547027320838,-58.429474223395012 -34.643130456541975,-58.429328276816825 -34.643713181330426,-58.429911604896638 -34.643814187768349,-58.43065546528571 -34.643942981043907)));;2380;4_3_1;COMUNA 4;3;1;974;432;542;79,70%;367;367;100,00%;0;0,00%;342;20;5,85%;322;94,15%
MULTIPOLYGON (((-58.423636518437057 -34.643445355938589,-58.422814512829483 -34.642825774779467,-58.422158292624786 -34.642305260432501,-58.421897546513073 -34.642650958939221,-58.421119899812574 -34.643681784757021,-58.420963856537377 -34.643888639290125,-58.420344705598225 -34.64471154991552,-58.419666447998587 -34.645612959981044,-58.419680404134688 -34.646309887712121,-58.419702780091605 -34.646544198554508,-58.420130058491921 -34.646031938386088,-58.420648788030725 -34.646490935245829,-58.421661153498476 -34.645449346729436,-58.422568628879851 -34.644515605814078,-58.423566272734064 -34.643510194591471,-58.423636518437057 -34.643445355938589)));;2381;4_3_10;COMUNA 4;3;10;822;377;445;84,72%;327;327;100,00%;0;0,00%;293;17;5,80%;276;94,20%
MULTIPOLYGON (((-58.426025186309182 -34.645605460321221,-58.425760115350187 -34.645339949602636,-58.425428082462652 -34.645041247811186,-58.425258484878917 -34.644898656244138,-58.425521496351159 -34.644807747982988,-58.424597821770305 -34.644148569242994,-58.423636518437057 -34.643445355938589,-58.423566272734064 -34.643510194591471,-58.422568628879851 -34.644515605814078,-58.423301988282702 -34.645215655298557,-58.424160571036538 -34.646035250649327,-58.424496513174034 -34.64635592957238,-58.424837398279145 -34.646681327543085,-58.425110849241747 -34.646697116844479,-58.425408828139055 -34.646745026694546,-58.425527867052715 -34.646762739635498,-58.425751968906035 -34.646799710278167,-58.425955274463284 -34.646845195631755,-58.426149458093207 -34.64689983312195,-58.42627011082643 -34.646930503964398,-58.426432763886801 -34.646987314744742,-58.426704722527766 -34.647107117290631,-58.426902897996364 -34.647195347332357,-58.427111291750606 -34.647302594698189,-58.427279221099319 -34.647379265646975,-58.427224064244349 -34.64743009623475,-58.427270925541855 -34.647448701974625,-58.427344105660175 -34.647498372614791,-58.427387209599459 -34.647535569336377,-58.427448122266796 -34.64757664454936,-58.427780095465472 -34.647855833069215,-58.428067094842547 -34.648089865691979,-58.428251475545224 -34.647955899758529,-58.428426905188687 -34.647828410098199,-58.428248875228164 -34.647649762945157,-58.42813379293969 -34.647539304478663,-58.427641267964226 -34.647066755092204,-58.427244236578943 -34.646685854007693,-58.426827446998111 -34.646285931129469,-58.426442262999224 -34.645916439673407,-58.426064067120187 -34.645553569001201,-58.426025186309182 -34.645605460321221)));;2382;4_3_11;COMUNA 4;3;11;920;430;490;87,76%;353;352;99,72%;1;0,28%;307;17;5,54%;290;94,46%
MULTIPOLYGON (((-58.419702780091605 -34.646544198554508,-58.419175667054084 -34.647134945112334,-58.419631366785012 -34.647537654386319,-58.420004873494811 -34.647867725342884,-58.420179770536102 -34.647806305709629,-58.421650574146568 -34.647377078289345,-58.421684388035288 -34.647411879459796,-58.42178223218621 -34.647380643770965,-58.421986099824146 -34.647320710176906,-58.422673840955582 -34.647095400552985,-58.422936572151848 -34.64689841130555,-58.423092083759826 -34.646873102989026,-58.423147874161366 -34.646928263627309,-58.423529346783738 -34.646833102153948,-58.423701073664262 -34.646798156123062,-58.423962284528741 -34.646747604027254,-58.424174060911461 -34.646716261704398,-58.424451107622865 -34.646695714480792,-58.424837398279145 -34.646681327543085,-58.424496513174034 -34.64635592957238,-58.424160571036538 -34.646035250649327,-58.423301988282702 -34.645215655298557,-58.422568628879851 -34.644515605814078,-58.421661153498476 -34.645449346729436,-58.420648788030725 -34.646490935245829,-58.420130058491921 -34.646031938386088,-58.419702780091605 -34.646544198554508)));;2383;4_3_12;COMUNA 4;3;12;1065;516;549;93,99%;359;359;100,00%;0;0,00%;341;42;12,32%;299;87,68%
MULTIPOLYGON (((-58.424837398279145 -34.646681327543085,-58.424451107622865 -34.646695714480792,-58.424174060911461 -34.646716261704398,-58.423962284528741 -34.646747604027254,-58.423701073664262 -34.646798156123062,-58.423529346783738 -34.646833102153948,-58.423147874161366 -34.646928263627309,-58.423092083759826 -34.646873102989026,-58.422936572151848 -34.64689841130555,-58.422673840955582 -34.647095400552985,-58.421986099824146 -34.647320710176906,-58.42178223218621 -34.647380643770965,-58.421684388035288 -34.647411879459796,-58.421650574146568 -34.647377078289345,-58.420179770536102 -34.647806305709629,-58.420004873494811 -34.647867725342884,-58.419631366785012 -34.647537654386319,-58.419175667054084 -34.647134945112334,-58.419133033015456 -34.647184297591387,-58.418421400087475 -34.647486022308222,-58.417644811379041 -34.647815818318911,-58.417427627692412 -34.647908557604126,-58.416433600293509 -34.648335006014278,-58.416281680135633 -34.648397707948803,-58.416192854974 -34.648474166444025,-58.416206751847263 -34.649073344783325,-58.416328783785239 -34.649074870167077,-58.416330027868398 -34.649136280943729,-58.416204246817479 -34.649133697761854,-58.416174704846277 -34.649692224444571,-58.416342326546641 -34.649699753296083,-58.41649103050645 -34.649705725407578,-58.416775996817336 -34.649717101004413,-58.417647936689782 -34.649757427465879,-58.418425883571246 -34.649792290904244,-58.419419088508981 -34.649839268586632,-58.419929455318261 -34.649860787332557,-58.421025007420447 -34.649913492186634,-58.422398711663988 -34.649976913565794,-58.422482020671481 -34.650050464406831,-58.422559346556476 -34.649984361137513,-58.424094710956169 -34.650055211107251,-58.42472855975975 -34.650084495509546,-58.42529329743477 -34.650110586326974,-58.425692085326538 -34.649815558285148,-58.425823620868115 -34.64971996145146,-58.425951405229434 -34.649627180330185,-58.426036054780951 -34.649565654660123,-58.427056016570148 -34.648824455791207,-58.42781954810998 -34.648269730179386,-58.428067094842547 -34.648089865691979,-58.427780095465472 -34.647855833069215,-58.427448122266796 -34.64757664454936,-58.427387209599459 -34.647535569336377,-58.427344105660175 -34.647498372614791,-58.427270925541855 -34.647448701974625,-58.427224064244349 -34.64743009623475,-58.427279221099319 -34.647379265646975,-58.427111291750606 -34.647302594698189,-58.426902897996364 -34.647195347332357,-58.426704722527766 -34.647107117290631,-58.426432763886801 -34.646987314744742,-58.42627011082643 -34.646930503964398,-58.426149458093207 -34.64689983312195,-58.425955274463284 -34.646845195631755,-58.425751968906035 -34.646799710278167,-58.425527867052715 -34.646762739635498,-58.425408828139055 -34.646745026694546,-58.425110849241747 -34.646697116844479,-58.424837398279145 -34.646681327543085)));;2384;4_3_13;COMUNA 4;3;13;590;279;311;89,71%;192;192;100,00%;0;0,00%;197;24;12,18%;173;87,82%
MULTIPOLYGON (((-58.428501638970232 -34.645757100080921,-58.427641267964226 -34.647066755092204,-58.42813379293969 -34.647539304478663,-58.428248875228164 -34.647649762945157,-58.428426905188687 -34.647828410098199,-58.428616910728174 -34.647690360555387,-58.429797499779312 -34.64684650410431,-58.431096034846497 -34.645918368356604,-58.432107560872296 -34.645163673459251,-58.432174976968511 -34.644202252131905,-58.431263677245049 -34.644048283455803,-58.43065546528571 -34.643942981043907,-58.430415918612553 -34.645074290950106,-58.430290230844129 -34.645065595372287,-58.429654203604564 -34.645034015260144,-58.429462986757279 -34.645023892560907,-58.429274667157074 -34.645013981630136,-58.428968154569752 -34.645006150514519,-58.428501638970232 -34.645757100080921)));;2385;4_3_2;COMUNA 4;3;2;849;416;433;96,07%;309;309;100,00%;0;0,00%;297;17;5,72%;280;94,28%
MULTIPOLYGON (((-58.425521496351159 -34.644807747982988,-58.425258484878917 -34.644898656244138,-58.425428082462652 -34.645041247811186,-58.425760115350187 -34.645339949602636,-58.426025186309182 -34.645605460321221,-58.426064067120187 -34.645553569001201,-58.426442262999224 -34.645916439673407,-58.426827446998111 -34.646285931129469,-58.427244236578943 -34.646685854007693,-58.427641267964226 -34.647066755092204,-58.428501638970232 -34.645757100080921,-58.428968154569752 -34.645006150514519,-58.42829888857613 -34.644989484174083,-58.427592466987583 -34.644978648720887,-58.427383780590304 -34.644970912171239,-58.426982687208856 -34.644947555201981,-58.426701487384065 -34.644931204410327,-58.426376490906392 -34.644907234064185,-58.426198739915321 -34.644894081994181,-58.425521496351159 -34.644807747982988)));;2386;4_3_3;COMUNA 4;3;3;643;298;345;86,38%;229;229;100,00%;0;0,00%;221;7;3,17%;214;96,83%
MULTIPOLYGON (((-58.427965308902799 -34.643477230029973,-58.427382241188326 -34.643376214353708,-58.426798748827991 -34.643275195763493,-58.426645792119977 -34.643866436649589,-58.426376490906392 -34.644907234064185,-58.426701487384065 -34.644931204410327,-58.426982687208856 -34.644947555201981,-58.427383780590304 -34.644970912171239,-58.427592466987583 -34.644978648720887,-58.42829888857613 -34.644989484174083,-58.428968154569752 -34.645006150514519,-58.429274667157074 -34.645013981630136,-58.429462986757279 -34.645023892560907,-58.429654203604564 -34.645034015260144,-58.430290230844129 -34.645065595372287,-58.430415918612553 -34.645074290950106,-58.43065546528571 -34.643942981043907,-58.429911604896638 -34.643814187768349,-58.429328276816825 -34.643713181330426,-58.428647217942739 -34.643595242916213,-58.427965308902799 -34.643477230029973)));;2387;4_3_4;COMUNA 4;3;4;904;440;464;94,83%;328;328;100,00%;0;0,00%;298;33;11,07%;265;88,93%
MULTIPOLYGON (((-58.427382241188326 -34.643376214353708,-58.427965308902799 -34.643477230029973,-58.428647217942739 -34.643595242916213,-58.429328276816825 -34.643713181330426,-58.429474223395012 -34.643130456541975,-58.429620338631118 -34.642547027320838,-58.429657550006802 -34.642398159506619,-58.42988133546725 -34.641482768647847,-58.429922401016206 -34.641281435321666,-58.429731880843512 -34.641255115534022,-58.4292509860134 -34.641173291870508,-58.428566368518666 -34.641056971755326,-58.428354465537851 -34.641020925212146,-58.427996437490876 -34.640960469841069,-58.42742275872375 -34.64086354162967,-58.427100387992368 -34.642109473083089,-58.426798748827991 -34.643275195763493,-58.427382241188326 -34.643376214353708)));;2388;4_3_5;COMUNA 4;3;5;1061;502;559;89,80%;365;365;100,00%;0;0,00%;361;8;2,22%;353;97,78%
MULTIPOLYGON (((-58.427100387992368 -34.642109473083089,-58.42742275872375 -34.64086354162967,-58.426768308150592 -34.640752994969233,-58.426166770677312 -34.640651404602053,-58.425938014120106 -34.64154481473696,-58.424850666246869 -34.642424791436177,-58.425769431752094 -34.643162631381202,-58.424597821770305 -34.644148569242994,-58.425521496351159 -34.644807747982988,-58.426198739915321 -34.644894081994181,-58.426376490906392 -34.644907234064185,-58.426645792119977 -34.643866436649589,-58.426798748827991 -34.643275195763493,-58.427100387992368 -34.642109473083089)));;2389;4_3_6;COMUNA 4;3;6;902;421;481;87,53%;321;321;100,00%;0;0,00%;296;12;4,05%;284;95,95%
MULTIPOLYGON (((-58.424850666246869 -34.642424791436177,-58.425938014120106 -34.64154481473696,-58.426166770677312 -34.640651404602053,-58.425069607649512 -34.640465994728835,-58.424918372340905 -34.640440031658102,-58.423491906062658 -34.640200348482139,-58.423248273770923 -34.641139595360478,-58.423934472393334 -34.641688987620832,-58.422877089834593 -34.642581914367973,-58.422814512829483 -34.642825774779467,-58.423636518437057 -34.643445355938589,-58.424597821770305 -34.644148569242994,-58.425769431752094 -34.643162631381202,-58.424850666246869 -34.642424791436177)));;2390;4_3_7;COMUNA 4;3;7;686;348;338;102,96%;257;257;100,00%;0;0,00%;229;20;8,73%;209;91,27%
MULTIPOLYGON (((-58.420659706195238 -34.640729562678359,-58.420576209940101 -34.641047924191483,-58.42154807651724 -34.641821238063663,-58.42178103788617 -34.642005970131919,-58.422158292624786 -34.642305260432501,-58.422814512829483 -34.642825774779467,-58.422877089834593 -34.642581914367973,-58.423934472393334 -34.641688987620832,-58.423248273770923 -34.641139595360478,-58.423491906062658 -34.640200348482139,-58.422306064725625 -34.639989109731602,-58.420917791105055 -34.639741803204231,-58.420863406992844 -34.639952988441522,-58.420659706195238 -34.640729562678359)));;2391;4_3_8;COMUNA 4;3;8;844;416;428;97,20%;305;304;99,67%;1;0,33%;275;25;9,09%;250;90,91%
MULTIPOLYGON (((-58.419943388358583 -34.643470526318055,-58.419654453080582 -34.644584191620183,-58.419659305336587 -34.645253368923463,-58.419666447998587 -34.645612959981044,-58.420344705598225 -34.64471154991552,-58.420963856537377 -34.643888639290125,-58.421119899812574 -34.643681784757021,-58.421897546513073 -34.642650958939221,-58.422158292624786 -34.642305260432501,-58.42178103788617 -34.642005970131919,-58.42154807651724 -34.641821238063663,-58.420576209940101 -34.641047924191483,-58.420534717649431 -34.64120622469931,-58.420236668935708 -34.642342635840478,-58.42018117356757 -34.642553961144628,-58.419943388358583 -34.643470526318055)));;2392;4_3_9;COMUNA 4;3;9;575;265;310;85,48%;200;200;100,00%;0;0,00%;183;1;0,55%;182;99,45%
MULTIPOLYGON (((-58.417086805809603 -34.6391082978067,-58.416135801345092 -34.638947581204306,-58.416078524766554 -34.640195627099843,-58.41607824269348 -34.64039514034225,-58.416709666687638 -34.640511017544121,-58.418248743546101 -34.640793216831064,-58.418470779076088 -34.640833932641868,-58.419612060542214 -34.64103977021486,-58.420534717649431 -34.64120622469931,-58.420576209940101 -34.641047924191483,-58.420659706195238 -34.640729562678359,-58.420863406992844 -34.639952988441522,-58.420917791105055 -34.639741803204231,-58.41975650068791 -34.639534914396755,-58.419534125913344 -34.639496595241326,-58.419295307556297 -34.639455452838291,-58.418622637742814 -34.63935718029866,-58.418479924580232 -34.639336353328801,-58.417257973365061 -34.639137235861831,-58.417086805809603 -34.6391082978067)));;2393;4_4_1;COMUNA 4;4;1;668;315;353;89,24%;283;282;99,65%;1;0,35%;236;4;1,69%;232;98,31%
MULTIPOLYGON (((-58.412112248352273 -34.648534867738398,-58.412204275540809 -34.64854964226253,-58.412200602483075 -34.648562581252797,-58.412297826410438 -34.648578607875166,-58.412389000626661 -34.648593434704878,-58.412514002785656 -34.648614261489406,-58.412628865086766 -34.648633393790753,-58.412712200383524 -34.648646526967845,-58.412790650908413 -34.648659789157037,-58.412793729594888 -34.648648728644737,-58.412939886677464 -34.648673592735548,-58.4130605434381 -34.648693642515141,-58.413171656255656 -34.648712984052707,-58.413368152783647 -34.64874572837364,-58.413370798334135 -34.648734121747239,-58.413467088288435 -34.648750407575051,-58.413467170382425 -34.648750358366421,-58.413561837400167 -34.648767791441649,-58.414005695623061 -34.648841211138702,-58.414291583451487 -34.64888815958281,-58.414288927492457 -34.648898649584069,-58.414760653198805 -34.64897250014026,-58.414853804836753 -34.648988144333373,-58.414854384310495 -34.648988241651857,-58.41494990552728 -34.649003138696415,-58.414961608374696 -34.64895440941298,-58.415385363940757 -34.64901612572185,-58.41551480973547 -34.649017725221206,-58.415698617849124 -34.649031740288713,-58.415858059668402 -34.649034900324075,-58.416077580413166 -34.649038153560269,-58.416080544409105 -34.649071465557881,-58.416206751847263 -34.649073344783325,-58.416192854974 -34.648474166444025,-58.416281680135633 -34.648397707948803,-58.415869129854229 -34.647766398514349,-58.415541850912717 -34.647314655871476,-58.415338174980626 -34.647029356975054,-58.415300523203229 -34.647154768706365,-58.413926030255709 -34.646926262008883,-58.413643473245848 -34.648049703979233,-58.412284222644935 -34.647823368101072,-58.412240994232327 -34.648002510587965,-58.412112248352273 -34.648534867738398)));;2394;4_4_10;COMUNA 4;4;10;661;318;343;92,71%;327;327;100,00%;0;0,00%;273;23;8,42%;250;91,58%
MULTIPOLYGON (((-58.419680404134688 -34.646309887712121,-58.419666447998587 -34.645612959981044,-58.419659305336587 -34.645253368923463,-58.418384744666994 -34.645266715663865,-58.417382445594562 -34.645277263148827,-58.417400616385422 -34.646337091188649,-58.416170009310683 -34.646351769160709,-58.416206089178687 -34.647360053151715,-58.416225578875292 -34.647710141656141,-58.416258822542019 -34.648305242805606,-58.416281680135633 -34.648397707948803,-58.416433600293509 -34.648335006014278,-58.417427627692412 -34.647908557604126,-58.417644811379041 -34.647815818318911,-58.418421400087475 -34.647486022308222,-58.419133033015456 -34.647184297591387,-58.419175667054084 -34.647134945112334,-58.419702780091605 -34.646544198554508,-58.419680404134688 -34.646309887712121)));;2395;4_4_11;COMUNA 4;4;11;960;439;521;84,26%;333;333;100,00%;0;0,00%;344;35;10,17%;309;89,83%
MULTIPOLYGON (((-58.41584382211483 -34.638896340988609,-58.414553307202681 -34.638669845238141,-58.414200849901086 -34.640052284710464,-58.415556473334505 -34.640299866337187,-58.41607824269348 -34.64039514034225,-58.416078524766554 -34.640195627099843,-58.416135801345092 -34.638947581204306,-58.41584382211483 -34.638896340988609)));;2396;4_4_2;COMUNA 4;4;2;738;318;420;75,71%;355;355;100,00%;0;0,00%;295;2;0,68%;293;99,32%
MULTIPOLYGON (((-58.412540621390107 -34.640922204047044,-58.412749620312994 -34.640957924752016,-58.413892760396443 -34.641169802702471,-58.414255291279417 -34.641237062037028,-58.414781324280796 -34.641334526438754,-58.415331640970905 -34.641436505188743,-58.41528066845548 -34.641315918209692,-58.415556473334505 -34.640299866337187,-58.414200849901086 -34.640052284710464,-58.414553307202681 -34.638669845238141,-58.413191999231117 -34.638430912348298,-58.411879773276596 -34.638200506118757,-58.411625795716901 -34.638159060675108,-58.411260463868643 -34.638099327767911,-58.41136668060971 -34.638435369162764,-58.411754691978381 -34.639449648632045,-58.411825738082364 -34.639618416035695,-58.412233287521204 -34.640609673043805,-58.412348577697301 -34.640889377400079,-58.412540621390107 -34.640922204047044)));;2397;4_4_3;COMUNA 4;4;3;902;414;488;84,84%;390;390;100,00%;0;0,00%;320;3;0,94%;317;99,06%
MULTIPOLYGON (((-58.415331640970905 -34.641436505188743,-58.414781324280796 -34.641334526438754,-58.414255291279417 -34.641237062037028,-58.413892760396443 -34.641169802702471,-58.412749620312994 -34.640957924752016,-58.412540621390107 -34.640922204047044,-58.412348577697301 -34.640889377400079,-58.412488884102054 -34.641229445947737,-58.412698366393741 -34.641738773359094,-58.412938483014194 -34.642322340546372,-58.413051062687991 -34.642582676254143,-58.413148155714801 -34.642807300216809,-58.413248227553382 -34.643038897350252,-58.413436470858201 -34.643455183672231,-58.413603610801559 -34.643824628743197,-58.414956112356883 -34.643527410018301,-58.416108330406693 -34.643274185801303,-58.416104190560716 -34.642753604612487,-58.416102142519257 -34.642149570861555,-58.41610735219485 -34.641671459270711,-58.416104507378257 -34.641577863695794,-58.416077822595355 -34.640689022700798,-58.41607824269348 -34.64039514034225,-58.415556473334505 -34.640299866337187,-58.41528066845548 -34.641315918209692,-58.415331640970905 -34.641436505188743)));;2398;4_4_4;COMUNA 4;4;4;1041;523;518;100,97%;366;365;99,73%;1;0,27%;330;7;2,12%;323;97,88%
MULTIPOLYGON (((-58.420534717649431 -34.64120622469931,-58.419612060542214 -34.64103977021486,-58.418470779076088 -34.640833932641868,-58.418248743546101 -34.640793216831064,-58.416709666687638 -34.640511017544121,-58.41607824269348 -34.64039514034225,-58.416077822595355 -34.640689022700798,-58.416104507378257 -34.641577863695794,-58.41610735219485 -34.641671459270711,-58.416102142519257 -34.642149570861555,-58.416104190560716 -34.642753604612487,-58.417644583939499 -34.643037713407011,-58.417886728781667 -34.642140098517679,-58.41794692296196 -34.641916381214955,-58.418102332642441 -34.641945101016347,-58.419194462727866 -34.642148530040117,-58.420236668935708 -34.642342635840478,-58.420534717649431 -34.64120622469931)));;2399;4_4_5;COMUNA 4;4;5;1016;497;519;95,76%;439;439;100,00%;0;0,00%;366;19;5,19%;347;94,81%
MULTIPOLYGON (((-58.420236668935708 -34.642342635840478,-58.419194462727866 -34.642148530040117,-58.418102332642441 -34.641945101016347,-58.41794692296196 -34.641916381214955,-58.417886728781667 -34.642140098517679,-58.417644583939499 -34.643037713407011,-58.417370072853444 -34.64405517852741,-58.417368969233692 -34.64420412639565,-58.417591887829225 -34.644203716080895,-58.418369554593959 -34.644347174698481,-58.419654453080582 -34.644584191620183,-58.419943388358583 -34.643470526318055,-58.42018117356757 -34.642553961144628,-58.420236668935708 -34.642342635840478)));;2400;4_4_6;COMUNA 4;4;6;795;370;425;87,06%;311;311;100,00%;0;0,00%;286;18;6,29%;268;93,71%
MULTIPOLYGON (((-58.41616420638875 -34.645298917712466,-58.416166197406937 -34.646005912034752,-58.416166762075427 -34.64621542571674,-58.416170009310683 -34.646351769160709,-58.417400616385422 -34.646337091188649,-58.417382445594562 -34.645277263148827,-58.418384744666994 -34.645266715663865,-58.419659305336587 -34.645253368923463,-58.419654453080582 -34.644584191620183,-58.418369554593959 -34.644347174698481,-58.417591887829225 -34.644203716080895,-58.417368969233692 -34.64420412639565,-58.417370072853444 -34.64405517852741,-58.417644583939499 -34.643037713407011,-58.416104190560716 -34.642753604612487,-58.416108330406693 -34.643274185801303,-58.416150940469471 -34.644182258440438,-58.416161860783568 -34.644464031894131,-58.41616420638875 -34.645298917712466)));;2401;4_4_7;COMUNA 4;4;7;886;422;464;90,95%;401;400;99,75%;1;0,25%;329;14;4,26%;315;95,74%
MULTIPOLYGON (((-58.414956112356883 -34.643527410018301,-58.413603610801559 -34.643824628743197,-58.41371364820327 -34.64406791997186,-58.413951349842407 -34.644579016950139,-58.414006328919534 -34.64469714115522,-58.414117904433276 -34.644937122638218,-58.414321774810951 -34.645311792692816,-58.414519688289587 -34.645675544202675,-58.414559611718808 -34.64574887208061,-58.414662187107517 -34.645937369019663,-58.415139098448826 -34.646750468166104,-58.415338174980626 -34.647029356975054,-58.415541850912717 -34.647314655871476,-58.415869129854229 -34.647766398514349,-58.416281680135633 -34.648397707948803,-58.416258822542019 -34.648305242805606,-58.416225578875292 -34.647710141656141,-58.416206089178687 -34.647360053151715,-58.416170009310683 -34.646351769160709,-58.416166762075427 -34.64621542571674,-58.416166197406937 -34.646005912034752,-58.41616420638875 -34.645298917712466,-58.416161860783568 -34.644464031894131,-58.416150940469471 -34.644182258440438,-58.416108330406693 -34.643274185801303,-58.414956112356883 -34.643527410018301)));;2402;4_4_8;COMUNA 4;4;8;780;377;403;93,55%;342;342;100,00%;0;0,00%;288;36;12,50%;252;87,50%
MULTIPOLYGON (((-58.413926030255709 -34.646926262008883,-58.415300523203229 -34.647154768706365,-58.415338174980626 -34.647029356975054,-58.415139098448826 -34.646750468166104,-58.414662187107517 -34.645937369019663,-58.414559611718808 -34.64574887208061,-58.414519688289587 -34.645675544202675,-58.414321774810951 -34.645311792692816,-58.414117904433276 -34.644937122638218,-58.414006328919534 -34.64469714115522,-58.413951349842407 -34.644579016950139,-58.41371364820327 -34.64406791997186,-58.413603610801559 -34.643824628743197,-58.413436470858201 -34.643455183672231,-58.413339232449502 -34.643473313932184,-58.413102870890214 -34.644444093202345,-58.413029919599737 -34.644743931930904,-58.412828575181777 -34.645570706212204,-58.412804997799036 -34.64566767137849,-58.412555975633119 -34.646698516310515,-58.412284222644935 -34.647823368101072,-58.413643473245848 -34.648049703979233,-58.413926030255709 -34.646926262008883)));;2403;4_4_9;COMUNA 4;4;9;850;386;464;83,19%;321;321;100,00%;0;0,00%;285;20;7,02%;265;92,98%
MULTIPOLYGON (((-58.409141680160936 -34.636674778537646,-58.409053670431312 -34.637721322735096,-58.410801158618121 -34.638024271634634,-58.411260463868643 -34.638099327767911,-58.411002197110626 -34.637281445903582,-58.410927363577052 -34.637043167074765,-58.410706014490337 -34.636334176860508,-58.410511967098692 -34.635709425925711,-58.410488575895926 -34.635237499226271,-58.41056534916968 -34.635094569684846,-58.409347169968136 -34.634720087084858,-58.409335952855109 -34.634939666773818,-58.409268147307195 -34.635444935158425,-58.407792356867994 -34.635131100540931,-58.407667833264036 -34.636353196591294,-58.407833959140767 -34.636390667007895,-58.408914643478866 -34.636618057086459,-58.409141680160936 -34.636674778537646)));;2404;4_5_1;COMUNA 4;5;1;891;409;482;84,85%;440;440;100,00%;0;0,00%;369;9;2,44%;360;97,56%
MULTIPOLYGON (((-58.404999203078582 -34.647440559786503,-58.406365449202987 -34.647659675433772,-58.409007997565297 -34.648083435000665,-58.409099616744697 -34.648098125965248,-58.410369509674638 -34.648303617851731,-58.410460315618124 -34.648317885207256,-58.412101046456215 -34.648580899647655,-58.412112248352273 -34.648534867738398,-58.412240994232327 -34.648002510587965,-58.412284222644935 -34.647823368101072,-58.410556625102558 -34.647535731501883,-58.409195090745882 -34.647308937655225,-58.40784361824155 -34.647083823321069,-58.408104948400009 -34.645957286458632,-58.408367297115639 -34.64482603082282,-58.407685744429372 -34.644712904884749,-58.406972667973065 -34.644594549306795,-58.406325371131054 -34.644487135813918,-58.405636155652289 -34.644372727230362,-58.405400101383279 -34.645505820456698,-58.404031288358063 -34.645275444249577,-58.403848200097684 -34.6461867924206,-58.403797314974227 -34.646444029235589,-58.403658939787171 -34.647143913230856,-58.40364568365456 -34.647211021529515,-58.403644912078633 -34.64721480988495,-58.40495961143138 -34.647434209916888,-58.404999203078582 -34.647440559786503)));;2405;4_5_10;COMUNA 4;5;10;1258;609;649;93,84%;399;399;100,00%;0;0,00%;397;71;17,88%;326;82,12%
MULTIPOLYGON (((-58.41083181041752 -34.646408772237734,-58.411061453266946 -34.64546834789806,-58.411106732230266 -34.645282445851464,-58.409950493500155 -34.64508877623944,-58.409712429724287 -34.645049305622763,-58.408367297115639 -34.64482603082282,-58.408104948400009 -34.645957286458632,-58.40784361824155 -34.647083823321069,-58.409195090745882 -34.647308937655225,-58.410556625102558 -34.647535731501883,-58.412284222644935 -34.647823368101072,-58.412555975633119 -34.646698516310515,-58.412299671723851 -34.646655874139782,-58.41083181041752 -34.646408772237734)));;2406;4_5_11;COMUNA 4;5;11;1016;503;513;98,05%;359;359;100,00%;0;0,00%;340;41;12,06%;299;87,94%
MULTIPOLYGON (((-58.409347169968136 -34.634720087084858,-58.407880173065628 -34.634269069781119,-58.406275192204006 -34.633775645726324,-58.406007208613659 -34.633681081755327,-58.405886360548465 -34.634725777849518,-58.407792356867994 -34.635131100540931,-58.409268147307195 -34.635444935158425,-58.409335952855109 -34.634939666773818,-58.409347169968136 -34.634720087084858)));;2407;4_5_2;COMUNA 4;5;2;639;292;347;84,15%;283;283;100,00%;0;0,00%;260;58;22,31%;202;77,69%
MULTIPOLYGON (((-58.407792356867994 -34.635131100540931,-58.405886360548465 -34.634725777849518,-58.405748280837429 -34.635920329592039,-58.407667833264036 -34.636353196591294,-58.407792356867994 -34.635131100540931)));;2408;4_5_3;COMUNA 4;5;3;797;345;452;76,33%;388;388;100,00%;0;0,00%;331;1;0,30%;330;99,70%
MULTIPOLYGON (((-58.404300880466707 -34.634373609136787,-58.404276425105181 -34.634497967665439,-58.404051777477932 -34.635539090783162,-58.405428300556608 -34.635848205602137,-58.405748280837429 -34.635920329592039,-58.405886360548465 -34.634725777849518,-58.406007208613659 -34.633681081755327,-58.404539272203706 -34.633163401874874,-58.404300880466707 -34.634373609136787)));;2409;4_5_4;COMUNA 4;5;4;715;341;374;91,18%;303;303;100,00%;0;0,00%;279;42;15,05%;237;84,95%
MULTIPOLYGON (((-58.405748280837429 -34.635920329592039,-58.405428300556608 -34.635848205602137,-58.404051777477932 -34.635539090783162,-58.403780876487161 -34.636794423207753,-58.40524819933627 -34.637052103312008,-58.40560627172345 -34.637123541352338,-58.405645597695447 -34.636807634119883,-58.405748280837429 -34.635920329592039)));;2410;4_5_5;COMUNA 4;5;5;453;203;250;81,20%;229;228;99,56%;1;0,44%;203;5;2,46%;198;97,54%
MULTIPOLYGON (((-58.407667833264036 -34.636353196591294,-58.405748280837429 -34.635920329592039,-58.405645597695447 -34.636807634119883,-58.40560627172345 -34.637123541352338,-58.407554884250729 -34.63746142061521,-58.409053670431312 -34.637721322735096,-58.409141680160936 -34.636674778537646,-58.408914643478866 -34.636618057086459,-58.407833959140767 -34.636390667007895,-58.407667833264036 -34.636353196591294)));;2411;4_5_6;COMUNA 4;5;6;936;442;494;89,47%;420;419;99,76%;1;0,24%;349;9;2,58%;340;97,42%
MULTIPOLYGON (((-58.404660767854828 -34.64209613986587,-58.406070116396243 -34.642289273246362,-58.40643768488782 -34.642339374510897,-58.407393671448823 -34.642470167980974,-58.408627086017972 -34.642638895360889,-58.408861824406841 -34.642670197371451,-58.409306166413259 -34.64272933822312,-58.409121253829134 -34.641673660739755,-58.408909179244198 -34.640462402531675,-58.40887199472995 -34.640249914629386,-58.408850346231375 -34.64012630961826,-58.408814859637211 -34.639923963602577,-58.408764633129437 -34.639851615168169,-58.408710161644969 -34.639755531687285,-58.408662014098361 -34.639631140226712,-58.408637134267622 -34.639498096814691,-58.408610187519706 -34.639398926792175,-58.408578657973806 -34.639271443970735,-58.408645331678997 -34.639208654644172,-58.408784317313071 -34.638928566418308,-58.408889016696072 -34.63856578420782,-58.409029096859285 -34.637906388265954,-58.409053670431312 -34.637721322735096,-58.407554884250729 -34.63746142061521,-58.40560627172345 -34.637123541352338,-58.405577887612452 -34.637387339335497,-58.405396078660736 -34.63834693260192,-58.405374870222374 -34.638458827609675,-58.405145107471881 -34.63963136227482,-58.405042863225191 -34.640114779973842,-58.405015558352574 -34.640292589577172,-58.404857789994381 -34.641094723210905,-58.404660767854828 -34.64209613986587)));;2412;4_5_7;COMUNA 4;5;7;834;356;478;74,48%;294;291;98,98%;3;1,03%;251;17;6,77%;234;93,23%
MULTIPOLYGON (((-58.413051062687991 -34.642582676254143,-58.412938483014194 -34.642322340546372,-58.412698366393741 -34.641738773359094,-58.412488884102054 -34.641229445947737,-58.412348577697301 -34.640889377400079,-58.412233287521204 -34.640609673043805,-58.411825738082364 -34.639618416035695,-58.411754691978381 -34.639449648632045,-58.41136668060971 -34.638435369162764,-58.411260463868643 -34.638099327767911,-58.410801158618121 -34.638024271634634,-58.409053670431312 -34.637721322735096,-58.409029096859285 -34.637906388265954,-58.408889016696072 -34.63856578420782,-58.408784317313071 -34.638928566418308,-58.408645331678997 -34.639208654644172,-58.408578657973806 -34.639271443970735,-58.408610187519706 -34.639398926792175,-58.408637134267622 -34.639498096814691,-58.408662014098361 -34.639631140226712,-58.408710161644969 -34.639755531687285,-58.408764633129437 -34.639851615168169,-58.408814859637211 -34.639923963602577,-58.408850346231375 -34.64012630961826,-58.40887199472995 -34.640249914629386,-58.408909179244198 -34.640462402531675,-58.409121253829134 -34.641673660739755,-58.409306166413259 -34.64272933822312,-58.409541855866102 -34.644075187224679,-58.409712429724287 -34.645049305622763,-58.409950493500155 -34.64508877623944,-58.411106732230266 -34.645282445851464,-58.411061453266946 -34.64546834789806,-58.41083181041752 -34.646408772237734,-58.412299671723851 -34.646655874139782,-58.412555975633119 -34.646698516310515,-58.412804997799036 -34.64566767137849,-58.412828575181777 -34.645570706212204,-58.413029919599737 -34.644743931930904,-58.413102870890214 -34.644444093202345,-58.413339232449502 -34.643473313932184,-58.413436470858201 -34.643455183672231,-58.413248227553382 -34.643038897350252,-58.413148155714801 -34.642807300216809,-58.413051062687991 -34.642582676254143)));;2413;4_5_8;COMUNA 4;5;8;1082;481;601;80,03%;301;298;99,00%;3;1,01%;247;11;4,45%;236;95,55%
MULTIPOLYGON (((-58.405636155652289 -34.644372727230362,-58.406325371131054 -34.644487135813918,-58.406972667973065 -34.644594549306795,-58.407685744429372 -34.644712904884749,-58.408367297115639 -34.64482603082282,-58.409712429724287 -34.645049305622763,-58.409541855866102 -34.644075187224679,-58.409306166413259 -34.64272933822312,-58.408861824406841 -34.642670197371451,-58.408627086017972 -34.642638895360889,-58.407393671448823 -34.642470167980974,-58.40643768488782 -34.642339374510897,-58.406070116396243 -34.642289273246362,-58.404660767854828 -34.64209613986587,-58.404533965448572 -34.642717788994609,-58.404400657832582 -34.643378238839119,-58.404226294328353 -34.64413296747751,-58.404066285306548 -34.645070595627203,-58.404031288358063 -34.645275444249577,-58.405400101383279 -34.645505820456698,-58.405636155652289 -34.644372727230362)));;2414;4_5_9;COMUNA 4;5;9;2162;1028;1134;90,65%;665;665;100,00%;0;0,00%;634;70;11,04%;564;88,96%
MULTIPOLYGON (((-58.408287466473837 -34.630321235002555,-58.408225844893764 -34.630877071003113,-58.408985709251695 -34.631060090103809,-58.409740721349316 -34.631241834712561,-58.409637208617539 -34.6323036557311,-58.409616795284911 -34.632516259472268,-58.41113562330802 -34.632886852758112,-58.411477659196528 -34.63296756290228,-58.411520583847057 -34.632856732214677,-58.411634527236089 -34.631697868594934,-58.41165090280051 -34.631530968530384,-58.411766411979187 -34.63059225334387,-58.411779336357831 -34.63035584243908,-58.41158127784464 -34.630307236855025,-58.410827294455657 -34.630122475781334,-58.410033873454701 -34.629928044812331,-58.409868953631033 -34.629888394709269,-58.409426502981489 -34.629775874582862,-58.408364500415722 -34.629515960854462,-58.408287466473837 -34.630321235002555)));;2415;4_6_1;COMUNA 4;6;1;1090;492;598;82,27%;517;517;100,00%;0;0,00%;431;22;5,10%;409;94,90%
MULTIPOLYGON (((-58.40244388738067 -34.635178084093589,-58.402116338689879 -34.636499725044914,-58.402514111305834 -34.636571896129418,-58.402975952869795 -34.636653041256217,-58.403780876487161 -34.636794423207753,-58.404051777477932 -34.635539090783162,-58.404276425105181 -34.634497967665439,-58.404300880466707 -34.634373609136787,-58.40406168465276 -34.634295041116665,-58.403505222259042 -34.634054623654343,-58.402822702029475 -34.633759773855388,-58.402870628384612 -34.6335820450958,-58.401590148948259 -34.633192524315049,-58.401257362419294 -34.634099076844564,-58.400913896463841 -34.63503484921646,-58.401217958822286 -34.635076764786874,-58.40244388738067 -34.635178084093589)));;2416;4_6_10;COMUNA 4;6;10;730;312;418;74,64%;255;254;99,61%;1;0,39%;215;4;1,86%;211;98,14%
MULTIPOLYGON (((-58.40244388738067 -34.635178084093589,-58.401217958822286 -34.635076764786874,-58.400913896463841 -34.63503484921646,-58.400484873326612 -34.636203682960762,-58.402116338689879 -34.636499725044914,-58.40244388738067 -34.635178084093589)));;2417;4_6_11;COMUNA 4;6;11;654;297;357;83,19%;272;272;100,00%;0;0,00%;246;2;0,81%;244;99,19%
MULTIPOLYGON (((-58.408985709251695 -34.631060090103809,-58.408225844893764 -34.630877071003113,-58.408101505507119 -34.63209761909124,-58.40809447384418 -34.63216656187457,-58.408234269617495 -34.632196061968628,-58.408758525837179 -34.632306861965347,-58.409616795284911 -34.632516259472268,-58.409637208617539 -34.6323036557311,-58.409740721349316 -34.631241834712561,-58.408985709251695 -34.631060090103809)));;2418;4_6_2;COMUNA 4;6;2;787;361;426;84,74%;356;356;100,00%;0;0,00%;320;12;3,75%;308;96,25%
MULTIPOLYGON (((-58.408101505507119 -34.63209761909124,-58.408225844893764 -34.630877071003113,-58.408287466473837 -34.630321235002555,-58.408364500415722 -34.629515960854462,-58.406751307352188 -34.629330929644539,-58.40651328161249 -34.629304058776086,-58.406400244739849 -34.630281715254874,-58.406331684273134 -34.630874731422566,-58.406218557578754 -34.63185288041128,-58.407140076357109 -34.632000421182454,-58.40809447384418 -34.63216656187457,-58.408101505507119 -34.63209761909124)));;2419;4_6_3;COMUNA 4;6;3;751;351;400;87,75%;309;309;100,00%;0;0,00%;285;38;13,33%;247;86,67%
MULTIPOLYGON (((-58.409616795284911 -34.632516259472268,-58.408758525837179 -34.632306861965347,-58.408234269617495 -34.632196061968628,-58.40809447384418 -34.63216656187457,-58.407140076357109 -34.632000421182454,-58.406218557578754 -34.63185288041128,-58.406129259504105 -34.632617159935513,-58.406821395788967 -34.632806006303319,-58.407996629122373 -34.633126619971122,-58.407880173065628 -34.634269069781119,-58.409347169968136 -34.634720087084858,-58.41056534916968 -34.635094569684846,-58.410880287286453 -34.634508487669819,-58.410986962470908 -34.634233312716674,-58.411477659196528 -34.63296756290228,-58.41113562330802 -34.632886852758112,-58.409616795284911 -34.632516259472268)));;2420;4_6_4;COMUNA 4;6;4;955;430;525;81,90%;366;366;100,00%;0;0,00%;320;17;5,31%;303;94,69%
MULTIPOLYGON (((-58.406821395788967 -34.632806006303319,-58.406129259504105 -34.632617159935513,-58.406218557578754 -34.63185288041128,-58.404772162218194 -34.631645786795978,-58.404566035289648 -34.633027494691866,-58.404539272203706 -34.633163401874874,-58.406007208613659 -34.633681081755327,-58.406275192204006 -34.633775645726324,-58.407880173065628 -34.634269069781119,-58.407996629122373 -34.633126619971122,-58.406821395788967 -34.632806006303319)));;2421;4_6_5;COMUNA 4;6;5;733;340;393;86,51%;316;315;99,68%;1;0,32%;275;18;6,55%;257;93,45%
MULTIPOLYGON (((-58.406331684273134 -34.630874731422566,-58.404916481222521 -34.630678358485262,-58.404772162218194 -34.631645786795978,-58.406218557578754 -34.63185288041128,-58.406331684273134 -34.630874731422566)));;2422;4_6_6;COMUNA 4;6;6;929;408;521;78,31%;429;429;100,00%;0;0,00%;375;2;0,53%;373;99,47%
MULTIPOLYGON (((-58.404968320728884 -34.630377316712298,-58.404931203943846 -34.630579700217517,-58.404916481222521 -34.630678358485262,-58.406331684273134 -34.630874731422566,-58.406400244739849 -34.630281715254874,-58.40651328161249 -34.629304058776086,-58.405645775316991 -34.62920618804106,-58.405454009253027 -34.629184548176191,-58.403542913797459 -34.628968910802186,-58.402385765833174 -34.62883826933912,-58.402348303850275 -34.629039032163412,-58.402225582846533 -34.630145346243424,-58.403388224454716 -34.630243666862754,-58.404968320728884 -34.630377316712298)));;2423;4_6_7;COMUNA 4;6;7;766;351;415;84,58%;312;312;100,00%;0;0,00%;310;36;11,61%;274;88,39%
MULTIPOLYGON (((-58.403256180653514 -34.631417232974648,-58.403147970974764 -34.632378338592062,-58.403107508989329 -34.632604523437493,-58.403815079720935 -34.632885791796028,-58.404310816524386 -34.633082797130001,-58.404539272203706 -34.633163401874874,-58.404566035289648 -34.633027494691866,-58.404772162218194 -34.631645786795978,-58.404916481222521 -34.630678358485262,-58.404931203943846 -34.630579700217517,-58.404968320728884 -34.630377316712298,-58.403388224454716 -34.630243666862754,-58.402225582846533 -34.630145346243424,-58.402103973743202 -34.631241237670366,-58.403256180653514 -34.631417232974648)));;2424;4_6_8;COMUNA 4;6;8;920;417;503;82,90%;356;356;100,00%;0;0,00%;317;53;16,72%;264;83,28%
MULTIPOLYGON (((-58.403815079720935 -34.632885791796028,-58.403107508989329 -34.632604523437493,-58.403147970974764 -34.632378338592062,-58.403256180653514 -34.631417232974648,-58.402103973743202 -34.631241237670366,-58.402001057588677 -34.632169245241279,-58.401590148948259 -34.633192524315049,-58.402870628384612 -34.6335820450958,-58.402822702029475 -34.633759773855388,-58.403505222259042 -34.634054623654343,-58.40406168465276 -34.634295041116665,-58.404300880466707 -34.634373609136787,-58.404539272203706 -34.633163401874874,-58.404310816524386 -34.633082797130001,-58.403815079720935 -34.632885791796028)));;2425;4_6_9;COMUNA 4;6;9;707;319;388;82,22%;309;309;100,00%;0;0,00%;274;1;0,36%;273;99,64%
MULTIPOLYGON (((-58.400861304788407 -34.630010995796418,-58.400632997515494 -34.629976301221546,-58.399562628167814 -34.629772153548473,-58.399162356330699 -34.631124244024505,-58.400528271475693 -34.631597428284046,-58.400682274326407 -34.631650818301445,-58.402001057588677 -34.632169245241279,-58.402103973743202 -34.631241237670366,-58.402225582846533 -34.630145346243424,-58.402348303850275 -34.629039032163412,-58.402385765833174 -34.62883826933912,-58.401100920939598 -34.628693256223784,-58.400861304788407 -34.630010995796418)));;2426;4_7_1;COMUNA 4;7;1;902;454;448;101,34%;365;364;99,73%;1;0,27%;304;27;8,88%;277;91,12%
MULTIPOLYGON (((-58.396857026864815 -34.633047873305578,-58.395828835549217 -34.632802235482998,-58.395614680794779 -34.632749440102032,-58.395573374530272 -34.632940409539252,-58.395234906770824 -34.633944058345762,-58.394835447650799 -34.635128875165599,-58.395955175226113 -34.63537330376478,-58.396259186851275 -34.634515554657092,-58.396372644053287 -34.634237015814911,-58.396857026864815 -34.633047873305578)));;2427;4_7_10;COMUNA 4;7;10;610;267;343;77,84%;356;356;100,00%;0;0,00%;287;0;0,00%;287;100,00%
MULTIPOLYGON (((-58.39775010948528 -34.630649329581466,-58.396257978831521 -34.630367037712773,-58.396296684858847 -34.630228040099752,-58.396542707057911 -34.629196238084326,-58.396807016492083 -34.628087048315926,-58.39534550069434 -34.62782926959418,-58.394292878581851 -34.627642409953239,-58.393206102610634 -34.62744939480595,-58.392159452953692 -34.627263576524747,-58.391722018557857 -34.629508609065212,-58.391496617918705 -34.630665065313558,-58.391297653935538 -34.631686250265318,-58.391393228866576 -34.631709828077653,-58.394638209850427 -34.632509032109319,-58.393853307679784 -34.634912613523916,-58.394146695819309 -34.634978485132429,-58.394835447650799 -34.635128875165599,-58.395234906770824 -34.633944058345762,-58.395573374530272 -34.632940409539252,-58.395614680794779 -34.632749440102032,-58.395828835549217 -34.632802235482998,-58.396857026864815 -34.633047873305578,-58.396920625593886 -34.632891775755333,-58.397295823914952 -34.631845323474721,-58.397352948140416 -34.631686053076848,-58.39775010948528 -34.630649329581466)));;2428;4_7_11;COMUNA 4;7;11;1277;496;781;63,51%;235;232;98,72%;3;1,29%;212;33;15,57%;179;84,43%
MULTIPOLYGON (((-58.392159452953692 -34.627263576524747,-58.391169824038741 -34.62725299986802,-58.39106149307451 -34.62819944689172,-58.390925313139334 -34.62932834814594,-58.390890044804145 -34.629620661045649,-58.39078302758373 -34.630518374218489,-58.39066244801338 -34.631529885715587,-58.390557314060814 -34.632411683504074,-58.390526847155726 -34.63266618085094,-58.390352621841565 -34.634124364583819,-58.390689703717563 -34.634201749668833,-58.390897133353654 -34.634248352341906,-58.391950895090929 -34.634486792761585,-58.393853307679784 -34.634912613523916,-58.394638209850427 -34.632509032109319,-58.391393228866576 -34.631709828077653,-58.391297653935538 -34.631686250265318,-58.391496617918705 -34.630665065313558,-58.391722018557857 -34.629508609065212,-58.392159452953692 -34.627263576524747)));;2429;4_7_12;COMUNA 4;7;12;866;461;405;113,83%;306;301;98,37%;5;1,66%;272;64;23,53%;208;76,47%
MULTIPOLYGON (((-58.401100920939598 -34.628693256223784,-58.40084287911575 -34.62866411058269,-58.399906550778134 -34.628560741389123,-58.399562628167814 -34.629772153548473,-58.400632997515494 -34.629976301221546,-58.400861304788407 -34.630010995796418,-58.401100920939598 -34.628693256223784)));;2430;4_7_2;COMUNA 4;7;2;756;356;400;89,00%;325;325;100,00%;0;0,00%;290;1;0,34%;289;99,66%
MULTIPOLYGON (((-58.396542707057911 -34.629196238084326,-58.396296684858847 -34.630228040099752,-58.396257978831521 -34.630367037712773,-58.39775010948528 -34.630649329581466,-58.397814309982735 -34.630481822993623,-58.398193687449918 -34.629511146917402,-58.399562628167814 -34.629772153548473,-58.399906550778134 -34.628560741389123,-58.398594118081888 -34.628405969026034,-58.396865708934776 -34.628097502892338,-58.396807016492083 -34.628087048315926,-58.396542707057911 -34.629196238084326)));;2431;4_7_3;COMUNA 4;7;3;938;430;508;84,65%;267;264;98,88%;3;1,14%;302;87;28,81%;215;71,19%
MULTIPOLYGON (((-58.399562628167814 -34.629772153548473,-58.398193687449918 -34.629511146917402,-58.397814309982735 -34.630481822993623,-58.39775010948528 -34.630649329581466,-58.399162356330699 -34.631124244024505,-58.399562628167814 -34.629772153548473)));;2432;4_7_4;COMUNA 4;7;4;2159;898;1261;71,21%;918;917;99,89%;1;0,11%;814;25;3,07%;789;96,93%
MULTIPOLYGON (((-58.399162356330699 -34.631124244024505,-58.39775010948528 -34.630649329581466,-58.397352948140416 -34.631686053076848,-58.397295823914952 -34.631845323474721,-58.396920625593886 -34.632891775755333,-58.396857026864815 -34.633047873305578,-58.398295567849878 -34.633391539921163,-58.398731230342769 -34.63225201356655,-58.400127543378147 -34.632658525847823,-58.400415377272274 -34.631944072242256,-58.400528271475693 -34.631597428284046,-58.399162356330699 -34.631124244024505)));;2433;4_7_5;COMUNA 4;7;5;763;349;414;84,30%;349;349;100,00%;0;0,00%;297;50;16,84%;247;83,16%
MULTIPOLYGON (((-58.401590148948259 -34.633192524315049,-58.402001057588677 -34.632169245241279,-58.400682274326407 -34.631650818301445,-58.400528271475693 -34.631597428284046,-58.400415377272274 -34.631944072242256,-58.400127543378147 -34.632658525847823,-58.398731230342769 -34.63225201356655,-58.398295567849878 -34.633391539921163,-58.399697234560939 -34.633726437836678,-58.401257362419294 -34.634099076844564,-58.401590148948259 -34.633192524315049)));;2434;4_7_6;COMUNA 4;7;6;861;404;457;88,40%;344;343;99,71%;1;0,29%;287;11;3,83%;276;96,17%
MULTIPOLYGON (((-58.399295399122302 -34.634759713908515,-58.39890564297805 -34.635917083302225,-58.400484873326612 -34.636203682960762,-58.400913896463841 -34.63503484921646,-58.401257362419294 -34.634099076844564,-58.399697234560939 -34.633726437836678,-58.399369267200633 -34.634540238122668,-58.399295399122302 -34.634759713908515)));;2435;4_7_7;COMUNA 4;7;7;785;355;430;82,56%;376;375;99,73%;1;0,27%;314;7;2,23%;307;97,77%
MULTIPOLYGON (((-58.397868601929538 -34.634508251480575,-58.397432232726281 -34.635649604984991,-58.398578757204255 -34.635857755047887,-58.39890564297805 -34.635917083302225,-58.399295399122302 -34.634759713908515,-58.399369267200633 -34.634540238122668,-58.399697234560939 -34.633726437836678,-58.398295567849878 -34.633391539921163,-58.397868601929538 -34.634508251480575)));;2436;4_7_8;COMUNA 4;7;8;689;314;375;83,73%;348;348;100,00%;0;0,00%;286;4;1,40%;282;98,60%
MULTIPOLYGON (((-58.398295567849878 -34.633391539921163,-58.396857026864815 -34.633047873305578,-58.396372644053287 -34.634237015814911,-58.396259186851275 -34.634515554657092,-58.395955175226113 -34.63537330376478,-58.396179649708863 -34.635422301218512,-58.397432232726281 -34.635649604984991,-58.397868601929538 -34.634508251480575,-58.398295567849878 -34.633391539921163)));;2437;4_7_9;COMUNA 4;7;9;744;322;422;76,30%;290;289;99,66%;1;0,35%;273;27;9,89%;246;90,11%
MULTIPOLYGON (((-58.403563367642988 -34.639284749532543,-58.404538919986607 -34.640991610575924,-58.404779063233079 -34.641083910859997,-58.404857789994381 -34.641094723210905,-58.405015558352574 -34.640292589577172,-58.405042863225191 -34.640114779973842,-58.405145107471881 -34.63963136227482,-58.405374870222374 -34.638458827609675,-58.405396078660736 -34.63834693260192,-58.404958257371085 -34.638260667021534,-58.403525440463298 -34.637978421966814,-58.403488167317995 -34.638151296717538,-58.40332652794563 -34.638870395960261,-58.403248827364521 -34.639215862035606,-58.403563367642988 -34.639284749532543)));;2438;4_8_1;COMUNA 4;8;1;705;313;392;79,85%;380;380;100,00%;0;0,00%;304;2;0,66%;302;99,34%
MULTIPOLYGON (((-58.400934661897942 -34.641618942680857,-58.402649001029836 -34.641878680215413,-58.402714046125972 -34.641601661300633,-58.402984007498716 -34.6403939389279,-58.403248827364521 -34.639215862035606,-58.402910603457975 -34.639141750685631,-58.401565961254271 -34.638869526159318,-58.399825342939593 -34.638517151184537,-58.399664237773571 -34.638487489617241,-58.398003609149349 -34.63818139902596,-58.397811263268956 -34.638661452961472,-58.397678335954396 -34.638993082836272,-58.39753140585622 -34.639359917448395,-58.399219400028549 -34.639564969135549,-58.39912850601501 -34.639645628568509,-58.398519357892276 -34.64018645337211,-58.398268558214902 -34.641215015446896,-58.399703080970752 -34.641432391402248,-58.400934661897942 -34.641618942680857)));;2439;4_8_10;COMUNA 4;8;10;763;371;392;94,64%;247;247;100,00%;0;0,00%;238;26;10,92%;212;89,08%
MULTIPOLYGON (((-58.402746646198558 -34.647061178822234,-58.402747624054918 -34.647062456899228,-58.403576840434233 -34.647203449515864,-58.403644912078633 -34.64721480988495,-58.40364568365456 -34.647211021529515,-58.403658939787171 -34.647143913230856,-58.403797314974227 -34.646444029235589,-58.403848200097684 -34.6461867924206,-58.404031288358063 -34.645275444249577,-58.404066285306548 -34.645070595627203,-58.404226294328353 -34.64413296747751,-58.404400657832582 -34.643378238839119,-58.404533965448572 -34.642717788994609,-58.404660767854828 -34.64209613986587,-58.404857789994381 -34.641094723210905,-58.404779063233079 -34.641083910859997,-58.404538919986607 -34.640991610575924,-58.403563367642988 -34.639284749532543,-58.403248827364521 -34.639215862035606,-58.402984007498716 -34.6403939389279,-58.402714046125972 -34.641601661300633,-58.402649001029836 -34.641878680215413,-58.402521628878802 -34.64244300125447,-58.402373310738604 -34.643100201959101,-58.402216954613685 -34.643792681207607,-58.401966129471127 -34.644903788036956,-58.401838320471718 -34.645470150175711,-58.401744011563153 -34.645786943771654,-58.401690333665591 -34.646125589265395,-58.401638439258434 -34.646355640744922,-58.401558501123077 -34.646711879167142,-58.401541147516078 -34.646786450202626,-58.401524478284117 -34.646858141713118,-58.402746646198558 -34.647061178822234)));;2440;4_8_11;COMUNA 4;8;11;899;431;468;92,09%;324;324;100,00%;0;0,00%;281;20;7,12%;261;92,88%
MULTIPOLYGON (((-58.402975952869795 -34.636653041256217,-58.402514111305834 -34.636571896129418,-58.402116338689879 -34.636499725044914,-58.402057544600751 -34.636736956971973,-58.401849238236615 -34.637640403299862,-58.401604085830655 -34.638703413223638,-58.401565961254271 -34.638869526159318,-58.402910603457975 -34.639141750685631,-58.403248827364521 -34.639215862035606,-58.40332652794563 -34.638870395960261,-58.403488167317995 -34.638151296717538,-58.403525440463298 -34.637978421966814,-58.404958257371085 -34.638260667021534,-58.405396078660736 -34.63834693260192,-58.405577887612452 -34.637387339335497,-58.40560627172345 -34.637123541352338,-58.40524819933627 -34.637052103312008,-58.403780876487161 -34.636794423207753,-58.402975952869795 -34.636653041256217)));;2441;4_8_2;COMUNA 4;8;2;767;336;431;77,96%;400;400;100,00%;0;0,00%;311;7;2,25%;304;97,75%
MULTIPOLYGON (((-58.401849238236615 -34.637640403299862,-58.402057544600751 -34.636736956971973,-58.402116338689879 -34.636499725044914,-58.400484873326612 -34.636203682960762,-58.40038369892919 -34.636479344404485,-58.400091342052406 -34.637295277195719,-58.398782933105942 -34.637046984949379,-58.398480579879468 -34.636990838410348,-58.398003609149349 -34.63818139902596,-58.399664237773571 -34.638487489617241,-58.399825342939593 -34.638517151184537,-58.401565961254271 -34.638869526159318,-58.401604085830655 -34.638703413223638,-58.401849238236615 -34.637640403299862)));;2442;4_8_3;COMUNA 4;8;3;630;302;328;92,07%;306;305;99,67%;1;0,33%;240;6;2,50%;234;97,50%
MULTIPOLYGON (((-58.397028114574809 -34.636720901406783,-58.395562368585836 -34.636448545346312,-58.395214903939682 -34.637391130268391,-58.395121724551224 -34.637661298572773,-58.395322096431663 -34.637703805152391,-58.396575652908936 -34.637925765904626,-58.397618612866836 -34.63811048771209,-58.398003609149349 -34.63818139902596,-58.398480579879468 -34.636990838410348,-58.398782933105942 -34.637046984949379,-58.400091342052406 -34.637295277195719,-58.40038369892919 -34.636479344404485,-58.400484873326612 -34.636203682960762,-58.39890564297805 -34.635917083302225,-58.398578757204255 -34.635857755047887,-58.397432232726281 -34.635649604984991,-58.397327300776354 -34.635924135105199,-58.397028114574809 -34.636720901406783)));;2443;4_8_4;COMUNA 4;8;4;800;405;395;102,53%;308;308;100,00%;0;0,00%;293;35;11,95%;258;88,05%
MULTIPOLYGON (((-58.397432232726281 -34.635649604984991,-58.396179649708863 -34.635422301218512,-58.395955175226113 -34.63537330376478,-58.394835447650799 -34.635128875165599,-58.394146695819309 -34.634978485132429,-58.393853307679784 -34.634912613523916,-58.393780273525465 -34.635136030207434,-58.393425610943993 -34.636109945194434,-58.393035583640163 -34.637180813727504,-58.394806429006486 -34.637594290342435,-58.395121724551224 -34.637661298572773,-58.395214903939682 -34.637391130268391,-58.395562368585836 -34.636448545346312,-58.397028114574809 -34.636720901406783,-58.397327300776354 -34.635924135105199,-58.397432232726281 -34.635649604984991)));;2444;4_8_5;COMUNA 4;8;5;594;270;324;83,33%;349;349;100,00%;0;0,00%;268;0;0,00%;268;100,00%
MULTIPOLYGON (((-58.393853307679784 -34.634912613523916,-58.391950895090929 -34.634486792761585,-58.390897133353654 -34.634248352341906,-58.390689703717563 -34.634201749668833,-58.390352621841565 -34.634124364583819,-58.390330949497837 -34.634355978959718,-58.390282371457708 -34.634958152721303,-58.390248758162322 -34.635399485037823,-58.39154813308415 -34.63569011848594,-58.393425610943993 -34.636109945194434,-58.393780273525465 -34.635136030207434,-58.393853307679784 -34.634912613523916)));;2445;4_8_6;COMUNA 4;8;6;710;321;389;82,52%;330;330;100,00%;0;0,00%;274;54;19,71%;220;80,29%
MULTIPOLYGON (((-58.390164119153077 -34.636511724023876,-58.390064049347799 -34.637826424799108,-58.390364003035835 -34.637895337655678,-58.390781699927992 -34.637979812712906,-58.392609932430794 -34.638349621212278,-58.393035583640163 -34.637180813727504,-58.393425610943993 -34.636109945194434,-58.39154813308415 -34.63569011848594,-58.390248758162322 -34.635399485037823,-58.390231348056503 -34.63562807361243,-58.390164119153077 -34.636511724023876)));;2446;4_8_7;COMUNA 4;8;7;2464;1192;1272;93,71%;993;993;100,00%;0;0,00%;837;93;11,11%;744;88,89%
MULTIPOLYGON (((-58.395121724551224 -34.637661298572773,-58.394806429006486 -34.637594290342435,-58.393035583640163 -34.637180813727504,-58.392609932430794 -34.638349621212278,-58.390781699927992 -34.637979812712906,-58.390364003035835 -34.637895337655678,-58.390064049347799 -34.637826424799108,-58.389966907732877 -34.639101829934823,-58.389881501735559 -34.640205475766969,-58.390244024178095 -34.640353231534853,-58.391471232669964 -34.640826504510201,-58.391400197095791 -34.642086220701287,-58.393507324247402 -34.642981828432013,-58.397276534765012 -34.644583746938729,-58.400379802507189 -34.645902454982725,-58.400492445037592 -34.645918428475198,-58.40035239933281 -34.646309566097486,-58.400332104959467 -34.64635789543663,-58.40044664625939 -34.646406271760732,-58.400436172967275 -34.646425827671429,-58.400634341979838 -34.646543705081733,-58.400689821589467 -34.646576078192872,-58.400847206790907 -34.64663757137054,-58.40108342256589 -34.646731121987173,-58.401135912009288 -34.646736859867772,-58.401302764729493 -34.646757562936735,-58.401399621735592 -34.646767830978746,-58.401541147516078 -34.646786450202626,-58.401558501123077 -34.646711879167142,-58.401638439258434 -34.646355640744922,-58.401690333665591 -34.646125589265395,-58.401744011563153 -34.645786943771654,-58.401838320471718 -34.645470150175711,-58.401966129471127 -34.644903788036956,-58.402216954613685 -34.643792681207607,-58.402373310738604 -34.643100201959101,-58.402521628878802 -34.64244300125447,-58.402649001029836 -34.641878680215413,-58.400934661897942 -34.641618942680857,-58.399703080970752 -34.641432391402248,-58.398268558214902 -34.641215015446896,-58.398129596412396 -34.64119395537827,-58.396900130098722 -34.640935261967989,-58.395552079453758 -34.640651630987136,-58.394204378791954 -34.6403680557193,-58.394739601425847 -34.638774642807498,-58.394809385643022 -34.638566787748971,-58.395121724551224 -34.637661298572773)));;2447;4_8_8;COMUNA 4;8;8;405;215;190;113,16%;117;114;97,44%;3;2,63%;97;19;19,59%;78;80,41%
MULTIPOLYGON (((-58.399219400028549 -34.639564969135549,-58.39753140585622 -34.639359917448395,-58.397678335954396 -34.638993082836272,-58.397811263268956 -34.638661452961472,-58.398003609149349 -34.63818139902596,-58.397618612866836 -34.63811048771209,-58.396575652908936 -34.637925765904626,-58.395322096431663 -34.637703805152391,-58.395121724551224 -34.637661298572773,-58.394809385643022 -34.638566787748971,-58.394739601425847 -34.638774642807498,-58.394204378791954 -34.6403680557193,-58.395552079453758 -34.640651630987136,-58.396900130098722 -34.640935261967989,-58.398129596412396 -34.64119395537827,-58.398268558214902 -34.641215015446896,-58.398519357892276 -34.64018645337211,-58.39912850601501 -34.639645628568509,-58.399219400028549 -34.639564969135549)));;2448;4_8_9;COMUNA 4;8;9;1093;543;550;98,73%;321;321;100,00%;0;0,00%;350;56;16,00%;294;84,00%
MULTIPOLYGON (((-58.416481156263181 -34.656748253337121,-58.416309904603999 -34.656652833431998,-58.416270371955541 -34.656630775493646,-58.415066254580971 -34.655959657796828,-58.414178834318449 -34.655464997743621,-58.412983099878318 -34.654798510719992,-58.412831226063666 -34.655090006509049,-58.412568686611358 -34.655593927618675,-58.412283452562235 -34.656133191876165,-58.411946166826098 -34.65677088731104,-58.411789168908314 -34.657067731838509,-58.411632508790284 -34.65736781582023,-58.412900490644319 -34.657835677674001,-58.413194679130271 -34.657290077549781,-58.414011210751291 -34.657627176596677,-58.414142599939602 -34.657680540384185,-58.414298528895472 -34.65774398448557,-58.414854774568255 -34.657949562037736,-58.4147966664069 -34.658068134175458,-58.414466030247809 -34.658741483617987,-58.41483253914005 -34.658853725380432,-58.415002790763296 -34.658934883780894,-58.415124014574253 -34.658944471340078,-58.415178833245335 -34.658985038557724,-58.415372226968898 -34.658977958631105,-58.415450139801997 -34.659013764589936,-58.415544497244795 -34.659044439534284,-58.415678623971907 -34.659085407994482,-58.415779111661841 -34.659154609542902,-58.415960933274484 -34.659195225215676,-58.416139874646063 -34.659225106795368,-58.416425611778337 -34.659258606264679,-58.416502212382078 -34.659266326221704,-58.416806424590227 -34.659295209883162,-58.416800542789161 -34.659142456834651,-58.41677448688786 -34.658480808394614,-58.416706143205523 -34.657229972040085,-58.416709850476757 -34.65715299938703,-58.416488150164611 -34.657199254928884,-58.416487409275845 -34.65715214061288,-58.416481156263181 -34.656748253337121)));;2449;4_9_1;COMUNA 4;9;1;1495;740;755;98,01%;312;312;100,00%;0;0,00%;463;70;15,12%;393;84,88%
MULTIPOLYGON (((-58.409475085957851 -34.657616829915675,-58.409302829394562 -34.657503371059434,-58.408840845736584 -34.65719013068874,-58.407672399479523 -34.656397966397414,-58.40743455728439 -34.656234403393221,-58.406174735384894 -34.655377533422225,-58.405984631167975 -34.655955419675742,-58.405568288888382 -34.657220543545336,-58.406879764708748 -34.65784652108006,-58.406117654920287 -34.660054442359282,-58.406371635035612 -34.660095105790035,-58.406393590520466 -34.660043543259953,-58.406483694878574 -34.660018936252108,-58.406574366447131 -34.660037851798236,-58.406675463514944 -34.660015996265024,-58.406826243746657 -34.660002543944877,-58.406926217528387 -34.660003364387634,-58.40699252166754 -34.660010085030102,-58.407119597671006 -34.660012114911169,-58.407234745824844 -34.660002484576161,-58.407349399552089 -34.659977781855048,-58.407455443209358 -34.659950575655856,-58.407949657665746 -34.65986924697404,-58.408098366423665 -34.659894666491844,-58.408268918153631 -34.659883193126582,-58.408418183138615 -34.659840019007937,-58.408598084355262 -34.659736786176779,-58.408816896127966 -34.65969343113499,-58.409025749294337 -34.659629225654072,-58.40913666561223 -34.659577794095135,-58.409296180405399 -34.659498284340266,-58.409451877905376 -34.659471607078011,-58.409651076489872 -34.659416837779318,-58.409752215223421 -34.659238003052351,-58.409784404622577 -34.659179826164127,-58.409841701855633 -34.659226116633548,-58.409908113735732 -34.659187984618725,-58.409911286889148 -34.659082272749231,-58.410069888937045 -34.658973400120352,-58.410130529195484 -34.658932880441839,-58.410243596100727 -34.65894283472543,-58.410332565945097 -34.658952047777873,-58.410397706312402 -34.658915717056047,-58.410487289743671 -34.658902515636576,-58.410549951456545 -34.658872541597781,-58.41060210451343 -34.658883338848511,-58.410635462527807 -34.658829478320229,-58.410676118955536 -34.658840097527886,-58.410702080236689 -34.65886634414548,-58.410855111871371 -34.658782932582959,-58.410987911713548 -34.658742443138031,-58.411051405206926 -34.658754395297507,-58.411008039534011 -34.658866474242366,-58.411207219421996 -34.658837937930251,-58.411363110429981 -34.658797457826708,-58.411409320846943 -34.658752161335364,-58.411669151349059 -34.658664023529738,-58.411810598143482 -34.658642617202354,-58.411871238770857 -34.658599711606044,-58.411943628468855 -34.658557979875951,-58.412171459037573 -34.658542595202022,-58.412367755683739 -34.658506900648518,-58.412457229643742 -34.658514092699285,-58.412561134165749 -34.658523675668889,-58.412665043012126 -34.658526103403069,-58.41284689600527 -34.6585094825464,-58.412962557726445 -34.658512905519288,-58.413170139741837 -34.658564470422647,-58.4132798271173 -34.658557359782009,-58.413360647670928 -34.658555007463967,-58.413525146986025 -34.658598004810628,-58.413851298909776 -34.658617216310745,-58.413972508164164 -34.658650655504367,-58.414047535079497 -34.658684076158139,-58.414145678321447 -34.658674575082301,-58.414304413791562 -34.658703258784691,-58.414466030247809 -34.658741483617987,-58.4147966664069 -34.658068134175458,-58.414854774568255 -34.657949562037736,-58.414298528895472 -34.65774398448557,-58.414142599939602 -34.657680540384185,-58.414011210751291 -34.657627176596677,-58.413194679130271 -34.657290077549781,-58.412900490644319 -34.657835677674001,-58.411632508790284 -34.65736781582023,-58.411789168908314 -34.657067731838509,-58.411946166826098 -34.65677088731104,-58.412283452562235 -34.656133191876165,-58.412568686611358 -34.655593927618675,-58.412831226063666 -34.655090006509049,-58.412983099878318 -34.654798510719992,-58.411257179373969 -34.654179255561253,-58.411109054083028 -34.654464975997193,-58.41060613726107 -34.655435001755997,-58.410274379673389 -34.656075089432157,-58.409932121432973 -34.656735242594429,-58.409475085957851 -34.657616829915675)));;2450;4_9_2;COMUNA 4;9;2;765;359;406;88,42%;263;263;100,00%;0;0,00%;254;30;11,81%;224;88,19%
MULTIPOLYGON (((-58.410218542970838 -34.653798660953854,-58.409245415499214 -34.653077371954993,-58.408929987483816 -34.652843564405408,-58.408789185992909 -34.652733991960098,-58.408552553453603 -34.652557684721444,-58.407405518148167 -34.651708342012974,-58.407301861371792 -34.652006472825988,-58.406971589480364 -34.65295592787345,-58.406922145010419 -34.653106261810578,-58.40661872831059 -34.65402826241445,-58.40654887223058 -34.654240701278304,-58.406174735384894 -34.655377533422225,-58.40743455728439 -34.656234403393221,-58.407672399479523 -34.656397966397414,-58.408840845736584 -34.65719013068874,-58.409302829394562 -34.657503371059434,-58.409475085957851 -34.657616829915675,-58.409932121432973 -34.656735242594429,-58.410274379673389 -34.656075089432157,-58.41060613726107 -34.655435001755997,-58.411109054083028 -34.654464975997193,-58.411257179373969 -34.654179255561253,-58.410218542970838 -34.653798660953854)));;2451;4_9_3;COMUNA 4;9;3;536;262;274;95,62%;176;176;100,00%;0;0,00%;186;5;2,69%;181;97,31%
MULTIPOLYGON (((-58.404933592192016 -34.649991581498639,-58.404747077534303 -34.650315094236362,-58.404663802430647 -34.650459565993771,-58.4044265180883 -34.650871084835707,-58.404317612657643 -34.651105546772435,-58.404166935671 -34.651479429323217,-58.403999075534905 -34.651927530946033,-58.403928027605843 -34.65213123515251,-58.403833666400523 -34.652401972293895,-58.403580537459995 -34.653270537418273,-58.404978551706819 -34.653732277099991,-58.405136860946342 -34.653783550622329,-58.404754614153113 -34.654915233661491,-58.405310919427556 -34.655096347099636,-58.406174735384894 -34.655377533422225,-58.40654887223058 -34.654240701278304,-58.40661872831059 -34.65402826241445,-58.406922145010419 -34.653106261810578,-58.406971589480364 -34.65295592787345,-58.407301861371792 -34.652006472825988,-58.407405518148167 -34.651708342012974,-58.407217272344901 -34.651568956593266,-58.406807413990734 -34.651233759454165,-58.406237092918921 -34.650767285629129,-58.405689348812366 -34.650319270917798,-58.4054891471594 -34.650101142459555,-58.405335709821237 -34.650038814989827,-58.405222858397927 -34.649945660468497,-58.405045022526906 -34.649798248155371,-58.404933592192016 -34.649991581498639)));;2452;4_9_4;COMUNA 4;9;4;503;222;281;79,00%;187;187;100,00%;0;0,00%;176;46;26,14%;130;73,86%
MULTIPOLYGON (((-58.405136860946328 -34.653783550622322,-58.404978551706812 -34.653732277099991,-58.403580537459995 -34.653270537418258,-58.403239165300526 -34.654421884064611,-58.402745441095234 -34.655872952144975,-58.403441325617628 -34.65620506249855,-58.403625947227987 -34.656293182799779,-58.40424504542986 -34.65529655084643,-58.405984631167975 -34.655955419675749,-58.40617473538488 -34.655377533422225,-58.404754614153099 -34.654915233661491,-58.405136860946328 -34.653783550622322)));;2453;4_9_5;COMUNA 4;9;5;537;249;288;86,46%;233;233;100,00%;0;0,00%;189;5;2,65%;184;97,35%
MULTIPOLYGON (((-58.404440774824906 -34.656681966351108,-58.405474229749387 -34.657175146018687,-58.405568288888354 -34.657220543545336,-58.405984631167975 -34.655955419675749,-58.404553225192906 -34.655408673285486,-58.40424504542986 -34.65529655084643,-58.403625947227987 -34.656293182799779,-58.404440774824906 -34.656681966351108)));;2454;4_9_6;COMUNA 4;9;6;839;373;466;80,04%;318;318;100,00%;0;0,00%;279;22;7,89%;257;92,11%
MULTIPOLYGON (((-58.405568288888382 -34.657220543545336,-58.405474229749387 -34.657175146018702,-58.404440774824934 -34.656681966351123,-58.403625947227987 -34.6562931827998,-58.403441325617628 -34.65620506249855,-58.402745441095234 -34.655872952144975,-58.402233721255357 -34.657083156950748,-58.402008846564875 -34.657615102769014,-58.40121254001324 -34.659502909863853,-58.401134544666974 -34.659586347220227,-58.400835345112867 -34.660196768277977,-58.400916199460397 -34.660151493350519,-58.400968210434328 -34.660077583183813,-58.401053369539461 -34.660065701026731,-58.40109606083228 -34.660037601356024,-58.401157298176429 -34.659980165866564,-58.401204210534395 -34.659931314914047,-58.401338632875529 -34.659910466553335,-58.401482148492185 -34.659873920636727,-58.401636601181167 -34.659835837306076,-58.401790019898542 -34.659661742169909,-58.401846076545333 -34.65955092868888,-58.401890806655459 -34.659564068774969,-58.401990390306132 -34.659561733351197,-58.402068343081957 -34.65953553660151,-58.402243025866696 -34.659461686823064,-58.402391692494405 -34.659440295006874,-58.402486946341796 -34.659437957035699,-58.402644108479919 -34.659416877197657,-58.402749362209235 -34.659422562958405,-58.402923903884684 -34.659432789787438,-58.402972417776112 -34.659406897333248,-58.402994923866444 -34.659485311558242,-58.403084399766222 -34.659490125437976,-58.403266248243838 -34.659485444118253,-58.403303193710435 -34.65940381939091,-58.403392693505403 -34.659390693569705,-58.403527247493599 -34.659422449985833,-58.403654486624561 -34.659433427473232,-58.403796483014482 -34.659426594550553,-58.403965571912352 -34.659434352395351,-58.404119897987385 -34.659468019142778,-58.40426911667177 -34.659492809755839,-58.404389044297105 -34.659521761995428,-58.404492940799955 -34.659543277080481,-58.404680973784082 -34.659571811488526,-58.404781685325865 -34.659613973242124,-58.404827662412579 -34.659693694502202,-58.404948854705296 -34.659748608092023,-58.405052754939788 -34.659765352603337,-58.405119133146698 -34.659779694262795,-58.405194170697605 -34.659794039970528,-58.405271874967774 -34.659808224697983,-58.405478965277631 -34.659833181922735,-58.405586695497725 -34.659839540400355,-58.405716564162034 -34.659870606800901,-58.405820490778076 -34.659849189887389,-58.405930121911673 -34.659927947596003,-58.405967579055158 -34.660025752034777,-58.406117654920287 -34.660054442359282,-58.406879764708748 -34.65784652108006,-58.405568288888382 -34.657220543545336)));;2455;4_9_7;COMUNA 4;9;7;782;372;410;90,73%;293;293;100,00%;0;0,00%;263;32;12,17%;231;87,83%
MULTIPOLYGON (((-58.428079791493005 -34.599065858284213,-58.426741074647943 -34.599197800151011,-58.426625759173838 -34.599194878679484,-58.426755166641321 -34.600094880945555,-58.428035554316239 -34.599970880442982,-58.42820751574132 -34.599954590519438,-58.429734468933688 -34.599809936615529,-58.430150189717729 -34.599770539662018,-58.42964659896429 -34.599320668726008,-58.429428903013694 -34.599126165473635,-58.429220123503022 -34.598999272507442,-58.429161800075114 -34.598959114102527,-58.428548032099265 -34.598672524393407,-58.427987566853034 -34.598423905969199,-58.428079791493005 -34.599065858284213)));;2456;5_1_1;COMUNA 5;1;1;553;228;325;70,15%;321;319;99,38%;2;0,63%;253;5;1,98%;248;98,02%
MULTIPOLYGON (((-58.420512701165514 -34.600024640335356,-58.419084533677584 -34.600149847240957,-58.419175731955058 -34.60083568062484,-58.419747413387462 -34.600784684067499,-58.420609708366058 -34.600698924938094,-58.420512701165514 -34.600024640335356)));;2457;5_1_10;COMUNA 5;1;10;673;283;390;72,56%;382;381;99,74%;1;0,26%;312;3;0,96%;309;99,04%
MULTIPOLYGON (((-58.426564822219788 -34.597915797304339,-58.426439379507428 -34.597899632709328,-58.426625759173838 -34.599194878679484,-58.426741074647943 -34.599197800151011,-58.428079791493005 -34.599065858284213,-58.427987566853034 -34.598423905969199,-58.427852517534767 -34.598364006014627,-58.427773242114284 -34.598328911574995,-58.426785219968636 -34.597944243749005,-58.426564822219788 -34.597915797304339)));;2458;5_1_2;COMUNA 5;1;2;879;388;491;79,02%;475;475;100,00%;0;0,00%;411;12;2,92%;399;97,08%
MULTIPOLYGON (((-58.426439379507428 -34.597899632709328,-58.426302780729216 -34.59788198572793,-58.424954103811018 -34.597851786114518,-58.425137645508137 -34.599156540889496,-58.425270848490648 -34.600103237825479,-58.425289951502563 -34.600236769916854,-58.426755166641321 -34.600094880945555,-58.426625759173838 -34.599194878679484,-58.426439379507428 -34.597899632709328)));;2459;5_1_3;COMUNA 5;1;3;775;366;409;89,49%;448;447;99,78%;1;0,22%;361;48;13,30%;313;86,70%
MULTIPOLYGON (((-58.424954103811018 -34.597851786114518,-58.42374689704716 -34.597824750217065,-58.423367161030654 -34.597748680950346,-58.423364971367299 -34.597750490210672,-58.423421357152776 -34.598059620266682,-58.423558454896153 -34.599009982601103,-58.423573053860977 -34.599116188546205,-58.42374747886192 -34.600388405757236,-58.425111260172592 -34.600254039607854,-58.425289951502563 -34.600236769916854,-58.425270848490648 -34.600103237825479,-58.425137645508137 -34.599156540889496,-58.424954103811018 -34.597851786114518)));;2460;5_1_4;COMUNA 5;1;4;683;307;376;81,65%;396;396;100,00%;0;0,00%;314;5;1,59%;309;98,41%
MULTIPOLYGON (((-58.42203864297462 -34.599363795002759,-58.422211388465563 -34.600539672085226,-58.42374747886192 -34.600388405757236,-58.423573053860977 -34.599116188546205,-58.423558454896153 -34.599009982601103,-58.423421357152776 -34.598059620266682,-58.423364971367299 -34.597750490210672,-58.423015797612713 -34.59787345485131,-58.422581365538484 -34.597875114528726,-58.421862740803832 -34.598209114394642,-58.422018355252561 -34.599225684349719,-58.42203864297462 -34.599363795002759)));;2461;5_1_5;COMUNA 5;1;5;1103;483;620;77,90%;646;645;99,85%;1;0,16%;472;4;0,85%;468;99,15%
MULTIPOLYGON (((-58.418967708625161 -34.598475304580987,-58.418970024713978 -34.59860615551684,-58.419003431943224 -34.599540217431802,-58.420337731040568 -34.598918269699546,-58.420612289399529 -34.598790261191802,-58.421862740803832 -34.598209114394642,-58.422581365538484 -34.597875114528726,-58.423015797612713 -34.59787345485131,-58.423364971367299 -34.597750490210672,-58.423367161030654 -34.597748680950346,-58.422933791295009 -34.597717771067103,-58.422837355446475 -34.597711535687559,-58.421777551428157 -34.597734912628006,-58.420432684322542 -34.597757412836387,-58.420162705218736 -34.597763164318359,-58.418940815057759 -34.597789282579058,-58.418967708625161 -34.598475304580987)));;2462;5_1_6;COMUNA 5;1;6;498;185;313;59,11%;307;305;99,35%;2;0,66%;209;13;6,22%;196;93,78%
MULTIPOLYGON (((-58.421862740803832 -34.598209114394642,-58.420612289399529 -34.598790261191802,-58.420337731040568 -34.598918269699546,-58.420436477398852 -34.599516566337527,-58.42203864297462 -34.599363795002759,-58.422018355252561 -34.599225684349719,-58.421862740803832 -34.598209114394642)));;2463;5_1_7;COMUNA 5;1;7;625;283;342;82,75%;376;376;100,00%;0;0,00%;302;3;0,99%;299;99,01%
MULTIPOLYGON (((-58.42203864297462 -34.599363795002759,-58.420436477398852 -34.599516566337527,-58.42046076068641 -34.599664115610395,-58.420512701165514 -34.600024640335356,-58.420609708366058 -34.600698924938094,-58.422044364361184 -34.600556166477041,-58.422211388465563 -34.600539672085226,-58.42203864297462 -34.599363795002759)));;2464;5_1_8;COMUNA 5;1;8;742;347;395;87,85%;374;373;99,73%;1;0,27%;323;7;2,17%;316;97,83%
MULTIPOLYGON (((-58.420436477398852 -34.599516566337527,-58.420337731040568 -34.598918269699546,-58.419003431943224 -34.599540217431802,-58.419084533677584 -34.600149847240957,-58.420512701165514 -34.600024640335356,-58.42046076068641 -34.599664115610395,-58.420436477398852 -34.599516566337527)));;2465;5_1_9;COMUNA 5;1;9;691;308;383;80,42%;428;428;100,00%;0;0,00%;349;5;1,43%;344;98,57%
MULTIPOLYGON (((-58.42467674489982 -34.608630768740774,-58.423035908272595 -34.608599681842165,-58.423042991385991 -34.608750605197251,-58.422798916869404 -34.60990627229593,-58.423347103135967 -34.609952578794491,-58.424563123567303 -34.610110294665652,-58.424671886393263 -34.608825070158616,-58.42467674489982 -34.608630768740774)));;2466;5_10_1;COMUNA 5;10;1;1160;508;652;77,91%;636;636;100,00%;0;0,00%;538;24;4,46%;514;95,54%
MULTIPOLYGON (((-58.420562965570589 -34.609774459418766,-58.41991410968496 -34.60971197779692,-58.419746231709709 -34.611019079256593,-58.419717813251552 -34.611123227972151,-58.420685073873067 -34.611370264026739,-58.421009383860024 -34.611480308856201,-58.421133643939292 -34.610831876931208,-58.421265552502149 -34.610043512709417,-58.42127922307062 -34.609958936789781,-58.421278505752525 -34.609958732804081,-58.421147811351688 -34.609921566794462,-58.4206770988758 -34.609785485101398,-58.420562965570589 -34.609774459418766)));;2467;5_10_10;COMUNA 5;10;10;540;245;295;83,05%;329;329;100,00%;0;0,00%;256;44;17,19%;212;82,81%
MULTIPOLYGON (((-58.421638328914739 -34.609822184384832,-58.422798916869404 -34.60990627229593,-58.423042991385991 -34.608750605197251,-58.423035908272595 -34.608599681842165,-58.421537828236971 -34.60857129727745,-58.421321240350423 -34.609708557649761,-58.421307656086441 -34.609804485103155,-58.421638328914739 -34.609822184384832)));;2468;5_10_2;COMUNA 5;10;2;1082;477;605;78,84%;694;694;100,00%;0;0,00%;548;28;5,11%;520;94,89%
MULTIPOLYGON (((-58.419964314023609 -34.609312403267886,-58.419940079591392 -34.609502732934644,-58.419940366727658 -34.60950261312685,-58.41991410968496 -34.60971197779692,-58.420562965570589 -34.609774459418766,-58.4206770988758 -34.609785485101398,-58.421147811351688 -34.609921566794462,-58.421278505752525 -34.609958732804081,-58.421307656086441 -34.609804485103155,-58.421321240350423 -34.609708557649761,-58.421537828236971 -34.60857129727745,-58.420060872951716 -34.608543253828877,-58.419964314023609 -34.609312403267886)));;2469;5_10_3;COMUNA 5;10;3;416;187;229;81,66%;190;189;99,47%;1;0,53%;164;22;13,41%;142;86,59%
MULTIPOLYGON (((-58.419940079591392 -34.609502732934644,-58.419964314023609 -34.609312403267886,-58.420060872951716 -34.608543253828877,-58.419876551736202 -34.608539738442225,-58.418788672019829 -34.608538154532461,-58.418708945906474 -34.609175860901814,-58.418756559462736 -34.60918640625566,-58.418760120672829 -34.609217253741718,-58.418971506980732 -34.609264373668893,-58.419250345182334 -34.609329053124519,-58.419394192137908 -34.609364387252505,-58.419940079591392 -34.609502732934644)));;2470;5_10_4;COMUNA 5;10;4;557;255;302;84,44%;290;290;100,00%;0;0,00%;254;0;0,00%;254;100,00%
MULTIPOLYGON (((-58.418708945906474 -34.609175860901814,-58.418788672019829 -34.608538154532461,-58.418505458766305 -34.608537700148446,-58.417506827791904 -34.608537079321053,-58.416234468020377 -34.60854101148476,-58.416065053656411 -34.60853622836391,-58.416048034426311 -34.608659606681975,-58.416026204550306 -34.608855661884512,-58.415951163562951 -34.609463120253594,-58.417405952629458 -34.609555292083996,-58.417519576206068 -34.609562517574957,-58.418651298176073 -34.609635610136358,-58.41991410968496 -34.60971197779692,-58.419940366727658 -34.60950261312685,-58.419940079591392 -34.609502732934644,-58.419394192137908 -34.609364387252505,-58.419250345182334 -34.609329053124519,-58.418971506980732 -34.609264373668893,-58.418760120672829 -34.609217253741718,-58.418756559462736 -34.60918640625566,-58.418708945906474 -34.609175860901814)));;2471;5_10_5;COMUNA 5;10;5;749;330;419;78,76%;360;359;99,72%;1;0,28%;269;1;0,37%;268;99,63%
MULTIPOLYGON (((-58.41458300044718 -34.609376388004797,-58.414467053489723 -34.61073639196033,-58.415823307158 -34.610834741066149,-58.415793797465966 -34.610750219601123,-58.415951163562951 -34.609463120253594,-58.416026204550306 -34.608855661884512,-58.416048034426311 -34.608659606681975,-58.416065053656411 -34.60853622836391,-58.415902197819861 -34.608531658799016,-58.41543374957967 -34.608487251239687,-58.415071883886277 -34.60839774102633,-58.414660003114641 -34.608190036685038,-58.41465245491414 -34.608281445533834,-58.414616610131489 -34.608847086040726,-58.41458300044718 -34.609376388004797)));;2472;5_10_6;COMUNA 5;10;6;791;365;426;85,68%;352;350;99,43%;2;0,57%;314;33;10,51%;281;89,49%
MULTIPOLYGON (((-58.417405952629458 -34.609555292083996,-58.415951163562951 -34.609463120253594,-58.415793797465966 -34.610750219601123,-58.415823307158 -34.610834741066149,-58.415985567089891 -34.610846705144112,-58.416972672077414 -34.610916870380265,-58.417339866652682 -34.610942430914001,-58.41730499000672 -34.610856217617382,-58.417405952629458 -34.609555292083996)));;2473;5_10_7;COMUNA 5;10;7;1225;566;659;85,89%;654;654;100,00%;0;0,00%;548;3;0,55%;545;99,45%
MULTIPOLYGON (((-58.418651298176073 -34.609635610136358,-58.417519576206068 -34.609562517574957,-58.417405952629458 -34.609555292083996,-58.41730499000672 -34.610856217617382,-58.417339866652682 -34.610942430914001,-58.417531939055451 -34.610955812517709,-58.41816701377882 -34.610999498267461,-58.41847288136897 -34.611022145561527,-58.41852088425339 -34.61093377945096,-58.418651298176073 -34.609635610136358)));;2474;5_10_8;COMUNA 5;10;8;660;279;381;73,23%;393;392;99,75%;1;0,26%;309;15;4,85%;294;95,15%
MULTIPOLYGON (((-58.41991410968496 -34.60971197779692,-58.418651298176073 -34.609635610136358,-58.41852088425339 -34.61093377945096,-58.41847288136897 -34.611022145561527,-58.419717813251552 -34.611123227972151,-58.419746231709709 -34.611019079256593,-58.41991410968496 -34.60971197779692)));;2475;5_10_9;COMUNA 5;10;9;785;323;462;69,91%;427;426;99,77%;1;0,23%;344;21;6,10%;323;93,90%
MULTIPOLYGON (((-58.429098688500495 -34.605944009239131,-58.427576281188536 -34.605946538338763,-58.427592837928557 -34.606070702663828,-58.427662259923956 -34.607275908279554,-58.427739001374796 -34.608702814030735,-58.427914804020901 -34.608710047643044,-58.429190322320103 -34.608734490027871,-58.429204452324313 -34.608545824980119,-58.429148961812515 -34.607163716346435,-58.429098688500495 -34.605944009239131)));;2476;5_11_1;COMUNA 5;11;1;1144;511;633;80,73%;679;679;100,00%;0;0,00%;536;49;9,14%;487;90,86%
MULTIPOLYGON (((-58.428776474900388 -34.611596029742302,-58.428752733626354 -34.611746380719744,-58.428780160496125 -34.611749275777093,-58.428758296765537 -34.611890753711975,-58.428729429594661 -34.612077794724378,-58.428700647876667 -34.612263849796733,-58.428677929882653 -34.612410679773816,-58.428648111003525 -34.612407138678975,-58.428594656305798 -34.612745598232436,-58.428661937704355 -34.612774561731797,-58.428685548065658 -34.612737454297466,-58.428683695593762 -34.612684705392681,-58.428773694926136 -34.612776212637456,-58.429286482475852 -34.612998826992225,-58.430021387630141 -34.613321502493299,-58.430047605446816 -34.613367990064248,-58.430121697599368 -34.613398068860825,-58.430127266110517 -34.613328150764843,-58.430232852424737 -34.611897352436465,-58.428776474900388 -34.611596029742302)));;2477;5_11_10;COMUNA 5;11;10;855;371;484;76,65%;395;394;99,75%;1;0,25%;354;21;5,93%;333;94,07%
MULTIPOLYGON (((-58.430669134114844 -34.605941332913901,-58.429098688500495 -34.605944009239131,-58.429148961812515 -34.607163716346435,-58.430605850009883 -34.607047061671395,-58.430669134114844 -34.605941332913901)));;2478;5_11_2;COMUNA 5;11;2;894;417;477;87,42%;463;463;100,00%;0;0,00%;389;21;5,40%;368;94,60%
MULTIPOLYGON (((-58.430605850009883 -34.607047061671395,-58.429148961812515 -34.607163716346435,-58.429204452324313 -34.608545824980119,-58.429190322320103 -34.608734490027871,-58.430473946219756 -34.608725258006771,-58.430512868654183 -34.608513711183889,-58.430549468522052 -34.607918839702322,-58.430559923700827 -34.607753625075397,-58.430605850009883 -34.607047061671395)));;2479;5_11_3;COMUNA 5;11;3;694;324;370;87,57%;323;323;100,00%;0;0,00%;281;0;0,00%;281;100,00%
MULTIPOLYGON (((-58.430473946219756 -34.608725258006771,-58.429190322320103 -34.608734490027871,-58.429170112269155 -34.609003719743747,-58.428914311565734 -34.610717373986233,-58.430330254048357 -34.610915441148592,-58.430370661783016 -34.610171903551581,-58.430413950500416 -34.609465410227187,-58.430473946219756 -34.608725258006771)));;2480;5_11_4;COMUNA 5;11;4;682;296;386;76,68%;442;442;100,00%;0;0,00%;331;2;0,60%;329;99,40%
MULTIPOLYGON (((-58.429190322320103 -34.608734490027871,-58.427914804020901 -34.608710047643044,-58.427739001374796 -34.608702814030735,-58.427459280979456 -34.610513785943887,-58.42754454014284 -34.610525712384387,-58.428914311565734 -34.610717373986233,-58.429170112269155 -34.609003719743747,-58.429190322320103 -34.608734490027871)));;2481;5_11_5;COMUNA 5;11;5;764;358;406;88,18%;438;437;99,77%;1;0,23%;321;6;1,87%;315;98,13%
MULTIPOLYGON (((-58.427028289456707 -34.608688030306695,-58.426246967962143 -34.608668643733239,-58.426237007829528 -34.608850689716739,-58.426024273289528 -34.610313003569502,-58.425924483108503 -34.610996378774381,-58.427019624649311 -34.611221993868412,-58.427344981818834 -34.611291386885398,-58.42754454014284 -34.610525712384387,-58.427459280979456 -34.610513785943887,-58.427739001374796 -34.608702814030735,-58.427028289456707 -34.608688030306695)));;2482;5_11_6;COMUNA 5;11;6;747;349;398;87,69%;430;428;99,53%;2;0,47%;315;4;1,27%;311;98,73%
MULTIPOLYGON (((-58.426246967962143 -34.608668643733239,-58.424877846250972 -34.608634634204336,-58.42467674489982 -34.608630768740774,-58.424671886393263 -34.608825070158616,-58.424563123567303 -34.610110294665652,-58.424738495955253 -34.610133026244434,-58.426024273289528 -34.610313003569502,-58.426237007829528 -34.608850689716739,-58.426246967962143 -34.608668643733239)));;2483;5_11_7;COMUNA 5;11;7;1059;460;599;76,79%;560;560;100,00%;0;0,00%;470;26;5,53%;444;94,47%
MULTIPOLYGON (((-58.428648111003525 -34.612407138678975,-58.428677929882653 -34.612410679773816,-58.428700647876667 -34.612263849796733,-58.428729429594661 -34.612077794724378,-58.428758296765537 -34.611890753711975,-58.428780160496125 -34.611749275777093,-58.428752733626354 -34.611746380719744,-58.428776474900388 -34.611596029742302,-58.428005151937114 -34.611432144906679,-58.427893235431064 -34.611408309345521,-58.427344981818834 -34.611291386885398,-58.427019624649311 -34.611221993868412,-58.425924483108503 -34.610996378774381,-58.426024273289528 -34.610313003569502,-58.424738495955253 -34.610133026244434,-58.424563123567303 -34.610110294665652,-58.424550448585371 -34.610260155342523,-58.424484697546859 -34.610988541651686,-58.424554363444535 -34.611012437563119,-58.425772969461164 -34.61152677486654,-58.425785824445526 -34.611543046954196,-58.425839358324026 -34.611565721418685,-58.425839477823622 -34.611565810482467,-58.425862301759558 -34.61157560646452,-58.425895296162651 -34.611590061144682,-58.42591311242122 -34.611588727462006,-58.426383254799859 -34.611790559190773,-58.427072410291771 -34.612079927817682,-58.427122912984174 -34.612101985608753,-58.427193940670861 -34.612132429939692,-58.427616279009008 -34.612304952740693,-58.427657243945568 -34.612321725685078,-58.42769914571079 -34.612338921434969,-58.428432596551168 -34.61264766195368,-58.42842023697149 -34.612667870480948,-58.428462053655608 -34.612685629344725,-58.428484536036734 -34.612698945993003,-58.428594637975309 -34.612745558451799,-58.428594656305798 -34.612745598232436,-58.428648111003525 -34.612407138678975)));;2484;5_11_8;COMUNA 5;11;8;791;369;422;87,44%;421;420;99,76%;1;0,24%;321;32;9,97%;289;90,03%
MULTIPOLYGON (((-58.430330254048357 -34.610915441148592,-58.428914311565734 -34.610717373986233,-58.42754454014284 -34.610525712384387,-58.427344981818834 -34.611291386885398,-58.427893235431064 -34.611408309345521,-58.428005151937114 -34.611432144906679,-58.428776474900388 -34.611596029742302,-58.430232852424737 -34.611897352436465,-58.430254626941149 -34.611759818018378,-58.430318672057275 -34.611128614866296,-58.430330254048357 -34.610915441148592)));;2485;5_11_9;COMUNA 5;11;9;1026;461;565;81,59%;569;569;100,00%;0;0,00%;459;53;11,55%;406;88,45%
MULTIPOLYGON (((-58.426831949442409 -34.612664737715818,-58.428275097567585 -34.61326418920342,-58.430085854524251 -34.614015277146116,-58.430112513593542 -34.613565253906451,-58.430121697599368 -34.613398068860825,-58.430047605446816 -34.613367990064248,-58.430021387630141 -34.613321502493299,-58.429286482475852 -34.612998826992225,-58.428773694926136 -34.612776212637456,-58.428683695593762 -34.612684705392681,-58.428685548065658 -34.612737454297466,-58.428661937704355 -34.612774561731797,-58.428594656305798 -34.612745598232436,-58.428594637975309 -34.612745558451799,-58.428484536036734 -34.612698945993003,-58.428462053655608 -34.612685629344725,-58.42842023697149 -34.612667870480948,-58.428432596551168 -34.61264766195368,-58.42769914571079 -34.612338921434969,-58.427657243945568 -34.612321725685078,-58.427616279009008 -34.612304952740693,-58.427193940670861 -34.612132429939692,-58.427122912984174 -34.612101985608753,-58.427072410291771 -34.612079927817682,-58.426383254799859 -34.611790559190773,-58.42591311242122 -34.611588727462006,-58.425895296162651 -34.611590061144682,-58.425862301759558 -34.61157560646452,-58.425839477823622 -34.611565810482467,-58.425839358324026 -34.611565721418685,-58.425785824445526 -34.611543046954196,-58.425772969461164 -34.61152677486654,-58.424554363444535 -34.611012437563119,-58.424484697546859 -34.610988541651686,-58.424467146677678 -34.611182839009729,-58.424465092001121 -34.611205444823206,-58.424408151054124 -34.611294514716938,-58.42423673080026 -34.611562639568483,-58.425574145713369 -34.612131173106718,-58.426724640364498 -34.612620127041488,-58.426831949442409 -34.612664737715818)));;2486;5_12_1;COMUNA 5;12;1;606;300;306;98,04%;323;323;100,00%;0;0,00%;293;71;24,23%;222;75,77%
MULTIPOLYGON (((-58.430085854524251 -34.614015277146116,-58.428275097567585 -34.61326418920342,-58.427677802563231 -34.614278492364825,-58.427598712594587 -34.614374177298977,-58.428608373925051 -34.614820817665866,-58.429252501814581 -34.615105654049721,-58.430028561113765 -34.615449186493485,-58.430085854524251 -34.614015277146116)));;2487;5_12_2;COMUNA 5;12;2;1821;786;1035;75,94%;1038;1038;100,00%;0;0,00%;840;6;0,71%;834;99,29%
MULTIPOLYGON (((-58.428275097567585 -34.61326418920342,-58.426831949442409 -34.612664737715818,-58.426177309723741 -34.613687749462699,-58.426103445717239 -34.613712798653722,-58.427598712594587 -34.614374177298977,-58.427677802563231 -34.614278492364825,-58.428275097567585 -34.61326418920342)));;2488;5_12_3;COMUNA 5;12;3;949;414;535;77,38%;526;524;99,62%;2;0,38%;426;24;5,63%;402;94,37%
MULTIPOLYGON (((-58.426831949442409 -34.612664737715818,-58.426724640364498 -34.612620127041488,-58.425574145713369 -34.612131173106718,-58.424947116877419 -34.613102846855128,-58.424938385489881 -34.61319749545828,-58.426103445717239 -34.613712798653722,-58.426177309723741 -34.613687749462699,-58.426831949442409 -34.612664737715818)));;2489;5_12_4;COMUNA 5;12;4;735;331;404;81,93%;407;407;100,00%;0;0,00%;328;8;2,44%;320;97,56%
MULTIPOLYGON (((-58.425574145713369 -34.612131173106718,-58.42423673080026 -34.611562639568483,-58.423582573327991 -34.612597750836137,-58.424938385489881 -34.61319749545828,-58.424947116877419 -34.613102846855128,-58.425574145713369 -34.612131173106718)));;2490;5_12_5;COMUNA 5;12;5;435;165;270;61,11%;278;277;99,64%;1;0,36%;198;1;0,51%;197;99,49%
MULTIPOLYGON (((-58.422922374577276 -34.611084665524231,-58.421133643939292 -34.610831876931208,-58.421009383860024 -34.611480308856201,-58.421211907733685 -34.611548971937466,-58.422402640900714 -34.612075728189126,-58.423582573327991 -34.612597750836137,-58.42423673080026 -34.611562639568483,-58.424408151054124 -34.611294514716938,-58.423233275511407 -34.61112992087304,-58.423230789272672 -34.611128217975931,-58.422922374577276 -34.611084665524231)));;2491;5_12_6;COMUNA 5;12;6;1575;680;895;75,98%;908;907;99,89%;1;0,11%;769;42;5,46%;727;94,54%
MULTIPOLYGON (((-58.421638328914739 -34.609822184384832,-58.421307656086441 -34.609804485103155,-58.421278505752525 -34.609958732804081,-58.42127922307062 -34.609958936789781,-58.421265552502149 -34.610043512709417,-58.421133643939292 -34.610831876931208,-58.422922374577276 -34.611084665524231,-58.423233275511407 -34.61112992087304,-58.424408151054124 -34.611294514716938,-58.424465092001121 -34.611205444823206,-58.424467146677678 -34.611182839009729,-58.424484697546859 -34.610988541651686,-58.424550448585371 -34.610260155342523,-58.424563123567303 -34.610110294665652,-58.423347103135967 -34.609952578794491,-58.422798916869404 -34.60990627229593,-58.421638328914739 -34.609822184384832)));;2492;5_12_7;COMUNA 5;12;7;897;437;460;95,00%;388;384;98,97%;4;1,04%;336;14;4,17%;322;95,83%
MULTIPOLYGON (((-58.427598712594587 -34.614374177298977,-58.426103445717239 -34.613712798653722,-58.425977438787172 -34.614730684698657,-58.425967908459171 -34.614900899198268,-58.426169617790272 -34.614912720748372,-58.427439847818647 -34.614975138962038,-58.427546809064786 -34.615044679361212,-58.428428784999618 -34.615082326016179,-58.428894048720224 -34.615105836948175,-58.429070524650882 -34.61516708509668,-58.429219048898354 -34.615257340444359,-58.429252501814581 -34.615105654049721,-58.428608373925051 -34.614820817665866,-58.427598712594587 -34.614374177298977)));;2493;5_13_1;COMUNA 5;13;1;856;365;491;74,34%;518;518;100,00%;0;0,00%;396;1;0,25%;395;99,75%
MULTIPOLYGON (((-58.426103445717239 -34.613712798653722,-58.424938385489881 -34.61319749545828,-58.42479123834179 -34.613843811154545,-58.42456624572668 -34.61483173426641,-58.425738600459674 -34.614887449179925,-58.425967908459171 -34.614900899198268,-58.425977438787172 -34.614730684698657,-58.426103445717239 -34.613712798653722)));;2494;5_13_2;COMUNA 5;13;2;710;327;383;85,38%;432;430;99,54%;2;0,47%;321;7;2,18%;314;97,82%
MULTIPOLYGON (((-58.424938385489881 -34.61319749545828,-58.423582573327991 -34.612597750836137,-58.423329022951151 -34.613608550853158,-58.42479123834179 -34.613843811154545,-58.424938385489881 -34.61319749545828)));;2495;5_13_3;COMUNA 5;13;3;759;329;430;76,51%;444;444;100,00%;0;0,00%;365;20;5,48%;345;94,52%
MULTIPOLYGON (((-58.42479123834179 -34.613843811154545,-58.423329022951151 -34.613608550853158,-58.42319272953452 -34.61415204747945,-58.423076405204569 -34.614615617948097,-58.423055637588355 -34.614758855773474,-58.423035211907454 -34.614899417550895,-58.422915602032376 -34.615639264214053,-58.422889455633687 -34.615806867299021,-58.423026090914398 -34.615807968185699,-58.424488411685822 -34.615895550758459,-58.424534216659076 -34.615018068953567,-58.42456624572668 -34.61483173426641,-58.42479123834179 -34.613843811154545)));;2496;5_13_4;COMUNA 5;13;4;731;320;411;77,86%;365;364;99,73%;1;0,27%;330;54;16,36%;276;83,64%
MULTIPOLYGON (((-58.422729843117942 -34.616824949929139,-58.422706943429034 -34.616970863095538,-58.422607824796131 -34.617601697979552,-58.422582098211976 -34.617779442285702,-58.42419784972865 -34.617919615752243,-58.42438201553761 -34.61793608276794,-58.424434526982971 -34.616928457938769,-58.424488411685822 -34.615895550758459,-58.423026090914398 -34.615807968185699,-58.422889455633687 -34.615806867299021,-58.422867068992112 -34.615949893260606,-58.422729843117942 -34.616824949929139)));;2497;5_13_5;COMUNA 5;13;5;795;354;441;80,27%;384;383;99,74%;1;0,26%;332;35;10,54%;297;89,46%
MULTIPOLYGON (((-58.425967908459171 -34.614900899198268,-58.425738600459674 -34.614887449179925,-58.42456624572668 -34.61483173426641,-58.424534216659076 -34.615018068953567,-58.424488411685822 -34.615895550758459,-58.424434526982971 -34.616928457938769,-58.42438201553761 -34.61793608276794,-58.424553318758925 -34.617951418683816,-58.425035203364565 -34.617986921776364,-58.425806797246217 -34.61804737095617,-58.425865861948161 -34.617014605767991,-58.425915044167063 -34.615980921870715,-58.425957433655206 -34.615087944996382,-58.425967908459171 -34.614900899198268)));;2498;5_13_6;COMUNA 5;13;6;850;378;472;80,08%;454;454;100,00%;0;0,00%;377;32;8,49%;345;91,51%
MULTIPOLYGON (((-58.427439847818647 -34.614975138962038,-58.426169617790272 -34.614912720748372,-58.425967908459171 -34.614900899198268,-58.425957433655206 -34.615087944996382,-58.425915044167063 -34.615980921870715,-58.425865861948161 -34.617014605767991,-58.427141995481492 -34.617091325135895,-58.427355380485864 -34.617103711525864,-58.427386505396001 -34.616223337133327,-58.427393129815052 -34.616069389903501,-58.427439847818647 -34.614975138962038)));;2499;5_13_7;COMUNA 5;13;7;739;326;413;78,93%;419;418;99,76%;1;0,24%;323;32;9,91%;291;90,09%
MULTIPOLYGON (((-58.428428784999618 -34.615082326016179,-58.427546809064786 -34.615044679361212,-58.427439847818647 -34.614975138962038,-58.427393129815052 -34.616069389903501,-58.427386505396001 -34.616223337133327,-58.427355380485864 -34.617103711525864,-58.428793026403937 -34.617187009837771,-58.429219048898354 -34.615257340444359,-58.429070524650882 -34.61516708509668,-58.428894048720224 -34.615105836948175,-58.428428784999618 -34.615082326016179)));;2500;5_13_8;COMUNA 5;13;8;940;409;531;77,02%;521;521;100,00%;0;0,00%;421;4;0,95%;417;99,05%
MULTIPOLYGON (((-58.428793026403937 -34.617187009837771,-58.427355380485864 -34.617103711525864,-58.427141995481492 -34.617091325135895,-58.425865861948161 -34.617014605767991,-58.425806797246217 -34.61804737095617,-58.425990027533786 -34.618061722510603,-58.426560245029656 -34.618113443882855,-58.427317270573241 -34.618182541469473,-58.428550985680452 -34.618294798414702,-58.428588286283173 -34.618114168671575,-58.428793026403937 -34.617187009837771)));;2501;5_13_9;COMUNA 5;13;9;1022;465;557;83,48%;538;536;99,63%;2;0,37%;422;2;0,47%;420;99,53%
MULTIPOLYGON (((-58.423582573327991 -34.612597750836137,-58.422402640900714 -34.612075728189126,-58.421986657535427 -34.613392257420124,-58.422120638097155 -34.613414133830943,-58.423329022951151 -34.613608550853158,-58.423582573327991 -34.612597750836137)));;2502;5_14_1;COMUNA 5;14;1;659;289;370;78,11%;324;323;99,69%;1;0,31%;274;2;0,73%;272;99,27%
MULTIPOLYGON (((-58.422402640900714 -34.612075728189126,-58.421211907733685 -34.611548971937466,-58.421009383860024 -34.611480308856201,-58.420632546330708 -34.613171367532502,-58.421986657535427 -34.613392257420124,-58.422402640900714 -34.612075728189126)));;2503;5_14_2;COMUNA 5;14;2;672;274;398;68,84%;485;484;99,79%;1;0,21%;347;32;9,22%;315;90,78%
MULTIPOLYGON (((-58.421009383860024 -34.611480308856201,-58.420685073873067 -34.611370264026739,-58.419717813251552 -34.611123227972151,-58.419144521584151 -34.612816888924243,-58.420479487422142 -34.613146384182613,-58.420632546330708 -34.613171367532502,-58.421009383860024 -34.611480308856201)));;2504;5_14_3;COMUNA 5;14;3;1153;494;659;74,96%;696;696;100,00%;0;0,00%;540;5;0,93%;535;99,07%
MULTIPOLYGON (((-58.419717813251552 -34.611123227972151,-58.41847288136897 -34.611022145561527,-58.417835032059273 -34.612493656248517,-58.419144521584151 -34.612816888924243,-58.419717813251552 -34.611123227972151)));;2505;5_14_4;COMUNA 5;14;4;931;399;532;75,00%;506;506;100,00%;0;0,00%;421;2;0,48%;419;99,52%
MULTIPOLYGON (((-58.419144521584151 -34.612816888924243,-58.417835032059273 -34.612493656248517,-58.417320403664121 -34.613680903132085,-58.417243805109031 -34.613873346328901,-58.417495562164206 -34.613951259571181,-58.418395034485222 -34.614215260981545,-58.418650465144047 -34.614276834556421,-58.419144521584151 -34.612816888924243)));;2506;5_14_5;COMUNA 5;14;5;1592;691;901;76,69%;886;886;100,00%;0;0,00%;787;46;5,84%;741;94,16%
MULTIPOLYGON (((-58.420632546330708 -34.613171367532502,-58.420479487422142 -34.613146384182613,-58.419144521584151 -34.612816888924243,-58.418650465144047 -34.614276834556421,-58.418849427066114 -34.614324795275188,-58.420334443739705 -34.614614555730604,-58.420382824535977 -34.614285264932015,-58.420585419293687 -34.613382696925264,-58.420632546330708 -34.613171367532502)));;2507;5_14_6;COMUNA 5;14;6;1229;531;698;76,07%;651;648;99,54%;3;0,46%;538;16;2,97%;522;97,03%
MULTIPOLYGON (((-58.421986657535427 -34.613392257420124,-58.420632546330708 -34.613171367532502,-58.420585419293687 -34.613382696925264,-58.420382824535977 -34.614285264932015,-58.420334443739705 -34.614614555730604,-58.420303927824037 -34.614822087778172,-58.420080225146634 -34.615843666058055,-58.421354180710772 -34.615799173285701,-58.421583072914231 -34.615795729392332,-58.421694239375427 -34.615794076607315,-58.422759549924507 -34.615805768462721,-58.422889455633687 -34.615806867299021,-58.422915602032376 -34.615639264214053,-58.423035211907454 -34.614899417550895,-58.423055637588355 -34.614758855773474,-58.423076405204569 -34.614615617948097,-58.42319272953452 -34.61415204747945,-58.423329022951151 -34.613608550853158,-58.422120638097155 -34.613414133830943,-58.421986657535427 -34.613392257420124)));;2508;5_14_7;COMUNA 5;14;7;454;196;258;75,97%;208;203;97,60%;5;2,46%;168;23;13,69%;145;86,31%
MULTIPOLYGON (((-58.420334443739705 -34.614614555730604,-58.418849427066114 -34.614324795275188,-58.418650465144047 -34.614276834556421,-58.418649813571299 -34.614542759354777,-58.418623138390799 -34.614728249326305,-58.418471377580111 -34.615784851882786,-58.420080225146634 -34.615843666058055,-58.420303927824037 -34.614822087778172,-58.420334443739705 -34.614614555730604)));;2509;5_14_8;COMUNA 5;14;8;650;289;361;80,06%;309;309;100,00%;0;0,00%;275;23;8,36%;252;91,64%
MULTIPOLYGON (((-58.417158592649969 -34.614552212163055,-58.417017498509608 -34.615696989074202,-58.418471377580111 -34.615784851882786,-58.418623138390799 -34.614728249326305,-58.418649813571299 -34.614542759354777,-58.418650465144047 -34.614276834556421,-58.418395034485222 -34.614215260981545,-58.417495562164206 -34.613951259571181,-58.417243805109031 -34.613873346328901,-58.417158592649969 -34.614552212163055)));;2510;5_14_9;COMUNA 5;14;9;907;404;503;80,32%;470;470;100,00%;0;0,00%;426;51;11,97%;375;88,03%
MULTIPOLYGON (((-58.415823307158 -34.610834741066149,-58.414467053489723 -34.61073639196033,-58.41401427652535 -34.611550467103612,-58.415334808276185 -34.611876491692215,-58.415823307158 -34.610834741066149)));;2511;5_15_1;COMUNA 5;15;1;1104;500;604;82,78%;595;595;100,00%;0;0,00%;521;47;9,02%;474;90,98%
MULTIPOLYGON (((-58.417339866652682 -34.610942430914001,-58.416972672077414 -34.610916870380265,-58.415985567089891 -34.610846705144112,-58.415823307158 -34.610834741066149,-58.415334808276185 -34.611876491692215,-58.416775098202351 -34.612232055224815,-58.417339866652682 -34.610942430914001)));;2512;5_15_2;COMUNA 5;15;2;1099;449;650;69,08%;631;631;100,00%;0;0,00%;530;22;4,15%;508;95,85%
MULTIPOLYGON (((-58.41847288136897 -34.611022145561527,-58.41816701377882 -34.610999498267461,-58.417531939055451 -34.610955812517709,-58.417339866652682 -34.610942430914001,-58.416775098202351 -34.612232055224815,-58.416286647221519 -34.61334740364488,-58.416221463185629 -34.613535906747472,-58.417023134794874 -34.613805092443521,-58.417243805109031 -34.613873346328901,-58.417320403664121 -34.613680903132085,-58.417835032059273 -34.612493656248517,-58.41847288136897 -34.611022145561527)));;2513;5_15_3;COMUNA 5;15;3;586;264;322;81,99%;284;284;100,00%;0;0,00%;267;14;5,24%;253;94,76%
MULTIPOLYGON (((-58.416775098202351 -34.612232055224815,-58.415334808276185 -34.611876491692215,-58.414784037151669 -34.613053220610048,-58.415626664192679 -34.613336164467484,-58.416221463185629 -34.613535906747472,-58.416286647221519 -34.61334740364488,-58.416775098202351 -34.612232055224815)));;2514;5_15_4;COMUNA 5;15;4;1186;537;649;82,74%;648;647;99,85%;1;0,15%;568;49;8,63%;519;91,37%
MULTIPOLYGON (((-58.415334808276185 -34.611876491692215,-58.41401427652535 -34.611550467103612,-58.413561234839108 -34.612365103747962,-58.413435360548327 -34.612614428200736,-58.414410077460133 -34.612927646102442,-58.414784037151669 -34.613053220610048,-58.415334808276185 -34.611876491692215)));;2515;5_15_5;COMUNA 5;15;5;922;388;534;72,66%;548;547;99,82%;1;0,18%;454;7;1,54%;447;98,46%
MULTIPOLYGON (((-58.414784037151669 -34.613053220610048,-58.414410077460133 -34.612927646102442,-58.413435360548327 -34.612614428200736,-58.413314005455966 -34.612854739932587,-58.41311630618177 -34.613416440564158,-58.412870052859198 -34.614116224550962,-58.414529737601562 -34.614289150853914,-58.415293526923186 -34.614369030357999,-58.415626664192679 -34.613336164467484,-58.414784037151669 -34.613053220610048)));;2516;5_15_6;COMUNA 5;15;6;863;393;470;83,62%;343;341;99,42%;2;0,59%;330;56;16,97%;274;83,03%
MULTIPOLYGON (((-58.416221463185629 -34.613535906747472,-58.415626664192679 -34.613336164467484,-58.415293526923186 -34.614369030357999,-58.415970265730621 -34.614439857359876,-58.416925708739534 -34.614539871046205,-58.417158592649969 -34.614552212163055,-58.417243805109031 -34.613873346328901,-58.417023134794874 -34.613805092443521,-58.416221463185629 -34.613535906747472)));;2517;5_15_7;COMUNA 5;15;7;723;321;402;79,85%;360;359;99,72%;1;0,28%;313;33;10,54%;280;89,46%
MULTIPOLYGON (((-58.417158592649969 -34.614552212163055,-58.416925708739534 -34.614539871046205,-58.415970265730621 -34.614439857359876,-58.415293526923186 -34.614369030357999,-58.414529737601562 -34.614289150853914,-58.414369466764292 -34.615537160283623,-58.415778449767089 -34.615622149963421,-58.416676091209098 -34.615676367065866,-58.417017498509608 -34.615696989074202,-58.417158592649969 -34.614552212163055)));;2518;5_15_8;COMUNA 5;15;8;775;356;419;84,96%;286;285;99,65%;1;0,35%;331;98;29,61%;233;70,39%
MULTIPOLYGON (((-58.414529737601562 -34.614289150853914,-58.412870052859198 -34.614116224550962,-58.412816360458045 -34.615443433204597,-58.414369466764292 -34.615537160283623,-58.414529737601562 -34.614289150853914)));;2519;5_15_9;COMUNA 5;15;9;406;192;214;89,72%;214;214;100,00%;0;0,00%;168;29;17,26%;139;82,74%
MULTIPOLYGON (((-58.418471377580111 -34.615784851882786,-58.417017498509608 -34.615696989074202,-58.416921568365289 -34.616650930718741,-58.418345776498192 -34.616659414864785,-58.418574072350026 -34.616660765304054,-58.419618695154917 -34.616669237552649,-58.41989844137693 -34.61667370237344,-58.420080225146634 -34.615843666058055,-58.418471377580111 -34.615784851882786)));;2520;5_16_1;COMUNA 5;16;1;833;408;425;96,00%;428;428;100,00%;0;0,00%;404;12;2,97%;392;97,03%
MULTIPOLYGON (((-58.415341759587427 -34.618384896031401,-58.414091980792875 -34.61823813170156,-58.412913332409637 -34.61809962334334,-58.412687605348886 -34.618069882080619,-58.412682284497272 -34.618277351996959,-58.412642086994104 -34.619394557844856,-58.412635329115943 -34.61958308279933,-58.412543881188107 -34.620642307566243,-58.413823531433202 -34.620751844867151,-58.413938917878951 -34.619664036173887,-58.415210315630226 -34.619731511916129,-58.415341759587427 -34.618384896031401)));;2521;5_16_10;COMUNA 5;16;10;923;430;493;87,22%;486;486;100,00%;0;0,00%;388;44;11,34%;344;88,66%
MULTIPOLYGON (((-58.415210315630226 -34.619731511916129,-58.413938917878951 -34.619664036173887,-58.413823531433202 -34.620751844867151,-58.41509321836137 -34.620860519756491,-58.416104711005005 -34.620947110486817,-58.416509686008766 -34.620977195119544,-58.418065443679048 -34.621092567004681,-58.418145371143773 -34.620099815136328,-58.418156292464857 -34.619908263132658,-58.416821266370214 -34.619817906055928,-58.41661801273348 -34.61980677272112,-58.416348228991204 -34.619791951686913,-58.415210315630226 -34.619731511916129)));;2522;5_16_11;COMUNA 5;16;11;1063;487;576;84,55%;488;486;99,59%;2;0,41%;424;23;5,42%;401;94,58%
MULTIPOLYGON (((-58.417017498509608 -34.615696989074202,-58.416676091209098 -34.615676367065866,-58.415778449767089 -34.615622149963421,-58.415521807954526 -34.617245981922935,-58.416588207010584 -34.617323786770108,-58.416851846090744 -34.617344661519482,-58.416921568365289 -34.616650930718741,-58.417017498509608 -34.615696989074202)));;2523;5_16_2;COMUNA 5;16;2;628;278;350;79,43%;328;328;100,00%;0;0,00%;286;20;6,99%;266;93,01%
MULTIPOLYGON (((-58.415778449767089 -34.615622149963421,-58.414369466764292 -34.615537160283623,-58.414344123005151 -34.615760045511465,-58.41425545083009 -34.616631590623236,-58.414202760554581 -34.617149686646123,-58.415521807954526 -34.617245981922935,-58.415778449767089 -34.615622149963421)));;2524;5_16_3;COMUNA 5;16;3;632;296;336;88,10%;247;244;98,79%;3;1,23%;214;28;13,08%;186;86,92%
MULTIPOLYGON (((-58.414369466764292 -34.615537160283623,-58.412816360458045 -34.615443433204597,-58.412754061909567 -34.616629576680005,-58.412687605348886 -34.618069882080619,-58.412913332409637 -34.61809962334334,-58.414091980792875 -34.61823813170156,-58.414202760554581 -34.617149686646123,-58.41425545083009 -34.616631590623236,-58.414344123005151 -34.615760045511465,-58.414369466764292 -34.615537160283623)));;2525;5_16_4;COMUNA 5;16;4;1025;449;576;77,95%;452;451;99,78%;1;0,22%;389;44;11,31%;345;88,69%
MULTIPOLYGON (((-58.416851846090744 -34.617344661519482,-58.416588207010584 -34.617323786770108,-58.415521807954526 -34.617245981922935,-58.414202760554581 -34.617149686646123,-58.414091980792875 -34.61823813170156,-58.415341759587427 -34.618384896031401,-58.416407380039502 -34.618510098182981,-58.416731835133248 -34.618551560355932,-58.416747431699633 -34.618383743422775,-58.416851846090744 -34.617344661519482)));;2526;5_16_5;COMUNA 5;16;5;846;380;466;81,55%;466;466;100,00%;0;0,00%;376;24;6,38%;352;93,62%
MULTIPOLYGON (((-58.418274559179402 -34.617463361106381,-58.417085501106698 -34.617363200465647,-58.416851846090744 -34.617344661519482,-58.416747431699633 -34.618383743422775,-58.416731835133248 -34.618551560355932,-58.416877239544341 -34.618570066412879,-58.418226893167947 -34.618669372197438,-58.418979409141173 -34.618724646146298,-58.41899562773272 -34.61752411665784,-58.418274559179402 -34.617463361106381)));;2527;5_16_6;COMUNA 5;16;6;715;315;400;78,75%;360;360;100,00%;0;0,00%;309;9;2,91%;300;97,09%
MULTIPOLYGON (((-58.41989844137693 -34.61667370237344,-58.419618695154917 -34.616669237552649,-58.418574072350026 -34.616660765304054,-58.418345776498192 -34.616659414864785,-58.416921568365289 -34.616650930718741,-58.416851846090744 -34.617344661519482,-58.417085501106698 -34.617363200465647,-58.418274559179402 -34.617463361106381,-58.41899562773272 -34.61752411665784,-58.418979409141173 -34.618724646146298,-58.419628853174324 -34.618772414054284,-58.41963160843288 -34.618550857935915,-58.41964011882451 -34.617577305464017,-58.419699576364785 -34.61758204491283,-58.41989844137693 -34.61667370237344)));;2528;5_16_7;COMUNA 5;16;7;604;296;308;96,10%;273;273;100,00%;0;0,00%;249;58;23,29%;191;76,71%
MULTIPOLYGON (((-58.418979409141173 -34.618724646146298,-58.418226893167947 -34.618669372197438,-58.418156292464857 -34.619908263132658,-58.418145371143773 -34.620099815136328,-58.418065443679048 -34.621092567004681,-58.419425787462245 -34.621193483186723,-58.419568823247538 -34.620201809141172,-58.419591840655478 -34.620005331537207,-58.419616141531947 -34.619797727225837,-58.419628853174324 -34.618772414054284,-58.418979409141173 -34.618724646146298)));;2529;5_16_8;COMUNA 5;16;8;1030;485;545;88,99%;432;432;100,00%;0;0,00%;376;39;10,37%;337;89,63%
MULTIPOLYGON (((-58.416731835133248 -34.618551560355932,-58.416407380039502 -34.618510098182981,-58.415341759587427 -34.618384896031401,-58.415210315630226 -34.619731511916129,-58.416348228991204 -34.619791951686913,-58.41661801273348 -34.61980677272112,-58.416821266370214 -34.619817906055928,-58.418156292464857 -34.619908263132658,-58.418226893167947 -34.618669372197438,-58.416877239544341 -34.618570066412879,-58.416731835133248 -34.618551560355932)));;2530;5_16_9;COMUNA 5;16;9;918;409;509;80,35%;455;454;99,78%;1;0,22%;394;35;8,88%;359;91,12%
MULTIPOLYGON (((-58.421583072914231 -34.615795729392332,-58.421354180710772 -34.615799173285701,-58.420080225146634 -34.615843666058055,-58.41989844137693 -34.61667370237344,-58.420168050615928 -34.616678092594029,-58.421567096672312 -34.616753927118317,-58.42155146920809 -34.617695081953059,-58.421732314598898 -34.617705706571996,-58.422582098211976 -34.617779442285702,-58.422607824796131 -34.617601697979552,-58.422706943429034 -34.616970863095538,-58.422729843117942 -34.616824949929139,-58.422867068992112 -34.615949893260606,-58.422889455633687 -34.615806867299021,-58.422759549924507 -34.615805768462721,-58.421694239375427 -34.615794076607315,-58.421583072914231 -34.615795729392332)));;2531;5_17_1;COMUNA 5;17;1;706;324;382;84,82%;356;356;100,00%;0;0,00%;290;30;10,34%;260;89,66%
MULTIPOLYGON (((-58.424156945476504 -34.620346941621989,-58.422479557490789 -34.620202451421754,-58.422328863691519 -34.620191344919988,-58.42222974161654 -34.621166416496038,-58.422212593236367 -34.621393742652927,-58.423520814395559 -34.621486496984801,-58.423718957103532 -34.621507335831616,-58.424040704987604 -34.621541101362709,-58.424288341110518 -34.621567166408212,-58.425163444082592 -34.621693781238434,-58.425348802076051 -34.62058950392575,-58.425373568645561 -34.620451760219382,-58.424802823612637 -34.620402568450913,-58.424156945476504 -34.620346941621989)));;2532;5_17_10;COMUNA 5;17;10;757;369;388;95,10%;351;350;99,72%;1;0,29%;280;1;0,36%;279;99,64%
MULTIPOLYGON (((-58.428068772169667 -34.620683901231352,-58.426874886891234 -34.620581088094994,-58.426119712340871 -34.620516002563029,-58.425373568645561 -34.620451760219382,-58.425348802076051 -34.62058950392575,-58.425163444082592 -34.621693781238434,-58.426615083368219 -34.621903733595666,-58.427795328290458 -34.622074505458436,-58.427842965412246 -34.621833806506807,-58.427941655211164 -34.621331352421784,-58.428068772169667 -34.620683901231352)));;2533;5_17_11;COMUNA 5;17;11;879;417;462;90,26%;502;502;100,00%;0;0,00%;428;2;0,47%;426;99,53%
MULTIPOLYGON (((-58.419699576364785 -34.61758204491283,-58.41964011882451 -34.617577305464017,-58.41963160843288 -34.618550857935915,-58.419628853174324 -34.618772414054284,-58.42053172133906 -34.618838788145723,-58.420549366980481 -34.617635864506859,-58.42155146920809 -34.617695081953059,-58.421567096672312 -34.616753927118317,-58.420168050615928 -34.616678092594029,-58.41989844137693 -34.61667370237344,-58.419699576364785 -34.61758204491283)));;2534;5_17_2;COMUNA 5;17;2;815;382;433;88,22%;428;428;100,00%;0;0,00%;353;29;8,22%;324;91,78%
MULTIPOLYGON (((-58.422582098211976 -34.617779442285702,-58.421732314598898 -34.617705706571996,-58.42155146920809 -34.617695081953059,-58.420549366980481 -34.617635864506859,-58.42053172133906 -34.618838788145723,-58.421531190172338 -34.618912230694178,-58.422452290889851 -34.618979934797821,-58.422556970061834 -34.617952538726662,-58.422582098211976 -34.617779442285702)));;2535;5_17_3;COMUNA 5;17;3;754;339;415;81,69%;331;331;100,00%;0;0,00%;317;28;8,83%;289;91,17%
MULTIPOLYGON (((-58.425035203364565 -34.617986921776364,-58.424553318758925 -34.617951418683816,-58.42438201553761 -34.61793608276794,-58.42419784972865 -34.617919615752243,-58.422582098211976 -34.617779442285702,-58.422556970061834 -34.617952538726662,-58.422452290889851 -34.618979934797821,-58.424276948733777 -34.619114048965557,-58.424397570591481 -34.619122890023753,-58.424921967915139 -34.619164393025443,-58.425273270126738 -34.619192178338665,-58.425596035914197 -34.619217066538731,-58.42614769410708 -34.619259628934763,-58.426347282835508 -34.619274829951138,-58.426560245029656 -34.618113443882855,-58.425990027533786 -34.618061722510603,-58.425806797246217 -34.61804737095617,-58.425035203364565 -34.617986921776364)));;2536;5_17_4;COMUNA 5;17;4;842;404;438;92,24%;342;342;100,00%;0;0,00%;298;25;8,39%;273;91,61%
MULTIPOLYGON (((-58.427317270573241 -34.618182541469473,-58.426560245029656 -34.618113443882855,-58.426347282835508 -34.619274829951138,-58.427105260594622 -34.619332731551168,-58.428317533157291 -34.619425265581121,-58.428550985680452 -34.618294798414702,-58.427317270573241 -34.618182541469473)));;2537;5_17_5;COMUNA 5;17;5;747;317;430;73,72%;389;389;100,00%;0;0,00%;309;2;0,65%;307;99,35%
MULTIPOLYGON (((-58.428317533157291 -34.619425265581121,-58.427105260594622 -34.619332731551168,-58.426347282835508 -34.619274829951138,-58.426119712340871 -34.620516002563029,-58.426874886891234 -34.620581088094994,-58.428068772169667 -34.620683901231352,-58.428283987193296 -34.61958765618531,-58.428317533157291 -34.619425265581121)));;2538;5_17_6;COMUNA 5;17;6;775;345;430;80,23%;435;435;100,00%;0;0,00%;341;2;0,59%;339;99,41%
MULTIPOLYGON (((-58.424276948733777 -34.619114048965557,-58.422452290889851 -34.618979934797821,-58.422347951993295 -34.62000296436765,-58.422328863691519 -34.620191344919988,-58.422479557490789 -34.620202451421754,-58.424156945476504 -34.620346941621989,-58.424802823612637 -34.620402568450913,-58.425373568645561 -34.620451760219382,-58.426119712340871 -34.620516002563029,-58.426347282835508 -34.619274829951138,-58.42614769410708 -34.619259628934763,-58.425596035914197 -34.619217066538731,-58.425273270126738 -34.619192178338665,-58.424921967915139 -34.619164393025443,-58.424397570591481 -34.619122890023753,-58.424276948733777 -34.619114048965557)));;2539;5_17_7;COMUNA 5;17;7;906;415;491;84,52%;379;378;99,74%;1;0,26%;329;12;3,65%;317;96,35%
MULTIPOLYGON (((-58.422452290889851 -34.618979934797821,-58.421531190172338 -34.618912230694178,-58.42053172133906 -34.618838788145723,-58.419628853174324 -34.618772414054284,-58.419616141531947 -34.619797727225837,-58.419591840655478 -34.620005331537207,-58.419568823247538 -34.620201809141172,-58.419425787462245 -34.621193483186723,-58.420238127861396 -34.621253700313758,-58.420497266468736 -34.621272100735744,-58.420499955245241 -34.621009205198028,-58.420513721265486 -34.620067698245812,-58.421012742094355 -34.620097659569218,-58.421510822484123 -34.620135154008395,-58.422176210657014 -34.620180096731239,-58.422328863691519 -34.620191344919988,-58.422347951993295 -34.62000296436765,-58.422452290889851 -34.618979934797821)));;2540;5_17_8;COMUNA 5;17;8;938;441;497;88,73%;427;427;100,00%;0;0,00%;385;11;2,86%;374;97,14%
MULTIPOLYGON (((-58.421510822484123 -34.620135154008395,-58.421012742094355 -34.620097659569218,-58.420513721265486 -34.620067698245812,-58.420499955245241 -34.621009205198028,-58.420497266468736 -34.621272100735744,-58.420972951061287 -34.621304800717489,-58.421448805398455 -34.621339541226206,-58.422212593236367 -34.621393742652927,-58.42222974161654 -34.621166416496038,-58.422328863691519 -34.620191344919988,-58.422176210657014 -34.620180096731239,-58.421510822484123 -34.620135154008395)));;2541;5_17_9;COMUNA 5;17;9;558;268;290;92,41%;309;309;100,00%;0;0,00%;253;18;7,11%;235;92,89%
MULTIPOLYGON (((-58.426615083368219 -34.621903733595666,-58.425163444082592 -34.621693781238434,-58.425146665007077 -34.621875261244277,-58.424857560259461 -34.623305643877799,-58.426300386273525 -34.623471088624918,-58.427491486658894 -34.623607569674647,-58.427795328290458 -34.622074505458436,-58.426615083368219 -34.621903733595666)));;2542;5_18_1;COMUNA 5;18;1;943;431;512;84,18%;527;527;100,00%;0;0,00%;423;32;7,57%;391;92,43%
MULTIPOLYGON (((-58.427176135105327 -34.625134854548271,-58.425981665793365 -34.62505527278519,-58.424522594909938 -34.624958131412967,-58.424493052858033 -34.625099957994607,-58.424334449140993 -34.625780917346923,-58.425752334843445 -34.625991573482004,-58.425779992053421 -34.625869465025936,-58.426971619178531 -34.626047572402307,-58.427040591793293 -34.625731666341153,-58.427176135105327 -34.625134854548271)));;2543;5_18_10;COMUNA 5;18;10;818;349;469;74,41%;406;406;100,00%;0;0,00%;344;15;4,36%;329;95,64%
MULTIPOLYGON (((-58.425752334843445 -34.625991573482004,-58.424334449140993 -34.625780917346923,-58.424188818185044 -34.626406315246882,-58.42413871194524 -34.626615179741066,-58.424380650380158 -34.626651454395123,-58.425344233316821 -34.626792814413207,-58.42556146790146 -34.626824924086193,-58.425776913668955 -34.626856751131044,-58.42675583645687 -34.626998456761918,-58.426819342007356 -34.626720085748154,-58.426971619178531 -34.626047572402307,-58.425779992053421 -34.625869465025936,-58.425752334843445 -34.625991573482004)));;2544;5_18_11;COMUNA 5;18;11;718;291;427;68,15%;405;404;99,75%;1;0,25%;315;6;1,90%;309;98,10%
MULTIPOLYGON (((-58.426300386273525 -34.623471088624918,-58.424857560259461 -34.623305643877799,-58.424557772271761 -34.624788700005126,-58.424522594909938 -34.624958131412967,-58.425981665793365 -34.62505527278519,-58.427176135105327 -34.625134854548271,-58.427237424469723 -34.624852538788517,-58.427462032383666 -34.623756369104647,-58.427491486658894 -34.623607569674647,-58.426300386273525 -34.623471088624918)));;2545;5_18_2;COMUNA 5;18;2;900;407;493;82,56%;382;382;100,00%;0;0,00%;375;38;10,13%;337;89,87%
MULTIPOLYGON (((-58.424040704987604 -34.621541101362709,-58.423718957103532 -34.621507335831616,-58.423585724009556 -34.622405704606166,-58.423475819298424 -34.623147173790947,-58.42323027867247 -34.624803489480229,-58.423220193706811 -34.624871305436571,-58.424522594909938 -34.624958131412967,-58.424557772271761 -34.624788700005126,-58.424857560259461 -34.623305643877799,-58.425146665007077 -34.621875261244277,-58.425163444082592 -34.621693781238434,-58.424288341110518 -34.621567166408212,-58.424040704987604 -34.621541101362709)));;2546;5_18_3;COMUNA 5;18;3;852;410;442;92,76%;412;412;100,00%;0;0,00%;343;6;1,75%;337;98,25%
MULTIPOLYGON (((-58.422707425795977 -34.62306882301084,-58.422054979429774 -34.622991069478061,-58.421299709101142 -34.622910953577431,-58.421126969402707 -34.624731802438134,-58.421860546976632 -34.624780713879979,-58.422528358654368 -34.624823965274203,-58.423080565807211 -34.624861752798552,-58.42323027867247 -34.624803489480229,-58.423475819298424 -34.623147173790947,-58.422707425795977 -34.62306882301084)));;2547;5_18_4;COMUNA 5;18;4;788;375;413;90,80%;295;293;99,32%;2;0,68%;277;31;11,19%;246;88,81%
MULTIPOLYGON (((-58.422212593236367 -34.621393742652927,-58.421448805398455 -34.621339541226206,-58.421299709101142 -34.622910953577431,-58.422054979429774 -34.622991069478061,-58.422707425795977 -34.62306882301084,-58.423475819298424 -34.623147173790947,-58.423585724009556 -34.622405704606166,-58.423718957103532 -34.621507335831616,-58.423520814395559 -34.621486496984801,-58.422212593236367 -34.621393742652927)));;2548;5_18_5;COMUNA 5;18;5;828;379;449;84,41%;417;417;100,00%;0;0,00%;336;34;10,12%;302;89,88%
MULTIPOLYGON (((-58.420972951061287 -34.621304800717489,-58.420497266468736 -34.621272100735744,-58.420494929238423 -34.621513657614663,-58.420522376821921 -34.622828430925097,-58.420561388557687 -34.624694142300498,-58.421126969402707 -34.624731802438134,-58.421299709101142 -34.622910953577431,-58.421448805398455 -34.621339541226206,-58.420972951061287 -34.621304800717489)));;2549;5_18_6;COMUNA 5;18;6;684;303;381;79,53%;273;272;99,63%;1;0,37%;242;22;9,09%;220;90,91%
MULTIPOLYGON (((-58.421126969402707 -34.624731802438134,-58.420561388557687 -34.624694142300498,-58.420247956289401 -34.626042952842838,-58.420465186768922 -34.626075423717573,-58.421312217919024 -34.626199943626879,-58.421515393223174 -34.626230013413597,-58.421572078454375 -34.625995517530427,-58.421719333159409 -34.625398293239172,-58.421835854912864 -34.624925780991603,-58.421860546976632 -34.624780713879979,-58.421126969402707 -34.624731802438134)));;2550;5_18_7;COMUNA 5;18;7;724;328;396;82,83%;370;370;100,00%;0;0,00%;309;0;0,00%;309;100,00%
MULTIPOLYGON (((-58.421719333159409 -34.625398293239172,-58.421572078454375 -34.625995517530427,-58.421515393223174 -34.626230013413597,-58.421751451589408 -34.626264953224933,-58.422636481157923 -34.626394688130638,-58.422842127304484 -34.626426376291654,-58.422887193621236 -34.626252159743736,-58.423043243104949 -34.625594582578124,-58.423220193706811 -34.624871305436571,-58.42323027867247 -34.624803489480229,-58.423080565807211 -34.624861752798552,-58.422528358654368 -34.624823965274203,-58.421860546976632 -34.624780713879979,-58.421835854912864 -34.624925780991603,-58.421719333159409 -34.625398293239172)));;2551;5_18_8;COMUNA 5;18;8;408;198;210;94,29%;181;181;100,00%;0;0,00%;149;4;2,68%;145;97,32%
MULTIPOLYGON (((-58.424522594909938 -34.624958131412967,-58.423220193706811 -34.624871305436571,-58.423043243104949 -34.625594582578124,-58.422887193621236 -34.626252159743736,-58.422842127304484 -34.626426376291654,-58.423069922741817 -34.62646152212524,-58.423893025385553 -34.626578340015229,-58.42413871194524 -34.626615179741066,-58.424188818185044 -34.626406315246882,-58.424334449140993 -34.625780917346923,-58.424493052858033 -34.625099957994607,-58.424522594909938 -34.624958131412967)));;2552;5_18_9;COMUNA 5;18;9;689;331;358;92,46%;311;311;100,00%;0;0,00%;267;16;5,99%;251;94,01%
MULTIPOLYGON (((-58.419425787462245 -34.621193483186723,-58.418065443679048 -34.621092567004681,-58.417960643531543 -34.622393559637253,-58.417943328185132 -34.622592362970785,-58.418203234156351 -34.622616402542327,-58.419275577797627 -34.622703482121871,-58.419570498270097 -34.622727390389649,-58.420522376821921 -34.622828430925097,-58.420494929238423 -34.621513657614663,-58.420497266468736 -34.621272100735744,-58.420238127861396 -34.621253700313758,-58.419425787462245 -34.621193483186723)));;2553;5_19_1;COMUNA 5;19;1;856;400;456;87,72%;405;405;100,00%;0;0,00%;344;5;1,45%;339;98,55%
MULTIPOLYGON (((-58.419107867802737 -34.62459721977666,-58.417776342860606 -34.62450842379085,-58.41754062149996 -34.624492702414173,-58.417063048758003 -34.6244546360562,-58.416211164421021 -34.62406275166304,-58.416164359613312 -34.624581343122152,-58.416099219248636 -34.625437403806458,-58.417362041293096 -34.625616829463041,-58.417681665393864 -34.625663921271823,-58.417996604535844 -34.625710306276709,-58.418643606316309 -34.62580624915411,-58.418825227301049 -34.625832794389581,-58.419107867802737 -34.62459721977666)));;2554;5_19_10;COMUNA 5;19;10;798;363;435;83,45%;473;473;100,00%;0;0,00%;364;21;5,77%;343;94,23%
MULTIPOLYGON (((-58.420522376821921 -34.622828430925097,-58.419570498270097 -34.622727390389649,-58.419275577797627 -34.622703482121871,-58.419107867802737 -34.62459721977666,-58.418825227301049 -34.625832794389581,-58.419082751068153 -34.625870423233096,-58.420058156624179 -34.626014575819312,-58.420247956289401 -34.626042952842838,-58.420561388557687 -34.624694142300498,-58.420522376821921 -34.622828430925097)));;2555;5_19_11;COMUNA 5;19;11;1046;498;548;90,88%;402;402;100,00%;0;0,00%;437;51;11,67%;386;88,33%
MULTIPOLYGON (((-58.419275577797627 -34.622703482121871,-58.418203234156351 -34.622616402542327,-58.417943328185132 -34.622592362970785,-58.417866179846527 -34.62347764683706,-58.417776342860606 -34.62450842379085,-58.419107867802737 -34.62459721977666,-58.419275577797627 -34.622703482121871)));;2556;5_19_2;COMUNA 5;19;2;692;309;383;80,68%;345;345;100,00%;0;0,00%;282;2;0,71%;280;99,29%
MULTIPOLYGON (((-58.416367539712283 -34.622446487927597,-58.416278599013246 -34.623366344978834,-58.416220269627914 -34.623928666027489,-58.416211164421021 -34.62406275166304,-58.417063048758003 -34.6244546360562,-58.41754062149996 -34.624492702414173,-58.417776342860606 -34.62450842379085,-58.417866179846527 -34.62347764683706,-58.417943328185132 -34.622592362970785,-58.417960643531543 -34.622393559637253,-58.418065443679048 -34.621092567004681,-58.416509686008766 -34.620977195119544,-58.416367539712283 -34.622446487927597)));;2557;5_19_3;COMUNA 5;19;3;929;415;514;80,74%;502;502;100,00%;0;0,00%;407;41;10,07%;366;89,93%
MULTIPOLYGON (((-58.41509321836137 -34.620860519756491,-58.413823531433202 -34.620751844867151,-58.413682780788868 -34.622085848771455,-58.414723462106089 -34.622250986510338,-58.414946050561248 -34.622278257888361,-58.416367539712283 -34.622446487927597,-58.416509686008766 -34.620977195119544,-58.416104711005005 -34.620947110486817,-58.41509321836137 -34.620860519756491)));;2558;5_19_4;COMUNA 5;19;4;994;435;559;77,82%;477;476;99,79%;1;0,21%;397;17;4,28%;380;95,72%
MULTIPOLYGON (((-58.414946050561248 -34.622278257888361,-58.414723462106089 -34.622250986510338,-58.413682780788868 -34.622085848771455,-58.413729924659528 -34.62333429104627,-58.414809756926786 -34.623591982123514,-58.416220269627914 -34.623928666027489,-58.416278599013246 -34.623366344978834,-58.416367539712283 -34.622446487927597,-58.414946050561248 -34.622278257888361)));;2559;5_19_5;COMUNA 5;19;5;768;346;422;81,99%;415;415;100,00%;0;0,00%;334;6;1,80%;328;98,20%
MULTIPOLYGON (((-58.41233346742591 -34.623032867031498,-58.412219751556101 -34.623992571304122,-58.4136541009306 -34.624207741262239,-58.413729924659528 -34.62333429104627,-58.413682780788868 -34.622085848771455,-58.413823531433202 -34.620751844867151,-58.412543881188107 -34.620642307566243,-58.412436816629587 -34.621883362929516,-58.412356405634505 -34.6218685405263,-58.412041891204559 -34.62297478655168,-58.41233346742591 -34.623032867031498)));;2560;5_19_6;COMUNA 5;19;6;808;371;437;84,90%;382;381;99,74%;1;0,26%;330;12;3,64%;318;96,36%
MULTIPOLYGON (((-58.4136541009306 -34.624207741262239,-58.412219751556101 -34.623992571304122,-58.412126670410778 -34.62477812300186,-58.412094095626728 -34.624969242775443,-58.413270454616473 -34.625107265033932,-58.413572191680089 -34.625140838775522,-58.4136541009306 -34.624207741262239)));;2561;5_19_7;COMUNA 5;19;7;446;212;234;90,60%;280;280;100,00%;0;0,00%;199;17;8,54%;182;91,46%
MULTIPOLYGON (((-58.414751207106221 -34.624371915443099,-58.414508512557653 -34.624335973506604,-58.4136541009306 -34.624207741262239,-58.413572191680089 -34.625140838775522,-58.413855357941323 -34.625172291587766,-58.414690715230094 -34.625267626464193,-58.41577746626762 -34.625391715530014,-58.416099219248636 -34.625437403806458,-58.416164359613312 -34.624581343122152,-58.414751207106221 -34.624371915443099)));;2562;5_19_8;COMUNA 5;19;8;922;417;505;82,57%;485;484;99,79%;1;0,21%;429;4;0,93%;425;99,07%
MULTIPOLYGON (((-58.416220269627914 -34.623928666027489,-58.414809756926786 -34.623591982123514,-58.413729924659528 -34.62333429104627,-58.4136541009306 -34.624207741262239,-58.414508512557653 -34.624335973506604,-58.414751207106221 -34.624371915443099,-58.416164359613312 -34.624581343122152,-58.416211164421021 -34.62406275166304,-58.416220269627914 -34.623928666027489)));;2563;5_19_9;COMUNA 5;19;9;605;271;334;81,14%;372;372;100,00%;0;0,00%;294;7;2,38%;287;97,62%
MULTIPOLYGON (((-58.41750773316501 -34.598877675423857,-58.417543603287875 -34.599007764121922,-58.417913345535737 -34.599901667039454,-58.418862018743809 -34.599606155153197,-58.419003431943224 -34.599540217431802,-58.418970024713978 -34.59860615551684,-58.418967708625161 -34.598475304580987,-58.418940815057759 -34.597789282579058,-58.417465637445098 -34.597820717718825,-58.417262939568552 -34.597825642604192,-58.416159087386397 -34.597852481157041,-58.416000506878511 -34.597854744604206,-58.416072869712572 -34.599277080504628,-58.41750773316501 -34.598877675423857)));;2564;5_2_1;COMUNA 5;2;1;875;371;504;73,61%;438;432;98,63%;6;1,39%;336;10;2,98%;326;97,02%
MULTIPOLYGON (((-58.416143328476309 -34.600452927031938,-58.415136455234979 -34.600766564766275,-58.415312531361067 -34.601760403448324,-58.416332284006948 -34.601433388421846,-58.417794052058262 -34.600958917070372,-58.417706522465693 -34.599966100462034,-58.416143328476309 -34.600452927031938)));;2565;5_2_10;COMUNA 5;2;10;675;326;349;93,41%;359;359;100,00%;0;0,00%;301;48;15,95%;253;84,05%
MULTIPOLYGON (((-58.419003431943224 -34.599540217431802,-58.418862018743809 -34.599606155153197,-58.417913345535737 -34.599901667039454,-58.417706522465693 -34.599966100462034,-58.417794052058262 -34.600958917070372,-58.419175731955058 -34.60083568062484,-58.419084533677584 -34.600149847240957,-58.419003431943224 -34.599540217431802)));;2566;5_2_11;COMUNA 5;2;11;841;375;466;80,47%;486;486;100,00%;0;0,00%;394;57;14,47%;337;85,53%
MULTIPOLYGON (((-58.416072869712572 -34.599277080504628,-58.415910515032969 -34.599322301784582,-58.414930162181847 -34.599600312879545,-58.414966495362627 -34.599807729401725,-58.415136455234979 -34.600766564766275,-58.416143328476309 -34.600452927031938,-58.417706522465693 -34.599966100462034,-58.417913345535737 -34.599901667039454,-58.417543603287875 -34.599007764121922,-58.41750773316501 -34.598877675423857,-58.416072869712572 -34.599277080504628)));;2567;5_2_2;COMUNA 5;2;2;616;288;328;87,80%;334;333;99,70%;1;0,30%;270;24;8,89%;246;91,11%
MULTIPOLYGON (((-58.416000506878511 -34.597854744604206,-58.415662565039092 -34.597859755848383,-58.414627860244863 -34.597897945649336,-58.414903761236964 -34.599449733394003,-58.414930162181847 -34.599600312879545,-58.415910515032969 -34.599322301784582,-58.416072869712572 -34.599277080504628,-58.416000506878511 -34.597854744604206)));;2568;5_2_3;COMUNA 5;2;3;723;334;389;85,86%;412;409;99,27%;3;0,73%;325;1;0,31%;324;99,69%
MULTIPOLYGON (((-58.414627860244863 -34.597897945649336,-58.413252567550835 -34.597948736107611,-58.413541661174989 -34.599182491895867,-58.414903761236964 -34.599449733394003,-58.414627860244863 -34.597897945649336)));;2569;5_2_4;COMUNA 5;2;4;941;422;519;81,31%;565;565;100,00%;0;0,00%;461;17;3,69%;444;96,31%
MULTIPOLYGON (((-58.413252567550835 -34.597948736107611,-58.412983862368925 -34.597958627311812,-58.412090958845837 -34.597993613729123,-58.411918832167956 -34.598003049628126,-58.4121240654761 -34.599296142299536,-58.413541661174989 -34.599182491895867,-58.413252567550835 -34.597948736107611)));;2570;5_2_5;COMUNA 5;2;5;568;215;353;60,91%;287;286;99,65%;1;0,35%;222;1;0,45%;221;99,55%
MULTIPOLYGON (((-58.4121240654761 -34.599296142299536,-58.412309363423269 -34.600238207136627,-58.413435394686012 -34.600009875079913,-58.413718961295224 -34.599939352733706,-58.413842899114748 -34.599908485745907,-58.414930162181847 -34.599600312879545,-58.414903761236964 -34.599449733394003,-58.413541661174989 -34.599182491895867,-58.4121240654761 -34.599296142299536)));;2571;5_2_6;COMUNA 5;2;6;610;287;323;88,85%;300;300;100,00%;0;0,00%;258;65;25,19%;193;74,81%
MULTIPOLYGON (((-58.412309363423269 -34.600238207136627,-58.412591613252594 -34.601601845651352,-58.413988760994762 -34.60112894271073,-58.413930502417642 -34.600842147962965,-58.413718961295224 -34.599939352733706,-58.413435394686012 -34.600009875079913,-58.412309363423269 -34.600238207136627)));;2572;5_2_7;COMUNA 5;2;7;572;250;322;77,64%;299;298;99,67%;1;0,34%;246;110;44,72%;136;55,28%
MULTIPOLYGON (((-58.413988760994762 -34.60112894271073,-58.412591613252594 -34.601601845651352,-58.412803993862205 -34.60251168544827,-58.414029374522116 -34.602171956242394,-58.414172402448344 -34.602126095977731,-58.414010926504517 -34.601238110637539,-58.413988760994762 -34.60112894271073)));;2573;5_2_8;COMUNA 5;2;8;1067;523;544;96,14%;613;613;100,00%;0;0,00%;433;2;0,46%;431;99,54%
MULTIPOLYGON (((-58.413988760994762 -34.60112894271073,-58.414010926504517 -34.601238110637539,-58.414172402448344 -34.602126095977731,-58.415312531361067 -34.601760403448324,-58.415136455234979 -34.600766564766275,-58.414966495362627 -34.599807729401725,-58.414930162181847 -34.599600312879545,-58.413842899114748 -34.599908485745907,-58.413718961295224 -34.599939352733706,-58.413930502417642 -34.600842147962965,-58.413988760994762 -34.60112894271073)));;2574;5_2_9;COMUNA 5;2;9;837;399;438;91,10%;401;401;100,00%;0;0,00%;339;67;19,76%;272;80,24%
MULTIPOLYGON (((-58.41457340013357 -34.627780904795607,-58.414550635071954 -34.628843607548887,-58.415906155854394 -34.628951180940199,-58.415924262114785 -34.628113202027031,-58.415935812423513 -34.627874536456318,-58.415975118922077 -34.627059735310219,-58.415983529697122 -34.626949875663726,-58.416099219248636 -34.625437403806458,-58.41577746626762 -34.625391715530014,-58.414690715230094 -34.625267626464193,-58.414676537541546 -34.625477064636428,-58.41459458673382 -34.626795034815288,-58.41457340013357 -34.627780904795607)));;2575;5_20_1;COMUNA 5;20;1;764;351;413;84,99%;419;418;99,76%;1;0,24%;316;29;9,18%;287;90,82%
MULTIPOLYGON (((-58.416163533189533 -34.637504447079245,-58.416150496643318 -34.63765684135678,-58.41584382211483 -34.638896340988609,-58.416135801345092 -34.638947581204306,-58.417086805809603 -34.6391082978067,-58.417149902977343 -34.638873666031039,-58.417302210108303 -34.638330325203761,-58.417615611340246 -34.637212800017814,-58.417916580740417 -34.636223019859813,-58.417909027511463 -34.635533135612967,-58.416774679455351 -34.635413977512563,-58.416175829338357 -34.635320860212921,-58.41618894573709 -34.636093143735621,-58.41620469978767 -34.637025222037195,-58.416192692786346 -34.637165221959343,-58.416163533189533 -34.637504447079245)));;2576;5_20_10;COMUNA 5;20;10;962;446;516;86,43%;457;457;100,00%;0;0,00%;380;35;9,21%;345;90,79%
MULTIPOLYGON (((-58.414553307202681 -34.638669845238141,-58.41584382211483 -34.638896340988609,-58.416150496643318 -34.63765684135678,-58.416163533189533 -34.637504447079245,-58.415861333022143 -34.63730376157914,-58.415608104130769 -34.637145067422523,-58.414638892821173 -34.636537768405006,-58.414558486176304 -34.636490270374793,-58.413814388465632 -34.636050523595593,-58.413540005201028 -34.637100095010865,-58.413191999231117 -34.638430912348298,-58.414553307202681 -34.638669845238141)));;2577;5_20_11;COMUNA 5;20;11;830;398;432;92,13%;320;320;100,00%;0;0,00%;302;20;6,62%;282;93,38%
MULTIPOLYGON (((-58.411625795716901 -34.638159060675108,-58.411879773276596 -34.638200506118757,-58.413191999231117 -34.638430912348298,-58.413540005201028 -34.637100095010865,-58.413814388465632 -34.636050523595593,-58.413580496761462 -34.635912256144394,-58.412677893243128 -34.635390111844934,-58.412408921780596 -34.635217601279273,-58.412242412119781 -34.63511083890549,-58.411296964221513 -34.634457113017,-58.410986962470908 -34.634233312716674,-58.410880287286453 -34.634508487669819,-58.41056534916968 -34.635094569684846,-58.410488575895926 -34.635237499226271,-58.410511967098692 -34.635709425925711,-58.410706014490337 -34.636334176860508,-58.410927363577052 -34.637043167074765,-58.411002197110626 -34.637281445903582,-58.411260463868643 -34.638099327767911,-58.411625795716901 -34.638159060675108)));;2578;5_20_12;COMUNA 5;20;12;905;455;450;101,11%;324;322;99,38%;2;0,62%;297;54;18,18%;243;81,82%
MULTIPOLYGON (((-58.413572191680089 -34.625140838775522,-58.413270454616473 -34.625107265033932,-58.412094095626728 -34.624969242775443,-58.412065197551165 -34.625138109780949,-58.411990332719654 -34.626504533551334,-58.413438302524746 -34.62666604785155,-58.41459458673382 -34.626795034815288,-58.414676537541546 -34.625477064636428,-58.414690715230094 -34.625267626464193,-58.413855357941323 -34.625172291587766,-58.413572191680089 -34.625140838775522)));;2579;5_20_2;COMUNA 5;20;2;930;439;491;89,41%;498;497;99,80%;1;0,20%;410;14;3,41%;396;96,59%
MULTIPOLYGON (((-58.411874196991747 -34.628623922803776,-58.411842318993592 -34.629205548697641,-58.412417492834308 -34.629344383339976,-58.412636080134007 -34.629396658094791,-58.413178460625993 -34.629526390871156,-58.413250919605893 -34.628740478497839,-58.414550635071954 -34.628843607548887,-58.41457340013357 -34.627780904795607,-58.41459458673382 -34.626795034815288,-58.413438302524746 -34.62666604785155,-58.411990332719654 -34.626504533551334,-58.41193105944744 -34.627586235565673,-58.411874196991747 -34.628623922803776)));;2580;5_20_3;COMUNA 5;20;3;1065;487;578;84,26%;399;399;100,00%;0;0,00%;385;75;19,48%;310;80,52%
MULTIPOLYGON (((-58.415906155854394 -34.628951180940199,-58.414550635071954 -34.628843607548887,-58.413250919605893 -34.628740478497839,-58.413178460625993 -34.629526390871156,-58.414529095046205 -34.62984947771664,-58.41451727322751 -34.630402942169688,-58.415922691137354 -34.63076040251201,-58.415905575804267 -34.630439469796983,-58.415894136660881 -34.630176005942317,-58.415884379767114 -34.629951346830602,-58.415906155854394 -34.628951180940199)));;2581;5_20_4;COMUNA 5;20;4;804;375;429;87,41%;373;373;100,00%;0;0,00%;314;14;4,46%;300;95,54%
MULTIPOLYGON (((-58.414478554836876 -34.63238256979956,-58.416029433152353 -34.632761706660666,-58.415989973749355 -34.632021315074411,-58.415955826559575 -34.631380928730557,-58.415922691137354 -34.63076040251201,-58.41451727322751 -34.630402942169688,-58.414503878223982 -34.631024577222639,-58.413071535376609 -34.630673005285388,-58.413051986773958 -34.630879623900569,-58.413008614231508 -34.631318071460207,-58.412960012965868 -34.631808490386504,-58.412962870155269 -34.632017653378561,-58.414478554836876 -34.63238256979956)));;2582;5_20_5;COMUNA 5;20;5;901;441;460;95,87%;392;392;100,00%;0;0,00%;332;27;8,13%;305;91,87%
MULTIPOLYGON (((-58.412086365427285 -34.631806652060895,-58.412962870155269 -34.632017653378561,-58.412960012965868 -34.631808490386504,-58.413008614231508 -34.631318071460207,-58.413051986773958 -34.630879623900569,-58.413071535376609 -34.630673005285388,-58.414503878223982 -34.631024577222639,-58.41451727322751 -34.630402942169688,-58.414529095046205 -34.62984947771664,-58.413178460625993 -34.629526390871156,-58.412636080134007 -34.629396658094791,-58.412417492834308 -34.629344383339976,-58.411842318993592 -34.629205548697641,-58.411779336357831 -34.63035584243908,-58.411766411979187 -34.63059225334387,-58.41165090280051 -34.631530968530384,-58.411634527236089 -34.631697868594934,-58.412086365427285 -34.631806652060895)));;2583;5_20_6;COMUNA 5;20;6;846;406;440;92,27%;321;321;100,00%;0;0,00%;288;19;6,60%;269;93,40%
MULTIPOLYGON (((-58.414478554836876 -34.63238256979956,-58.412962870155269 -34.632017653378561,-58.412086365427285 -34.631806652060895,-58.411634527236089 -34.631697868594934,-58.411520583847057 -34.632856732214677,-58.411477659196528 -34.63296756290228,-58.413031012866419 -34.633334484968785,-58.414460256930596 -34.633671971055463,-58.416106581205263 -34.634060722355841,-58.416042671695365 -34.633008409966195,-58.416029433152353 -34.632761706660666,-58.414478554836876 -34.63238256979956)));;2584;5_20_7;COMUNA 5;20;7;912;443;469;94,46%;341;341;100,00%;0;0,00%;315;21;6,67%;294;93,33%
MULTIPOLYGON (((-58.416106581205263 -34.634060722355841,-58.414460256930596 -34.633671971055463,-58.413031012866419 -34.633334484968785,-58.411477659196528 -34.63296756290228,-58.410986962470908 -34.634233312716674,-58.411296964221513 -34.634457113017,-58.412242412119781 -34.63511083890549,-58.412408921780596 -34.635217601279273,-58.412734621140231 -34.634283831542724,-58.414166551992224 -34.634715409693626,-58.415205688742375 -34.63502850498439,-58.416175829338357 -34.635320860212921,-58.416173025314876 -34.635154445292898,-58.416106581205263 -34.634060722355841)));;2585;5_20_8;COMUNA 5;20;8;907;439;468;93,80%;333;333;100,00%;0;0,00%;317;26;8,20%;291;91,80%
MULTIPOLYGON (((-58.414166551992224 -34.634715409693626,-58.412734621140231 -34.634283831542724,-58.412408921780596 -34.635217601279273,-58.412677893243128 -34.635390111844934,-58.413580496761462 -34.635912256144394,-58.413814388465632 -34.636050523595593,-58.414558486176304 -34.636490270374793,-58.414638892821173 -34.636537768405006,-58.415608104130769 -34.637145067422523,-58.415861333022143 -34.63730376157914,-58.416163533189533 -34.637504447079245,-58.416192692786346 -34.637165221959343,-58.41620469978767 -34.637025222037195,-58.41618894573709 -34.636093143735621,-58.416175829338357 -34.635320860212921,-58.415205688742375 -34.63502850498439,-58.414166551992224 -34.634715409693626)));;2586;5_20_9;COMUNA 5;20;9;861;408;453;90,07%;356;355;99,72%;1;0,28%;326;17;5,21%;309;94,79%
MULTIPOLYGON (((-58.423980359859016 -34.627292194745962,-58.423833184207147 -34.627930127207534,-58.425261584583943 -34.62814044021038,-58.42645579995628 -34.62831629976737,-58.426502066023836 -34.628110954483816,-58.42675583645687 -34.626998456761918,-58.425776913668955 -34.626856751131044,-58.42556146790146 -34.626824924086193,-58.425344233316821 -34.626792814413207,-58.424380650380158 -34.626651454395123,-58.42413871194524 -34.626615179741066,-58.424082459554313 -34.626849536082773,-58.423980359859016 -34.627292194745962)));;2587;5_21_1;COMUNA 5;21;1;860;390;470;82,98%;512;512;100,00%;0;0,00%;378;12;3,17%;366;96,83%
MULTIPOLYGON (((-58.425014958251964 -34.629228851501402,-58.424972017933385 -34.629418069910635,-58.424790013899852 -34.630212124491258,-58.425979714215593 -34.630451933046132,-58.426015407906171 -34.63026940249808,-58.426212771371375 -34.629394784613289,-58.426250758254767 -34.629226410053839,-58.42645579995628 -34.62831629976737,-58.425261584583943 -34.62814044021038,-58.423833184207147 -34.627930127207534,-58.423783328327602 -34.628146315772746,-58.423584063457703 -34.629030577498831,-58.425014958251964 -34.629228851501402)));;2588;5_21_10;COMUNA 5;21;10;599;262;337;77,74%;287;286;99,65%;1;0,35%;253;6;2,37%;247;97,63%
MULTIPOLYGON (((-58.425979714215593 -34.630451933046132,-58.424790013899852 -34.630212124491258,-58.424972017933385 -34.629418069910635,-58.425014958251964 -34.629228851501402,-58.423584063457703 -34.629030577498831,-58.423381720880052 -34.629928218505484,-58.423177324764936 -34.630835084035738,-58.423116282698807 -34.631096622215587,-58.424432019575434 -34.631298245968523,-58.4245372345151 -34.631314335803715,-58.425752882102223 -34.63148351850753,-58.425802727456983 -34.631284090370308,-58.425932577745535 -34.630693124051405,-58.425979714215593 -34.630451933046132)));;2589;5_21_11;COMUNA 5;21;11;694;326;368;88,59%;299;299;100,00%;0;0,00%;245;9;3,67%;236;96,33%
MULTIPOLYGON (((-58.422526951541016 -34.627743500539175,-58.42361236931238 -34.627897661189863,-58.423833184207147 -34.627930127207534,-58.423980359859016 -34.627292194745962,-58.424082459554313 -34.626849536082773,-58.42413871194524 -34.626615179741066,-58.423893025385553 -34.626578340015229,-58.423069922741817 -34.62646152212524,-58.422842127304484 -34.626426376291654,-58.422636481157923 -34.626394688130638,-58.421751451589408 -34.626264953224933,-58.421515393223174 -34.626230013413597,-58.421462122313294 -34.626450707130587,-58.42135481770476 -34.626882375573189,-58.421221987302182 -34.627416573886478,-58.421189286842825 -34.627557694285294,-58.421356091806494 -34.627577117787624,-58.422526951541016 -34.627743500539175)));;2590;5_21_2;COMUNA 5;21;2;857;396;461;85,90%;407;407;100,00%;0;0,00%;350;48;13,71%;302;86,29%
MULTIPOLYGON (((-58.419953842131633 -34.627413741621332,-58.419772792028795 -34.628256382477915,-58.419721649859426 -34.628467920871351,-58.42093630283037 -34.628649334796727,-58.421189286842825 -34.627557694285294,-58.421221987302182 -34.627416573886478,-58.42135481770476 -34.626882375573189,-58.421462122313294 -34.626450707130587,-58.421515393223174 -34.626230013413597,-58.421312217919024 -34.626199943626879,-58.420465186768922 -34.626075423717573,-58.420247956289401 -34.626042952842838,-58.420188774876756 -34.626320124742044,-58.419953842131633 -34.627413741621332)));;2591;5_21_3;COMUNA 5;21;3;531;228;303;75,25%;272;271;99,63%;1;0,37%;209;14;6,70%;195;93,30%
MULTIPOLYGON (((-58.418825227301049 -34.625832794389581,-58.418643606316309 -34.62580624915411,-58.417996604535844 -34.625710306276709,-58.417681665393864 -34.625663921271823,-58.417671187551363 -34.625819626925932,-58.417458598218168 -34.626971207029079,-58.417424951271208 -34.627118100918551,-58.418235540080268 -34.627213472727455,-58.418496053555245 -34.627243850126398,-58.419953842131633 -34.627413741621332,-58.420188774876756 -34.626320124742044,-58.420247956289401 -34.626042952842838,-58.420058156624179 -34.626014575819312,-58.419082751068153 -34.625870423233096,-58.418825227301049 -34.625832794389581)));;2592;5_21_4;COMUNA 5;21;4;914;429;485;88,45%;453;453;100,00%;0;0,00%;370;37;10,00%;333;90,00%
MULTIPOLYGON (((-58.417681665393864 -34.625663921271823,-58.417362041293096 -34.625616829463041,-58.416099219248636 -34.625437403806458,-58.415983529697122 -34.626949875663726,-58.416179553086387 -34.626971641455,-58.417424951271208 -34.627118100918551,-58.417458598218168 -34.626971207029079,-58.417671187551363 -34.625819626925932,-58.417681665393864 -34.625663921271823)));;2593;5_21_5;COMUNA 5;21;5;640;285;355;80,28%;337;337;100,00%;0;0,00%;266;1;0,38%;265;99,62%
MULTIPOLYGON (((-58.41644150588553 -34.630239033751778,-58.417468179753605 -34.630351887326981,-58.417763292226034 -34.63038495525003,-58.41805713782432 -34.629125302821997,-58.417880787301165 -34.629107843202164,-58.416861948774461 -34.629027039353822,-58.417130148595867 -34.628253874479739,-58.417194145407493 -34.628072624672946,-58.417228362246185 -34.627975732765407,-58.417257825305228 -34.627847077443221,-58.417424951271208 -34.627118100918551,-58.416179553086387 -34.626971641455,-58.415983529697122 -34.626949875663726,-58.415975118922077 -34.627059735310219,-58.415935812423513 -34.627874536456318,-58.415924262114785 -34.628113202027031,-58.415906155854394 -34.628951180940199,-58.415884379767114 -34.629951346830602,-58.415894136660881 -34.630176005942317,-58.41644150588553 -34.630239033751778)));;2594;5_21_6;COMUNA 5;21;6;717;319;398;80,15%;467;467;100,00%;0;0,00%;337;13;3,86%;324;96,14%
MULTIPOLYGON (((-58.419953842131633 -34.627413741621332,-58.418496053555245 -34.627243850126398,-58.418235540080268 -34.627213472727455,-58.417424951271208 -34.627118100918551,-58.417257825305228 -34.627847077443221,-58.417228362246185 -34.627975732765407,-58.417194145407493 -34.628072624672946,-58.417130148595867 -34.628253874479739,-58.416861948774461 -34.629027039353822,-58.417880787301165 -34.629107843202164,-58.41805713782432 -34.629125302821997,-58.417763292226034 -34.63038495525003,-58.418349087771226 -34.630450594369194,-58.419008832992233 -34.630524567321409,-58.419138242806653 -34.630540177505274,-58.419496732163275 -34.629283291273339,-58.419678959982278 -34.62864460189305,-58.419721649859426 -34.628467920871351,-58.419772792028795 -34.628256382477915,-58.419953842131633 -34.627413741621332)));;2595;5_21_7;COMUNA 5;21;7;719;366;353;103,68%;308;308;100,00%;0;0,00%;257;25;9,73%;232;90,27%
MULTIPOLYGON (((-58.423381720880052 -34.629928218505484,-58.422312920529414 -34.629712791696967,-58.42208886934899 -34.629669265150504,-58.421802288595714 -34.629613674586601,-58.420756656983762 -34.629424721657735,-58.419496732163275 -34.629283291273339,-58.419138242806653 -34.630540177505274,-58.420461224510859 -34.630699803040869,-58.420769628466239 -34.630737023358819,-58.421819379946946 -34.630897877998876,-58.423116282698807 -34.631096622215587,-58.423177324764936 -34.630835084035738,-58.423381720880052 -34.629928218505484)));;2596;5_21_8;COMUNA 5;21;8;728;360;368;97,83%;289;286;98,96%;3;1,05%;248;36;14,52%;212;85,48%
MULTIPOLYGON (((-58.42093630283037 -34.628649334796727,-58.419721649859426 -34.628467920871351,-58.419678959982278 -34.62864460189305,-58.419496732163275 -34.629283291273339,-58.420756656983762 -34.629424721657735,-58.421802288595714 -34.629613674586601,-58.42208886934899 -34.629669265150504,-58.422312920529414 -34.629712791696967,-58.423381720880052 -34.629928218505484,-58.423584063457703 -34.629030577498831,-58.423783328327602 -34.628146315772746,-58.423833184207147 -34.627930127207534,-58.42361236931238 -34.627897661189863,-58.422526951541016 -34.627743500539175,-58.421356091806494 -34.627577117787624,-58.421189286842825 -34.627557694285294,-58.42093630283037 -34.628649334796727)));;2597;5_21_9;COMUNA 5;21;9;726;355;371;95,69%;279;277;99,28%;2;0,72%;236;17;7,20%;219;92,80%
MULTIPOLYGON (((-58.424432019575434 -34.631298245968523,-58.423116282698807 -34.631096622215587,-58.423063265623725 -34.631323373077009,-58.422863946977536 -34.632109953864493,-58.422526675893678 -34.633440872925846,-58.422798799526433 -34.633467934967811,-58.423816240966346 -34.633567421752105,-58.423906892388246 -34.633576253723547,-58.424466392596202 -34.633631009646798,-58.425183085603692 -34.633701093646913,-58.425222773398907 -34.633548706490487,-58.425456460841801 -34.632647340017151,-58.425528752456152 -34.632365240101379,-58.425686307312439 -34.631750197287339,-58.425752882102223 -34.63148351850753,-58.4245372345151 -34.631314335803715,-58.424432019575434 -34.631298245968523)));;2598;5_22_1;COMUNA 5;22;1;738;347;391;88,75%;310;309;99,68%;1;0,32%;260;0;0,00%;260;100,00%
MULTIPOLYGON (((-58.418498425567279 -34.63433718499568,-58.417872727492686 -34.634271461540635,-58.41761559854244 -34.634244534904511,-58.416704834708526 -34.634137642074286,-58.416106581205263 -34.634060722355841,-58.416173025314876 -34.635154445292898,-58.416175829338357 -34.635320860212921,-58.416774679455351 -34.635413977512563,-58.417909027511463 -34.635533135612967,-58.417916580740417 -34.636223019859813,-58.41879834354593 -34.636273623756836,-58.419098427685512 -34.636290915058183,-58.419317394399762 -34.636312120583987,-58.419336353459023 -34.636228603502239,-58.419349337718231 -34.635837539135835,-58.419344135012402 -34.635683799914581,-58.419337421403334 -34.635486326339894,-58.41929443886697 -34.634417121362183,-58.418701709501427 -34.634358526796653,-58.418498425567279 -34.63433718499568)));;2599;5_22_10;COMUNA 5;22;10;858;393;465;84,52%;305;305;100,00%;0;0,00%;296;33;11,15%;263;88,85%
MULTIPOLYGON (((-58.420322922520505 -34.637446454279512,-58.420668302823579 -34.636526192064267,-58.419549993357279 -34.636334739036592,-58.419317394399762 -34.636312120583987,-58.419098427685512 -34.636290915058183,-58.41879834354593 -34.636273623756836,-58.417916580740417 -34.636223019859813,-58.417615611340246 -34.637212800017814,-58.418146777898833 -34.637230530985775,-58.418347439626316 -34.637228913927856,-58.419111061944875 -34.637222498878451,-58.418866292684676 -34.638302093640284,-58.41992404936871 -34.638483813041645,-58.420191662949811 -34.638529823568952,-58.420905385315507 -34.638653524887786,-58.421184841659489 -34.638703974054003,-58.421412529262163 -34.637819445595227,-58.421457350492865 -34.637642483254787,-58.420322922520505 -34.637446454279512)));;2600;5_22_11;COMUNA 5;22;11;894;424;470;90,21%;341;341;100,00%;0;0,00%;320;36;11,25%;284;88,75%
MULTIPOLYGON (((-58.419111061944875 -34.637222498878451,-58.418347439626316 -34.637228913927856,-58.418146777898833 -34.637230530985775,-58.417615611340246 -34.637212800017814,-58.417302210108303 -34.638330325203761,-58.417149902977343 -34.638873666031039,-58.417086805809603 -34.6391082978067,-58.417257973365061 -34.639137235861831,-58.418479924580232 -34.639336353328801,-58.418622637742814 -34.63935718029866,-58.419295307556297 -34.639455452838291,-58.419534125913344 -34.639496595241326,-58.41975650068791 -34.639534914396755,-58.420917791105055 -34.639741803204231,-58.421184841659489 -34.638703974054003,-58.420905385315507 -34.638653524887786,-58.420191662949811 -34.638529823568952,-58.41992404936871 -34.638483813041645,-58.418866292684676 -34.638302093640284,-58.419111061944875 -34.637222498878451)));;2601;5_22_12;COMUNA 5;22;12;909;424;485;87,42%;323;323;100,00%;0;0,00%;326;20;6,13%;306;93,87%
MULTIPOLYGON (((-58.423759604867044 -34.639168570500161,-58.424043430146128 -34.638074400502326,-58.42427748501413 -34.637170642639433,-58.42308529491023 -34.636958212153289,-58.422845845760591 -34.637891051431879,-58.422792747913412 -34.638097942104068,-58.422574630868013 -34.638954728890347,-58.421818476136075 -34.638818276242873,-58.421184841659489 -34.638703974054003,-58.420917791105055 -34.639741803204231,-58.422306064725625 -34.639989109731602,-58.423491906062658 -34.640200348482139,-58.423759604867044 -34.639168570500161)));;2602;5_22_13;COMUNA 5;22;13;678;295;383;77,02%;264;263;99,62%;1;0,38%;218;20;9,17%;198;90,83%
MULTIPOLYGON (((-58.419187029996671 -34.631743896775085,-58.419241784871595 -34.633106848493462,-58.42053908923215 -34.633241181462196,-58.420488572772776 -34.631878865638619,-58.421615044120543 -34.631988760941084,-58.422512338382276 -34.632076245863423,-58.422863946977536 -34.632109953864493,-58.423063265623725 -34.631323373077009,-58.423116282698807 -34.631096622215587,-58.421819379946946 -34.630897877998876,-58.420769628466239 -34.630737023358819,-58.420461224510859 -34.630699803040869,-58.419138242806653 -34.630540177505274,-58.419187029996671 -34.631743896775085)));;2603;5_22_2;COMUNA 5;22;2;827;390;437;89,24%;358;358;100,00%;0;0,00%;292;26;8,90%;266;91,10%
MULTIPOLYGON (((-58.418349087771226 -34.630450594369194,-58.417763292226034 -34.63038495525003,-58.417783087719769 -34.631595284356607,-58.417828703006144 -34.632958092517541,-58.418263633608113 -34.633005577246053,-58.418447659816152 -34.633024588436257,-58.419241784871595 -34.633106848493462,-58.419187029996671 -34.631743896775085,-58.419138242806653 -34.630540177505274,-58.419008832992233 -34.630524567321409,-58.418349087771226 -34.630450594369194)));;2604;5_22_3;COMUNA 5;22;3;629;276;353;78,19%;311;311;100,00%;0;0,00%;260;15;5,77%;245;94,23%
MULTIPOLYGON (((-58.416633136287018 -34.632827572127212,-58.417828703006144 -34.632958092517541,-58.417783087719769 -34.631595284356607,-58.417763292226034 -34.63038495525003,-58.417468179753605 -34.630351887326981,-58.41644150588553 -34.630239033751778,-58.415894136660881 -34.630176005942317,-58.415905575804267 -34.630439469796983,-58.415922691137354 -34.63076040251201,-58.415955826559575 -34.631380928730557,-58.415989973749355 -34.632021315074411,-58.416029433152353 -34.632761706660666,-58.416042671695365 -34.633008409966195,-58.416106581205263 -34.634060722355841,-58.416704834708526 -34.634137642074286,-58.416633136287018 -34.632827572127212)));;2605;5_22_4;COMUNA 5;22;4;936;437;499;87,58%;435;435;100,00%;0;0,00%;362;7;1,93%;355;98,07%
MULTIPOLYGON (((-58.417828703006144 -34.632958092517541,-58.416633136287018 -34.632827572127212,-58.416704834708526 -34.634137642074286,-58.41761559854244 -34.634244534904511,-58.417872727492686 -34.634271461540635,-58.418498425567279 -34.63433718499568,-58.418701709501427 -34.634358526796653,-58.41929443886697 -34.634417121362183,-58.42058750680674 -34.634544973202914,-58.42053908923215 -34.633241181462196,-58.419241784871595 -34.633106848493462,-58.418447659816152 -34.633024588436257,-58.418263633608113 -34.633005577246053,-58.417828703006144 -34.632958092517541)));;2606;5_22_5;COMUNA 5;22;5;801;378;423;89,36%;322;322;100,00%;0;0,00%;277;31;11,19%;246;88,81%
MULTIPOLYGON (((-58.422863946977536 -34.632109953864493,-58.422512338382276 -34.632076245863423,-58.421615044120543 -34.631988760941084,-58.420488572772776 -34.631878865638619,-58.42053908923215 -34.633241181462196,-58.42058750680674 -34.634544973202914,-58.421140109934647 -34.634599530721566,-58.422211834846301 -34.634705458019837,-58.422241797088589 -34.634590675490955,-58.422526675893678 -34.633440872925846,-58.422863946977536 -34.632109953864493)));;2607;5_22_6;COMUNA 5;22;6;938;457;481;95,01%;306;306;100,00%;0;0,00%;332;44;13,25%;288;86,75%
MULTIPOLYGON (((-58.425183085603692 -34.633701093646913,-58.424466392596202 -34.633631009646798,-58.423906892388246 -34.633576253723547,-58.423816240966346 -34.633567421752105,-58.422798799526433 -34.633467934967811,-58.422526675893678 -34.633440872925846,-58.422241797088589 -34.634590675490955,-58.422211834846301 -34.634705458019837,-58.421886428357745 -34.635950530826577,-58.423014315857976 -34.636068864604766,-58.423305106593041 -34.636099241547392,-58.424525613355208 -34.636223929462382,-58.424673789535753 -34.635654661547015,-58.424859804031982 -34.634876384259222,-58.425092024877685 -34.634032203196121,-58.425183085603692 -34.633701093646913)));;2608;5_22_7;COMUNA 5;22;7;1596;722;874;82,61%;891;891;100,00%;0;0,00%;724;24;3,31%;700;96,69%
MULTIPOLYGON (((-58.424525613355208 -34.636223929462382,-58.423305106593041 -34.636099241547392,-58.423014315857976 -34.636068864604766,-58.421886428357745 -34.635950530826577,-58.421694088473032 -34.636708448536389,-58.421457350492865 -34.637642483254787,-58.421412529262163 -34.637819445595227,-58.421184841659489 -34.638703974054003,-58.421818476136075 -34.638818276242873,-58.422574630868013 -34.638954728890347,-58.422792747913412 -34.638097942104068,-58.422845845760591 -34.637891051431879,-58.42308529491023 -34.636958212153289,-58.42427748501413 -34.637170642639433,-58.424385877747859 -34.636777495064187,-58.424525613355208 -34.636223929462382)));;2609;5_22_8;COMUNA 5;22;8;713;332;381;87,14%;242;242;100,00%;0;0,00%;246;26;10,57%;220;89,43%
MULTIPOLYGON (((-58.420668302823579 -34.636526192064267,-58.420322922520505 -34.637446454279512,-58.421457350492865 -34.637642483254787,-58.421694088473032 -34.636708448536389,-58.421886428357745 -34.635950530826577,-58.422211834846301 -34.634705458019837,-58.421140109934647 -34.634599530721566,-58.42058750680674 -34.634544973202914,-58.41929443886697 -34.634417121362183,-58.419337421403334 -34.635486326339894,-58.419344135012402 -34.635683799914581,-58.419349337718231 -34.635837539135835,-58.419336353459023 -34.636228603502239,-58.419317394399762 -34.636312120583987,-58.419549993357279 -34.636334739036592,-58.420668302823579 -34.636526192064267)));;2610;5_22_9;COMUNA 5;22;9;901;417;484;86,16%;319;318;99,69%;1;0,31%;278;10;3,60%;268;96,40%
MULTIPOLYGON (((-58.416332284006948 -34.601433388421846,-58.415312531361067 -34.601760403448324,-58.415448369383952 -34.60252682318017,-58.415469250438697 -34.602652188115833,-58.415660746313833 -34.603804699899378,-58.416746549463163 -34.603598345321075,-58.416717264989629 -34.603417200707121,-58.41652150244051 -34.602408497147643,-58.416332284006948 -34.601433388421846)));;2611;5_3_1;COMUNA 5;3;1;757;348;409;85,09%;400;398;99,50%;2;0,50%;320;29;9,06%;291;90,94%
MULTIPOLYGON (((-58.416028327774583 -34.605670051754011,-58.414944891406819 -34.605857808542815,-58.414763326413272 -34.606997357165561,-58.414743906650436 -34.607145101489024,-58.416100675401907 -34.606979846428047,-58.416287388887739 -34.606963649387296,-58.416028327774583 -34.605670051754011)));;2612;5_3_10;COMUNA 5;3;10;535;240;295;81,36%;284;284;100,00%;0;0,00%;241;32;13,28%;209;86,72%
MULTIPOLYGON (((-58.416287388887739 -34.606963649387296,-58.416100675401907 -34.606979846428047,-58.414743906650436 -34.607145101489024,-58.414724657331938 -34.607292564172234,-58.414660003114641 -34.608190036685038,-58.415071883886277 -34.60839774102633,-58.41543374957967 -34.608487251239687,-58.415902197819861 -34.608531658799016,-58.416065053656411 -34.60853622836391,-58.416287388887739 -34.606963649387296)));;2613;5_3_11;COMUNA 5;3;11;839;399;440;90,68%;507;507;100,00%;0;0,00%;386;35;9,07%;351;90,93%
MULTIPOLYGON (((-58.414172402448344 -34.602126095977731,-58.414029374522116 -34.602171956242394,-58.412803993862205 -34.60251168544827,-58.412972712272108 -34.603234528081508,-58.414316901589515 -34.602920901716082,-58.414336513433206 -34.60302908258673,-58.414514037053557 -34.604015387129508,-58.415660746313833 -34.603804699899378,-58.415469250438697 -34.602652188115833,-58.415448369383952 -34.60252682318017,-58.415312531361067 -34.601760403448324,-58.414172402448344 -34.602126095977731)));;2614;5_3_2;COMUNA 5;3;2;1145;559;586;95,39%;672;671;99,85%;1;0,15%;507;113;22,29%;394;77,71%
MULTIPOLYGON (((-58.414316901589515 -34.602920901716082,-58.412972712272108 -34.603234528081508,-58.413183486950764 -34.604137535081144,-58.413345311068959 -34.60414365721094,-58.414356366175966 -34.604044410360295,-58.414514037053557 -34.604015387129508,-58.414336513433206 -34.60302908258673,-58.414316901589515 -34.602920901716082)));;2615;5_3_3;COMUNA 5;3;3;369;176;193;91,19%;156;156;100,00%;0;0,00%;177;61;34,46%;116;65,54%
MULTIPOLYGON (((-58.414514037053557 -34.604015387129508,-58.414356366175966 -34.604044410360295,-58.413345311068959 -34.60414365721094,-58.413183486950764 -34.604137535081144,-58.413221972380555 -34.604302275183834,-58.413412361717995 -34.60511907295993,-58.413549064526002 -34.605120184482125,-58.414733316568842 -34.604972551658577,-58.41454264829558 -34.604174488905926,-58.414514037053557 -34.604015387129508)));;2616;5_3_4;COMUNA 5;3;4;582;242;340;71,18%;293;292;99,66%;1;0,34%;235;25;10,64%;210;89,36%
MULTIPOLYGON (((-58.415660746313833 -34.603804699899378,-58.414514037053557 -34.604015387129508,-58.41454264829558 -34.604174488905926,-58.414733316568842 -34.604972551658577,-58.415860579582322 -34.604831998413843,-58.415689692026376 -34.603978590830252,-58.415660746313833 -34.603804699899378)));;2617;5_3_5;COMUNA 5;3;5;727;344;383;89,82%;401;399;99,50%;2;0,50%;336;8;2,38%;328;97,62%
MULTIPOLYGON (((-58.416746549463163 -34.603598345321075,-58.415660746313833 -34.603804699899378,-58.415689692026376 -34.603978590830252,-58.415860579582322 -34.604831998413843,-58.416028327774583 -34.605670051754011,-58.416870438731038 -34.605524097903562,-58.417052472069926 -34.605493601620346,-58.416924210177811 -34.604699368938157,-58.416746549463163 -34.603598345321075)));;2618;5_3_6;COMUNA 5;3;6;669;300;369;81,30%;367;365;99,46%;2;0,55%;303;6;1,98%;297;98,02%
MULTIPOLYGON (((-58.415860579582322 -34.604831998413843,-58.414733316568842 -34.604972551658577,-58.414944891406819 -34.605857808542815,-58.416028327774583 -34.605670051754011,-58.415860579582322 -34.604831998413843)));;2619;5_3_7;COMUNA 5;3;7;563;234;329;71,12%;414;414;100,00%;0;0,00%;297;5;1,68%;292;98,32%
MULTIPOLYGON (((-58.414733316568842 -34.604972551658577,-58.413549064526002 -34.605120184482125,-58.413412361717995 -34.60511907295993,-58.413644894834412 -34.606116809510524,-58.414791818021051 -34.605884369244833,-58.414944891406819 -34.605857808542815,-58.414733316568842 -34.604972551658577)));;2620;5_3_8;COMUNA 5;3;8;357;165;192;85,94%;221;221;100,00%;0;0,00%;163;0;0,00%;163;100,00%
MULTIPOLYGON (((-58.414944891406819 -34.605857808542815,-58.414791818021051 -34.605884369244833,-58.413644894834412 -34.606116809510524,-58.413908275134354 -34.607246323240624,-58.413937006205018 -34.607346056728353,-58.414098939207328 -34.607906987143565,-58.414660003114641 -34.608190036685038,-58.414724657331938 -34.607292564172234,-58.414743906650436 -34.607145101489024,-58.414763326413272 -34.606997357165561,-58.414944891406819 -34.605857808542815)));;2621;5_3_9;COMUNA 5;3;9;610;285;325;87,69%;401;401;100,00%;0;0,00%;309;50;16,18%;259;83,82%
MULTIPOLYGON (((-58.42374747886192 -34.600388405757236,-58.422211388465563 -34.600539672085226,-58.422044364361184 -34.600556166477041,-58.420609708366058 -34.600698924938094,-58.420759338290438 -34.601739297735755,-58.420782334517455 -34.601908185286668,-58.422212155228799 -34.601767676834342,-58.422381140671078 -34.601751112439899,-58.423921085648715 -34.601599986088424,-58.423764964053902 -34.600516021845003,-58.42374747886192 -34.600388405757236)));;2622;5_4_1;COMUNA 5;4;1;1030;428;602;71,10%;498;494;99,20%;4;0,81%;420;6;1,43%;414;98,57%
MULTIPOLYGON (((-58.420609708366058 -34.600698924938094,-58.419747413387462 -34.600784684067499,-58.419175731955058 -34.60083568062484,-58.419190069525307 -34.600943084196004,-58.419339647626124 -34.602049940061526,-58.420782334517455 -34.601908185286668,-58.420759338290438 -34.601739297735755,-58.420609708366058 -34.600698924938094)));;2623;5_4_2;COMUNA 5;4;2;726;317;409;77,51%;457;457;100,00%;0;0,00%;347;7;2,02%;340;97,98%
MULTIPOLYGON (((-58.419175731955058 -34.60083568062484,-58.417794052058262 -34.600958917070372,-58.417891741777041 -34.60206786834938,-58.417902918087911 -34.602191116559212,-58.419339647626124 -34.602049940061526,-58.419190069525307 -34.600943084196004,-58.419175731955058 -34.60083568062484)));;2624;5_4_3;COMUNA 5;4;3;703;318;385;82,60%;369;368;99,73%;1;0,27%;319;10;3,13%;309;96,87%
MULTIPOLYGON (((-58.417794052058262 -34.600958917070372,-58.416332284006948 -34.601433388421846,-58.41652150244051 -34.602408497147643,-58.416669122210408 -34.602374255853498,-58.417902918087911 -34.602191116559212,-58.417891741777041 -34.60206786834938,-58.417794052058262 -34.600958917070372)));;2625;5_4_4;COMUNA 5;4;4;699;317;382;82,98%;372;371;99,73%;1;0,27%;341;18;5,28%;323;94,72%
MULTIPOLYGON (((-58.417902918087911 -34.602191116559212,-58.416669122210408 -34.602374255853498,-58.41652150244051 -34.602408497147643,-58.416717264989629 -34.603417200707121,-58.416746549463163 -34.603598345321075,-58.418031693067334 -34.603468958515165,-58.417998594031502 -34.603248797251787,-58.417902918087911 -34.602191116559212)));;2626;5_4_5;COMUNA 5;4;5;723;327;396;82,58%;409;408;99,76%;1;0,25%;331;12;3,63%;319;96,37%
MULTIPOLYGON (((-58.419339647626124 -34.602049940061526,-58.417902918087911 -34.602191116559212,-58.417998594031502 -34.603248797251787,-58.418031693067334 -34.603468958515165,-58.419510267655625 -34.60332011901265,-58.419489993742957 -34.603161584729285,-58.419339647626124 -34.602049940061526)));;2627;5_4_6;COMUNA 5;4;6;1027;477;550;86,73%;658;658;100,00%;0;0,00%;504;30;5,95%;474;94,05%
MULTIPOLYGON (((-58.420782334517455 -34.601908185286668,-58.419339647626124 -34.602049940061526,-58.419489993742957 -34.603161584729285,-58.419510267655625 -34.60332011901265,-58.420745489624132 -34.603195826972545,-58.420954510970546 -34.603175052806847,-58.420782334517455 -34.601908185286668)));;2628;5_4_7;COMUNA 5;4;7;553;242;311;77,81%;322;322;100,00%;0;0,00%;253;5;1,98%;248;98,02%
MULTIPOLYGON (((-58.422381140671078 -34.601751112439899,-58.422212155228799 -34.601767676834342,-58.420782334517455 -34.601908185286668,-58.420954510970546 -34.603175052806847,-58.422558452414812 -34.603015796254134,-58.42253476769838 -34.602853599234258,-58.422381140671078 -34.601751112439899)));;2629;5_4_8;COMUNA 5;4;8;1094;492;602;81,73%;597;597;100,00%;0;0,00%;516;1;0,19%;515;99,81%
MULTIPOLYGON (((-58.423921085648715 -34.601599986088424,-58.422381140671078 -34.601751112439899,-58.42253476769838 -34.602853599234258,-58.422558452414812 -34.603015796254134,-58.424102935503434 -34.602862485958987,-58.423921085648715 -34.601599986088424)));;2630;5_4_9;COMUNA 5;4;9;778;341;437;78,03%;440;439;99,77%;1;0,23%;337;43;12,76%;294;87,24%
MULTIPOLYGON (((-58.430187991152359 -34.599804353852228,-58.430150189717729 -34.599770539662018,-58.429734468933688 -34.599809936615529,-58.429926273805329 -34.600877846010576,-58.429949220712942 -34.601002082261324,-58.431154326851278 -34.60088119796017,-58.43103820616335 -34.600749261442722,-58.430275087843569 -34.599882196910556,-58.430187991152359 -34.599804353852228)));;2631;5_5_1;COMUNA 5;5;1;784;336;448;75,00%;414;414;100,00%;0;0,00%;348;3;0,86%;345;99,14%
MULTIPOLYGON (((-58.431154326851278 -34.60088119796017,-58.429949220712942 -34.601002082261324,-58.430146396411175 -34.602070978497508,-58.430170768064251 -34.602256273716193,-58.431069352473756 -34.602164534643968,-58.431894941134999 -34.602080235617599,-58.43219849130174 -34.602072424251517,-58.431872682782206 -34.601697398552766,-58.431154326851278 -34.60088119796017)));;2632;5_5_2;COMUNA 5;5;2;1353;608;745;81,61%;716;716;100,00%;0;0,00%;592;27;4,56%;565;95,44%
MULTIPOLYGON (((-58.429949220712942 -34.601002082261324,-58.428384851589087 -34.601159123139539,-58.428541894333719 -34.602223010452235,-58.428571368072006 -34.602419645870633,-58.430170768064251 -34.602256273716193,-58.430146396411175 -34.602070978497508,-58.429949220712942 -34.601002082261324)));;2633;5_5_3;COMUNA 5;5;3;743;323;420;76,90%;441;439;99,55%;2;0,46%;370;17;4,59%;353;95,41%
MULTIPOLYGON (((-58.429734468933688 -34.599809936615529,-58.42820751574132 -34.599954590519438,-58.428035554316239 -34.599970880442982,-58.426755166641321 -34.600094880945555,-58.42677715956907 -34.600247428467945,-58.426926176819428 -34.601305118230172,-58.427103813903329 -34.602565429288219,-58.428351362779495 -34.602442120201566,-58.428571368072006 -34.602419645870633,-58.428541894333719 -34.602223010452235,-58.428384851589087 -34.601159123139539,-58.429949220712942 -34.601002082261324,-58.429926273805329 -34.600877846010576,-58.429734468933688 -34.599809936615529)));;2634;5_5_4;COMUNA 5;5;4;727;322;405;79,51%;386;385;99,74%;1;0,26%;288;8;2,78%;280;97,22%
MULTIPOLYGON (((-58.426926176819428 -34.601305118230172,-58.42546366542205 -34.601448629824816,-58.425480137171171 -34.601563357522458,-58.425644602039647 -34.602709718654367,-58.427103813903329 -34.602565429288219,-58.426926176819428 -34.601305118230172)));;2635;5_5_5;COMUNA 5;5;5;593;257;336;76,49%;307;307;100,00%;0;0,00%;244;3;1,23%;241;98,77%
MULTIPOLYGON (((-58.426755166641321 -34.600094880945555,-58.425289951502563 -34.600236769916854,-58.42546366542205 -34.601448629824816,-58.426926176819428 -34.601305118230172,-58.42677715956907 -34.600247428467945,-58.426755166641321 -34.600094880945555)));;2636;5_5_6;COMUNA 5;5;6;716;317;399;79,45%;393;392;99,75%;1;0,26%;315;13;4,13%;302;95,87%
MULTIPOLYGON (((-58.425289951502563 -34.600236769916854,-58.425111260172592 -34.600254039607854,-58.42374747886192 -34.600388405757236,-58.423764964053902 -34.600516021845003,-58.423921085648715 -34.601599986088424,-58.42546366542205 -34.601448629824816,-58.425289951502563 -34.600236769916854)));;2637;5_5_7;COMUNA 5;5;7;890;386;504;76,59%;507;506;99,80%;1;0,20%;422;6;1,42%;416;98,58%
MULTIPOLYGON (((-58.42546366542205 -34.601448629824816,-58.423921085648715 -34.601599986088424,-58.424102935503434 -34.602862485958987,-58.424840295791427 -34.602789263494714,-58.425644602039647 -34.602709718654367,-58.425480137171171 -34.601563357522458,-58.42546366542205 -34.601448629824816)));;2638;5_5_8;COMUNA 5;5;8;710;322;388;82,99%;427;427;100,00%;0;0,00%;324;12;3,70%;312;96,30%
MULTIPOLYGON (((-58.43219849130174 -34.602072424251517,-58.431894941134999 -34.602080235617599,-58.432145257721551 -34.603938467391174,-58.432330170534073 -34.603928161053794,-58.433334112118949 -34.602673429841985,-58.433141829586376 -34.602578591091984,-58.432240628247122 -34.602133775133495,-58.43219849130174 -34.602072424251517)));;2639;5_6_1;COMUNA 5;6;1;740;330;410;80,49%;361;361;100,00%;0;0,00%;304;0;0,00%;304;100,00%
MULTIPOLYGON (((-58.431894941134999 -34.602080235617599,-58.431069352473756 -34.602164534643968,-58.431314895628226 -34.603984596401972,-58.432145257721551 -34.603938467391174,-58.431894941134999 -34.602080235617599)));;2640;5_6_2;COMUNA 5;6;2;991;452;539;83,86%;507;507;100,00%;0;0,00%;437;4;0,92%;433;99,08%
MULTIPOLYGON (((-58.431069352473756 -34.602164534643968,-58.430170768064251 -34.602256273716193,-58.430197347597677 -34.602458682836996,-58.430410686556186 -34.604034855327193,-58.431314895628226 -34.603984596401972,-58.431069352473756 -34.602164534643968)));;2641;5_6_3;COMUNA 5;6;3;877;369;508;72,64%;553;553;100,00%;0;0,00%;438;3;0,68%;435;99,32%
MULTIPOLYGON (((-58.430170768064251 -34.602256273716193,-58.428571368072006 -34.602419645870633,-58.428826188752851 -34.604122809335337,-58.430410686556186 -34.604034855327193,-58.430197347597677 -34.602458682836996,-58.430170768064251 -34.602256273716193)));;2642;5_6_4;COMUNA 5;6;4;1481;677;804;84,20%;824;824;100,00%;0;0,00%;660;6;0,91%;654;99,09%
MULTIPOLYGON (((-58.428571368072006 -34.602419645870633,-58.428351362779495 -34.602442120201566,-58.427103813903329 -34.602565429288219,-58.427224222829452 -34.603420003688747,-58.427243159169507 -34.603554028330834,-58.427336911120754 -34.604209432320708,-58.428644511721131 -34.60413289998953,-58.428826188752851 -34.604122809335337,-58.428571368072006 -34.602419645870633)));;2643;5_6_5;COMUNA 5;6;5;1134;494;640;77,19%;692;692;100,00%;0;0,00%;558;7;1,25%;551;98,75%
MULTIPOLYGON (((-58.428826188752851 -34.604122809335337,-58.428644511721131 -34.60413289998953,-58.427336911120754 -34.604209432320708,-58.427452404552248 -34.605017101677298,-58.427464376250207 -34.605106474679097,-58.428736471710288 -34.605034297480323,-58.428959039365445 -34.605010766797662,-58.429062699802763 -34.604999809092128,-58.430531033395781 -34.604922878211347,-58.430429455875426 -34.604173879606712,-58.430410686556186 -34.604034855327193,-58.428826188752851 -34.604122809335337)));;2644;5_6_6;COMUNA 5;6;6;907;428;479;89,35%;473;473;100,00%;0;0,00%;407;6;1,47%;401;98,53%
MULTIPOLYGON (((-58.428959039365445 -34.605010766797662,-58.428736471710288 -34.605034297480323,-58.427464376250207 -34.605106474679097,-58.427576281188536 -34.605946538338763,-58.429098688500495 -34.605944009239131,-58.430669134114844 -34.605941332913901,-58.430531033395781 -34.604922878211347,-58.429062699802763 -34.604999809092128,-58.428959039365445 -34.605010766797662)));;2645;5_6_7;COMUNA 5;6;7;894;418;476;87,82%;535;535;100,00%;0;0,00%;418;25;5,98%;393;94,02%
MULTIPOLYGON (((-58.432330170534073 -34.603928161053794,-58.432145257721551 -34.603938467391174,-58.431314895628226 -34.603984596401972,-58.430410686556186 -34.604034855327193,-58.430429455875426 -34.604173879606712,-58.430531033395781 -34.604922878211347,-58.430669134114844 -34.605941332913901,-58.431529512224614 -34.604943771950616,-58.432330170534073 -34.603928161053794)));;2646;5_6_8;COMUNA 5;6;8;922;424;498;85,14%;491;491;100,00%;0;0,00%;385;1;0,26%;384;99,74%
MULTIPOLYGON (((-58.425644602039647 -34.602709718654367,-58.424840295791427 -34.602789263494714,-58.424102935503434 -34.602862485958987,-58.424129933297664 -34.603049895942469,-58.424339556551359 -34.604495861530594,-58.425686299038567 -34.604328383874694,-58.425874283016377 -34.604310623184745,-58.425856536486044 -34.604187092058957,-58.425766871002999 -34.603562041426777,-58.425644602039647 -34.602709718654367)));;2647;5_7_1;COMUNA 5;7;1;1206;531;675;78,67%;659;657;99,70%;2;0,30%;529;3;0,57%;526;99,43%
MULTIPOLYGON (((-58.427103813903329 -34.602565429288219,-58.425644602039647 -34.602709718654367,-58.425766871002999 -34.603562041426777,-58.427224222829452 -34.603420003688747,-58.427103813903329 -34.602565429288219)));;2648;5_7_2;COMUNA 5;7;2;538;227;311;72,99%;237;237;100,00%;0;0,00%;222;25;11,26%;197;88,74%
MULTIPOLYGON (((-58.427224222829452 -34.603420003688747,-58.425766871002999 -34.603562041426777,-58.425856536486044 -34.604187092058957,-58.425874283016377 -34.604310623184745,-58.426030836907351 -34.60429581062111,-58.427191177237724 -34.604217911443399,-58.427336911120754 -34.604209432320708,-58.427243159169507 -34.603554028330834,-58.427224222829452 -34.603420003688747)));;2649;5_7_3;COMUNA 5;7;3;640;274;366;74,86%;343;343;100,00%;0;0,00%;276;17;6,16%;259;93,84%
MULTIPOLYGON (((-58.427336911120754 -34.604209432320708,-58.427191177237724 -34.604217911443399,-58.426030836907351 -34.60429581062111,-58.425874283016377 -34.604310623184745,-58.426111278525383 -34.605955403934956,-58.42743727655116 -34.605946779944993,-58.427576281188536 -34.605946538338763,-58.427464376250207 -34.605106474679097,-58.427452404552248 -34.605017101677298,-58.427336911120754 -34.604209432320708)));;2650;5_7_4;COMUNA 5;7;4;1364;602;762;79,00%;739;736;99,59%;3;0,41%;605;23;3,80%;582;96,20%
MULTIPOLYGON (((-58.425874283016377 -34.604310623184745,-58.425686299038567 -34.604328383874694,-58.424339556551359 -34.604495861530594,-58.42455207408625 -34.605961264667613,-58.425428007825303 -34.605959915610569,-58.426111278525383 -34.605955403934956,-58.425874283016377 -34.604310623184745)));;2651;5_7_5;COMUNA 5;7;5;1295;556;739;75,24%;824;822;99,76%;2;0,24%;618;28;4,53%;590;95,47%
MULTIPOLYGON (((-58.424339556551359 -34.604495861530594,-58.422802094854994 -34.60468713623505,-58.422812453900931 -34.606001061980571,-58.422969175278745 -34.606000056736889,-58.424349614496101 -34.605961553325251,-58.42455207408625 -34.605961264667613,-58.424339556551359 -34.604495861530594)));;2652;5_7_6;COMUNA 5;7;6;627;268;359;74,65%;362;360;99,45%;2;0,56%;300;40;13,33%;260;86,67%
MULTIPOLYGON (((-58.422913888077069 -34.607268959129463,-58.422921850795781 -34.607360796115117,-58.423027728302728 -34.608426855910146,-58.423035908272595 -34.608599681842165,-58.42467674489982 -34.608630768740774,-58.424682209315812 -34.608415199115207,-58.424627621429529 -34.607272604628243,-58.426180116225254 -34.607278783631685,-58.427034171612981 -34.607282134983038,-58.427551613194673 -34.607284186622287,-58.427662259923956 -34.607275908279554,-58.427592837928557 -34.606070702663828,-58.427576281188536 -34.605946538338763,-58.42743727655116 -34.605946779944993,-58.426111278525383 -34.605955403934956,-58.425428007825303 -34.605959915610569,-58.42455207408625 -34.605961264667613,-58.424349614496101 -34.605961553325251,-58.422969175278745 -34.606000056736889,-58.422812453900931 -34.606001061980571,-58.422814696430294 -34.6061206446348,-58.422913888077069 -34.607268959129463)));;2653;5_7_7;COMUNA 5;7;7;894;417;477;87,42%;262;260;99,24%;2;0,77%;196;20;10,20%;176;89,80%
MULTIPOLYGON (((-58.427662259923956 -34.607275908279554,-58.427551613194673 -34.607284186622287,-58.427034171612981 -34.607282134983038,-58.426180116225254 -34.607278783631685,-58.424627621429529 -34.607272604628243,-58.424682209315812 -34.608415199115207,-58.42467674489982 -34.608630768740774,-58.424877846250972 -34.608634634204336,-58.426246967962143 -34.608668643733239,-58.427028289456707 -34.608688030306695,-58.427739001374796 -34.608702814030735,-58.427662259923956 -34.607275908279554)));;2654;5_7_8;COMUNA 5;7;8;909;393;516;76,16%;475;473;99,58%;2;0,42%;394;42;10,66%;352;89,34%
MULTIPOLYGON (((-58.424102935503434 -34.602862485958987,-58.422558452414812 -34.603015796254134,-58.422802094854994 -34.60468713623505,-58.424339556551359 -34.604495861530594,-58.424129933297664 -34.603049895942469,-58.424102935503434 -34.602862485958987)));;2655;5_8_1;COMUNA 5;8;1;1171;525;646;81,27%;656;656;100,00%;0;0,00%;547;68;12,43%;479;87,57%
MULTIPOLYGON (((-58.422558452414812 -34.603015796254134,-58.420954510970546 -34.603175052806847,-58.421187793626444 -34.6048909011202,-58.421369225321904 -34.604865398375026,-58.422802094854994 -34.60468713623505,-58.422558452414812 -34.603015796254134)));;2656;5_8_2;COMUNA 5;8;2;703;307;396;77,53%;436;436;100,00%;0;0,00%;320;9;2,81%;311;97,19%
MULTIPOLYGON (((-58.420954510970546 -34.603175052806847,-58.420745489624132 -34.603195826972545,-58.419510267655625 -34.60332011901265,-58.419643365100661 -34.604360346024478,-58.419737358269572 -34.605094702446941,-58.421187793626444 -34.6048909011202,-58.420954510970546 -34.603175052806847)));;2657;5_8_3;COMUNA 5;8;3;1180;524;656;79,88%;634;634;100,00%;0;0,00%;504;5;0,99%;499;99,01%
MULTIPOLYGON (((-58.421187793626444 -34.6048909011202,-58.419737358269572 -34.605094702446941,-58.419854342765284 -34.606009214345164,-58.421295492960553 -34.60601083870835,-58.421208075771624 -34.605040209383269,-58.421187793626444 -34.6048909011202)));;2658;5_8_4;COMUNA 5;8;4;990;418;572;73,08%;552;549;99,46%;3;0,55%;454;22;4,85%;432;95,15%
MULTIPOLYGON (((-58.422802094854994 -34.60468713623505,-58.421369225321904 -34.604865398375026,-58.421187793626444 -34.6048909011202,-58.421208075771624 -34.605040209383269,-58.421295492960553 -34.60601083870835,-58.422812453900931 -34.606001061980571,-58.422802094854994 -34.60468713623505)));;2659;5_8_5;COMUNA 5;8;5;401;192;209;91,87%;220;220;100,00%;0;0,00%;175;5;2,86%;170;97,14%
MULTIPOLYGON (((-58.422812453900931 -34.606001061980571,-58.421295492960553 -34.60601083870835,-58.421341828139226 -34.606525591894467,-58.421357673787519 -34.606691166799095,-58.421412922521874 -34.607267826624039,-58.421605760956396 -34.607266483223313,-58.422913888077069 -34.607268959129463,-58.422814696430294 -34.6061206446348,-58.422812453900931 -34.606001061980571)));;2660;5_8_6;COMUNA 5;8;6;896;364;532;68,42%;474;472;99,58%;2;0,42%;394;15;3,81%;379;96,19%
MULTIPOLYGON (((-58.419917613621777 -34.606700248171265,-58.419962460466451 -34.60727789095256,-58.421412922521874 -34.607267826624039,-58.421357673787519 -34.606691166799095,-58.421341828139226 -34.606525591894467,-58.421295492960553 -34.60601083870835,-58.419854342765284 -34.606009214345164,-58.419878605244776 -34.606198948239047,-58.419917613621777 -34.606700248171265)));;2661;5_8_7;COMUNA 5;8;7;855;362;493;73,43%;496;495;99,80%;1;0,20%;399;1;0,25%;398;99,75%
MULTIPOLYGON (((-58.421412922521874 -34.607267826624039,-58.419962460466451 -34.60727789095256,-58.420060872951716 -34.608543253828877,-58.421537828236971 -34.60857129727745,-58.421412922521874 -34.607267826624039)));;2662;5_8_8;COMUNA 5;8;8;834;375;459;81,70%;449;448;99,78%;1;0,22%;353;12;3,40%;341;96,60%
MULTIPOLYGON (((-58.422913888077069 -34.607268959129463,-58.421605760956396 -34.607266483223313,-58.421412922521874 -34.607267826624039,-58.421537828236971 -34.60857129727745,-58.423035908272595 -34.608599681842165,-58.423027728302728 -34.608426855910146,-58.422921850795781 -34.607360796115117,-58.422913888077069 -34.607268959129463)));;2663;5_8_9;COMUNA 5;8;9;767;326;441;73,92%;401;400;99,75%;1;0,25%;333;17;5,11%;316;94,89%
MULTIPOLYGON (((-58.419510267655625 -34.60332011901265,-58.418031693067334 -34.603468958515165,-58.418088556308071 -34.603846458315132,-58.418216201205936 -34.604538291458844,-58.419643365100661 -34.604360346024478,-58.419510267655625 -34.60332011901265)));;2664;5_9_1;COMUNA 5;9;1;1082;475;607;78,25%;569;568;99,82%;1;0,18%;472;0;0,00%;472;100,00%
MULTIPOLYGON (((-58.419962460466451 -34.60727789095256,-58.418664718700924 -34.607286866449989,-58.418788672019829 -34.608538154532461,-58.419876551736202 -34.608539738442225,-58.420060872951716 -34.608543253828877,-58.419962460466451 -34.60727789095256)));;2665;5_9_10;COMUNA 5;9;10;806;361;445;81,12%;390;390;100,00%;0;0,00%;341;5;1,47%;336;98,53%
MULTIPOLYGON (((-58.418031693067334 -34.603468958515165,-58.416746549463163 -34.603598345321075,-58.416924210177811 -34.604699368938157,-58.418216201205936 -34.604538291458844,-58.418088556308071 -34.603846458315132,-58.418031693067334 -34.603468958515165)));;2666;5_9_2;COMUNA 5;9;2;601;255;346;73,70%;366;366;100,00%;0;0,00%;287;2;0,70%;285;99,30%
MULTIPOLYGON (((-58.418216201205936 -34.604538291458844,-58.416924210177811 -34.604699368938157,-58.417052472069926 -34.605493601620346,-58.418191348585893 -34.605302958906186,-58.418353360476161 -34.605281256521415,-58.418216201205936 -34.604538291458844)));;2667;5_9_3;COMUNA 5;9;3;575;259;316;81,96%;341;341;100,00%;0;0,00%;268;2;0,75%;266;99,25%
MULTIPOLYGON (((-58.419643365100661 -34.604360346024478,-58.418216201205936 -34.604538291458844,-58.418353360476161 -34.605281256521415,-58.419561973333522 -34.60511935980017,-58.419737358269572 -34.605094702446941,-58.419643365100661 -34.604360346024478)));;2668;5_9_4;COMUNA 5;9;4;526;216;310;69,68%;297;297;100,00%;0;0,00%;232;1;0,43%;231;99,57%
MULTIPOLYGON (((-58.419917613621777 -34.606700248171265,-58.419878605244776 -34.606198948239047,-58.419854342765284 -34.606009214345164,-58.419737358269572 -34.605094702446941,-58.419561973333522 -34.60511935980017,-58.418353360476161 -34.605281256521415,-58.418596601358452 -34.606598576873793,-58.418614477585919 -34.606779646397577,-58.418664718700924 -34.607286866449989,-58.419962460466451 -34.60727789095256,-58.419917613621777 -34.606700248171265)));;2669;5_9_5;COMUNA 5;9;5;576;268;308;87,01%;335;335;100,00%;0;0,00%;260;24;9,23%;236;90,77%
MULTIPOLYGON (((-58.418353360476161 -34.605281256521415,-58.418191348585893 -34.605302958906186,-58.417052472069926 -34.605493601620346,-58.417257729623721 -34.606765486149982,-58.41727503858521 -34.606888102779799,-58.418614477585919 -34.606779646397577,-58.418596601358452 -34.606598576873793,-58.418353360476161 -34.605281256521415)));;2670;5_9_6;COMUNA 5;9;6;572;266;306;86,93%;311;311;100,00%;0;0,00%;245;9;3,67%;236;96,33%
MULTIPOLYGON (((-58.417052472069926 -34.605493601620346,-58.416870438731038 -34.605524097903562,-58.416028327774583 -34.605670051754011,-58.416287388887739 -34.606963649387296,-58.416424442690428 -34.606951729170191,-58.41727503858521 -34.606888102779799,-58.417257729623721 -34.606765486149982,-58.417052472069926 -34.605493601620346)));;2671;5_9_7;COMUNA 5;9;7;485;215;270;79,63%;307;307;100,00%;0;0,00%;220;4;1,82%;216;98,18%
MULTIPOLYGON (((-58.41727503858521 -34.606888102779799,-58.416424442690428 -34.606951729170191,-58.416287388887739 -34.606963649387296,-58.416065053656411 -34.60853622836391,-58.416234468020377 -34.60854101148476,-58.417506827791904 -34.608537079321053,-58.41727503858521 -34.606888102779799)));;2672;5_9_8;COMUNA 5;9;8;941;416;525;79,24%;549;549;100,00%;0;0,00%;454;3;0,66%;451;99,34%
MULTIPOLYGON (((-58.418614477585919 -34.606779646397577,-58.41727503858521 -34.606888102779799,-58.417506827791904 -34.608537079321053,-58.418505458766305 -34.608537700148446,-58.418788672019829 -34.608538154532461,-58.418664718700924 -34.607286866449989,-58.418614477585919 -34.606779646397577)));;2673;5_9_9;COMUNA 5;9;9;924;439;485;90,52%;524;524;100,00%;0;0,00%;438;49;11,19%;389;88,81%
MULTIPOLYGON (((-58.462704653845897 -34.607372984849533,-58.462510027418588 -34.607241993920148,-58.462150502498091 -34.606997828823296,-58.461540481849731 -34.606583583775418,-58.460861358678017 -34.607620937946038,-58.46148654575682 -34.607980043583474,-58.460771294807543 -34.609038172064061,-58.459935918009734 -34.610273905653074,-58.460864019025529 -34.610586821936742,-58.461074835734365 -34.61066605317923,-58.46164061032156 -34.609522918869359,-58.462192911293833 -34.608406965769625,-58.462704653845897 -34.607372984849533)));;2674;6_1_1;COMUNA 6;1;1;677;322;355;90,70%;253;253;100,00%;0;0,00%;242;14;5,79%;228;94,21%
MULTIPOLYGON (((-58.457462926046553 -34.610220794449901,-58.456765667600244 -34.611213545329505,-58.457915391454605 -34.611774250079705,-58.457074668752142 -34.612934678893794,-58.457328332646256 -34.613036877125531,-58.459195822296017 -34.613789507470798,-58.459448384254372 -34.613885644692253,-58.459543879233685 -34.613741909619613,-58.460036264498939 -34.612756181481409,-58.460485364234053 -34.611856932440126,-58.460552660241291 -34.611721013200949,-58.461074835734365 -34.61066605317923,-58.460864019025529 -34.610586821936742,-58.459935918009734 -34.610273905653074,-58.459180478194888 -34.610019933222063,-58.458135791156344 -34.609518823864065,-58.457999339487664 -34.609456914997317,-58.457462926046553 -34.610220794449901)));;2675;6_1_10;COMUNA 6;1;10;620;272;348;78,16%;180;178;98,89%;2;1,12%;145;1;0,69%;144;99,31%
MULTIPOLYGON (((-58.455662124414928 -34.610675297977508,-58.455577190473569 -34.610795860839524,-58.454754247095153 -34.611963951220915,-58.455355768798789 -34.612224843468802,-58.455536430473046 -34.612303166914842,-58.455896477831331 -34.612451150643963,-58.456765667600244 -34.611213545329505,-58.457462926046553 -34.610220794449901,-58.457999339487664 -34.609456914997317,-58.457845597368006 -34.609387188101508,-58.4570385628544 -34.609007491449418,-58.456886781495967 -34.608937059179972,-58.456353342950266 -34.609694313999078,-58.455662124414928 -34.610675297977508)));;2676;6_1_11;COMUNA 6;1;11;675;309;366;84,43%;316;316;100,00%;0;0,00%;253;2;0,79%;251;99,21%
MULTIPOLYGON (((-58.457915391454605 -34.611774250079705,-58.456765667600244 -34.611213545329505,-58.455896477831331 -34.612451150643963,-58.456947411148057 -34.61288333307165,-58.457074668752142 -34.612934678893794,-58.457915391454605 -34.611774250079705)));;2677;6_1_12;COMUNA 6;1;12;622;273;349;78,22%;325;325;100,00%;0;0,00%;292;15;5,14%;277;94,86%
MULTIPOLYGON (((-58.459653561548635 -34.60530399639142,-58.459513028578058 -34.605208989240523,-58.458564383425113 -34.606555701257804,-58.459675131390483 -34.607076527887273,-58.460695181766745 -34.607554876539695,-58.460861358678017 -34.607620937946038,-58.461540481849731 -34.606583583775418,-58.460513034071866 -34.605885867587773,-58.460310578719273 -34.605748393861894,-58.459653561548635 -34.60530399639142)));;2678;6_1_2;COMUNA 6;1;2;824;384;440;87,27%;386;386;100,00%;0;0,00%;345;2;0,58%;343;99,42%
MULTIPOLYGON (((-58.459513028578058 -34.605208989240523,-58.458782432641563 -34.604714864918293,-58.458473946988917 -34.604491818070478,-58.457454253161366 -34.605913874062715,-58.457388577998607 -34.606004367560828,-58.458564383425113 -34.606555701257804,-58.459513028578058 -34.605208989240523)));;2679;6_1_3;COMUNA 6;1;3;888;400;488;81,97%;429;428;99,77%;1;0,23%;347;2;0,58%;345;99,42%
MULTIPOLYGON (((-58.456214491768513 -34.605450768969675,-58.455442301376877 -34.606479073765122,-58.456514190603833 -34.606975982305947,-58.456640501425362 -34.607035216199513,-58.457388577998607 -34.606004367560828,-58.457454253161366 -34.605913874062715,-58.458473946988917 -34.604491818070478,-58.458080102055661 -34.604592793506569,-58.456563312843784 -34.604986262555556,-58.455803379713785 -34.605183412463504,-58.456214491768513 -34.605450768969675)));;2680;6_1_4;COMUNA 6;1;4;698;316;382;82,72%;332;331;99,70%;1;0,30%;274;7;2,55%;267;97,45%
MULTIPOLYGON (((-58.452958836663989 -34.605923105372128,-58.452428268854995 -34.606060461358609,-58.452015073824754 -34.606167260848622,-58.452263337909145 -34.606325598104114,-58.45241008173479 -34.606424910046123,-58.452553419194899 -34.606521897496549,-58.4532244611107 -34.606974714793203,-58.453335010440739 -34.607049021866516,-58.454466934260985 -34.605913709057006,-58.455442301376877 -34.606479073765122,-58.456214491768513 -34.605450768969675,-58.455803379713785 -34.605183412463504,-58.455524600386426 -34.605255723042504,-58.454982371897444 -34.605396751573814,-58.454001824616746 -34.605651765583758,-58.453069225918895 -34.605894310242007,-58.452958836663989 -34.605923105372128)));;2681;6_1_5;COMUNA 6;1;5;1124;499;625;79,84%;550;549;99,82%;1;0,18%;431;23;5,34%;408;94,66%
MULTIPOLYGON (((-58.456640501425362 -34.607035216199513,-58.456514190603833 -34.606975982305947,-58.455442301376877 -34.606479073765122,-58.454466934260985 -34.605913709057006,-58.453335010440739 -34.607049021866516,-58.454451501571064 -34.607799552850921,-58.45567032538473 -34.608372115143162,-58.456640501425362 -34.607035216199513)));;2682;6_1_6;COMUNA 6;1;6;938;439;499;87,98%;428;427;99,77%;1;0,23%;348;3;0,86%;345;99,14%
MULTIPOLYGON (((-58.458564383425113 -34.606555701257804,-58.457388577998607 -34.606004367560828,-58.456640501425362 -34.607035216199513,-58.45567032538473 -34.608372115143162,-58.456886781495967 -34.608937059179972,-58.457832754958069 -34.607594304436319,-58.458564383425113 -34.606555701257804)));;2683;6_1_7;COMUNA 6;1;7;692;316;376;84,04%;301;301;100,00%;0;0,00%;260;5;1,92%;255;98,08%
MULTIPOLYGON (((-58.46148654575682 -34.607980043583474,-58.460861358678017 -34.607620937946038,-58.460695181766745 -34.607554876539695,-58.459675131390483 -34.607076527887273,-58.458564383425113 -34.606555701257804,-58.457832754958069 -34.607594304436319,-58.457987600888657 -34.607666918842362,-58.458815409680518 -34.608049567819307,-58.45894436412145 -34.608111334706763,-58.459070082105967 -34.608171622433083,-58.460141673767367 -34.608675752749583,-58.460771294807543 -34.609038172064061,-58.46148654575682 -34.607980043583474)));;2684;6_1_8;COMUNA 6;1;8;871;379;492;77,03%;369;368;99,73%;1;0,27%;310;18;5,81%;292;94,19%
MULTIPOLYGON (((-58.460141673767367 -34.608675752749583,-58.459070082105967 -34.608171622433083,-58.45894436412145 -34.608111334706763,-58.458815409680518 -34.608049567819307,-58.457987600888657 -34.607666918842362,-58.457832754958069 -34.607594304436319,-58.456886781495967 -34.608937059179972,-58.4570385628544 -34.609007491449418,-58.457845597368006 -34.609387188101508,-58.457999339487664 -34.609456914997317,-58.458135791156344 -34.609518823864065,-58.459180478194888 -34.610019933222063,-58.459935918009734 -34.610273905653074,-58.460771294807543 -34.609038172064061,-58.460141673767367 -34.608675752749583)));;2685;6_1_9;COMUNA 6;1;9;715;353;362;97,51%;230;229;99,57%;1;0,44%;227;7;3,08%;220;96,92%
MULTIPOLYGON (((-58.445055653573753 -34.61981594110879,-58.445088040364055 -34.61966948176164,-58.445143037921824 -34.619427016384201,-58.444693003434743 -34.61936054000013,-58.444149536782646 -34.619211650519276,-58.444192325948919 -34.61909975167255,-58.444198719564788 -34.619079329388335,-58.444212189460153 -34.619033203046094,-58.443753499573788 -34.61883087202429,-58.443664061822467 -34.61879085669127,-58.443532034814972 -34.61873181985321,-58.442568668574062 -34.618303691832409,-58.442402401045413 -34.618232042032957,-58.442278552279241 -34.618526820505132,-58.442278215566915 -34.618526686395889,-58.442203399190461 -34.618704126402442,-58.442192715770084 -34.618729463920062,-58.442192663743064 -34.618729545339868,-58.442192608514937 -34.618729631769249,-58.442007669797867 -34.619161656381905,-58.441957378201522 -34.619285314162163,-58.442082249697123 -34.619342238739534,-58.443189493003779 -34.619837719931411,-58.443320413936689 -34.619897320354056,-58.443824763730319 -34.620126632818881,-58.443964460644622 -34.620183487330188,-58.444126901112277 -34.620249711670972,-58.444687398922142 -34.620460577743053,-58.444885276655825 -34.62053884897314,-58.445006524868646 -34.620024834542527,-58.445055653573753 -34.61981594110879)));;2686;6_10_1;COMUNA 6;10;1;604;256;348;73,56%;391;391;100,00%;0;0,00%;303;2;0,66%;301;99,34%
MULTIPOLYGON (((-58.444885276655825 -34.62053884897314,-58.444687398922142 -34.620460577743053,-58.444126901112277 -34.620249711670972,-58.443964460644622 -34.620183487330188,-58.443534917387318 -34.621385927380018,-58.44435224113586 -34.621728881877956,-58.444794384033713 -34.620915398114434,-58.444846906065472 -34.620704271679955,-58.444885276655825 -34.62053884897314)));;2687;6_10_10;COMUNA 6;10;10;943;399;544;73,35%;616;616;100,00%;0;0,00%;463;2;0,43%;461;99,57%
MULTIPOLYGON (((-58.442192608514937 -34.618729631769249,-58.442192639664974 -34.618729644416007,-58.442192687685214 -34.618729446823153,-58.442192608514937 -34.618729631769249)),((-58.44212440541564 -34.618701941626149,-58.441680536999861 -34.618531296558267,-58.44140302798376 -34.618410328666947,-58.441201497947205 -34.618322684591043,-58.441036509689681 -34.618249765505425,-58.440956271900028 -34.618217989544895,-58.440745638779759 -34.618735716570761,-58.440895636625378 -34.618801450013969,-58.441957378201522 -34.619285314162163,-58.442007669797867 -34.619161656381905,-58.442192608514937 -34.618729631769249,-58.44212440541564 -34.618701941626149)));;2688;6_10_2;COMUNA 6;10;2;564;222;342;64,91%;382;382;100,00%;0;0,00%;288;3;1,04%;285;98,96%
MULTIPOLYGON (((-58.440425060461891 -34.615933587219125,-58.439056654467976 -34.615938400295406,-58.438998260191127 -34.616089168993518,-58.438752938765703 -34.61664569021184,-58.438613404295893 -34.61694398320958,-58.43858723822995 -34.616992712166514,-58.438591065652354 -34.616994426818124,-58.43850098003746 -34.617203584606983,-58.438578082835377 -34.61718558688105,-58.438691776972355 -34.617233093431651,-58.438967404483066 -34.617352517795482,-58.438959902801706 -34.61737117896967,-58.439435184330165 -34.617573531225169,-58.439534584578695 -34.617617002384563,-58.439607750999478 -34.617648003269416,-58.439673340170202 -34.617663509173731,-58.439721976451146 -34.61768204012705,-58.439791481242786 -34.617708462584766,-58.440197431101168 -34.617887628987191,-58.44051054011841 -34.618025648967418,-58.440860276227909 -34.618180013309306,-58.440956271900028 -34.618217989544895,-58.441036509689681 -34.618249765505425,-58.441201497947205 -34.618322684591043,-58.44140302798376 -34.618410328666947,-58.441680536999861 -34.618531296558267,-58.44212440541564 -34.618701941626149,-58.442192715770084 -34.618729463920062,-58.442203399190461 -34.618704126402442,-58.442278215566915 -34.618526686395889,-58.442278552279241 -34.618526820505132,-58.442402401045413 -34.618232042032957,-58.441901980942582 -34.618019837570472,-58.441380600651534 -34.617168168096612,-58.4406305238562 -34.615940174090625,-58.440564250834107 -34.615938049332172,-58.440425060461891 -34.615933587219125)));;2689;6_10_3;COMUNA 6;10;3;791;352;439;80,18%;465;465;100,00%;0;0,00%;383;5;1,31%;378;98,69%
MULTIPOLYGON (((-58.439516025786688 -34.618187230301793,-58.440622642425531 -34.618681819235057,-58.440745638779759 -34.618735716570761,-58.440956271900028 -34.618217989544895,-58.440860276227909 -34.618180013309306,-58.44051054011841 -34.618025648967418,-58.440197431101168 -34.617887628987191,-58.439791481242786 -34.617708462584766,-58.439721976451146 -34.61768204012705,-58.439673340170202 -34.617663509173731,-58.439607750999478 -34.617648003269416,-58.439534584578695 -34.617617002384563,-58.439435184330165 -34.617573531225169,-58.438959902801706 -34.61737117896967,-58.438967404483066 -34.617352517795482,-58.438691776972355 -34.617233093431651,-58.438578082835377 -34.61718558688105,-58.43850098003746 -34.617203584606983,-58.438485708902761 -34.617207149265951,-58.438497559272299 -34.617212068395155,-58.438302783528165 -34.617642889944932,-58.438431482653542 -34.61770256561509,-58.439516025786688 -34.618187230301793)));;2690;6_10_4;COMUNA 6;10;4;712;305;407;74,94%;414;414;100,00%;0;0,00%;337;20;5,93%;317;94,07%
MULTIPOLYGON (((-58.439516025786688 -34.618187230301793,-58.438431482653542 -34.61770256561509,-58.438302783528165 -34.617642889944932,-58.437746574713941 -34.61887324343455,-58.439013835313673 -34.619435839794008,-58.439064127512793 -34.619325775258332,-58.439516025786688 -34.618187230301793)));;2691;6_10_5;COMUNA 6;10;5;959;421;538;78,25%;565;565;100,00%;0;0,00%;461;4;0,87%;457;99,13%
MULTIPOLYGON (((-58.440745638779759 -34.618735716570761,-58.440622642425531 -34.618681819235057,-58.439516025786688 -34.618187230301793,-58.439064127512793 -34.619325775258332,-58.439013835313673 -34.619435839794008,-58.440250704296879 -34.619984895751081,-58.440745638779759 -34.618735716570761)));;2692;6_10_6;COMUNA 6;10;6;956;400;556;71,94%;591;591;100,00%;0;0,00%;455;3;0,66%;452;99,34%
MULTIPOLYGON (((-58.441957378201522 -34.619285314162163,-58.440895636625378 -34.618801450013969,-58.440745638779759 -34.618735716570761,-58.440250704296879 -34.619984895751081,-58.44120981931669 -34.62041022421144,-58.441462633629641 -34.620516258107806,-58.441645311249523 -34.620052611575581,-58.441957378201522 -34.619285314162163)));;2693;6_10_7;COMUNA 6;10;7;592;243;349;69,63%;478;478;100,00%;0;0,00%;335;2;0,60%;333;99,40%
MULTIPOLYGON (((-58.443320413936689 -34.619897320354056,-58.443189493003779 -34.619837719931411,-58.442082249697123 -34.619342238739534,-58.441957378201522 -34.619285314162163,-58.441645311249523 -34.620052611575581,-58.441462633629641 -34.620516258107806,-58.442889070283279 -34.621114899271753,-58.443320413936689 -34.619897320354056)));;2694;6_10_8;COMUNA 6;10;8;1243;540;703;76,81%;728;728;100,00%;0;0,00%;568;8;1,41%;560;98,59%
MULTIPOLYGON (((-58.443964460644622 -34.620183487330188,-58.443824763730319 -34.620126632818881,-58.443320413936689 -34.619897320354056,-58.442889070283279 -34.621114899271753,-58.442893574263451 -34.621116789373659,-58.443534917387318 -34.621385927380018,-58.443964460644622 -34.620183487330188)));;2695;6_10_9;COMUNA 6;10;9;501;236;265;89,06%;323;323;100,00%;0;0,00%;246;0;0,00%;246;100,00%
MULTIPOLYGON (((-58.452035827821547 -34.61571697786286,-58.45137010908126 -34.61574043982155,-58.450719297152681 -34.615764463012681,-58.450271991355301 -34.61578202452818,-58.45001108817636 -34.616232506716912,-58.449425281248594 -34.61724395925453,-58.449378242783254 -34.617343183001765,-58.448962205526385 -34.618309649960608,-58.449209655991865 -34.618419118061063,-58.450229874671358 -34.618867904415374,-58.450701086574384 -34.618001090074181,-58.450783820479238 -34.61787757268452,-58.450840822203133 -34.617793702029303,-58.45143709576341 -34.616766468541613,-58.452035827821547 -34.61571697786286)));;2696;6_11_1;COMUNA 6;11;1;1053;478;575;83,13%;478;477;99,79%;1;0,21%;429;2;0,47%;427;99,53%
MULTIPOLYGON (((-58.445380760258168 -34.618378281023709,-58.444182372901324 -34.617886397478543,-58.443753499573788 -34.61883087202429,-58.444212189460153 -34.619033203046094,-58.444198719564788 -34.619079329388335,-58.444192325948919 -34.61909975167255,-58.444149536782646 -34.619211650519276,-58.444693003434743 -34.61936054000013,-58.445143037921824 -34.619427016384201,-58.445380760258168 -34.618378281023709)));;2697;6_11_10;COMUNA 6;11;10;536;238;298;79,87%;297;297;100,00%;0;0,00%;240;6;2,50%;234;97,50%
MULTIPOLYGON (((-58.450271991355301 -34.61578202452818,-58.449489227059523 -34.615812718023449,-58.44914601562315 -34.615833455765419,-58.449162018373833 -34.61590691087126,-58.448515788475021 -34.617026525234273,-58.448010738829225 -34.617901707779694,-58.448177353157476 -34.617962504527007,-58.448962205526385 -34.618309649960608,-58.449378242783254 -34.617343183001765,-58.449425281248594 -34.61724395925453,-58.45001108817636 -34.616232506716912,-58.450271991355301 -34.61578202452818)));;2698;6_11_2;COMUNA 6;11;2;550;263;287;91,64%;295;295;100,00%;0;0,00%;242;1;0,41%;241;99,59%
MULTIPOLYGON (((-58.449162018373833 -34.61590691087126,-58.449009709115764 -34.615902809221403,-58.448876820424502 -34.615907864840132,-58.448653209611528 -34.615916360729507,-58.448585240651042 -34.615867337048762,-58.447696585973567 -34.615923641462707,-58.446838596915342 -34.615978041917266,-58.446696081572902 -34.61598591091046,-58.446730300264413 -34.616119159587967,-58.446681568063433 -34.616596564584633,-58.448270723483603 -34.616944592174576,-58.448515788475021 -34.617026525234273,-58.449162018373833 -34.61590691087126)));;2699;6_11_3;COMUNA 6;11;3;876;413;463;89,20%;449;449;100,00%;0;0,00%;368;24;6,52%;344;93,48%
MULTIPOLYGON (((-58.448515788475021 -34.617026525234273,-58.448270723483603 -34.616944592174576,-58.446681568063433 -34.616596564584633,-58.446604825818071 -34.617429189711075,-58.446591257026398 -34.617554474053321,-58.446738707554594 -34.617589987650419,-58.447811500440075 -34.617829004997184,-58.448010738829225 -34.617901707779694,-58.448515788475021 -34.617026525234273)));;2700;6_11_4;COMUNA 6;11;4;782;359;423;84,87%;408;408;100,00%;0;0,00%;343;0;0,00%;343;100,00%
MULTIPOLYGON (((-58.44562060816228 -34.617320249211637,-58.44462171931243 -34.616918964266844,-58.444182372901324 -34.617886397478543,-58.445380760258168 -34.618378281023709,-58.445143037921824 -34.619427016384201,-58.445088040364055 -34.61966948176164,-58.445173136924303 -34.619700973995698,-58.445604663157191 -34.61988730937238,-58.44601021714417 -34.620031666364788,-58.446076832995296 -34.620040408160918,-58.446170095291464 -34.619708507784686,-58.446233440490822 -34.619454282070897,-58.446263458026941 -34.619295477719447,-58.446407098554872 -34.618790056657453,-58.446451947595392 -34.618582590533499,-58.446490661781517 -34.618381109697872,-58.446520772906624 -34.618174486675784,-58.446530158114058 -34.618098921868039,-58.44654722205788 -34.617961665752027,-58.446591257026398 -34.617554474053321,-58.446604825818071 -34.617429189711075,-58.446681568063433 -34.616596564584633,-58.446730300264413 -34.616119159587967,-58.446696081572902 -34.61598591091046,-58.446181904306428 -34.616000983761069,-58.445920984726044 -34.615996440950809,-58.44562060816228 -34.617320249211637)));;2701;6_11_5;COMUNA 6;11;5;581;280;301;93,02%;315;315;100,00%;0;0,00%;249;2;0,80%;247;99,20%
MULTIPOLYGON (((-58.44506275388256 -34.615976741729675,-58.4433575395296 -34.615929791478166,-58.443189375670812 -34.616334708725709,-58.443337242367278 -34.616396706324061,-58.44445664422004 -34.616852599305751,-58.44462171931243 -34.616918964266844,-58.44562060816228 -34.617320249211637,-58.445920984726044 -34.615996440950809,-58.445525388800185 -34.615989484245453,-58.44506275388256 -34.615976741729675)));;2702;6_11_6;COMUNA 6;11;6;727;337;390;86,41%;384;384;100,00%;0;0,00%;309;1;0,32%;308;99,68%
MULTIPOLYGON (((-58.44462171931243 -34.616918964266844,-58.44445664422004 -34.616852599305751,-58.443337242367278 -34.616396706324061,-58.443189375670812 -34.616334708725709,-58.442782724302198 -34.617313973617527,-58.442884680881981 -34.617360329893117,-58.444009545300723 -34.617815453118865,-58.444182372901324 -34.617886397478543,-58.44462171931243 -34.616918964266844)));;2703;6_11_7;COMUNA 6;11;7;755;354;401;88,28%;405;405;100,00%;0;0,00%;357;20;5,60%;337;94,40%
MULTIPOLYGON (((-58.4433575395296 -34.615929791478166,-58.442264617612985 -34.615946797012832,-58.441852066897674 -34.615954262690082,-58.440863586841132 -34.615947681084961,-58.4406305238562 -34.615940174090625,-58.441380600651534 -34.617168168096612,-58.441539744108546 -34.616768040738123,-58.442662625216869 -34.61725937454878,-58.442782724302198 -34.617313973617527,-58.443189375670812 -34.616334708725709,-58.4433575395296 -34.615929791478166)));;2704;6_11_8;COMUNA 6;11;8;779;351;428;82,01%;460;460;100,00%;0;0,00%;369;2;0,54%;367;99,46%
MULTIPOLYGON (((-58.444182372901324 -34.617886397478543,-58.444009545300723 -34.617815453118865,-58.442884680881981 -34.617360329893117,-58.442782724302198 -34.617313973617527,-58.442662625216869 -34.61725937454878,-58.441539744108546 -34.616768040738123,-58.441380600651534 -34.617168168096612,-58.441901980942582 -34.618019837570472,-58.442402401045413 -34.618232042032957,-58.442568668574062 -34.618303691832409,-58.443532034814972 -34.61873181985321,-58.443664061822467 -34.61879085669127,-58.443753499573788 -34.61883087202429,-58.444182372901324 -34.617886397478543)));;2705;6_11_9;COMUNA 6;11;9;723;324;399;81,20%;330;329;99,70%;1;0,30%;288;5;1,74%;283;98,26%
MULTIPOLYGON (((-58.448010738829225 -34.617901707779694,-58.447811500440075 -34.617829004997184,-58.446738707554594 -34.617589987650419,-58.446591257026398 -34.617554474053321,-58.44654722205788 -34.617961665752027,-58.446530158114058 -34.618098921868039,-58.447178259265854 -34.618097597550005,-58.447659734130028 -34.618101601661614,-58.447892037364277 -34.61810768663284,-58.448010738829225 -34.617901707779694)));;2706;6_12_1;COMUNA 6;12;1;522;235;287;81,88%;326;326;100,00%;0;0,00%;256;3;1,17%;253;98,83%
MULTIPOLYGON (((-58.451205021808001 -34.623154769493084,-58.4501315819941 -34.622732184221263,-58.44995856873944 -34.622662304699531,-58.449407790746868 -34.623827497423555,-58.449892592706817 -34.624017767101158,-58.450434898833521 -34.624230647052457,-58.450664651480366 -34.624320391329476,-58.451205021808001 -34.623154769493084)));;2707;6_12_10;COMUNA 6;12;10;536;247;289;85,47%;311;311;100,00%;0;0,00%;236;3;1,27%;233;98,73%
MULTIPOLYGON (((-58.453537561194835 -34.624072674681891,-58.453355171283583 -34.624001109088802,-58.451205021808001 -34.623154769493084,-58.450664651480366 -34.624320391329476,-58.451986186046106 -34.624836588602477,-58.452181866225864 -34.624912946275892,-58.453002329974382 -34.625231405442307,-58.453537561194835 -34.624072674681891)));;2708;6_12_11;COMUNA 6;12;11;814;363;451;80,49%;502;502;100,00%;0;0,00%;372;7;1,88%;365;98,12%
MULTIPOLYGON (((-58.45457491507932 -34.624479874854003,-58.453537561194835 -34.624072674681891,-58.453002329974382 -34.625231405442307,-58.454031262200857 -34.625631003597974,-58.45457491507932 -34.624479874854003)));;2709;6_12_12;COMUNA 6;12;12;519;225;294;76,53%;255;254;99,61%;1;0,39%;208;2;0,96%;206;99,04%
MULTIPOLYGON (((-58.456076025478417 -34.621204359320757,-58.455172104220217 -34.620881197023294,-58.455022175270905 -34.620829495733048,-58.454781011534259 -34.620746378821543,-58.453975063336948 -34.620465609800767,-58.453655360412633 -34.62035424459151,-58.45336189707723 -34.620238091653746,-58.45307926797804 -34.621473253669556,-58.453442760530649 -34.621600117196294,-58.454505899516398 -34.621971403331564,-58.455557803092148 -34.622338665298443,-58.456076025478417 -34.621204359320757)));;2710;6_12_2;COMUNA 6;12;2;556;257;299;85,95%;256;255;99,61%;1;0,39%;228;23;10,09%;205;89,91%
MULTIPOLYGON (((-58.453442760530649 -34.621600117196294,-58.45307926797804 -34.621473253669556,-58.45336189707723 -34.620238091653746,-58.453204560176545 -34.620175823806647,-58.452698138943752 -34.619953240325323,-58.451499690460395 -34.619426427545172,-58.451319187657738 -34.619347112276465,-58.450229874671358 -34.618867904415374,-58.449209655991865 -34.618419118061063,-58.448962205526385 -34.618309649960608,-58.448177353157476 -34.617962504527007,-58.448010738829225 -34.617901707779694,-58.447892037364277 -34.61810768663284,-58.447659734130028 -34.618101601661614,-58.447178259265854 -34.618097597550005,-58.446530158114058 -34.618098921868039,-58.446520772906624 -34.618174486675784,-58.446490661781517 -34.618381109697872,-58.446451947595392 -34.618582590533499,-58.446407098554872 -34.618790056657453,-58.446263458026941 -34.619295477719447,-58.446233440490822 -34.619454282070897,-58.446170095291464 -34.619708507784686,-58.446076832995296 -34.620040408160918,-58.446007012832219 -34.620293013107926,-58.445964655604143 -34.620384137254071,-58.445731983516175 -34.620904193709315,-58.445844423047014 -34.620957521016877,-58.446491300675682 -34.621229308298673,-58.447630118802401 -34.62170778080997,-58.448688876167111 -34.62215264076972,-58.44995856873944 -34.622662304699531,-58.4501315819941 -34.622732184221263,-58.451205021808001 -34.623154769493084,-58.453355171283583 -34.624001109088802,-58.453537561194835 -34.624072674681891,-58.45457491507932 -34.624479874854003,-58.454762549427812 -34.624073112667382,-58.454679745820677 -34.624032965025414,-58.454762560259468 -34.624073117102228,-58.454830121189822 -34.623926773982319,-58.455048598802712 -34.62345310958856,-58.455557803092148 -34.622338665298443,-58.454505899516398 -34.621971403331564,-58.453442760530649 -34.621600117196294)));;2711;6_12_3;COMUNA 6;12;3;629;286;343;83,38%;373;372;99,73%;1;0,27%;288;1;0,35%;287;99,65%
MULTIPOLYGON (((-58.445006524868646 -34.620024834542527,-58.444885276655825 -34.62053884897314,-58.445046611608525 -34.620602607049271,-58.445566646556387 -34.620825787581815,-58.445731983516175 -34.620904193709315,-58.445964655604143 -34.620384137254071,-58.446007012832219 -34.620293013107926,-58.446076832995296 -34.620040408160918,-58.44601021714417 -34.620031666364788,-58.445604663157191 -34.61988730937238,-58.445173136924303 -34.619700973995698,-58.445088040364055 -34.61966948176164,-58.445055653573753 -34.61981594110879,-58.445006524868646 -34.620024834542527)));;2712;6_12_4;COMUNA 6;12;4;360;153;207;73,91%;267;267;100,00%;0;0,00%;193;1;0,52%;192;99,48%
MULTIPOLYGON (((-58.445731983516175 -34.620904193709315,-58.445566646556387 -34.620825787581815,-58.445046611608525 -34.620602607049271,-58.444885276655825 -34.62053884897314,-58.444846906065472 -34.620704271679955,-58.444794384033713 -34.620915398114434,-58.44435224113586 -34.621728881877956,-58.444487085295926 -34.621785453346412,-58.444426155095677 -34.62187199653745,-58.445168444876757 -34.622163383193403,-58.445731983516175 -34.620904193709315)));;2713;6_12_5;COMUNA 6;12;5;841;359;482;74,48%;502;502;100,00%;0;0,00%;384;7;1,82%;377;98,18%
MULTIPOLYGON (((-58.446491300675682 -34.621229308298673,-58.445844423047014 -34.620957521016877,-58.445731983516175 -34.620904193709315,-58.445168444876757 -34.622163383193403,-58.445787477964672 -34.622406436759775,-58.446491300675682 -34.621229308298673)));;2714;6_12_6;COMUNA 6;12;6;571;251;320;78,44%;301;301;100,00%;0;0,00%;243;4;1,65%;239;98,35%
MULTIPOLYGON (((-58.447630118802401 -34.62170778080997,-58.446491300675682 -34.621229308298673,-58.445787477964672 -34.622406436759775,-58.447012606820898 -34.62288732133014,-58.447090159408788 -34.622736833115169,-58.447630118802401 -34.62170778080997)));;2715;6_12_7;COMUNA 6;12;7;685;296;389;76,09%;494;494;100,00%;0;0,00%;349;2;0,57%;347;99,43%
MULTIPOLYGON (((-58.448688876167111 -34.62215264076972,-58.447630118802401 -34.62170778080997,-58.447090159408788 -34.622736833115169,-58.447012606820898 -34.62288732133014,-58.447263818756284 -34.622985948335284,-58.448122066810697 -34.623322826114347,-58.448688876167111 -34.62215264076972)));;2716;6_12_8;COMUNA 6;12;8;741;335;406;82,51%;409;409;100,00%;0;0,00%;303;8;2,64%;295;97,36%
MULTIPOLYGON (((-58.44995856873944 -34.622662304699531,-58.448688876167111 -34.62215264076972,-58.448122066810697 -34.623322826114347,-58.44864783767509 -34.623529232959775,-58.449407790746868 -34.623827497423555,-58.44995856873944 -34.622662304699531)));;2717;6_12_9;COMUNA 6;12;9;773;346;427;81,03%;461;461;100,00%;0;0,00%;362;3;0,83%;359;99,17%
MULTIPOLYGON (((-58.453002329974382 -34.625231405442307,-58.452181866225864 -34.624912946275892,-58.451986186046106 -34.624836588602477,-58.451470876970909 -34.625898620807213,-58.453437073407194 -34.626781069499259,-58.453938045438399 -34.62576438177144,-58.454031262200857 -34.625631003597974,-58.453002329974382 -34.625231405442307)));;2718;6_13_1;COMUNA 6;13;1;689;291;398;73,12%;418;418;100,00%;0;0,00%;307;3;0,98%;304;99,02%
MULTIPOLYGON (((-58.450664651480366 -34.624320391329476,-58.450434898833521 -34.624230647052457,-58.449892592706817 -34.624017767101158,-58.449498929383147 -34.625013674803249,-58.449705680359813 -34.625106376231344,-58.451470876970909 -34.625898620807213,-58.451986186046106 -34.624836588602477,-58.450664651480366 -34.624320391329476)));;2719;6_13_2;COMUNA 6;13;2;1302;557;745;74,77%;703;702;99,86%;1;0,14%;586;2;0,34%;584;99,66%
MULTIPOLYGON (((-58.451470876970909 -34.625898620807213,-58.449705680359813 -34.625106376231344,-58.449498929383147 -34.625013674803249,-58.449111052275327 -34.625995003754298,-58.449351879063478 -34.626113696359219,-58.450052127726067 -34.626468712630711,-58.450972597472152 -34.626935440164289,-58.451072391840029 -34.626719738171829,-58.451470876970909 -34.625898620807213)));;2720;6_13_3;COMUNA 6;13;3;764;338;426;79,34%;366;364;99,45%;2;0,55%;302;2;0,66%;300;99,34%
MULTIPOLYGON (((-58.453437073407194 -34.626781069499259,-58.451470876970909 -34.625898620807213,-58.451072391840029 -34.626719738171829,-58.450972597472152 -34.626935440164289,-58.452870557941161 -34.627924655428856,-58.453437073407194 -34.626781069499259)));;2721;6_13_4;COMUNA 6;13;4;1240;540;700;77,14%;577;576;99,83%;1;0,17%;497;5;1,01%;492;98,99%
MULTIPOLYGON (((-58.452870557941161 -34.627924655428856,-58.450972597472152 -34.626935440164289,-58.450860871484295 -34.627176916431154,-58.450395132118715 -34.628145494626779,-58.451183610664565 -34.628290153957657,-58.451508118804774 -34.628349129812378,-58.452568801025969 -34.628541834642711,-58.452669188957998 -34.628331202043178,-58.452870557941161 -34.627924655428856)));;2722;6_13_5;COMUNA 6;13;5;873;378;495;76,36%;526;525;99,81%;1;0,19%;361;19;5,26%;342;94,74%
MULTIPOLYGON (((-58.450972597472152 -34.626935440164289,-58.450052127726067 -34.626468712630711,-58.449312394943284 -34.62794685277202,-58.450395132118715 -34.628145494626779,-58.450860871484295 -34.627176916431154,-58.450972597472152 -34.626935440164289)));;2723;6_13_6;COMUNA 6;13;6;535;212;323;65,63%;364;364;100,00%;0;0,00%;267;1;0,37%;266;99,63%
MULTIPOLYGON (((-58.447994672066898 -34.628819195200585,-58.447513509117648 -34.630036500975592,-58.448222260758484 -34.630143280864537,-58.448345504141606 -34.629878990825219,-58.448807520754173 -34.628955773947283,-58.449312394943284 -34.62794685277202,-58.450052127726067 -34.626468712630711,-58.449351879063478 -34.626113696359219,-58.449111052275327 -34.625995003754298,-58.448784021560435 -34.626822389385254,-58.448408656970088 -34.627771955600089,-58.447994672066898 -34.628819195200585)));;2724;6_13_7;COMUNA 6;13;7;862;392;470;83,40%;463;463;100,00%;0;0,00%;369;12;3,25%;357;96,75%
MULTIPOLYGON (((-58.451039566548801 -34.629334259874931,-58.450158213487335 -34.629182688482452,-58.449916001547237 -34.629142028170897,-58.450395132118715 -34.628145494626779,-58.449312394943284 -34.62794685277202,-58.448807520754173 -34.628955773947283,-58.448345504141606 -34.629878990825219,-58.448222260758484 -34.630143280864537,-58.449054038814502 -34.6302685217793,-58.44935895958465 -34.630313345738536,-58.450497963839851 -34.630480653675413,-58.451576396947573 -34.630639071928073,-58.451995267679848 -34.629745417599302,-58.452102902314437 -34.629519574366363,-58.451039566548801 -34.629334259874931)));;2725;6_13_8;COMUNA 6;13;8;1221;572;649;88,14%;638;638;100,00%;0;0,00%;497;16;3,22%;481;96,78%
MULTIPOLYGON (((-58.452568801025969 -34.628541834642711,-58.451508118804774 -34.628349129812378,-58.451183610664565 -34.628290153957657,-58.450395132118715 -34.628145494626779,-58.449916001547237 -34.629142028170897,-58.450158213487335 -34.629182688482452,-58.451039566548801 -34.629334259874931,-58.452102902314437 -34.629519574366363,-58.452568801025969 -34.628541834642711)));;2726;6_13_9;COMUNA 6;13;9;896;420;476;88,24%;552;552;100,00%;0;0,00%;426;2;0,47%;424;99,53%
MULTIPOLYGON (((-58.449407790746868 -34.623827497423555,-58.44864783767509 -34.623529232959775,-58.448122066810697 -34.623322826114347,-58.447785051822088 -34.624247324249808,-58.448068978179172 -34.624373067178247,-58.448266355460298 -34.624461474008449,-58.449498929383147 -34.625013674803249,-58.449892592706817 -34.624017767101158,-58.449407790746868 -34.623827497423555)));;2727;6_14_1;COMUNA 6;14;1;896;383;513;74,66%;475;473;99,58%;2;0,42%;382;2;0,52%;380;99,48%
MULTIPOLYGON (((-58.446570038411039 -34.628598937306045,-58.444995724238744 -34.62836195042906,-58.44447754315599 -34.629583041878647,-58.446060910306656 -34.629818416862378,-58.446423676018377 -34.629872340850291,-58.447513509117648 -34.630036500975592,-58.447994672066898 -34.628819195200585,-58.447663007398262 -34.628763448666724,-58.446570038411039 -34.628598937306045)));;2728;6_14_10;COMUNA 6;14;10;912;423;489;86,50%;576;576;100,00%;0;0,00%;392;8;2,04%;384;97,96%
MULTIPOLYGON (((-58.448266355460298 -34.624461474008449,-58.448068978179172 -34.624373067178247,-58.447785051822088 -34.624247324249808,-58.44744521757891 -34.625173863283734,-58.447885887502956 -34.625391108120702,-58.449111052275327 -34.625995003754298,-58.449498929383147 -34.625013674803249,-58.448266355460298 -34.624461474008449)));;2729;6_14_2;COMUNA 6;14;2;625;269;356;75,56%;320;320;100,00%;0;0,00%;250;6;2,40%;244;97,60%
MULTIPOLYGON (((-58.448122066810697 -34.623322826114347,-58.447263818756284 -34.622985948335284,-58.446897585130777 -34.623854452525627,-58.446531173415188 -34.624723307592696,-58.44744521757891 -34.625173863283734,-58.447785051822088 -34.624247324249808,-58.448122066810697 -34.623322826114347)));;2730;6_14_3;COMUNA 6;14;3;850;394;456;86,40%;495;493;99,60%;2;0,41%;384;47;12,24%;337;87,76%
MULTIPOLYGON (((-58.447012606820898 -34.62288732133014,-58.445787477964672 -34.622406436759775,-58.444977691387123 -34.62381813112502,-58.44567201277993 -34.624227187748801,-58.446531173415188 -34.624723307592696,-58.446897585130777 -34.623854452525627,-58.447263818756284 -34.622985948335284,-58.447012606820898 -34.62288732133014)));;2731;6_14_4;COMUNA 6;14;4;1059;471;588;80,10%;699;699;100,00%;0;0,00%;531;2;0,38%;529;99,62%
MULTIPOLYGON (((-58.444595271776407 -34.625341014521368,-58.444518204390846 -34.625969334356164,-58.444418876907456 -34.626702161334222,-58.444369147944442 -34.626974768753485,-58.444953057475175 -34.627081478437574,-58.445327633238549 -34.625594228257079,-58.446047384401666 -34.625877155188029,-58.446142763545552 -34.625644272904822,-58.446531173415188 -34.624723307592696,-58.44567201277993 -34.624227187748801,-58.444977691387123 -34.62381813112502,-58.444809543483792 -34.624111144828788,-58.444698921422201 -34.624304092930721,-58.444595271776407 -34.625341014521368)));;2732;6_14_5;COMUNA 6;14;5;1031;468;563;83,13%;517;516;99,81%;1;0,19%;407;3;0,74%;404;99,26%
MULTIPOLYGON (((-58.447481801451161 -34.626378486401947,-58.447885887502956 -34.625391108120702,-58.44744521757891 -34.625173863283734,-58.446531173415188 -34.624723307592696,-58.446142763545552 -34.625644272904822,-58.446047384401666 -34.625877155188029,-58.445327633238549 -34.625594228257079,-58.444953057475175 -34.627081478437574,-58.445502891360668 -34.627181983132473,-58.446655979290782 -34.627392710759423,-58.447032105489249 -34.627474100432245,-58.447381737282335 -34.626623200504071,-58.447481801451161 -34.626378486401947)));;2733;6_14_6;COMUNA 6;14;6;1161;544;617;88,17%;618;618;100,00%;0;0,00%;484;13;2,69%;471;97,31%
MULTIPOLYGON (((-58.449111052275327 -34.625995003754298,-58.447885887502956 -34.625391108120702,-58.447481801451161 -34.626378486401947,-58.448784021560435 -34.626822389385254,-58.449111052275327 -34.625995003754298)));;2734;6_14_7;COMUNA 6;14;7;539;243;296;82,09%;277;277;100,00%;0;0,00%;237;2;0,84%;235;99,16%
MULTIPOLYGON (((-58.448784021560435 -34.626822389385254,-58.447481801451161 -34.626378486401947,-58.447381737282335 -34.626623200504071,-58.447032105489249 -34.627474100432245,-58.448408656970088 -34.627771955600089,-58.448784021560435 -34.626822389385254)));;2735;6_14_8;COMUNA 6;14;8;540;253;287;88,15%;276;275;99,64%;1;0,36%;218;1;0,46%;217;99,54%
MULTIPOLYGON (((-58.447032105489249 -34.627474100432245,-58.446655979290782 -34.627392710759423,-58.445502891360668 -34.627181983132473,-58.445383305958806 -34.627448383682783,-58.444995724238744 -34.62836195042906,-58.446570038411039 -34.628598937306045,-58.447663007398262 -34.628763448666724,-58.447994672066898 -34.628819195200585,-58.448408656970088 -34.627771955600089,-58.447032105489249 -34.627474100432245)));;2736;6_14_9;COMUNA 6;14;9;794;376;418;89,95%;411;411;100,00%;0;0,00%;309;3;0,97%;306;99,03%
MULTIPOLYGON (((-58.44362024501131 -34.623018462167657,-58.443540565503838 -34.623128030928797,-58.443454000225081 -34.623910649911416,-58.443442388718552 -34.62402015888771,-58.443693533402126 -34.624036536867507,-58.444809543483792 -34.624111144828788,-58.444977691387123 -34.62381813112502,-58.445787477964672 -34.622406436759775,-58.445168444876757 -34.622163383193403,-58.444426155095677 -34.62187199653745,-58.44362024501131 -34.623018462167657)));;2737;6_15_1;COMUNA 6;15;1;671;304;367;82,83%;385;384;99,74%;1;0,26%;284;7;2,46%;277;97,54%
MULTIPOLYGON (((-58.444081929244909 -34.628224344954042,-58.443172397516072 -34.628085043115433,-58.442925196071201 -34.629352088134787,-58.44447754315599 -34.629583041878647,-58.444995724238744 -34.62836195042906,-58.444081929244909 -34.628224344954042)));;2738;6_15_10;COMUNA 6;15;10;716;349;367;95,10%;375;375;100,00%;0;0,00%;305;0;0,00%;305;100,00%
MULTIPOLYGON (((-58.442803277619113 -34.621292985826912,-58.442799238060324 -34.621291369673052,-58.441877604976455 -34.622845354278773,-58.442758832639022 -34.622821909152478,-58.443547500398623 -34.622978519810708,-58.44362024501131 -34.623018462167657,-58.444426155095677 -34.62187199653745,-58.444487085295926 -34.621785453346412,-58.44435224113586 -34.621728881877956,-58.443534917387318 -34.621385927380018,-58.442893574263451 -34.621116789373659,-58.442803277619113 -34.621292985826912)));;2739;6_15_2;COMUNA 6;15;2;1667;708;959;73,83%;983;983;100,00%;0;0,00%;770;0;0,00%;770;100,00%
MULTIPOLYGON (((-58.44362024501131 -34.623018462167657,-58.443547500398623 -34.622978519810708,-58.442758832639022 -34.622821909152478,-58.441877604976455 -34.622845354278773,-58.441773573933943 -34.623911570431567,-58.443442388718552 -34.62402015888771,-58.443454000225081 -34.623910649911416,-58.443540565503838 -34.623128030928797,-58.44362024501131 -34.623018462167657)));;2740;6_15_3;COMUNA 6;15;3;816;367;449;81,74%;451;451;100,00%;0;0,00%;358;2;0,56%;356;99,44%
MULTIPOLYGON (((-58.443442388718552 -34.62402015888771,-58.441773573933943 -34.623911570431567,-58.441643953337845 -34.625091588604953,-58.442547839466364 -34.625179490761447,-58.443323598496399 -34.625254900719099,-58.443330186948323 -34.625132221514335,-58.443442388718552 -34.62402015888771)));;2741;6_15_4;COMUNA 6;15;4;682;318;364;87,36%;347;347;100,00%;0;0,00%;270;3;1,11%;267;98,89%
MULTIPOLYGON (((-58.444809543483792 -34.624111144828788,-58.443693533402126 -34.624036536867507,-58.443442388718552 -34.62402015888771,-58.443330186948323 -34.625132221514335,-58.443323598496399 -34.625254900719099,-58.444595271776407 -34.625341014521368,-58.444698921422201 -34.624304092930721,-58.444809543483792 -34.624111144828788)));;2742;6_15_5;COMUNA 6;15;5;760;338;422;80,09%;418;417;99,76%;1;0,24%;320;0;0,00%;320;100,00%
MULTIPOLYGON (((-58.442280906263676 -34.626653862803963,-58.442928969461953 -34.626734042707575,-58.443242222909781 -34.626780010130304,-58.443553858050315 -34.626825694794597,-58.444369147944442 -34.626974768753485,-58.444418876907456 -34.626702161334222,-58.444518204390846 -34.625969334356164,-58.444595271776407 -34.625341014521368,-58.443323598496399 -34.625254900719099,-58.442547839466364 -34.625179490761447,-58.441643953337845 -34.625091588604953,-58.441565393630967 -34.625806669859998,-58.441483245852339 -34.626555202196755,-58.442280906263676 -34.626653862803963)));;2743;6_15_6;COMUNA 6;15;6;803;361;442;81,67%;352;351;99,72%;1;0,28%;283;3;1,06%;280;98,94%
MULTIPOLYGON (((-58.442280906263676 -34.626653862803963,-58.441483245852339 -34.626555202196755,-58.441404171016167 -34.627274931130721,-58.441344052781496 -34.627821910940511,-58.440285354388827 -34.627669462325507,-58.439769944843427 -34.628491084366715,-58.43952762742385 -34.628855276168657,-58.441759385837365 -34.629181676586846,-58.442925196071201 -34.629352088134787,-58.443172397516072 -34.628085043115433,-58.443204058836486 -34.627493197209233,-58.443242222909781 -34.626780010130304,-58.442928969461953 -34.626734042707575,-58.442280906263676 -34.626653862803963)));;2744;6_15_7;COMUNA 6;15;7;859;402;457;87,96%;420;419;99,76%;1;0,24%;335;18;5,37%;317;94,63%
MULTIPOLYGON (((-58.444369147944442 -34.626974768753485,-58.443553858050315 -34.626825694794597,-58.443242222909781 -34.626780010130304,-58.443204058836486 -34.627493197209233,-58.443172397516072 -34.628085043115433,-58.444081929244909 -34.628224344954042,-58.444328801590508 -34.627195826512306,-58.444369147944442 -34.626974768753485)));;2745;6_15_8;COMUNA 6;15;8;959;438;521;84,07%;560;560;100,00%;0;0,00%;445;1;0,22%;444;99,78%
MULTIPOLYGON (((-58.444953057475175 -34.627081478437574,-58.444369147944442 -34.626974768753485,-58.444328801590508 -34.627195826512306,-58.444081929244909 -34.628224344954042,-58.444995724238744 -34.62836195042906,-58.445383305958806 -34.627448383682783,-58.445502891360668 -34.627181983132473,-58.444953057475175 -34.627081478437574)));;2746;6_15_9;COMUNA 6;15;9;517;250;267;93,63%;295;295;100,00%;0;0,00%;227;1;0,44%;226;99,56%
MULTIPOLYGON (((-58.441877604976455 -34.622845354278773,-58.441205606838508 -34.622871294959452,-58.440845409086251 -34.622899893921748,-58.440744208391401 -34.623843640690112,-58.441584704822695 -34.623899283942009,-58.441773573933943 -34.623911570431567,-58.441877604976455 -34.622845354278773)));;2747;6_16_1;COMUNA 6;16;1;672;292;380;76,84%;321;321;100,00%;0;0,00%;283;2;0,71%;281;99,29%
MULTIPOLYGON (((-58.437444686777461 -34.627253822791531,-58.435934571430252 -34.627032577806055,-58.435037161562228 -34.626901035110777,-58.43480455105108 -34.627997216373593,-58.434763176558263 -34.628158339094817,-58.435647479873076 -34.628287697703733,-58.43716954439877 -34.628510357202821,-58.437410476296556 -34.627408187122789,-58.437444686777461 -34.627253822791531)));;2748;6_16_10;COMUNA 6;16;10;1155;531;624;85,10%;612;612;100,00%;0;0,00%;499;42;8,42%;457;91,58%
MULTIPOLYGON (((-58.435260267192817 -34.625932883597919,-58.434658378548171 -34.62589605532677,-58.434306704134265 -34.625868367400813,-58.434108404090793 -34.626764971272202,-58.433818304069767 -34.628020086207854,-58.434763176558263 -34.628158339094817,-58.43480455105108 -34.627997216373593,-58.435037161562228 -34.626901035110777,-58.435934571430252 -34.627032577806055,-58.4360510266104 -34.626523431105845,-58.436199095266367 -34.625990346646738,-58.435260267192817 -34.625932883597919)));;2749;6_16_11;COMUNA 6;16;11;886;391;495;78,99%;499;499;100,00%;0;0,00%;390;6;1,54%;384;98,46%
MULTIPOLYGON (((-58.44062105641855 -34.624992108575654,-58.440544280953631 -34.625692752393917,-58.440470988090233 -34.626427552808167,-58.441020138542648 -34.626497865300081,-58.441483245852339 -34.626555202196755,-58.441565393630967 -34.625806669859998,-58.441643953337845 -34.625091588604953,-58.441773573933943 -34.623911570431567,-58.441584704822695 -34.623899283942009,-58.440744208391401 -34.623843640690112,-58.44062105641855 -34.624992108575654)));;2750;6_16_2;COMUNA 6;16;2;678;299;379;78,89%;347;347;100,00%;0;0,00%;284;2;0,70%;282;99,30%
MULTIPOLYGON (((-58.439369658510806 -34.62372478991059,-58.439261911774018 -34.624859244823618,-58.439543383863104 -34.624887327710539,-58.44062105641855 -34.624992108575654,-58.440744208391401 -34.623843640690112,-58.440845409086251 -34.622899893921748,-58.439434595905475 -34.623040130817458,-58.439369658510806 -34.62372478991059)));;2751;6_16_3;COMUNA 6;16;3;945;432;513;84,21%;520;520;100,00%;0;0,00%;393;9;2,29%;384;97,71%
MULTIPOLYGON (((-58.438452408096595 -34.623665101940119,-58.438346873823228 -34.624765893368348,-58.4382139058402 -34.626150632331672,-58.439114214971326 -34.626262081126484,-58.439147582174087 -34.626064193516612,-58.439261911774018 -34.624859244823618,-58.439369658510806 -34.62372478991059,-58.439434595905475 -34.623040130817458,-58.438917978097173 -34.623091511843398,-58.43850299752954 -34.623129389290504,-58.438452408096595 -34.623665101940119)));;2752;6_16_4;COMUNA 6;16;4;696;317;379;83,64%;393;393;100,00%;0;0,00%;310;3;0,97%;307;99,03%
MULTIPOLYGON (((-58.43850299752954 -34.623129389290504,-58.437729689722246 -34.623199165436638,-58.43720395646811 -34.623243565263977,-58.436934920653187 -34.623241677687055,-58.436561780413292 -34.623239133429593,-58.436262253729204 -34.623212518669249,-58.43622664151895 -34.624559951650284,-58.437402530387665 -34.624675768521648,-58.437709899610923 -34.624705339931729,-58.437951671909538 -34.624728559030984,-58.438346873823228 -34.624765893368348,-58.438452408096595 -34.623665101940119,-58.43850299752954 -34.623129389290504)));;2753;6_16_5;COMUNA 6;16;5;976;440;536;82,09%;463;463;100,00%;0;0,00%;393;1;0,25%;392;99,75%
MULTIPOLYGON (((-58.437709899610923 -34.624705339931729,-58.437402530387665 -34.624675768521648,-58.43622664151895 -34.624559951650284,-58.436199095266367 -34.625990346646738,-58.4373693948274 -34.626062006168304,-58.437677024650547 -34.62609185940952,-58.437963952905328 -34.626119735780463,-58.4382139058402 -34.626150632331672,-58.438346873823228 -34.624765893368348,-58.437951671909538 -34.624728559030984,-58.437709899610923 -34.624705339931729)));;2754;6_16_6;COMUNA 6;16;6;979;449;530;84,72%;513;513;100,00%;0;0,00%;415;0;0,00%;415;100,00%
MULTIPOLYGON (((-58.4382139058402 -34.626150632331672,-58.437963952905328 -34.626119735780463,-58.437677024650547 -34.62609185940952,-58.4373693948274 -34.626062006168304,-58.436199095266367 -34.625990346646738,-58.4360510266104 -34.626523431105845,-58.435934571430252 -34.627032577806055,-58.437444686777461 -34.627253822791531,-58.438864590994797 -34.627461862021427,-58.439078799589574 -34.626471729287104,-58.439114214971326 -34.626262081126484,-58.4382139058402 -34.626150632331672)));;2755;6_16_7;COMUNA 6;16;7;1040;489;551;88,75%;497;497;100,00%;0;0,00%;388;13;3,35%;375;96,65%
MULTIPOLYGON (((-58.441483245852339 -34.626555202196755,-58.441020138542648 -34.626497865300081,-58.440470988090233 -34.626427552808167,-58.440544280953631 -34.625692752393917,-58.44062105641855 -34.624992108575654,-58.439543383863104 -34.624887327710539,-58.439261911774018 -34.624859244823618,-58.439147582174087 -34.626064193516612,-58.439114214971326 -34.626262081126484,-58.439078799589574 -34.626471729287104,-58.438864590994797 -34.627461862021427,-58.440074671566478 -34.62763914071531,-58.440285354388827 -34.627669462325507,-58.441344052781496 -34.627821910940511,-58.441404171016167 -34.627274931130721,-58.441483245852339 -34.626555202196755)));;2756;6_16_8;COMUNA 6;16;8;1406;674;732;92,08%;653;653;100,00%;0;0,00%;560;4;0,71%;556;99,29%
MULTIPOLYGON (((-58.438864590994797 -34.627461862021427,-58.437444686777461 -34.627253822791531,-58.437410476296556 -34.627408187122789,-58.43716954439877 -34.628510357202821,-58.43859279199831 -34.628718541107929,-58.43952762742385 -34.628855276168657,-58.439769944843427 -34.628491084366715,-58.440285354388827 -34.627669462325507,-58.440074671566478 -34.62763914071531,-58.438864590994797 -34.627461862021427)));;2757;6_16_9;COMUNA 6;16;9;1087;520;567;91,71%;525;525;100,00%;0;0,00%;418;6;1,44%;412;98,56%
MULTIPOLYGON (((-58.440923464124388 -34.622173122153576,-58.440845409086251 -34.622899893921748,-58.441205606838508 -34.622871294959452,-58.441877604976455 -34.622845354278773,-58.442799238060324 -34.621291369673052,-58.441100414223421 -34.620824937689299,-58.440948146392394 -34.62193516055266,-58.440923464124388 -34.622173122153576)));;2758;6_17_1;COMUNA 6;17;1;838;351;487;72,07%;590;590;100,00%;0;0,00%;416;2;0,48%;414;99,52%
MULTIPOLYGON (((-58.440250704296879 -34.619984895751081,-58.439013835313673 -34.619435839794008,-58.438730795089633 -34.620185881234619,-58.438917939071452 -34.620242046587208,-58.440885580619714 -34.620769756691161,-58.441100414223421 -34.620824937689299,-58.442799238060324 -34.621291369673052,-58.442803277619113 -34.621292985826912,-58.442893574263451 -34.621116789373659,-58.442889070283279 -34.621114899271753,-58.441462633629641 -34.620516258107806,-58.44120981931669 -34.62041022421144,-58.440250704296879 -34.619984895751081)));;2759;6_17_2;COMUNA 6;17;2;899;365;534;68,35%;586;586;100,00%;0;0,00%;419;3;0,72%;416;99,28%
MULTIPOLYGON (((-58.439013835313673 -34.619435839794008,-58.437746574713941 -34.61887324343455,-58.437331012858358 -34.619768893426922,-58.437554102243126 -34.61983260382052,-58.438188615631233 -34.620023091746596,-58.438730795089633 -34.620185881234619,-58.439013835313673 -34.619435839794008)));;2760;6_17_3;COMUNA 6;17;3;708;311;397;78,34%;462;462;100,00%;0;0,00%;309;2;0,65%;307;99,35%
MULTIPOLYGON (((-58.438730795089633 -34.620185881234619,-58.438188615631233 -34.620023091746596,-58.43767512821865 -34.62134134338681,-58.438261760745242 -34.62158534404427,-58.438670179487147 -34.620346508733164,-58.438730795089633 -34.620185881234619)));;2761;6_17_4;COMUNA 6;17;4;747;313;434;72,12%;439;439;100,00%;0;0,00%;360;3;0,83%;357;99,17%
MULTIPOLYGON (((-58.441100414223421 -34.620824937689299,-58.440885580619714 -34.620769756691161,-58.438917939071452 -34.620242046587208,-58.438730795089633 -34.620185881234619,-58.438670179487147 -34.620346508733164,-58.438261760745242 -34.62158534404427,-58.439158008951715 -34.621724187093328,-58.440948146392394 -34.62193516055266,-58.441100414223421 -34.620824937689299)));;2762;6_17_5;COMUNA 6;17;5;1730;750;980;76,53%;1062;1062;100,00%;0;0,00%;839;56;6,67%;783;93,33%
MULTIPOLYGON (((-58.440948146392394 -34.62193516055266,-58.439158008951715 -34.621724187093328,-58.438788335034801 -34.623025427880279,-58.438917978097173 -34.623091511843398,-58.439434595905475 -34.623040130817458,-58.440845409086251 -34.622899893921748,-58.440923464124388 -34.622173122153576,-58.440948146392394 -34.62193516055266)));;2763;6_17_6;COMUNA 6;17;6;1047;433;614;70,52%;649;649;100,00%;0;0,00%;507;2;0,39%;505;99,61%
MULTIPOLYGON (((-58.437930924192067 -34.62258862198285,-58.437729689722246 -34.623199165436638,-58.43850299752954 -34.623129389290504,-58.438917978097173 -34.623091511843398,-58.438788335034801 -34.623025427880279,-58.439158008951715 -34.621724187093328,-58.438261760745242 -34.62158534404427,-58.437930924192067 -34.62258862198285)));;2764;6_17_7;COMUNA 6;17;7;606;263;343;76,68%;359;359;100,00%;0;0,00%;277;0;0,00%;277;100,00%
MULTIPOLYGON (((-58.437746574713941 -34.61887324343455,-58.436456844987347 -34.618300699103088,-58.436009762790434 -34.619164576211205,-58.435913777357591 -34.619363505827565,-58.43609188909241 -34.619415166338122,-58.437331012858358 -34.619768893426922,-58.437746574713941 -34.61887324343455)));;2765;6_18_1;COMUNA 6;18;1;623;250;373;67,02%;346;346;100,00%;0;0,00%;263;0;0,00%;263;100,00%
MULTIPOLYGON (((-58.437331012858358 -34.619768893426922,-58.43609188909241 -34.619415166338122,-58.435913777357591 -34.619363505827565,-58.435824270086961 -34.619549056037805,-58.435500359940342 -34.620407324173229,-58.435684163795678 -34.62051307293688,-58.436940287901244 -34.621035616401841,-58.43767512821865 -34.62134134338681,-58.438188615631233 -34.620023091746596,-58.437554102243126 -34.61983260382052,-58.437331012858358 -34.619768893426922)));;2766;6_18_2;COMUNA 6;18;2;611;259;352;73,58%;309;308;99,68%;1;0,32%;256;2;0,78%;254;99,22%
MULTIPOLYGON (((-58.435913777357591 -34.619363505827565,-58.435671099393289 -34.619293168140416,-58.434683666590658 -34.619095896183296,-58.434536214356655 -34.619072762826541,-58.43413348261943 -34.620210878126883,-58.435500359940342 -34.620407324173229,-58.435824270086961 -34.619549056037805,-58.435913777357591 -34.619363505827565)));;2767;6_18_3;COMUNA 6;18;3;648;292;356;82,02%;356;356;100,00%;0;0,00%;313;2;0,64%;311;99,36%
MULTIPOLYGON (((-58.436456844987347 -34.618300699103088,-58.435283565760571 -34.617779859283438,-58.434736835435459 -34.61753712096381,-58.434131168581501 -34.617268238710182,-58.433118723122952 -34.616818685686276,-58.432860992790708 -34.616704534357055,-58.432211219159079 -34.616416546555385,-58.431766698179231 -34.617633167989332,-58.431492933233251 -34.617569645314191,-58.431305703838923 -34.618674495455799,-58.431542512383153 -34.618707374225401,-58.431691582614931 -34.618728046737381,-58.431737070696748 -34.618733410592419,-58.432586097260142 -34.618834049202114,-58.43339892245568 -34.618930940686205,-58.434369255268102 -34.619046526062313,-58.434536214356655 -34.619072762826541,-58.434683666590658 -34.619095896183296,-58.435671099393289 -34.619293168140416,-58.435913777357591 -34.619363505827565,-58.436009762790434 -34.619164576211205,-58.436456844987347 -34.618300699103088)));;2768;6_18_4;COMUNA 6;18;4;722;320;402;79,60%;428;428;100,00%;0;0,00%;309;4;1,29%;305;98,71%
MULTIPOLYGON (((-58.431634526481673 -34.61616089900788,-58.431359169930559 -34.616038922824835,-58.430906699332589 -34.617299906925368,-58.430871639952805 -34.617425536039256,-58.431492933233251 -34.617569645314191,-58.431766698179231 -34.617633167989332,-58.432211219159079 -34.616416546555385,-58.431634526481673 -34.61616089900788)));;2769;6_18_5;COMUNA 6;18;5;812;336;476;70,59%;506;506;100,00%;0;0,00%;390;13;3,33%;377;96,67%
MULTIPOLYGON (((-58.431359169930559 -34.616038922824835,-58.43086884482269 -34.615821605027492,-58.430776009544594 -34.615780452540932,-58.430252982405094 -34.615548616137488,-58.429576802525361 -34.617234057808375,-58.430208270794118 -34.617271623318771,-58.430339615654816 -34.617302081844031,-58.430871639952805 -34.617425536039256,-58.430906699332589 -34.617299906925368,-58.431359169930559 -34.616038922824835)));;2770;6_18_6;COMUNA 6;18;6;1083;503;580;86,72%;526;526;100,00%;0;0,00%;454;13;2,86%;441;97,14%
MULTIPOLYGON (((-58.429252501814581 -34.615105654049721,-58.429219048898354 -34.615257340444359,-58.428793026403937 -34.617187009837771,-58.429086825083495 -34.617204979100293,-58.429576802525361 -34.617234057808375,-58.430252982405094 -34.615548616137488,-58.430028561113765 -34.615449186493485,-58.429252501814581 -34.615105654049721)));;2771;6_18_7;COMUNA 6;18;7;1153;495;658;75,23%;622;622;100,00%;0;0,00%;526;12;2,28%;514;97,72%
MULTIPOLYGON (((-58.429576802525361 -34.617234057808375,-58.429086825083495 -34.617204979100293,-58.428793026403937 -34.617187009837771,-58.428588286283173 -34.618114168671575,-58.428550985680452 -34.618294798414702,-58.428791456900299 -34.618323246774985,-58.429959136839528 -34.618484486918284,-58.430208270794118 -34.617271623318771,-58.429576802525361 -34.617234057808375)));;2772;6_18_8;COMUNA 6;18;8;1071;470;601;78,20%;684;684;100,00%;0;0,00%;512;4;0,78%;508;99,22%
MULTIPOLYGON (((-58.431492933233251 -34.617569645314191,-58.430871639952805 -34.617425536039256,-58.430339615654816 -34.617302081844031,-58.430208270794118 -34.617271623318771,-58.429959136839528 -34.618484486918284,-58.430155482654854 -34.618511582663338,-58.430625945760013 -34.618578399755627,-58.431168644571827 -34.618655515777633,-58.431305703838923 -34.618674495455799,-58.431492933233251 -34.617569645314191)));;2773;6_18_9;COMUNA 6;18;9;819;362;457;79,21%;487;487;100,00%;0;0,00%;395;32;8,10%;363;91,90%
MULTIPOLYGON (((-58.434536214356655 -34.619072762826541,-58.434369255268102 -34.619046526062313,-58.43339892245568 -34.618930940686205,-58.432985365016499 -34.620046302342864,-58.43413348261943 -34.620210878126883,-58.434536214356655 -34.619072762826541)));;2774;6_19_1;COMUNA 6;19;1;887;377;510;73,92%;474;474;100,00%;0;0,00%;385;13;3,38%;372;96,62%
MULTIPOLYGON (((-58.431737070696748 -34.618733410592419,-58.431691582614931 -34.618728046737381,-58.431542512383153 -34.618707374225401,-58.431347844369903 -34.619652991390623,-58.431308754738538 -34.619847847323719,-58.432985365016499 -34.620046302342864,-58.43339892245568 -34.618930940686205,-58.432586097260142 -34.618834049202114,-58.431737070696748 -34.618733410592419)));;2775;6_19_2;COMUNA 6;19;2;1468;630;838;75,18%;806;806;100,00%;0;0,00%;641;4;0,62%;637;99,38%
MULTIPOLYGON (((-58.430625945760013 -34.618578399755627,-58.430155482654854 -34.618511582663338,-58.429959136839528 -34.618484486918284,-58.429761633813072 -34.619446228147524,-58.429727743911734 -34.619623760432226,-58.431308754738538 -34.619847847323719,-58.431347844369903 -34.619652991390623,-58.431542512383153 -34.618707374225401,-58.431305703838923 -34.618674495455799,-58.431168644571827 -34.618655515777633,-58.430625945760013 -34.618578399755627)));;2776;6_19_3;COMUNA 6;19;3;1420;606;814;74,45%;770;768;99,74%;2;0,26%;603;4;0,66%;599;99,34%
MULTIPOLYGON (((-58.429959136839528 -34.618484486918284,-58.428791456900299 -34.618323246774985,-58.428550985680452 -34.618294798414702,-58.428317533157291 -34.619425265581121,-58.428598470884374 -34.619456261016332,-58.429581483781043 -34.619603086286133,-58.429727743911734 -34.619623760432226,-58.429761633813072 -34.619446228147524,-58.429959136839528 -34.618484486918284)));;2777;6_19_4;COMUNA 6;19;4;1010;443;567;78,13%;557;557;100,00%;0;0,00%;453;4;0,88%;449;99,12%
MULTIPOLYGON (((-58.429727743911734 -34.619623760432226,-58.429581483781043 -34.619603086286133,-58.428598470884374 -34.619456261016332,-58.428317533157291 -34.619425265581121,-58.428283987193296 -34.61958765618531,-58.428068772169667 -34.620683901231352,-58.428337195176248 -34.620705245485816,-58.429491303572277 -34.620800427588904,-58.429696756351916 -34.619785940836898,-58.429727743911734 -34.619623760432226)));;2778;6_19_5;COMUNA 6;19;5;748;315;433;72,75%;387;386;99,74%;1;0,26%;305;0;0,00%;305;100,00%
MULTIPOLYGON (((-58.431308754738538 -34.619847847323719,-58.429727743911734 -34.619623760432226,-58.429696756351916 -34.619785940836898,-58.429491303572277 -34.620800427588904,-58.431091197958189 -34.620932336090902,-58.431124058042357 -34.620768465646748,-58.431308754738538 -34.619847847323719)));;2779;6_19_6;COMUNA 6;19;6;1017;447;570;78,42%;546;546;100,00%;0;0,00%;439;2;0,46%;437;99,54%
MULTIPOLYGON (((-58.432985365016499 -34.620046302342864,-58.431308754738538 -34.619847847323719,-58.431124058042357 -34.620768465646748,-58.431091197958189 -34.620932336090902,-58.432621158668688 -34.621058501960945,-58.432653061399435 -34.620942660715052,-58.432985365016499 -34.620046302342864)));;2780;6_19_7;COMUNA 6;19;7;966;412;554;74,37%;513;513;100,00%;0;0,00%;444;7;1,58%;437;98,42%
MULTIPOLYGON (((-58.43413348261943 -34.620210878126883,-58.432985365016499 -34.620046302342864,-58.432653061399435 -34.620942660715052,-58.432621158668688 -34.621058501960945,-58.433191317253474 -34.621105544255975,-58.43378975871623 -34.621154914616675,-58.433835646537418 -34.620994145232977,-58.43413348261943 -34.620210878126883)));;2781;6_19_8;COMUNA 6;19;8;907;403;504;79,96%;543;543;100,00%;0;0,00%;431;3;0,70%;428;99,30%
MULTIPOLYGON (((-58.447946257298831 -34.615468021815467,-58.447696585973567 -34.615923641462707,-58.448585240651042 -34.615867337048762,-58.448653209611528 -34.615916360729507,-58.448876820424502 -34.615907864840132,-58.449009709115764 -34.615902809221403,-58.449162018373833 -34.61590691087126,-58.44914601562315 -34.615833455765419,-58.449489227059523 -34.615812718023449,-58.450271991355301 -34.61578202452818,-58.450719297152681 -34.615764463012681,-58.45137010908126 -34.61574043982155,-58.452164857556212 -34.614562651907669,-58.451609238637708 -34.614331185887394,-58.451453362660672 -34.614266239702701,-58.450367348501601 -34.61381203388266,-58.450237538673129 -34.613757652532819,-58.449127090108853 -34.613306250140674,-58.448631263032198 -34.614217776155293,-58.448558153546784 -34.614351293635231,-58.447946257298831 -34.615468021815467)));;2782;6_2_1;COMUNA 6;2;1;1081;527;554;95,13%;450;449;99,78%;1;0,22%;387;9;2,33%;378;97,67%
MULTIPOLYGON (((-58.450783820479238 -34.61787757268452,-58.450701086574384 -34.618001090074181,-58.450229874671358 -34.618867904415374,-58.451319187657738 -34.619347112276465,-58.451499690460395 -34.619426427545172,-58.452698138943752 -34.619953240325323,-58.453174800029238 -34.618940355545369,-58.453223368710113 -34.618837116252763,-58.453287526797894 -34.618731835817307,-58.45380473282858 -34.617621694525049,-58.453860883269826 -34.617502046476012,-58.452586800515661 -34.617118060640713,-58.451670238252248 -34.616841774212169,-58.45143709576341 -34.616766468541613,-58.450840822203133 -34.617793702029303,-58.450783820479238 -34.61787757268452)));;2783;6_2_10;COMUNA 6;2;10;917;458;459;99,78%;364;364;100,00%;0;0,00%;334;5;1,50%;329;98,50%
MULTIPOLYGON (((-58.453975063336948 -34.620465609800767,-58.454781011534259 -34.620746378821543,-58.455022175270905 -34.620829495733048,-58.455172104220217 -34.620881197023294,-58.456076025478417 -34.621204359320757,-58.456623032157246 -34.620007092413225,-58.45555871552277 -34.619643148742249,-58.454526863701069 -34.619290395520864,-58.454584886533119 -34.619189550775495,-58.455173055111999 -34.617897500617516,-58.453860883269826 -34.617502046476012,-58.45380473282858 -34.617621694525049,-58.453287526797894 -34.618731835817307,-58.453223368710113 -34.618837116252763,-58.453174800029238 -34.618940355545369,-58.452698138943752 -34.619953240325323,-58.453204560176545 -34.620175823806647,-58.45336189707723 -34.620238091653746,-58.453655360412633 -34.62035424459151,-58.453975063336948 -34.620465609800767)));;2784;6_2_11;COMUNA 6;2;11;1327;622;705;88,23%;572;570;99,65%;2;0,35%;508;14;2,76%;494;97,24%
MULTIPOLYGON (((-58.454141371755753 -34.612810067251708,-58.453527667976026 -34.612556069784972,-58.45290553544536 -34.612298547289789,-58.451605150756855 -34.611763416506577,-58.451002786249802 -34.612760368291354,-58.450689499880262 -34.613278948176635,-58.450367348501601 -34.61381203388266,-58.451453362660672 -34.614266239702701,-58.451609238637708 -34.614331185887394,-58.452164857556212 -34.614562651907669,-58.452250397316973 -34.61443596456737,-58.452779988086355 -34.613653374941102,-58.45285223511965 -34.613547461476465,-58.453245927716488 -34.61371630153166,-58.453428294286631 -34.613794628212503,-58.454141371755753 -34.612810067251708)));;2785;6_2_2;COMUNA 6;2;2;899;437;462;94,59%;377;377;100,00%;0;0,00%;334;0;0,00%;334;100,00%
MULTIPOLYGON (((-58.455355768798789 -34.612224843468802,-58.454754247095153 -34.611963951220915,-58.454118743750563 -34.611688405190101,-58.453510423927099 -34.611350038694674,-58.453372781818089 -34.61127347616064,-58.452971269638709 -34.611056042500685,-58.452278721424953 -34.610680901175769,-58.45217768229395 -34.610812587461453,-58.451605150756855 -34.611763416506577,-58.45290553544536 -34.612298547289789,-58.453527667976026 -34.612556069784972,-58.454141371755753 -34.612810067251708,-58.454798605381399 -34.613082022844587,-58.454158530616006 -34.61410814352918,-58.454776590985539 -34.614373546903124,-58.455194728986932 -34.613706507048185,-58.455254645732381 -34.612376040015235,-58.455355768798789 -34.612224843468802)));;2786;6_2_3;COMUNA 6;2;3;591;275;316;87,03%;281;280;99,64%;1;0,36%;243;10;4,12%;233;95,88%
MULTIPOLYGON (((-58.453428294286631 -34.613794628212503,-58.453245927716488 -34.61371630153166,-58.45285223511965 -34.613547461476465,-58.452779988086355 -34.613653374941102,-58.452250397316973 -34.61443596456737,-58.452164857556212 -34.614562651907669,-58.45137010908126 -34.61574043982155,-58.452035827821547 -34.61571697786286,-58.452995944366343 -34.615683113135916,-58.453184542479121 -34.61568242374134,-58.453427703253901 -34.615279611141183,-58.453522274038434 -34.61512813398862,-58.454158530616006 -34.61410814352918,-58.454798605381399 -34.613082022844587,-58.454141371755753 -34.612810067251708,-58.453428294286631 -34.613794628212503)));;2787;6_2_4;COMUNA 6;2;4;667;309;358;86,31%;283;283;100,00%;0;0,00%;247;12;4,86%;235;95,14%
MULTIPOLYGON (((-58.455355768798789 -34.612224843468802,-58.455254645732381 -34.612376040015235,-58.455194728986932 -34.613706507048185,-58.454776590985539 -34.614373546903124,-58.454158530616006 -34.61410814352918,-58.453522274038434 -34.61512813398862,-58.453427703253901 -34.615279611141183,-58.453184542479121 -34.61568242374134,-58.453256863978176 -34.615682147660586,-58.45396789755209 -34.615679735749019,-58.454136647702136 -34.615679113885349,-58.454721096561748 -34.615685139639375,-58.454841206303776 -34.615686415086699,-58.455084321061832 -34.615699952115854,-58.455276751474528 -34.615710668584811,-58.456162323854436 -34.615760016793544,-58.45710641876704 -34.615812600823347,-58.457306005070073 -34.61582521589564,-58.45849917976804 -34.615900476772211,-58.459033082429059 -34.614734466290216,-58.459448384254372 -34.613885644692253,-58.459195822296017 -34.613789507470798,-58.457328332646256 -34.613036877125531,-58.457074668752142 -34.612934678893794,-58.456947411148057 -34.61288333307165,-58.455896477831331 -34.612451150643963,-58.455536430473046 -34.612303166914842,-58.455355768798789 -34.612224843468802)));;2788;6_2_5;COMUNA 6;2;5;634;299;335;89,25%;259;258;99,61%;1;0,39%;226;0;0,00%;226;100,00%
MULTIPOLYGON (((-58.457306005070073 -34.61582521589564,-58.45710641876704 -34.615812600823347,-58.456162323854436 -34.615760016793544,-58.455276751474528 -34.615710668584811,-58.455084321061832 -34.615699952115854,-58.454841206303776 -34.615686415086699,-58.454721096561748 -34.615685139639375,-58.454136647702136 -34.615679113885349,-58.45396789755209 -34.615679735749019,-58.453256863978176 -34.615682147660586,-58.453098467277705 -34.616021654474231,-58.454370745070158 -34.616422466496452,-58.455659645827353 -34.616828407213269,-58.456692410999345 -34.617153685274559,-58.456759206802104 -34.617011429968244,-58.457306005070073 -34.61582521589564)));;2789;6_2_6;COMUNA 6;2;6;905;395;510;77,45%;391;390;99,74%;1;0,26%;342;8;2,34%;334;97,66%
MULTIPOLYGON (((-58.45849917976804 -34.615900476772211,-58.457306005070073 -34.61582521589564,-58.456759206802104 -34.617011429968244,-58.456692410999345 -34.617153685274559,-58.457591529769481 -34.617436834882319,-58.457765731224669 -34.617506069860852,-58.458198613144624 -34.61656063045406,-58.45849917976804 -34.615900476772211)));;2790;6_2_7;COMUNA 6;2;7;737;305;432;70,60%;417;417;100,00%;0;0,00%;346;4;1,16%;342;98,84%
MULTIPOLYGON (((-58.455173055111999 -34.617897500617516,-58.454584886533119 -34.619189550775495,-58.454526863701069 -34.619290395520864,-58.45555871552277 -34.619643148742249,-58.456623032157246 -34.620007092413225,-58.457224636153903 -34.618690314022174,-58.45729475530775 -34.618536861029249,-58.457765731224669 -34.617506069860852,-58.457591529769481 -34.617436834882319,-58.456692410999345 -34.617153685274559,-58.455659645827353 -34.616828407213269,-58.455173055111999 -34.617897500617516)));;2791;6_2_8;COMUNA 6;2;8;1089;497;592;83,95%;446;445;99,78%;1;0,22%;368;6;1,63%;362;98,37%
MULTIPOLYGON (((-58.454370745070158 -34.616422466496452,-58.453098467277705 -34.616021654474231,-58.453256863978176 -34.615682147660586,-58.453184542479121 -34.61568242374134,-58.452995944366343 -34.615683113135916,-58.452035827821547 -34.61571697786286,-58.45143709576341 -34.616766468541613,-58.451670238252248 -34.616841774212169,-58.452586800515661 -34.617118060640713,-58.453860883269826 -34.617502046476012,-58.455173055111999 -34.617897500617516,-58.455659645827353 -34.616828407213269,-58.454370745070158 -34.616422466496452)));;2792;6_2_9;COMUNA 6;2;9;660;291;369;78,86%;296;295;99,66%;1;0,34%;252;3;1,19%;249;98,81%
MULTIPOLYGON (((-58.438261760745242 -34.62158534404427,-58.43767512821865 -34.62134134338681,-58.436940287901244 -34.621035616401841,-58.436803080764676 -34.621476025223913,-58.436658453153974 -34.6219402359188,-58.43731210506877 -34.622273272578504,-58.437930924192067 -34.62258862198285,-58.438261760745242 -34.62158534404427)));;2793;6_20_1;COMUNA 6;20;1;491;226;265;85,28%;273;273;100,00%;0;0,00%;214;4;1,87%;210;98,13%
MULTIPOLYGON (((-58.429491303572277 -34.620800427588904,-58.428337195176248 -34.620705245485816,-58.428068772169667 -34.620683901231352,-58.427941655211164 -34.621331352421784,-58.427842965412246 -34.621833806506807,-58.427795328290458 -34.622074505458436,-58.429197734927385 -34.622298145846116,-58.429231300648929 -34.622084837810412,-58.429491303572277 -34.620800427588904)));;2794;6_20_10;COMUNA 6;20;10;864;356;508;70,08%;485;485;100,00%;0;0,00%;385;1;0,26%;384;99,74%
MULTIPOLYGON (((-58.43731210506877 -34.622273272578504,-58.436658453153974 -34.6219402359188,-58.436262253729204 -34.623212518669249,-58.436561780413292 -34.623239133429593,-58.436934920653187 -34.623241677687055,-58.43720395646811 -34.623243565263977,-58.437729689722246 -34.623199165436638,-58.437930924192067 -34.62258862198285,-58.43731210506877 -34.622273272578504)));;2795;6_20_2;COMUNA 6;20;2;558;242;316;76,58%;344;344;100,00%;0;0,00%;258;1;0,39%;257;99,61%
MULTIPOLYGON (((-58.436803080764676 -34.621476025223913,-58.435421524908541 -34.621295647419437,-58.435173970446762 -34.621272140290408,-58.435099960618011 -34.621468186728869,-58.434704312703857 -34.622809833232438,-58.434657633102141 -34.623047084227231,-58.435981809670395 -34.623187667978634,-58.436262253729204 -34.623212518669249,-58.436658453153974 -34.6219402359188,-58.436803080764676 -34.621476025223913)));;2796;6_20_3;COMUNA 6;20;3;970;430;540;79,63%;650;650;100,00%;0;0,00%;447;5;1,12%;442;98,88%
MULTIPOLYGON (((-58.436940287901244 -34.621035616401841,-58.435684163795678 -34.62051307293688,-58.435500359940342 -34.620407324173229,-58.435173970446762 -34.621272140290408,-58.435421524908541 -34.621295647419437,-58.436803080764676 -34.621476025223913,-58.436940287901244 -34.621035616401841)));;2797;6_20_4;COMUNA 6;20;4;532;243;289;84,08%;343;343;100,00%;0;0,00%;256;2;0,78%;254;99,22%
MULTIPOLYGON (((-58.435500359940342 -34.620407324173229,-58.43413348261943 -34.620210878126883,-58.433835646537418 -34.620994145232977,-58.43378975871623 -34.621154914616675,-58.434918152932134 -34.621247926527502,-58.435173970446762 -34.621272140290408,-58.435500359940342 -34.620407324173229)));;2798;6_20_5;COMUNA 6;20;5;836;352;484;72,73%;528;528;100,00%;0;0,00%;384;2;0,52%;382;99,48%
MULTIPOLYGON (((-58.435173970446762 -34.621272140290408,-58.434918152932134 -34.621247926527502,-58.43378975871623 -34.621154914616675,-58.433743444351826 -34.621316881102324,-58.43341507237615 -34.622912914392309,-58.434657633102141 -34.623047084227231,-58.434704312703857 -34.622809833232438,-58.435099960618011 -34.621468186728869,-58.435173970446762 -34.621272140290408)));;2799;6_20_6;COMUNA 6;20;6;824;368;456;80,70%;484;484;100,00%;0;0,00%;380;2;0,53%;378;99,47%
MULTIPOLYGON (((-58.433191317253474 -34.621105544255975,-58.432621158668688 -34.621058501960945,-58.432209314608649 -34.622556198196932,-58.432154374507192 -34.622766050863895,-58.43283306524409 -34.62285030633528,-58.43341507237615 -34.622912914392309,-58.433743444351826 -34.621316881102324,-58.43378975871623 -34.621154914616675,-58.433191317253474 -34.621105544255975)));;2800;6_20_7;COMUNA 6;20;7;603;273;330;82,73%;315;315;100,00%;0;0,00%;254;1;0,39%;253;99,61%
MULTIPOLYGON (((-58.432621158668688 -34.621058501960945,-58.431091197958189 -34.620932336090902,-58.430815680467227 -34.622305762815607,-58.430759192220677 -34.622545263370228,-58.432154374507192 -34.622766050863895,-58.432209314608649 -34.622556198196932,-58.432621158668688 -34.621058501960945)));;2801;6_20_8;COMUNA 6;20;8;1194;525;669;78,48%;575;575;100,00%;0;0,00%;483;4;0,83%;479;99,17%
MULTIPOLYGON (((-58.431091197958189 -34.620932336090902,-58.429491303572277 -34.620800427588904,-58.429231300648929 -34.622084837810412,-58.429197734927385 -34.622298145846116,-58.430759192220677 -34.622545263370228,-58.430815680467227 -34.622305762815607,-58.431091197958189 -34.620932336090902)));;2802;6_20_9;COMUNA 6;20;9;770;351;419;83,77%;371;371;100,00%;0;0,00%;317;3;0,95%;314;99,05%
MULTIPOLYGON (((-58.43622664151895 -34.624559951650284,-58.434481489525467 -34.624459275296054,-58.434353217512147 -34.625626468566352,-58.434306704134265 -34.625868367400813,-58.434658378548171 -34.62589605532677,-58.435260267192817 -34.625932883597919,-58.436199095266367 -34.625990346646738,-58.43622664151895 -34.624559951650284)));;2803;6_21_1;COMUNA 6;21;1;620;266;354;75,14%;385;385;100,00%;0;0,00%;293;19;6,48%;274;93,52%
MULTIPOLYGON (((-58.431220177161848 -34.626341076710212,-58.431050988982619 -34.626316172930345,-58.429918469034973 -34.626152206294336,-58.429633843617097 -34.62741287642676,-58.430933782006065 -34.62760083386182,-58.432333741883212 -34.627803239487193,-58.432624630487012 -34.626547494413465,-58.432464301274443 -34.626524003276955,-58.431220177161848 -34.626341076710212)));;2804;6_21_10;COMUNA 6;21;10;825;389;436;89,22%;470;470;100,00%;0;0,00%;368;2;0,54%;366;99,46%
MULTIPOLYGON (((-58.427040591793293 -34.625731666341153,-58.426971619178531 -34.626047572402307,-58.426819342007356 -34.626720085748154,-58.42675583645687 -34.626998456761918,-58.427080071613759 -34.627045877420507,-58.428160121350153 -34.627200136902744,-58.428367135599764 -34.627229703386128,-58.429633843617097 -34.62741287642676,-58.429918469034973 -34.626152206294336,-58.429955934812646 -34.625986295221153,-58.430083857886473 -34.62543419800577,-58.428583906856673 -34.625277233079153,-58.427176135105327 -34.625134854548271,-58.427040591793293 -34.625731666341153)));;2805;6_21_11;COMUNA 6;21;11;1008;453;555;81,62%;474;471;99,37%;3;0,64%;387;1;0,26%;386;99,74%
MULTIPOLYGON (((-58.436262253729204 -34.623212518669249,-58.435981809670395 -34.623187667978634,-58.434657633102141 -34.623047084227231,-58.434610270677389 -34.623287363311071,-58.434481489525467 -34.624459275296054,-58.43622664151895 -34.624559951650284,-58.436262253729204 -34.623212518669249)));;2806;6_21_2;COMUNA 6;21;2;992;431;561;76,83%;556;556;100,00%;0;0,00%;452;21;4,65%;431;95,35%
MULTIPOLYGON (((-58.43283306524409 -34.62285030633528,-58.432154374507192 -34.622766050863895,-58.431969845423382 -34.623470817567835,-58.431789919980723 -34.624158471813338,-58.431994286701979 -34.624188806157576,-58.433119301847952 -34.624311130601505,-58.434481489525467 -34.624459275296054,-58.434610270677389 -34.623287363311071,-58.434657633102141 -34.623047084227231,-58.43341507237615 -34.622912914392309,-58.43283306524409 -34.62285030633528)));;2807;6_21_3;COMUNA 6;21;3;1027;465;562;82,74%;564;564;100,00%;0;0,00%;454;51;11,23%;403;88,77%
MULTIPOLYGON (((-58.430594418415367 -34.6232447513148,-58.430421364483308 -34.623979519667351,-58.431622354751966 -34.624133498804511,-58.431789919980723 -34.624158471813338,-58.431969845423382 -34.623470817567835,-58.432154374507192 -34.622766050863895,-58.430759192220677 -34.622545263370228,-58.430594418415367 -34.6232447513148)));;2808;6_21_4;COMUNA 6;21;4;614;278;336;82,74%;353;353;100,00%;0;0,00%;262;5;1,91%;257;98,09%
MULTIPOLYGON (((-58.430759192220677 -34.622545263370228,-58.429197734927385 -34.622298145846116,-58.429159983923078 -34.622538143778485,-58.428919630761463 -34.623659665441657,-58.428894193150107 -34.623783606319591,-58.430421364483308 -34.623979519667351,-58.430594418415367 -34.6232447513148,-58.430759192220677 -34.622545263370228)));;2809;6_21_5;COMUNA 6;21;5;784;362;422;85,78%;411;411;100,00%;0;0,00%;330;4;1,21%;326;98,79%
MULTIPOLYGON (((-58.429197734927385 -34.622298145846116,-58.427795328290458 -34.622074505458436,-58.427491486658894 -34.623607569674647,-58.427703691117628 -34.623630870975227,-58.428894193150107 -34.623783606319591,-58.428919630761463 -34.623659665441657,-58.429159983923078 -34.622538143778485,-58.429197734927385 -34.622298145846116)));;2810;6_21_6;COMUNA 6;21;6;523;221;302;73,18%;293;292;99,66%;1;0,34%;231;2;0,87%;229;99,13%
MULTIPOLYGON (((-58.430421364483308 -34.623979519667351,-58.428894193150107 -34.623783606319591,-58.427703691117628 -34.623630870975227,-58.427491486658894 -34.623607569674647,-58.427462032383666 -34.623756369104647,-58.427237424469723 -34.624852538788517,-58.427176135105327 -34.625134854548271,-58.428583906856673 -34.625277233079153,-58.430083857886473 -34.62543419800577,-58.430256837317273 -34.624687387623545,-58.430383732444724 -34.624139515198593,-58.430421364483308 -34.623979519667351)));;2811;6_21_7;COMUNA 6;21;7;963;427;536;79,66%;445;443;99,55%;2;0,45%;378;41;10,85%;337;89,15%
MULTIPOLYGON (((-58.430083857886473 -34.62543419800577,-58.429955934812646 -34.625986295221153,-58.429918469034973 -34.626152206294336,-58.431050988982619 -34.626316172930345,-58.431220177161848 -34.626341076710212,-58.432464301274443 -34.626524003276955,-58.432624630487012 -34.626547494413465,-58.432816276007259 -34.625720048582963,-58.432860304462096 -34.625529912033436,-58.433119301847952 -34.624311130601505,-58.431994286701979 -34.624188806157576,-58.431789919980723 -34.624158471813338,-58.431622354751966 -34.624133498804511,-58.430421364483308 -34.623979519667351,-58.430383732444724 -34.624139515198593,-58.430256837317273 -34.624687387623545,-58.430083857886473 -34.62543419800577)));;2812;6_21_8;COMUNA 6;21;8;1223;572;651;87,86%;574;573;99,83%;1;0,17%;465;26;5,59%;439;94,41%
MULTIPOLYGON (((-58.432624630487012 -34.626547494413465,-58.432333741883212 -34.627803239487193,-58.432545103791831 -34.62783378590894,-58.433818304069767 -34.628020086207854,-58.434108404090793 -34.626764971272202,-58.434306704134265 -34.625868367400813,-58.434353217512147 -34.625626468566352,-58.434481489525467 -34.624459275296054,-58.433119301847952 -34.624311130601505,-58.432860304462096 -34.625529912033436,-58.432816276007259 -34.625720048582963,-58.432624630487012 -34.626547494413465)));;2813;6_21_9;COMUNA 6;21;9;740;345;395;87,34%;364;364;100,00%;0;0,00%;294;4;1,36%;290;98,64%
MULTIPOLYGON (((-58.454371199355393 -34.610168367127045,-58.454303557882277 -34.610263858950027,-58.453510423927099 -34.611350038694674,-58.454118743750563 -34.611688405190101,-58.454754247095153 -34.611963951220915,-58.455577190473569 -34.610795860839524,-58.455662124414928 -34.610675297977508,-58.456353342950266 -34.609694313999078,-58.456886781495967 -34.608937059179972,-58.45567032538473 -34.608372115143162,-58.45559553134629 -34.608475213213339,-58.455166526565051 -34.609070139012474,-58.455085342163365 -34.609181898654192,-58.454448893158791 -34.610058579646079,-58.454371199355393 -34.610168367127045)));;2814;6_3_1;COMUNA 6;3;1;962;427;535;79,81%;446;445;99,78%;1;0,22%;367;14;3,81%;353;96,19%
MULTIPOLYGON (((-58.445864445442062 -34.607442037197558,-58.445677757181507 -34.607357430690371,-58.445360476322683 -34.607772119704634,-58.445102150796608 -34.608109771279032,-58.444901589199048 -34.608372075830587,-58.444430000331799 -34.608988930300534,-58.445229839540971 -34.609286382345417,-58.445626056320407 -34.609433767800944,-58.446161785887071 -34.609633003848458,-58.446572144545293 -34.609785599598844,-58.44654075693213 -34.608683512615862,-58.446513600339117 -34.607728825818363,-58.446247447131995 -34.607615617009024,-58.445864445442062 -34.607442037197558)));;2815;6_3_10;COMUNA 6;3;10;864;407;457;89,06%;476;475;99,79%;1;0,21%;393;3;0,76%;390;99,24%
MULTIPOLYGON (((-58.453335010440739 -34.607049021866516,-58.4532244611107 -34.606974714793203,-58.452553419194899 -34.606521897496549,-58.45241008173479 -34.606424910046123,-58.451687285952978 -34.607085787049101,-58.452566911341862 -34.607640109206784,-58.452676524630867 -34.607709416605502,-58.45202021582098 -34.608581998847811,-58.451948484758489 -34.608675024152113,-58.452057928107557 -34.608747712486355,-58.452528918973094 -34.60906853913766,-58.45317076697259 -34.609505719727139,-58.453292645217111 -34.609607282215791,-58.453841162041769 -34.6098905026954,-58.454371199355393 -34.610168367127045,-58.454448893158791 -34.610058579646079,-58.455085342163365 -34.609181898654192,-58.455166526565051 -34.609070139012474,-58.45559553134629 -34.608475213213339,-58.45567032538473 -34.608372115143162,-58.454451501571064 -34.607799552850921,-58.453335010440739 -34.607049021866516)));;2816;6_3_2;COMUNA 6;3;2;874;393;481;81,70%;388;386;99,48%;2;0,52%;303;27;8,91%;276;91,09%
MULTIPOLYGON (((-58.453841162041769 -34.6098905026954,-58.453292645217111 -34.609607282215791,-58.45317076697259 -34.609505719727139,-58.452528918973094 -34.60906853913766,-58.452057928107557 -34.608747712486355,-58.451948484758489 -34.608675024152113,-58.45095471195593 -34.609963712367538,-58.451593419115206 -34.61030970036353,-58.452278721424953 -34.610680901175769,-58.452971269638709 -34.611056042500685,-58.453372781818089 -34.61127347616064,-58.453510423927099 -34.611350038694674,-58.454303557882277 -34.610263858950027,-58.454371199355393 -34.610168367127045,-58.453841162041769 -34.6098905026954)));;2817;6_3_3;COMUNA 6;3;3;909;445;464;95,91%;447;447;100,00%;0;0,00%;349;5;1,43%;344;98,57%
MULTIPOLYGON (((-58.451593419115206 -34.61030970036353,-58.45095471195593 -34.609963712367538,-58.449920475814331 -34.609403517414435,-58.449172642139779 -34.610805530472724,-58.450258529433206 -34.6112331264438,-58.451605150756855 -34.611763416506577,-58.45217768229395 -34.610812587461453,-58.452278721424953 -34.610680901175769,-58.451593419115206 -34.61030970036353)));;2818;6_3_4;COMUNA 6;3;4;635;281;354;79,38%;294;293;99,66%;1;0,34%;243;1;0,41%;242;99,59%
MULTIPOLYGON (((-58.449920475814331 -34.609403517414435,-58.448893492997641 -34.608847187847658,-58.448032936674579 -34.61035664996546,-58.449172642139779 -34.610805530472724,-58.449920475814331 -34.609403517414435)));;2819;6_3_5;COMUNA 6;3;5;720;346;374;92,51%;309;309;100,00%;0;0,00%;260;5;1,92%;255;98,08%
MULTIPOLYGON (((-58.450985138410303 -34.608018080187513,-58.450157819354828 -34.607451779773932,-58.450019593266795 -34.607357184510548,-58.448893492997641 -34.608847187847658,-58.449920475814331 -34.609403517414435,-58.45095471195593 -34.609963712367538,-58.451948484758489 -34.608675024152113,-58.451838871246032 -34.608602335703694,-58.450985138410303 -34.608018080187513)));;2820;6_3_6;COMUNA 6;3;6;880;399;481;82,95%;433;433;100,00%;0;0,00%;356;4;1,12%;352;98,88%
MULTIPOLYGON (((-58.450738771085163 -34.606494056006589,-58.450655978031683 -34.606515104984872,-58.450019593266795 -34.607357184510548,-58.450157819354828 -34.607451779773932,-58.450985138410303 -34.608018080187513,-58.451838871246032 -34.608602335703694,-58.451948484758489 -34.608675024152113,-58.45202021582098 -34.608581998847811,-58.452676524630867 -34.607709416605502,-58.452566911341862 -34.607640109206784,-58.451687285952978 -34.607085787049101,-58.45241008173479 -34.606424910046123,-58.452263337909145 -34.606325598104114,-58.452015073824754 -34.606167260848622,-58.451507586089662 -34.606298417430423,-58.451049926099159 -34.606414857807671,-58.450738771085163 -34.606494056006589)));;2821;6_3_7;COMUNA 6;3;7;876;396;480;82,50%;440;439;99,77%;1;0,23%;370;2;0,54%;368;99,46%
MULTIPOLYGON (((-58.449061988758643 -34.606914181999706,-58.44906160831394 -34.606914599953079,-58.448769744063128 -34.607235142277311,-58.448341910678991 -34.607706729901189,-58.447808517828548 -34.608294715905693,-58.447959268948594 -34.608361074692837,-58.448253956544775 -34.608500762988129,-58.448893492997641 -34.608847187847658,-58.450019593266795 -34.607357184510548,-58.450655978031683 -34.606515104984872,-58.450236986600054 -34.606621757022303,-58.449289972558667 -34.606857651315075,-58.449290078128513 -34.60685772359399,-58.449061988758643 -34.606914181999706)));;2822;6_3_8;COMUNA 6;3;8;732;313;419;74,70%;367;367;100,00%;0;0,00%;305;8;2,62%;297;97,38%
MULTIPOLYGON (((-58.44906160831394 -34.606914599953079,-58.44704004740607 -34.607418178773464,-58.446627265396941 -34.607521016236795,-58.446247447131995 -34.607615617009024,-58.446513600339117 -34.607728825818363,-58.44654075693213 -34.608683512615862,-58.446572144545293 -34.609785599598844,-58.446762589633096 -34.609856401871852,-58.448032936674579 -34.61035664996546,-58.448893492997641 -34.608847187847658,-58.448253956544775 -34.608500762988129,-58.447959268948594 -34.608361074692837,-58.447808517828548 -34.608294715905693,-58.448341910678991 -34.607706729901189,-58.448769744063128 -34.607235142277311,-58.44906160831394 -34.606914599953079)));;2823;6_3_9;COMUNA 6;3;9;1142;530;612;86,60%;510;510;100,00%;0;0,00%;451;7;1,55%;444;98,45%
MULTIPOLYGON (((-58.449700869272348 -34.612251203964775,-58.449127090108853 -34.613306250140674,-58.450237538673129 -34.613757652532819,-58.450367348501601 -34.61381203388266,-58.450689499880262 -34.613278948176635,-58.451002786249802 -34.612760368291354,-58.451605150756855 -34.611763416506577,-58.450258529433206 -34.6112331264438,-58.449778405887798 -34.61210860138528,-58.449700869272348 -34.612251203964775)));;2824;6_4_1;COMUNA 6;4;1;554;257;297;86,53%;245;245;100,00%;0;0,00%;208;1;0,48%;207;99,52%
MULTIPOLYGON (((-58.4433575395296 -34.615929791478166,-58.44506275388256 -34.615976741729675,-58.445525388800185 -34.615989484245453,-58.445920984726044 -34.615996440950809,-58.446181904306428 -34.616000983761069,-58.445228596971184 -34.615624217782511,-58.443731959315222 -34.615032705484914,-58.442405011165114 -34.614508247783505,-58.44215032309819 -34.615161468031644,-58.441943109092733 -34.615692860423771,-58.441905007349654 -34.61579053348256,-58.441852066897674 -34.615954262690082,-58.442264617612985 -34.615946797012832,-58.4433575395296 -34.615929791478166)));;2825;6_4_10;COMUNA 6;4;10;804;391;413;94,67%;426;426;100,00%;0;0,00%;339;10;2,95%;329;97,05%
MULTIPOLYGON (((-58.440689783924903 -34.614756832570329,-58.440629223690848 -34.61505929726934,-58.440564250834107 -34.615938049332172,-58.4406305238562 -34.615940174090625,-58.440863586841132 -34.615947681084961,-58.441852066897674 -34.615954262690082,-58.441905007349654 -34.61579053348256,-58.441943109092733 -34.615692860423771,-58.44215032309819 -34.615161468031644,-58.442405011165114 -34.614508247783505,-58.440993331795326 -34.613950238226309,-58.440733796374928 -34.614537255151063,-58.440689783924903 -34.614756832570329)));;2826;6_4_11;COMUNA 6;4;11;762;343;419;81,86%;419;419;100,00%;0;0,00%;345;1;0,29%;344;99,71%
MULTIPOLYGON (((-58.447457536006091 -34.611384504331625,-58.446608355663514 -34.61105635514464,-58.446638052707939 -34.612099918205196,-58.44662727799394 -34.612317600751012,-58.44688186496623 -34.612415736178058,-58.448058900034859 -34.612874843412477,-58.447522863097149 -34.613757133747093,-58.447440467275577 -34.613891071962016,-58.448558153546784 -34.614351293635231,-58.448631263032198 -34.614217776155293,-58.449127090108853 -34.613306250140674,-58.449700869272348 -34.612251203964775,-58.449778405887798 -34.61210860138528,-58.450258529433206 -34.6112331264438,-58.449172642139779 -34.610805530472724,-58.448623487695123 -34.611835012948049,-58.447457536006091 -34.611384504331625)));;2827;6_4_2;COMUNA 6;4;2;658;308;350;88,00%;272;272;100,00%;0;0,00%;227;2;0,88%;225;99,12%
MULTIPOLYGON (((-58.448032936674579 -34.61035664996546,-58.446762589633096 -34.609856401871852,-58.446572144545293 -34.609785599598844,-58.446608355663514 -34.61105635514464,-58.447457536006091 -34.611384504331625,-58.448623487695123 -34.611835012948049,-58.449172642139779 -34.610805530472724,-58.448032936674579 -34.61035664996546)));;2828;6_4_3;COMUNA 6;4;3;831;391;440;88,86%;394;394;100,00%;0;0,00%;339;18;5,31%;321;94,69%
MULTIPOLYGON (((-58.445229839540971 -34.609286382345417,-58.444430000331799 -34.608988930300534,-58.44368456042519 -34.60996406352767,-58.444100792714444 -34.610120189752678,-58.444792472554148 -34.610379528087904,-58.445053099247232 -34.610477245696714,-58.445191163633723 -34.610528394220538,-58.445725451401948 -34.610726364290244,-58.446428725488239 -34.610986962589415,-58.446608355663514 -34.61105635514464,-58.446572144545293 -34.609785599598844,-58.446161785887071 -34.609633003848458,-58.445626056320407 -34.609433767800944,-58.445229839540971 -34.609286382345417)));;2829;6_4_4;COMUNA 6;4;4;773;344;429;80,19%;417;417;100,00%;0;0,00%;319;2;0,63%;317;99,37%
MULTIPOLYGON (((-58.445191163633723 -34.610528394220538,-58.445053099247232 -34.610477245696714,-58.444792472554148 -34.610379528087904,-58.444100792714444 -34.610120189752678,-58.443697909365156 -34.611191293612855,-58.444222146462344 -34.611389902504591,-58.444369154522342 -34.611446616888429,-58.444765634384595 -34.611599568709863,-58.445286554074663 -34.611800496556029,-58.44662727799394 -34.612317600751012,-58.446638052707939 -34.612099918205196,-58.446608355663514 -34.61105635514464,-58.446428725488239 -34.610986962589415,-58.445725451401948 -34.610726364290244,-58.445191163633723 -34.610528394220538)));;2830;6_4_5;COMUNA 6;4;5;731;343;388;88,40%;341;341;100,00%;0;0,00%;288;2;0,69%;286;99,31%
MULTIPOLYGON (((-58.44327975885183 -34.612302958376574,-58.444618519115828 -34.612820577266127,-58.444749091892092 -34.612868274331397,-58.4457619093129 -34.613236812764029,-58.446189746223375 -34.613394694019291,-58.446455835724144 -34.613491916348487,-58.44662727799394 -34.612317600751012,-58.445286554074663 -34.611800496556029,-58.444765634384595 -34.611599568709863,-58.444369154522342 -34.611446616888429,-58.444222146462344 -34.611389902504591,-58.443697909365156 -34.611191293612855,-58.444100792714444 -34.610120189752678,-58.44368456042519 -34.60996406352767,-58.442960063728698 -34.610911729639447,-58.442394803426794 -34.611651100463483,-58.442222764738773 -34.611895094674715,-58.442466869140304 -34.611988659929338,-58.44327975885183 -34.612302958376574)));;2831;6_4_6;COMUNA 6;4;6;774;365;409;89,24%;400;400;100,00%;0;0,00%;322;2;0,62%;320;99,38%
MULTIPOLYGON (((-58.446593199522546 -34.614995439385467,-58.44661939111532 -34.615228549789904,-58.446657651189341 -34.615606173980936,-58.446696081572902 -34.61598591091046,-58.446838596915342 -34.615978041917266,-58.447696585973567 -34.615923641462707,-58.447946257298831 -34.615468021815467,-58.448558153546784 -34.614351293635231,-58.447440467275577 -34.613891071962016,-58.447522863097149 -34.613757133747093,-58.448058900034859 -34.612874843412477,-58.44688186496623 -34.612415736178058,-58.44662727799394 -34.612317600751012,-58.446455835724144 -34.613491916348487,-58.446568708922896 -34.614776907179731,-58.446593199522546 -34.614995439385467)));;2832;6_4_7;COMUNA 6;4;7;673;333;340;97,94%;304;304;100,00%;0;0,00%;242;1;0,41%;241;99,59%
MULTIPOLYGON (((-58.446455835724144 -34.613491916348487,-58.446189746223375 -34.613394694019291,-58.4457619093129 -34.613236812764029,-58.444749091892092 -34.612868274331397,-58.444618519115828 -34.612820577266127,-58.44327975885183 -34.612302958376574,-58.442466869140304 -34.611988659929338,-58.442222764738773 -34.611895094674715,-58.441463873693941 -34.61297176457316,-58.442826053759447 -34.613509196596461,-58.444164402352044 -34.614037172788194,-58.445060193142872 -34.614390628176636,-58.445660344006562 -34.614627412126538,-58.446593199522546 -34.614995439385467,-58.446568708922896 -34.614776907179731,-58.446455835724144 -34.613491916348487)));;2833;6_4_8;COMUNA 6;4;8;883;391;492;79,47%;479;479;100,00%;0;0,00%;370;10;2,70%;360;97,30%
MULTIPOLYGON (((-58.445228596971184 -34.615624217782511,-58.446181904306428 -34.616000983761069,-58.446696081572902 -34.61598591091046,-58.446657651189341 -34.615606173980936,-58.44661939111532 -34.615228549789904,-58.446593199522546 -34.614995439385467,-58.445660344006562 -34.614627412126538,-58.445060193142872 -34.614390628176636,-58.444164402352044 -34.614037172788194,-58.442826053759447 -34.613509196596461,-58.441463873693941 -34.61297176457316,-58.441362215233625 -34.613115977406338,-58.440993331795326 -34.613950238226309,-58.442405011165114 -34.614508247783505,-58.443731959315222 -34.615032705484914,-58.445228596971184 -34.615624217782511)));;2834;6_4_9;COMUNA 6;4;9;1080;433;647;66,92%;388;379;97,68%;9;2,37%;322;8;2,48%;314;97,52%
MULTIPOLYGON (((-58.445360476322683 -34.607772119704634,-58.44510800538108 -34.607813070997402,-58.44374113153097 -34.608034987158177,-58.443350384018203 -34.608587411024999,-58.444430000331799 -34.608988930300534,-58.444901589199048 -34.608372075830587,-58.445102150796608 -34.608109771279032,-58.445360476322683 -34.607772119704634)));;2835;6_5_1;COMUNA 6;5;1;741;300;441;68,03%;475;475;100,00%;0;0,00%;383;1;0,26%;382;99,74%
MULTIPOLYGON (((-58.441109381611589 -34.610210475028921,-58.440845369018525 -34.611352723297117,-58.441026609888652 -34.611436984050705,-58.441134266697304 -34.611478201812403,-58.442222764738773 -34.611895094674715,-58.442394803426794 -34.611651100463483,-58.442960063728698 -34.610911729639447,-58.441881794234931 -34.610503155198707,-58.442605276558972 -34.609559368642742,-58.442433317759914 -34.609494901211022,-58.441370655718586 -34.60908998686012,-58.441329045491479 -34.609260056262983,-58.441109381611589 -34.610210475028921)));;2836;6_5_10;COMUNA 6;5;10;978;463;515;89,90%;495;495;100,00%;0;0,00%;407;2;0,49%;405;99,51%
MULTIPOLYGON (((-58.441450113063219 -34.608807948076596,-58.440119646753715 -34.608797990429373,-58.439300702112121 -34.610799388466148,-58.439481860116715 -34.61086541140272,-58.440620521780197 -34.611248383234795,-58.440845369018525 -34.611352723297117,-58.441109381611589 -34.610210475028921,-58.441329045491479 -34.609260056262983,-58.441370655718586 -34.60908998686012,-58.441450113063219 -34.608807948076596)));;2837;6_5_11;COMUNA 6;5;11;936;407;529;76,94%;485;485;100,00%;0;0,00%;416;3;0,72%;413;99,28%
MULTIPOLYGON (((-58.440119646753715 -34.608797990429373,-58.438858852759438 -34.608798525252794,-58.438355317487456 -34.610437359268424,-58.439069804849744 -34.610715256383273,-58.439300702112121 -34.610799388466148,-58.440119646753715 -34.608797990429373)));;2838;6_5_12;COMUNA 6;5;12;369;156;213;73,24%;180;180;100,00%;0;0,00%;159;23;14,47%;136;85,53%
MULTIPOLYGON (((-58.445677757181507 -34.607357430690371,-58.445263491037579 -34.607219127620496,-58.445131478052822 -34.607175092963423,-58.444167261047618 -34.606922898691295,-58.442980075282399 -34.606612348925985,-58.442629589245414 -34.607635991784605,-58.442588252953882 -34.607743383324618,-58.442525949935671 -34.607905562145113,-58.442403722720734 -34.608252103992129,-58.443350384018203 -34.608587411024999,-58.44374113153097 -34.608034987158177,-58.44510800538108 -34.607813070997402,-58.445360476322683 -34.607772119704634,-58.445677757181507 -34.607357430690371)));;2839;6_5_2;COMUNA 6;5;2;1015;446;569;78,38%;689;689;100,00%;0;0,00%;453;1;0,22%;452;99,78%
MULTIPOLYGON (((-58.441594672891505 -34.607742792949011,-58.441592551642351 -34.608383731789772,-58.442403722720734 -34.608252103992129,-58.442525949935671 -34.607905562145113,-58.442588252953882 -34.607743383324618,-58.442629589245414 -34.607635991784605,-58.442980075282399 -34.606612348925985,-58.44282404436408 -34.606571477016217,-58.441599737974499 -34.606239075951137,-58.441598905004568 -34.60650155038028,-58.441594672891505 -34.607742792949011)));;2840;6_5_3;COMUNA 6;5;3;774;344;430;80,00%;476;476;100,00%;0;0,00%;372;12;3,23%;360;96,77%
MULTIPOLYGON (((-58.441598905004568 -34.60650155038028,-58.440132109682871 -34.606494386225521,-58.440123517575856 -34.607084758713768,-58.440115270911889 -34.607657172796131,-58.440114566581464 -34.607741823689921,-58.441594672891505 -34.607742792949011,-58.441598905004568 -34.60650155038028)));;2841;6_5_4;COMUNA 6;5;4;637;308;329;93,62%;348;348;100,00%;0;0,00%;293;5;1,71%;288;98,29%
MULTIPOLYGON (((-58.438728684666593 -34.606487498604615,-58.438720764760077 -34.607075335819268,-58.438713627586999 -34.60760662173881,-58.438712737203758 -34.607740922315166,-58.440114566581464 -34.607741823689921,-58.440115270911889 -34.607657172796131,-58.440123517575856 -34.607084758713768,-58.440132109682871 -34.606494386225521,-58.441598905004568 -34.60650155038028,-58.441599737974499 -34.606239075951137,-58.441465256261914 -34.606203487913398,-58.440335072220684 -34.605893626537863,-58.440141570568926 -34.605840560765486,-58.439285379801042 -34.605605813230582,-58.438811615446575 -34.606247578502639,-58.438730426231011 -34.606355029221902,-58.438728684666593 -34.606487498604615)));;2842;6_5_5;COMUNA 6;5;5;939;436;503;86,68%;472;471;99,79%;1;0,21%;392;17;4,34%;375;95,66%
MULTIPOLYGON (((-58.440114566581464 -34.607741823689921,-58.438712737203758 -34.607740922315166,-58.43870519312744 -34.608798002154003,-58.438858852759438 -34.608798525252794,-58.440119646753715 -34.608797990429373,-58.440114566581464 -34.607741823689921)));;2843;6_5_6;COMUNA 6;5;6;689;327;362;90,33%;379;379;100,00%;0;0,00%;304;4;1,32%;300;98,68%
MULTIPOLYGON (((-58.442403722720734 -34.608252103992129,-58.441592551642351 -34.608383731789772,-58.441594672891505 -34.607742792949011,-58.440114566581464 -34.607741823689921,-58.440119646753715 -34.608797990429373,-58.441450113063219 -34.608807948076596,-58.441370655718586 -34.60908998686012,-58.442433317759914 -34.609494901211022,-58.442605276558972 -34.609559368642742,-58.443350384018203 -34.608587411024999,-58.442403722720734 -34.608252103992129)));;2844;6_5_7;COMUNA 6;5;7;749;324;425;76,24%;403;403;100,00%;0;0,00%;334;3;0,90%;331;99,10%
MULTIPOLYGON (((-58.444430000331799 -34.608988930300534,-58.443350384018203 -34.608587411024999,-58.442605276558972 -34.609559368642742,-58.44368456042519 -34.60996406352767,-58.444430000331799 -34.608988930300534)));;2845;6_5_8;COMUNA 6;5;8;466;212;254;83,46%;279;279;100,00%;0;0,00%;205;0;0,00%;205;100,00%
MULTIPOLYGON (((-58.44368456042519 -34.60996406352767,-58.442605276558972 -34.609559368642742,-58.441881794234931 -34.610503155198707,-58.442960063728698 -34.610911729639447,-58.44368456042519 -34.60996406352767)));;2846;6_5_9;COMUNA 6;5;9;569;255;314;81,21%;300;300;100,00%;0;0,00%;237;1;0,42%;236;99,58%
MULTIPOLYGON (((-58.441134266697304 -34.611478201812403,-58.441026609888652 -34.611436984050705,-58.440845369018525 -34.611352723297117,-58.440808700100028 -34.611511102777222,-58.44053799860751 -34.612470243703633,-58.440488132546612 -34.612602281677155,-58.441463873693941 -34.61297176457316,-58.442222764738773 -34.611895094674715,-58.441134266697304 -34.611478201812403)));;2847;6_6_1;COMUNA 6;6;1;1118;508;610;83,28%;672;672;100,00%;0;0,00%;546;5;0,92%;541;99,08%
MULTIPOLYGON (((-58.440845369018525 -34.611352723297117,-58.440620521780197 -34.611248383234795,-58.439481860116715 -34.61086541140272,-58.439300702112121 -34.610799388466148,-58.439236091759128 -34.610957339574689,-58.43890530249822 -34.611685471072107,-58.438477253849072 -34.612627533733026,-58.438400968254683 -34.612793792192775,-58.440060170926202 -34.613586041414365,-58.44012137035994 -34.613443301123404,-58.440424286740644 -34.612771219821035,-58.440488132546612 -34.612602281677155,-58.44053799860751 -34.612470243703633,-58.440808700100028 -34.611511102777222,-58.440845369018525 -34.611352723297117)));;2848;6_6_2;COMUNA 6;6;2;1836;831;1005;82,69%;939;939;100,00%;0;0,00%;792;4;0,51%;788;99,49%
MULTIPOLYGON (((-58.439300702112121 -34.610799388466148,-58.439069804849744 -34.610715256383273,-58.438355317487456 -34.610437359268424,-58.438092543615106 -34.611292760338394,-58.438044114868461 -34.611450432364578,-58.4377298352344 -34.612473292954512,-58.438400968254683 -34.612793792192775,-58.438477253849072 -34.612627533733026,-58.43890530249822 -34.611685471072107,-58.439236091759128 -34.610957339574689,-58.439300702112121 -34.610799388466148)));;2849;6_6_3;COMUNA 6;6;3;1107;489;618;79,13%;629;629;100,00%;0;0,00%;509;4;0,79%;505;99,21%
MULTIPOLYGON (((-58.438400968254683 -34.612793792192775,-58.4377298352344 -34.612473292954512,-58.437671002866551 -34.61266476671387,-58.437290987183793 -34.613856210091292,-58.437012503293992 -34.614205882676742,-58.436953604354436 -34.614327776054537,-58.437743161463722 -34.614623373278413,-58.437812152895972 -34.61407590289646,-58.438400968254683 -34.612793792192775)));;2850;6_6_4;COMUNA 6;6;4;482;208;274;75,91%;301;301;100,00%;0;0,00%;226;1;0,44%;225;99,56%
MULTIPOLYGON (((-58.440060170926202 -34.613586041414365,-58.438400968254683 -34.612793792192775,-58.437812152895972 -34.61407590289646,-58.439577046059469 -34.614712751927684,-58.439650265603646 -34.61454240755171,-58.440060170926202 -34.613586041414365)));;2851;6_6_5;COMUNA 6;6;5;677;293;384;76,30%;258;257;99,61%;1;0,39%;201;2;1,00%;199;99,00%
MULTIPOLYGON (((-58.440060170926202 -34.613586041414365,-58.439650265603646 -34.61454240755171,-58.439577046059469 -34.614712751927684,-58.440689783924903 -34.614756832570329,-58.440733796374928 -34.614537255151063,-58.440993331795326 -34.613950238226309,-58.441362215233625 -34.613115977406338,-58.441463873693941 -34.61297176457316,-58.440488132546612 -34.612602281677155,-58.440424286740644 -34.612771219821035,-58.44012137035994 -34.613443301123404,-58.440060170926202 -34.613586041414365)));;2852;6_6_6;COMUNA 6;6;6;786;360;426;84,51%;438;437;99,77%;1;0,23%;333;7;2,10%;326;97,90%
MULTIPOLYGON (((-58.440689783924903 -34.614756832570329,-58.439577046059469 -34.614712751927684,-58.43911547481401 -34.615786363997017,-58.439056654467976 -34.615938400295406,-58.440425060461891 -34.615933587219125,-58.440564250834107 -34.615938049332172,-58.440629223690848 -34.61505929726934,-58.440689783924903 -34.614756832570329)));;2853;6_6_7;COMUNA 6;6;7;741;322;419;76,85%;438;438;100,00%;0;0,00%;350;4;1,14%;346;98,86%
MULTIPOLYGON (((-58.437812152895972 -34.61407590289646,-58.437743161463722 -34.614623373278413,-58.437584169917642 -34.615886343625007,-58.437576997169117 -34.615943597713375,-58.439056654467976 -34.615938400295406,-58.43911547481401 -34.615786363997017,-58.439577046059469 -34.614712751927684,-58.437812152895972 -34.61407590289646)));;2854;6_6_8;COMUNA 6;6;8;1009;450;559;80,50%;507;505;99,61%;2;0,40%;408;9;2,21%;399;97,79%
MULTIPOLYGON (((-58.437743161463722 -34.614623373278413,-58.436953604354436 -34.614327776054537,-58.436366736643265 -34.615541778836359,-58.437584169917642 -34.615886343625007,-58.437743161463722 -34.614623373278413)));;2855;6_6_9;COMUNA 6;6;9;761;326;435;74,94%;439;439;100,00%;0;0,00%;356;0;0,00%;356;100,00%
MULTIPOLYGON (((-58.433865744028203 -34.602935820076731,-58.433334112118949 -34.602673429841985,-58.432330170534073 -34.603928161053794,-58.433219322885037 -34.604300294526581,-58.433913942752547 -34.602959635174308,-58.433865744028203 -34.602935820076731)));;2856;6_7_1;COMUNA 6;7;1;593;264;329;80,24%;332;332;100,00%;0;0,00%;280;3;1,07%;277;98,93%
MULTIPOLYGON (((-58.432780249616528 -34.609072196161208,-58.432710688685638 -34.609228100313423,-58.432314037881497 -34.610103597696401,-58.432258627202138 -34.610225771457799,-58.431981315752559 -34.610836851060256,-58.431933235532952 -34.610942758304979,-58.431676719176188 -34.611511023924095,-58.43241043356052 -34.611818261713161,-58.432717488426505 -34.61116387710841,-58.432946966462062 -34.610675183049452,-58.433000254630471 -34.610531458383711,-58.433050302688109 -34.610396536042977,-58.433264241884167 -34.609275349529739,-58.434277030822507 -34.609700394016599,-58.434733229148968 -34.608732083528842,-58.434196727622371 -34.60873575624543,-58.432924570555492 -34.608749050548418,-58.432780249616528 -34.609072196161208)));;2857;6_7_10;COMUNA 6;7;10;778;352;426;82,63%;393;392;99,75%;1;0,26%;326;1;0,31%;325;99,69%
MULTIPOLYGON (((-58.432108064727096 -34.608741101787821,-58.431816163497871 -34.60873828166806,-58.431185797993557 -34.609783511031033,-58.432258627202138 -34.610225771457799,-58.432314037881497 -34.610103597696401,-58.432710688685638 -34.609228100313423,-58.432780249616528 -34.609072196161208,-58.432924570555492 -34.608749050548418,-58.432108064727096 -34.608741101787821)));;2858;6_7_11;COMUNA 6;7;11;613;296;317;93,38%;311;311;100,00%;0;0,00%;293;31;10,58%;262;89,42%
MULTIPOLYGON (((-58.430413950500416 -34.609465410227187,-58.430370661783016 -34.610171903551581,-58.431981315752559 -34.610836851060256,-58.432258627202138 -34.610225771457799,-58.431185797993557 -34.609783511031033,-58.431816163497871 -34.60873828166806,-58.430473946219756 -34.608725258006771,-58.430413950500416 -34.609465410227187)));;2859;6_7_12;COMUNA 6;7;12;652;296;356;83,15%;332;332;100,00%;0;0,00%;286;2;0,70%;284;99,30%
MULTIPOLYGON (((-58.431981315752559 -34.610836851060256,-58.430370661783016 -34.610171903551581,-58.430330254048357 -34.610915441148592,-58.431676719176188 -34.611511023924095,-58.431933235532952 -34.610942758304979,-58.431981315752559 -34.610836851060256)));;2860;6_7_13;COMUNA 6;7;13;491;212;279;75,99%;289;289;100,00%;0;0,00%;236;1;0,42%;235;99,58%
MULTIPOLYGON (((-58.431529512224614 -34.604943771950616,-58.430669134114844 -34.605941332913901,-58.432075324627029 -34.606508546080654,-58.432631648438957 -34.605434700707498,-58.433219322885037 -34.604300294526581,-58.432330170534073 -34.603928161053794,-58.431529512224614 -34.604943771950616)));;2861;6_7_2;COMUNA 6;7;2;803;359;444;80,86%;431;430;99,77%;1;0,23%;343;3;0,87%;340;99,13%
MULTIPOLYGON (((-58.432904317138437 -34.606353727401711,-58.432943022663807 -34.606210651088027,-58.432986073999984 -34.606103544909701,-58.433025795782903 -34.606017917579301,-58.433052303473694 -34.605966020677975,-58.433083157071621 -34.605908349961972,-58.433130798690527 -34.605826034499508,-58.433169915771209 -34.605763576851253,-58.433202725203735 -34.60571442802155,-58.433266978708602 -34.605623102096679,-58.433331570164938 -34.605539170860602,-58.433365654173947 -34.605498121186443,-58.433400845186725 -34.60545770559483,-58.433469095125361 -34.605384409362806,-58.433518427909021 -34.605335334827622,-58.433563414416092 -34.605293020050738,-58.433615301488658 -34.605246270116233,-58.43366863603724 -34.605200717731641,-58.433735090186325 -34.605146717417789,-58.433778625529264 -34.605113064512032,-58.433823097550075 -34.605079975213641,-58.433894575615064 -34.60502921555873,-58.433947480704262 -34.604993240772949,-58.434001322291088 -34.60495832256192,-58.434049114835489 -34.604928332668969,-58.434118374943345 -34.604886868484037,-58.434188571334133 -34.604847024257367,-58.434273480876676 -34.604797192806323,-58.43440220020436 -34.604745251824582,-58.434497991539267 -34.604705677124727,-58.43457881582458 -34.604671048510617,-58.434646275659581 -34.604643108611427,-58.434779371433578 -34.604609224445284,-58.435234353429443 -34.604495486681799,-58.435357079104264 -34.604463341780672,-58.435419283578042 -34.604451164001361,-58.435464938001282 -34.60444568103631,-58.435563231274294 -34.60443387150633,-58.435752829610969 -34.604422504647239,-58.435852992990739 -34.604421963325883,-58.435920875317883 -34.604423175471283,-58.436013797636171 -34.604426928364582,-58.436081423507552 -34.604431098222207,-58.43617434454314 -34.604438935653505,-58.43625806659761 -34.604447827398594,-58.436367679696495 -34.604461513588937,-58.43641622403684 -34.604474763989863,-58.436616184548512 -34.604283391254107,-58.435338027726786 -34.603675130682234,-58.435148382703275 -34.603574943385588,-58.434971767153215 -34.603481589997941,-58.433913942752547 -34.602959635174308,-58.433219322885037 -34.604300294526581,-58.432631648438957 -34.605434700707498,-58.432075324627029 -34.606508546080654,-58.432364896779696 -34.606465757658249,-58.432676186356908 -34.606418243912763,-58.432676139807427 -34.606419173089549,-58.432677436210355 -34.606418801257519,-58.432904317138437 -34.606353727401711)));;2862;6_7_3;COMUNA 6;7;3;954;438;516;84,88%;336;335;99,70%;1;0,30%;278;5;1,80%;273;98,20%
MULTIPOLYGON (((-58.432676139807427 -34.606419173089549,-58.432676186356908 -34.606418243912763,-58.432364896779696 -34.606465757658249,-58.432075324627029 -34.606508546080654,-58.430669134114844 -34.605941332913901,-58.430605850009883 -34.607047061671395,-58.431583852191174 -34.607457048521788,-58.43235364054933 -34.607777324692691,-58.433233992587901 -34.608133486013259,-58.433122694506039 -34.607853324012368,-58.433118158261813 -34.607835055107117,-58.433095193273608 -34.60774256763429,-58.433095196212591 -34.607734287282902,-58.433110050536186 -34.607622300345263,-58.433105803815408 -34.60761595417388,-58.43300339241916 -34.607460360144401,-58.432964583270923 -34.607373234785776,-58.432940670656151 -34.607312170352671,-58.4329125919379 -34.60723018862808,-58.43288349897206 -34.60712637485161,-58.432863092033713 -34.607027985927495,-58.432850604333595 -34.60693551464886,-58.432844422327285 -34.606835509419277,-58.432845565322765 -34.606735717255738,-58.432854720741723 -34.606619236288829,-58.432875109161685 -34.606506948920476,-58.432904216972403 -34.606354097668266,-58.432904317138437 -34.606353727401711,-58.432677436210355 -34.606418801257519,-58.432676139807427 -34.606419173089549)));;2863;6_7_4;COMUNA 6;7;4;869;390;479;81,42%;419;419;100,00%;0;0,00%;372;10;2,69%;362;97,31%
MULTIPOLYGON (((-58.431583852191174 -34.607457048521788,-58.430605850009883 -34.607047061671395,-58.430559923700827 -34.607753625075397,-58.430549468522052 -34.607918839702322,-58.430512868654183 -34.608513711183889,-58.430473946219756 -34.608725258006771,-58.431816163497871 -34.60873828166806,-58.432108064727096 -34.608741101787821,-58.432924570555492 -34.608749050548418,-58.434196727622371 -34.60873575624543,-58.434733229148968 -34.608732083528842,-58.434394447929172 -34.608573971404894,-58.434238665681676 -34.608500429587977,-58.433870379895964 -34.608322687169164,-58.433781104739907 -34.608280366030961,-58.433685472149726 -34.608220341109401,-58.433613345296045 -34.608169336136015,-58.433526659595458 -34.608100439654038,-58.433450535846426 -34.60803175691764,-58.433373648631289 -34.607954552507508,-58.43330681144522 -34.607879956199753,-58.43323103716854 -34.607787540135234,-58.433194682566743 -34.60774330435946,-58.433164203685237 -34.607703225078517,-58.433110050536186 -34.607622300345263,-58.433095196212591 -34.607734287282902,-58.433095193273608 -34.60774256763429,-58.433118158261813 -34.607835055107117,-58.433122694506039 -34.607853324012368,-58.433233992587901 -34.608133486013259,-58.43235364054933 -34.607777324692691,-58.431583852191174 -34.607457048521788)));;2864;6_7_5;COMUNA 6;7;5;784;356;428;83,18%;442;442;100,00%;0;0,00%;359;3;0,84%;356;99,16%
MULTIPOLYGON (((-58.433894575615064 -34.60502921555873,-58.433823097550075 -34.605079975213641,-58.433778625529264 -34.605113064512032,-58.433735090186325 -34.605146717417789,-58.43366863603724 -34.605200717731641,-58.433615301488658 -34.605246270116233,-58.433563414416092 -34.605293020050738,-58.433518427909021 -34.605335334827622,-58.433469095125361 -34.605384409362806,-58.433400845186725 -34.60545770559483,-58.433365654173947 -34.605498121186443,-58.433331570164938 -34.605539170860602,-58.433266978708602 -34.605623102096679,-58.433202725203735 -34.60571442802155,-58.433169915771209 -34.605763576851253,-58.433130798690527 -34.605826034499508,-58.433083157071621 -34.605908349961972,-58.433052303473694 -34.605966020677975,-58.433025795782903 -34.606017917579301,-58.432986073999984 -34.606103544909701,-58.432943022663807 -34.606210651088027,-58.432904317138437 -34.606353727401711,-58.432904216972403 -34.606354097668266,-58.432875109161685 -34.606506948920476,-58.432854720741723 -34.606619236288829,-58.432845565322765 -34.606735717255738,-58.432844422327285 -34.606835509419277,-58.432850604333595 -34.60693551464886,-58.432863092033713 -34.607027985927495,-58.43288349897206 -34.60712637485161,-58.4329125919379 -34.60723018862808,-58.432940670656151 -34.607312170352671,-58.432964583270923 -34.607373234785776,-58.43300339241916 -34.607460360144401,-58.433105803815408 -34.60761595417388,-58.433110050536186 -34.607622300345263,-58.433164203685237 -34.607703225078517,-58.433194682566743 -34.60774330435946,-58.43323103716854 -34.607787540135234,-58.43330681144522 -34.607879956199753,-58.433373648631289 -34.607954552507508,-58.433450535846426 -34.60803175691764,-58.433526659595458 -34.608100439654038,-58.433613345296045 -34.608169336136015,-58.433685472149726 -34.608220341109401,-58.433781104739907 -34.608280366030961,-58.433870379895964 -34.608322687169164,-58.434238665681676 -34.608500429587977,-58.434394447929172 -34.608573971404894,-58.434733229148968 -34.608732083528842,-58.434808599208345 -34.608767242922667,-58.436123305714744 -34.608779931208439,-58.436899693972066 -34.608787422070641,-58.437390143143432 -34.608792172855964,-58.437561008220577 -34.60879382795936,-58.43870519312744 -34.608798002154003,-58.438712737203758 -34.607740922315166,-58.438713627586999 -34.60760662173881,-58.438720764760077 -34.607075335819268,-58.438728684666593 -34.606487498604615,-58.438730426231011 -34.606355029221902,-58.438811615446575 -34.606247578502639,-58.439285379801042 -34.605605813230582,-58.439201660228242 -34.605582838530729,-58.438516280984409 -34.605234663414016,-58.437974998936333 -34.604959685472195,-58.437174579122861 -34.604553026519788,-58.437053311827349 -34.604491379057066,-58.436616184548512 -34.604283391254107,-58.43641622403684 -34.604474763989863,-58.436367679696495 -34.604461513588937,-58.43625806659761 -34.604447827398594,-58.43617434454314 -34.604438935653505,-58.436081423507552 -34.604431098222207,-58.436013797636171 -34.604426928364582,-58.435920875317883 -34.604423175471283,-58.435852992990739 -34.604421963325883,-58.435752829610969 -34.604422504647239,-58.435563231274294 -34.60443387150633,-58.435464938001282 -34.60444568103631,-58.435419283578042 -34.604451164001361,-58.435357079104264 -34.604463341780672,-58.435234353429443 -34.604495486681799,-58.434779371433578 -34.604609224445284,-58.434646275659581 -34.604643108611427,-58.43457881582458 -34.604671048510617,-58.434497991539267 -34.604705677124727,-58.43440220020436 -34.604745251824582,-58.434273480876676 -34.604797192806323,-58.434188571334133 -34.604847024257367,-58.434118374943345 -34.604886868484037,-58.434049114835489 -34.604928332668969,-58.434001322291088 -34.60495832256192,-58.433947480704262 -34.604993240772949,-58.433894575615064 -34.60502921555873)));;2865;6_7_6;COMUNA 6;7;6;682;323;359;89,97%;327;326;99,69%;1;0,31%;260;30;11,54%;230;88,46%
MULTIPOLYGON (((-58.43870519312744 -34.608798002154003,-58.437561008220577 -34.60879382795936,-58.437390143143432 -34.608792172855964,-58.436899693972066 -34.608787422070641,-58.436123305714744 -34.608779931208439,-58.434808599208345 -34.608767242922667,-58.434733229148968 -34.608732083528842,-58.434277030822507 -34.609700394016599,-58.435698631880634 -34.610297076809445,-58.436500910350468 -34.610633742912391,-58.436672438966312 -34.610704768136316,-58.438092543615106 -34.611292760338394,-58.438355317487456 -34.610437359268424,-58.438858852759438 -34.608798525252794,-58.43870519312744 -34.608798002154003)));;2866;6_7_7;COMUNA 6;7;7;1151;515;636;80,97%;495;491;99,19%;4;0,81%;399;16;4,01%;383;95,99%
MULTIPOLYGON (((-58.436672438966312 -34.610704768136316,-58.436500910350468 -34.610633742912391,-58.435698631880634 -34.610297076809445,-58.435360757742146 -34.611504369600112,-58.436749695480749 -34.612076806422856,-58.4377298352344 -34.612473292954512,-58.438044114868461 -34.611450432364578,-58.438092543615106 -34.611292760338394,-58.436672438966312 -34.610704768136316)));;2867;6_7_8;COMUNA 6;7;8;740;331;409;80,93%;348;348;100,00%;0;0,00%;307;26;8,47%;281;91,53%
MULTIPOLYGON (((-58.435698631880634 -34.610297076809445,-58.434277030822507 -34.609700394016599,-58.433264241884167 -34.609275349529739,-58.433050302688109 -34.610396536042977,-58.433000254630471 -34.610531458383711,-58.433748956380491 -34.610840029895996,-58.434603697610761 -34.61119235525485,-58.435360757742146 -34.611504369600112,-58.435698631880634 -34.610297076809445)));;2868;6_7_9;COMUNA 6;7;9;769;354;415;85,30%;406;405;99,75%;1;0,25%;320;1;0,31%;319;99,69%
MULTIPOLYGON (((-58.433748956380491 -34.610840029895996,-58.433000254630471 -34.610531458383711,-58.432946966462062 -34.610675183049452,-58.432717488426505 -34.61116387710841,-58.43241043356052 -34.611818261713161,-58.433155310372236 -34.612130145835494,-58.434107408349291 -34.612528767420066,-58.434603697610761 -34.61119235525485,-58.433748956380491 -34.610840029895996)));;2869;6_8_1;COMUNA 6;8;1;832;399;433;92,15%;443;443;100,00%;0;0,00%;355;15;4,23%;340;95,77%
MULTIPOLYGON (((-58.431321112882067 -34.612362513219708,-58.430232852424737 -34.611897352436465,-58.430127266110517 -34.613328150764843,-58.430884154460102 -34.613650756495439,-58.431257850510029 -34.612516727875608,-58.431321112882067 -34.612362513219708)));;2870;6_8_10;COMUNA 6;8;10;677;297;380;78,16%;409;409;100,00%;0;0,00%;334;2;0,60%;332;99,40%
MULTIPOLYGON (((-58.434107408349291 -34.612528767420066,-58.433155310372236 -34.612130145835494,-58.432832126217484 -34.612867981215508,-58.432790173063886 -34.61299036973174,-58.434427661171661 -34.613365139917185,-58.434707765356897 -34.61278011292751,-58.43590329484298 -34.613280610735039,-58.4361132403127 -34.613367702065432,-58.436749695480749 -34.612076806422856,-58.435360757742146 -34.611504369600112,-58.434603697610761 -34.61119235525485,-58.434107408349291 -34.612528767420066)));;2871;6_8_2;COMUNA 6;8;2;1023;476;547;87,02%;542;542;100,00%;0;0,00%;457;39;8,53%;418;91,47%
MULTIPOLYGON (((-58.4377298352344 -34.612473292954512,-58.436749695480749 -34.612076806422856,-58.4361132403127 -34.613367702065432,-58.437290987183793 -34.613856210091292,-58.437671002866551 -34.61266476671387,-58.4377298352344 -34.612473292954512)));;2872;6_8_3;COMUNA 6;8;3;640;290;350;82,86%;291;291;100,00%;0;0,00%;260;0;0,00%;260;100,00%
MULTIPOLYGON (((-58.434707765356897 -34.61278011292751,-58.434427661171661 -34.613365139917185,-58.435687346551468 -34.613844597548336,-58.435858455889104 -34.613913370185543,-58.436019941142632 -34.613978196673735,-58.436953604354436 -34.614327776054537,-58.437012503293992 -34.614205882676742,-58.437290987183793 -34.613856210091292,-58.4361132403127 -34.613367702065432,-58.43590329484298 -34.613280610735039,-58.434707765356897 -34.61278011292751)));;2873;6_8_4;COMUNA 6;8;4;626;271;355;76,34%;351;351;100,00%;0;0,00%;300;1;0,33%;299;99,67%
MULTIPOLYGON (((-58.436953604354436 -34.614327776054537,-58.436019941142632 -34.613978196673735,-58.435858455889104 -34.613913370185543,-58.435270623311077 -34.615172439598744,-58.435250079510645 -34.615216521063935,-58.436272872130886 -34.615515208294205,-58.436366736643265 -34.615541778836359,-58.436953604354436 -34.614327776054537)));;2874;6_8_5;COMUNA 6;8;5;511;219;292;75,00%;310;310;100,00%;0;0,00%;251;28;11,16%;223;88,84%
MULTIPOLYGON (((-58.435858455889104 -34.613913370185543,-58.435687346551468 -34.613844597548336,-58.434427661171661 -34.613365139917185,-58.434361172127517 -34.613503861893612,-58.433992232679294 -34.61429239559375,-58.433804350492544 -34.614693914959766,-58.435270623311077 -34.615172439598744,-58.435858455889104 -34.613913370185543)));;2875;6_8_6;COMUNA 6;8;6;1320;597;723;82,57%;607;607;100,00%;0;0,00%;533;25;4,69%;508;95,31%
MULTIPOLYGON (((-58.434427661171661 -34.613365139917185,-58.432790173063886 -34.61299036973174,-58.432729119150402 -34.613168248503705,-58.432560357476738 -34.613685760821042,-58.432366095569364 -34.614281579198014,-58.433728992567872 -34.614854818354182,-58.433707790431114 -34.614899023941256,-58.433707862266701 -34.614899053657474,-58.433704307417408 -34.614906149843726,-58.433628071839202 -34.615065022353043,-58.433679761724157 -34.615084674047942,-58.433665867736721 -34.615110657588566,-58.434052033735043 -34.615276388614944,-58.434344598688227 -34.615398926136962,-58.435099222932074 -34.615719251489061,-58.436077768598878 -34.616136224070431,-58.436208071010384 -34.615869329082841,-58.436208052109187 -34.615869375920731,-58.436366736643265 -34.615541778836359,-58.436272872130886 -34.615515208294205,-58.435250079510645 -34.615216521063935,-58.435270623311077 -34.615172439598744,-58.433804350492544 -34.614693914959766,-58.433992232679294 -34.61429239559375,-58.434361172127517 -34.613503861893612,-58.434427661171661 -34.613365139917185)));;2876;6_8_7;COMUNA 6;8;7;664;296;368;80,43%;375;375;100,00%;0;0,00%;319;38;11,91%;281;88,09%
MULTIPOLYGON (((-58.431321112882067 -34.612362513219708,-58.431257850510029 -34.612516727875608,-58.430884154460102 -34.613650756495439,-58.432241321826723 -34.614229151860179,-58.432366095569364 -34.614281579198014,-58.432560357476738 -34.613685760821042,-58.432729119150402 -34.613168248503705,-58.432790173063886 -34.61299036973174,-58.432832126217484 -34.612867981215508,-58.433155310372236 -34.612130145835494,-58.43241043356052 -34.611818261713161,-58.431676719176188 -34.611511023924095,-58.431607410552232 -34.61166460341969,-58.431321112882067 -34.612362513219708)));;2877;6_8_8;COMUNA 6;8;8;1333;565;768;73,57%;524;517;98,66%;7;1,35%;509;26;5,11%;483;94,89%
MULTIPOLYGON (((-58.431676719176188 -34.611511023924095,-58.430330254048357 -34.610915441148592,-58.430318672057275 -34.611128614866296,-58.430254626941149 -34.611759818018378,-58.430232852424737 -34.611897352436465,-58.431321112882067 -34.612362513219708,-58.431607410552232 -34.61166460341969,-58.431676719176188 -34.611511023924095)));;2878;6_8_9;COMUNA 6;8;9;511;232;279;83,15%;313;313;100,00%;0;0,00%;266;29;10,90%;237;89,10%
MULTIPOLYGON (((-58.439056654467976 -34.615938400295406,-58.437576997169117 -34.615943597713375,-58.437563591115286 -34.616050007200243,-58.437371124365441 -34.616444277222563,-58.437371252376671 -34.616444370832724,-58.43754726571234 -34.616515161259287,-58.438613404295893 -34.61694398320958,-58.438752938765703 -34.61664569021184,-58.438998260191127 -34.616089168993518,-58.439056654467976 -34.615938400295406)));;2879;6_9_1;COMUNA 6;9;1;600;239;361;66,20%;365;365;100,00%;0;0,00%;297;3;1,01%;294;98,99%
MULTIPOLYGON (((-58.430112513593542 -34.613565253906451,-58.430085854524251 -34.614015277146116,-58.430028561113765 -34.615449186493485,-58.430252982405094 -34.615548616137488,-58.430776009544594 -34.615780452540932,-58.430843159715337 -34.614377532520045,-58.432095726149292 -34.614975198546162,-58.432281941637314 -34.614496636396503,-58.432281646207294 -34.614496509624502,-58.432347010914171 -34.614330633866039,-58.432366095569364 -34.614281579198014,-58.432241321826723 -34.614229151860179,-58.430884154460102 -34.613650756495439,-58.430127266110517 -34.613328150764843,-58.430121697599368 -34.613398068860825,-58.430112513593542 -34.613565253906451)));;2880;6_9_10;COMUNA 6;9;10;735;326;409;79,71%;391;391;100,00%;0;0,00%;324;2;0,62%;322;99,38%
MULTIPOLYGON (((-58.437280893658297 -34.616707006024143,-58.437280833277619 -34.6167070142738,-58.437088285192758 -34.617079452028676,-58.438302783528165 -34.617642889944932,-58.438497559272299 -34.617212068395155,-58.438485708902761 -34.617207149265951,-58.43850098003746 -34.617203584606983,-58.438591065652354 -34.616994426818124,-58.43858723822995 -34.616992712166514,-58.438613404295893 -34.61694398320958,-58.43754726571234 -34.616515161259287,-58.437371252376671 -34.616444370832724,-58.437280893658297 -34.616707006024143)));;2881;6_9_2;COMUNA 6;9;2;598;261;337;77,45%;306;306;100,00%;0;0,00%;260;0;0,00%;260;100,00%
MULTIPOLYGON (((-58.438302783528165 -34.617642889944932,-58.437088285192758 -34.617079452028676,-58.436456844987347 -34.618300699103088,-58.437746574713941 -34.61887324343455,-58.438302783528165 -34.617642889944932)));;2882;6_9_3;COMUNA 6;9;3;653;289;364;79,40%;378;378;100,00%;0;0,00%;293;3;1,02%;290;98,98%
MULTIPOLYGON (((-58.43607811320485 -34.616136596593151,-58.435858275346256 -34.616591282931203,-58.435283565760571 -34.617779859283438,-58.436456844987347 -34.618300699103088,-58.437088285192758 -34.617079452028676,-58.437280833277619 -34.6167070142738,-58.43715664753519 -34.616659733132813,-58.43718554275975 -34.616602835746221,-58.43607811320485 -34.616136596593151)));;2883;6_9_4;COMUNA 6;9;4;1012;442;570;77,54%;606;606;100,00%;0;0,00%;430;2;0,47%;428;99,53%
MULTIPOLYGON (((-58.437280893658297 -34.616707006024143,-58.437371252376671 -34.616444370832724,-58.437371124365441 -34.616444277222563,-58.437563591115286 -34.616050007200243,-58.437576997169117 -34.615943597713375,-58.437584169917642 -34.615886343625007,-58.436366736643265 -34.615541778836359,-58.436208052109187 -34.615869375920731,-58.436208071010384 -34.615869329082841,-58.436077768598878 -34.616136224070431,-58.43607811320485 -34.616136596593151,-58.43718554275975 -34.616602835746221,-58.43715664753519 -34.616659733132813,-58.437280833277619 -34.6167070142738,-58.437280893658297 -34.616707006024143)));;2884;6_9_5;COMUNA 6;9;5;438;160;278;57,55%;215;211;98,14%;4;1,90%;170;0;0,00%;170;100,00%
MULTIPOLYGON (((-58.434736835435459 -34.61753712096381,-58.435283565760571 -34.617779859283438,-58.435858275346256 -34.616591282931203,-58.43607811320485 -34.616136596593151,-58.436077768598878 -34.616136224070431,-58.435099222932074 -34.615719251489061,-58.434344598688227 -34.615398926136962,-58.434052033735043 -34.615276388614944,-58.433665867736721 -34.615110657588566,-58.433679761724157 -34.615084674047942,-58.433628071839202 -34.615065022353043,-58.433628071787126 -34.61506517169731,-58.43339695981598 -34.615546946938373,-58.433237631005106 -34.615885512209076,-58.432860992790708 -34.616704534357055,-58.433118723122952 -34.616818685686276,-58.434131168581501 -34.617268238710182,-58.434736835435459 -34.61753712096381)));;2885;6_9_6;COMUNA 6;9;6;864;395;469;84,22%;505;505;100,00%;0;0,00%;381;2;0,52%;379;99,48%
MULTIPOLYGON (((-58.43339695981598 -34.615546946938373,-58.433628071787126 -34.61506517169731,-58.433628071839202 -34.615065022353043,-58.433704307417408 -34.614906149843726,-58.433707862266701 -34.614899053657474,-58.433707790431114 -34.614899023941256,-58.433728992567872 -34.614854818354182,-58.432366095569364 -34.614281579198014,-58.432347010914171 -34.614330633866039,-58.432281646207294 -34.614496509624502,-58.432281941637314 -34.614496636396503,-58.432095726149292 -34.614975198546162,-58.43339695981598 -34.615546946938373)));;2886;6_9_7;COMUNA 6;9;7;540;232;308;75,32%;287;287;100,00%;0;0,00%;249;48;19,28%;201;80,72%
MULTIPOLYGON (((-58.43339695981598 -34.615546946938373,-58.432095726149292 -34.614975198546162,-58.431634526481673 -34.61616089900788,-58.432211219159079 -34.616416546555385,-58.432860992790708 -34.616704534357055,-58.433237631005106 -34.615885512209076,-58.43339695981598 -34.615546946938373)));;2887;6_9_8;COMUNA 6;9;8;401;159;242;65,70%;232;232;100,00%;0;0,00%;196;2;1,02%;194;98,98%
MULTIPOLYGON (((-58.432095726149292 -34.614975198546162,-58.430843159715337 -34.614377532520045,-58.430776009544594 -34.615780452540932,-58.43086884482269 -34.615821605027492,-58.431359169930559 -34.616038922824835,-58.431634526481673 -34.61616089900788,-58.432095726149292 -34.614975198546162)));;2888;6_9_9;COMUNA 6;9;9;838;363;475;76,42%;443;443;100,00%;0;0,00%;362;12;3,31%;350;96,69%
MULTIPOLYGON (((-58.476741761774299 -34.621830161260675,-58.476026442211953 -34.621458115881858,-58.475745547092245 -34.621310887594561,-58.47556278995215 -34.621704300977392,-58.475136378295304 -34.622622123522412,-58.474672058400074 -34.623621641122888,-58.474829414914474 -34.623663810130019,-58.475814024511024 -34.623920829782179,-58.47541545737149 -34.624804282598411,-58.475361548019677 -34.624924151467312,-58.476490159030675 -34.625223616815802,-58.476950546041571 -34.624217543497878,-58.477014501990382 -34.62407774247189,-58.477414587249783 -34.623223087956482,-58.477807255551937 -34.622384278548552,-58.476741761774299 -34.621830161260675)));;2889;7_1_1;COMUNA 7;1;1;601;287;314;91,40%;266;266;100,00%;0;0,00%;223;20;8,97%;203;91,03%
MULTIPOLYGON (((-58.47119322474952 -34.631130144854147,-58.469639651187983 -34.630707060045232,-58.468991305979557 -34.632155382711517,-58.469196475559173 -34.632222768550754,-58.470387024806769 -34.632579049126008,-58.470527610001675 -34.632606858004031,-58.470665468791353 -34.632634173923982,-58.471744915561544 -34.632886853463617,-58.472874298755755 -34.633151209809135,-58.473483829423579 -34.631791816790667,-58.473228301011453 -34.631702117832489,-58.472378226092609 -34.63146232113791,-58.471411172768207 -34.631189497653175,-58.47119322474952 -34.631130144854147)));;2890;7_1_10;COMUNA 7;1;10;1125;480;645;74,42%;483;481;99,59%;2;0,42%;419;51;12,17%;368;87,83%
MULTIPOLYGON (((-58.475490041584536 -34.621176895895637,-58.474509432888013 -34.620662751464828,-58.474189694351523 -34.620497494529708,-58.473904829498956 -34.621190009998145,-58.473461883852899 -34.622174943292066,-58.473014073179193 -34.623171002375791,-58.473229702065979 -34.623234859398693,-58.474672058400074 -34.623621641122888,-58.475136378295304 -34.622622123522412,-58.47556278995215 -34.621704300977392,-58.475745547092245 -34.621310887594561,-58.475490041584536 -34.621176895895637)));;2891;7_1_2;COMUNA 7;1;2;891;406;485;83,71%;322;321;99,69%;1;0,31%;306;16;5,23%;290;94,77%
MULTIPOLYGON (((-58.472563355970628 -34.624173186860027,-58.472117227280783 -34.625165439243673,-58.472327578503652 -34.625228382722995,-58.473748409790957 -34.625606373818719,-58.474144617674646 -34.624756871610359,-58.474209004885502 -34.624618339675706,-58.474672058400074 -34.623621641122888,-58.473229702065979 -34.623234859398693,-58.473014073179193 -34.623171002375791,-58.472563355970628 -34.624173186860027)));;2892;7_1_3;COMUNA 7;1;3;878;393;485;81,03%;396;395;99,75%;1;0,25%;316;17;5,38%;299;94,62%
MULTIPOLYGON (((-58.474347970096254 -34.627162356877619,-58.475468683569524 -34.627455634925276,-58.476036488976646 -34.626215039111301,-58.476490159030675 -34.625223616815802,-58.475361548019677 -34.624924151467312,-58.47541545737149 -34.624804282598411,-58.475814024511024 -34.623920829782179,-58.474829414914474 -34.623663810130019,-58.474672058400074 -34.623621641122888,-58.474209004885502 -34.624618339675706,-58.474144617674646 -34.624756871610359,-58.473748409790957 -34.625606373818719,-58.473522962885355 -34.626089790795533,-58.473166773560223 -34.626853298539864,-58.474347970096254 -34.627162356877619)));;2893;7_1_4;COMUNA 7;1;4;738;352;386;91,19%;310;310;100,00%;0;0,00%;255;36;14,12%;219;85,88%
MULTIPOLYGON (((-58.473866583684348 -34.628218775626522,-58.473435267427128 -34.629165113782093,-58.473304524890693 -34.629452036248054,-58.473147969650391 -34.629766003932588,-58.474253725974876 -34.630110352338484,-58.474553703757188 -34.629454808668356,-58.474990119596882 -34.628501282749944,-58.475468683569524 -34.627455634925276,-58.474347970096254 -34.627162356877619,-58.473866583684348 -34.628218775626522)));;2894;7_1_5;COMUNA 7;1;5;450;219;231;94,81%;234;234;100,00%;0;0,00%;172;17;9,88%;155;90,12%
MULTIPOLYGON (((-58.472231213210449 -34.628858865494266,-58.471977980689097 -34.629401649714545,-58.473147969650391 -34.629766003932588,-58.473304524890693 -34.629452036248054,-58.473435267427128 -34.629165113782093,-58.473866583684348 -34.628218775626522,-58.474347970096254 -34.627162356877619,-58.473166773560223 -34.626853298539864,-58.472966131190411 -34.626800778597186,-58.47157569212937 -34.62636953500995,-58.471447247712142 -34.626655117376117,-58.471104413420292 -34.627425026738365,-58.471421780093408 -34.627525078267169,-58.472521110289762 -34.627873598039116,-58.472671572685982 -34.627914784405867,-58.472231213210449 -34.628858865494266)));;2895;7_1_6;COMUNA 7;1;6;749;339;410;82,68%;287;287;100,00%;0;0,00%;269;16;5,95%;253;94,05%
MULTIPOLYGON (((-58.470659528569371 -34.62842403396931,-58.470437806173123 -34.628921881884324,-58.470372132224703 -34.629069355774504,-58.47031770189227 -34.62919161681058,-58.470209437016294 -34.629434800692835,-58.471556799977918 -34.629775848483945,-58.471783264543276 -34.629834777463543,-58.471852344448877 -34.629686457478002,-58.471953451111915 -34.629469541177023,-58.471977980689097 -34.629401649714545,-58.472231213210449 -34.628858865494266,-58.472671572685982 -34.627914784405867,-58.472521110289762 -34.627873598039116,-58.471421780093408 -34.627525078267169,-58.471104413420292 -34.627425026738365,-58.470659528569371 -34.62842403396931)));;2896;7_1_7;COMUNA 7;1;7;487;230;257;89,49%;242;242;100,00%;0;0,00%;185;16;8,65%;169;91,35%
MULTIPOLYGON (((-58.471783264543276 -34.629834777463543,-58.471556799977918 -34.629775848483945,-58.470209437016294 -34.629434800692835,-58.469639651187983 -34.630707060045232,-58.47119322474952 -34.631130144854147,-58.471702089759908 -34.630016550121773,-58.471783264543276 -34.629834777463543)));;2897;7_1_8;COMUNA 7;1;8;721;313;408;76,72%;407;406;99,75%;1;0,25%;319;13;4,08%;306;95,92%
MULTIPOLYGON (((-58.471783264543276 -34.629834777463543,-58.471702089759908 -34.630016550121773,-58.47119322474952 -34.631130144854147,-58.471411172768207 -34.631189497653175,-58.472378226092609 -34.63146232113791,-58.473228301011453 -34.631702117832489,-58.473483829423579 -34.631791816790667,-58.474103650134403 -34.630438264728532,-58.474253725974876 -34.630110352338484,-58.473147969650391 -34.629766003932588,-58.471977980689097 -34.629401649714545,-58.471953451111915 -34.629469541177023,-58.471852344448877 -34.629686457478002,-58.471783264543276 -34.629834777463543)));;2898;7_1_9;COMUNA 7;1;9;680;328;352;93,18%;323;323;100,00%;0;0,00%;291;107;36,77%;184;63,23%
MULTIPOLYGON (((-58.461206971521953 -34.628415692690382,-58.460988697440179 -34.628346321289115,-58.460018567103532 -34.628016363116465,-58.459857461836712 -34.62795558276909,-58.459306273586996 -34.629181032462,-58.460469387943981 -34.629554240804133,-58.460641487575792 -34.629606217401737,-58.462237338492457 -34.630088644397354,-58.462293740930264 -34.629947724395514,-58.462711896853811 -34.628849730516585,-58.461386907336895 -34.628472950209606,-58.461206971521953 -34.628415692690382)));;2899;7_10_1;COMUNA 7;10;1;733;316;417;75,78%;396;396;100,00%;0;0,00%;303;1;0,33%;302;99,67%
MULTIPOLYGON (((-58.4582283092899 -34.631477905339018,-58.458172155741316 -34.631596780450124,-58.457718745838086 -34.632562358099968,-58.457899113843744 -34.632626099830283,-58.459025037931617 -34.63297157287365,-58.459543447579172 -34.631892326397058,-58.460084934442492 -34.630764977829465,-58.459944782310615 -34.63072286066555,-58.458761717411043 -34.630348590376315,-58.4582283092899 -34.631477905339018)));;2900;7_10_10;COMUNA 7;10;10;932;382;550;69,45%;394;392;99,49%;2;0,51%;332;21;6,33%;311;93,67%
MULTIPOLYGON (((-58.459857461836712 -34.62795558276909,-58.459687070483518 -34.627891280733635,-58.458854032243856 -34.627548710523676,-58.458270631354026 -34.628696194229867,-58.458202551421678 -34.6288269003593,-58.459306273586996 -34.629181032462,-58.459857461836712 -34.62795558276909)));;2901;7_10_2;COMUNA 7;10;2;380;160;220;72,73%;239;239;100,00%;0;0,00%;185;1;0,54%;184;99,46%
MULTIPOLYGON (((-58.458854032243856 -34.627548710523676,-58.457838089268087 -34.62713098406077,-58.457137261968022 -34.628482971619384,-58.458076375831077 -34.628786401322607,-58.458202551421678 -34.6288269003593,-58.458270631354026 -34.628696194229867,-58.458854032243856 -34.627548710523676)));;2902;7_10_3;COMUNA 7;10;3;588;248;340;72,94%;321;321;100,00%;0;0,00%;254;4;1,57%;250;98,43%
MULTIPOLYGON (((-58.458202551421678 -34.6288269003593,-58.458076375831077 -34.628786401322607,-58.457137261968022 -34.628482971619384,-58.456622511928103 -34.629479670678677,-58.45654241311933 -34.629646362385586,-58.45760217758346 -34.629981704188374,-58.45766420973461 -34.629860153405119,-58.458202551421678 -34.6288269003593)));;2903;7_10_4;COMUNA 7;10;4;690;302;388;77,84%;347;347;100,00%;0;0,00%;295;0;0,00%;295;100,00%
MULTIPOLYGON (((-58.456041713796417 -34.629487950494777,-58.455461698990725 -34.629304460600338,-58.45491181121595 -34.630413900454634,-58.456002845584997 -34.630768906645301,-58.45609136580962 -34.630797644824568,-58.457067052278354 -34.631108337923031,-58.457137607048431 -34.630971716899623,-58.45753775939049 -34.630107902879267,-58.45760217758346 -34.629981704188374,-58.45654241311933 -34.629646362385586,-58.456041713796417 -34.629487950494777)));;2904;7_10_5;COMUNA 7;10;5;640;284;356;79,78%;291;290;99,66%;1;0,34%;240;4;1,67%;236;98,33%
MULTIPOLYGON (((-58.459306273586996 -34.629181032462,-58.458202551421678 -34.6288269003593,-58.45766420973461 -34.629860153405119,-58.45760217758346 -34.629981704188374,-58.45753775939049 -34.630107902879267,-58.457137607048431 -34.630971716899623,-58.457067052278354 -34.631108337923031,-58.458141917538846 -34.631450577290757,-58.4582283092899 -34.631477905339018,-58.458761717411043 -34.630348590376315,-58.458830224375916 -34.630203446879207,-58.459306273586996 -34.629181032462)));;2905;7_10_6;COMUNA 7;10;6;760;349;411;84,91%;460;459;99,78%;1;0,22%;351;34;9,69%;317;90,31%
MULTIPOLYGON (((-58.460641487575792 -34.629606217401737,-58.460469387943981 -34.629554240804133,-58.459306273586996 -34.629181032462,-58.458830224375916 -34.630203446879207,-58.458761717411043 -34.630348590376315,-58.459944782310615 -34.63072286066555,-58.460084934442492 -34.630764977829465,-58.460641487575792 -34.629606217401737)));;2906;7_10_7;COMUNA 7;10;7;710;292;418;69,86%;448;448;100,00%;0;0,00%;339;14;4,13%;325;95,87%
MULTIPOLYGON (((-58.462237338492457 -34.630088644397354,-58.460641487575792 -34.629606217401737,-58.460084934442492 -34.630764977829465,-58.461737206692938 -34.631261990422779,-58.462184684686768 -34.630219916176301,-58.462237338492457 -34.630088644397354)));;2907;7_10_8;COMUNA 7;10;8;1072;467;605;77,19%;566;566;100,00%;0;0,00%;428;0;0,00%;428;100,00%
MULTIPOLYGON (((-58.461737206692938 -34.631261990422779,-58.460084934442492 -34.630764977829465,-58.459543447579172 -34.631892326397058,-58.461246518702445 -34.632404629044821,-58.461737206692938 -34.631261990422779)));;2908;7_10_9;COMUNA 7;10;9;682;292;390;74,87%;384;384;100,00%;0;0,00%;307;3;0,98%;304;99,02%
MULTIPOLYGON (((-58.455376947883586 -34.626155123759936,-58.454031262200857 -34.625631003597974,-58.453938045438399 -34.62576438177144,-58.453437073407194 -34.626781069499259,-58.454515821999834 -34.627634203717854,-58.45470788939955 -34.62727476767045,-58.455376947883586 -34.626155123759936)));;2909;7_11_1;COMUNA 7;11;1;855;370;485;76,29%;434;429;98,85%;5;1,17%;315;27;8,57%;288;91,43%
MULTIPOLYGON (((-58.4582283092899 -34.631477905339018,-58.458141917538846 -34.631450577290757,-58.457067052278354 -34.631108337923031,-58.45699947966451 -34.631239395476861,-58.456545718443145 -34.63218968661036,-58.457555929231333 -34.632504814231424,-58.457718745838086 -34.632562358099968,-58.458172155741316 -34.631596780450124,-58.4582283092899 -34.631477905339018)));;2910;7_11_10;COMUNA 7;11;10;645;277;368;75,27%;285;285;100,00%;0;0,00%;249;2;0,80%;247;99,20%
MULTIPOLYGON (((-58.456709786841877 -34.626667044889672,-58.455376947883586 -34.626155123759936,-58.45470788939955 -34.62727476767045,-58.456182507755564 -34.62780776072502,-58.456709786841877 -34.626667044889672)));;2911;7_11_2;COMUNA 7;11;2;863;367;496;73,99%;534;534;100,00%;0;0,00%;402;0;0,00%;402;100,00%
MULTIPOLYGON (((-58.457838089268087 -34.62713098406077,-58.456709786841877 -34.626667044889672,-58.456182507755564 -34.62780776072502,-58.456030235863935 -34.628125298424138,-58.456618081483242 -34.628313927059189,-58.457137261968022 -34.628482971619384,-58.457838089268087 -34.62713098406077)));;2912;7_11_3;COMUNA 7;11;3;850;366;484;75,62%;459;459;100,00%;0;0,00%;367;38;10,35%;329;89,65%
MULTIPOLYGON (((-58.457137261968022 -34.628482971619384,-58.456618081483242 -34.628313927059189,-58.456030235863935 -34.628125298424138,-58.456182507755564 -34.62780776072502,-58.45470788939955 -34.62727476767045,-58.454515821999834 -34.627634203717854,-58.453997299930457 -34.628604411818301,-58.454802369069192 -34.629103074908421,-58.455461698990725 -34.629304460600338,-58.456041713796417 -34.629487950494777,-58.45654241311933 -34.629646362385586,-58.456622511928103 -34.629479670678677,-58.457137261968022 -34.628482971619384)));;2913;7_11_4;COMUNA 7;11;4;939;420;519;80,92%;484;484;100,00%;0;0,00%;380;3;0,79%;377;99,21%
MULTIPOLYGON (((-58.453997299930457 -34.628604411818301,-58.454515821999834 -34.627634203717854,-58.453437073407194 -34.626781069499259,-58.452870557941161 -34.627924655428856,-58.452669188957998 -34.628331202043178,-58.452568801025969 -34.628541834642711,-58.452845260771369 -34.628592070249312,-58.454000680536723 -34.62886589972603,-58.454122935609192 -34.628902106783521,-58.454802369069192 -34.629103074908421,-58.453997299930457 -34.628604411818301)));;2914;7_11_5;COMUNA 7;11;5;548;254;294;86,39%;281;281;100,00%;0;0,00%;229;7;3,06%;222;96,94%
MULTIPOLYGON (((-58.454122935609192 -34.628902106783521,-58.454000680536723 -34.62886589972603,-58.452845260771369 -34.628592070249312,-58.452568801025969 -34.628541834642711,-58.452102902314437 -34.629519574366363,-58.45374121234066 -34.630039793522144,-58.454122935609192 -34.628902106783521)));;2915;7_11_6;COMUNA 7;11;6;801;375;426;88,03%;360;359;99,72%;1;0,28%;267;1;0,37%;266;99,63%
MULTIPOLYGON (((-58.45374121234066 -34.630039793522144,-58.452102902314437 -34.629519574366363,-58.451995267679848 -34.629745417599302,-58.451576396947573 -34.630639071928073,-58.453232960723753 -34.631139862214347,-58.453706013842307 -34.630144724014549,-58.45374121234066 -34.630039793522144)));;2916;7_11_7;COMUNA 7;11;7;1123;489;634;77,13%;600;599;99,83%;1;0,17%;496;0;0,00%;496;100,00%
MULTIPOLYGON (((-58.45374121234066 -34.630039793522144,-58.453706013842307 -34.630144724014549,-58.453232960723753 -34.631139862214347,-58.454378099168615 -34.631500521073228,-58.454845172658572 -34.630548266858874,-58.45491181121595 -34.630413900454634,-58.455461698990725 -34.629304460600338,-58.454802369069192 -34.629103074908421,-58.454122935609192 -34.628902106783521,-58.45374121234066 -34.630039793522144)));;2917;7_11_8;COMUNA 7;11;8;1005;463;542;85,42%;638;638;100,00%;0;0,00%;452;39;8,63%;413;91,37%
MULTIPOLYGON (((-58.457067052278354 -34.631108337923031,-58.45609136580962 -34.630797644824568,-58.456002845584997 -34.630768906645301,-58.45491181121595 -34.630413900454634,-58.454845172658572 -34.630548266858874,-58.454378099168615 -34.631500521073228,-58.454573969015087 -34.631562226466961,-58.455346375437159 -34.631806368078408,-58.455487293605543 -34.631851589258076,-58.456376172134469 -34.632136788864841,-58.456545718443145 -34.63218968661036,-58.45699947966451 -34.631239395476861,-58.457067052278354 -34.631108337923031)));;2918;7_11_9;COMUNA 7;11;9;987;408;579;70,47%;442;441;99,77%;1;0,23%;366;2;0,55%;364;99,45%
MULTIPOLYGON (((-58.453870280075016 -34.632534322394392,-58.453941694143616 -34.632389745304955,-58.454378099168615 -34.631500521073228,-58.453232960723753 -34.631139862214347,-58.451576396947573 -34.630639071928073,-58.451100671649705 -34.631653779644736,-58.451230000536441 -34.631694849573996,-58.451692705804525 -34.631842643582026,-58.451208032864741 -34.632828265243184,-58.452261341187871 -34.633161751197186,-58.45312815644774 -34.633436197521235,-58.453384180570708 -34.63351861441766,-58.453870280075016 -34.632534322394392)));;2919;7_12_1;COMUNA 7;12;1;1020;467;553;84,45%;511;510;99,80%;1;0,20%;422;1;0,24%;421;99,76%
MULTIPOLYGON (((-58.451300076545245 -34.63513144793454,-58.450820066396751 -34.636115025635561,-58.45043891392438 -34.636895858244458,-58.450583836634443 -34.636982917790739,-58.451243280190653 -34.637356796388119,-58.451441029484954 -34.63746688877076,-58.451923681104383 -34.636486126070125,-58.452416207564362 -34.635485291058309,-58.452899262355132 -34.634503538262074,-58.453322650319933 -34.633643261682437,-58.453384180570708 -34.63351861441766,-58.45312815644774 -34.633436197521235,-58.452261341187871 -34.633161751197186,-58.451778029910329 -34.634152234340434,-58.451300076545245 -34.63513144793454)));;2920;7_12_2;COMUNA 7;12;2;578;265;313;84,66%;268;267;99,63%;1;0,37%;216;6;2,78%;210;97,22%
MULTIPOLYGON (((-58.451692705804525 -34.631842643582026,-58.451230000536441 -34.631694849573996,-58.451100671649705 -34.631653779644736,-58.451048006915023 -34.631730678582031,-58.450195628235896 -34.632504422581697,-58.449244130820972 -34.633356532487966,-58.4494607041607 -34.633426135939665,-58.450720024564419 -34.633820715700111,-58.450572580030418 -34.634120499683945,-58.450240612857684 -34.634795558711772,-58.449755735070816 -34.635781667073253,-58.449561238151077 -34.636158841609053,-58.449481725521927 -34.636260667302473,-58.450304641310339 -34.636815137840465,-58.45043891392438 -34.636895858244458,-58.450820066396751 -34.636115025635561,-58.451300076545245 -34.63513144793454,-58.451778029910329 -34.634152234340434,-58.452261341187871 -34.633161751197186,-58.451208032864741 -34.632828265243184,-58.451692705804525 -34.631842643582026)));;2921;7_12_3;COMUNA 7;12;3;772;387;385;100,52%;309;305;98,71%;4;1,31%;278;30;10,79%;248;89,21%
MULTIPOLYGON (((-58.450720024564419 -34.633820715700111,-58.4494607041607 -34.633426135939665,-58.449244130820972 -34.633356532487966,-58.448317241495943 -34.634186524354547,-58.447668399447139 -34.634767591866272,-58.447503928627327 -34.63491828062643,-58.44766979880059 -34.635039854437665,-58.448249289244998 -34.635430289293886,-58.448589441348815 -34.635336875377213,-58.44871937475957 -34.635356398017365,-58.448819865733959 -34.635146402658812,-58.448577645123443 -34.635058484665642,-58.448754922768416 -34.634741100346922,-58.449310333996571 -34.634941380384255,-58.449794968702228 -34.633876820356441,-58.450572580030418 -34.634120499683945,-58.450720024564419 -34.633820715700111)));;2922;7_12_4;COMUNA 7;12;4;797;349;448;77,90%;347;347;100,00%;0;0,00%;319;0;0,00%;319;100,00%
MULTIPOLYGON (((-58.450240612857684 -34.634795558711772,-58.450572580030418 -34.634120499683945,-58.449794968702228 -34.633876820356441,-58.449310333996571 -34.634941380384255,-58.448754922768416 -34.634741100346922,-58.448577645123443 -34.635058484665642,-58.448819865733959 -34.635146402658812,-58.44871937475957 -34.635356398017365,-58.448589441348815 -34.635336875377213,-58.448249289244998 -34.635430289293886,-58.448502061915711 -34.635600606206928,-58.449481725521927 -34.636260667302473,-58.449561238151077 -34.636158841609053,-58.449755735070816 -34.635781667073253,-58.450240612857684 -34.634795558711772)));;2923;7_12_5;COMUNA 7;12;5;740;311;429;72,49%;333;333;100,00%;0;0,00%;297;0;0,00%;297;100,00%
MULTIPOLYGON (((-58.4468875252442 -34.635567307905362,-58.445876608109188 -34.636656574153449,-58.44531463547893 -34.637260528915675,-58.446342639836182 -34.638180841544184,-58.447135872263267 -34.63889103850569,-58.44724014956045 -34.63898436460866,-58.448517925442182 -34.638012657784593,-58.448433918602717 -34.63796954801191,-58.448989612217595 -34.637097682281279,-58.449324386437112 -34.636572420801649,-58.449481725521927 -34.636260667302473,-58.448502061915711 -34.635600606206928,-58.448249289244998 -34.635430289293886,-58.44766979880059 -34.635039854437665,-58.447503928627327 -34.63491828062643,-58.447296825856284 -34.634766559558436,-58.447193768789823 -34.635011977038282,-58.447115945063715 -34.635185353048961,-58.446989217098029 -34.635340623534915,-58.4468875252442 -34.635567307905362)));;2924;7_12_6;COMUNA 7;12;6;755;346;409;84,60%;378;376;99,47%;2;0,53%;302;0;0,00%;302;100,00%
MULTIPOLYGON (((-58.448517925442182 -34.638012657784593,-58.44724014956045 -34.63898436460866,-58.448126856700732 -34.639778513179309,-58.449407531642805 -34.638805881985853,-58.449558964275695 -34.638690894718806,-58.450322416607186 -34.638182578023752,-58.450516367532416 -34.638045805662692,-58.450934854836532 -34.637760864849234,-58.451302806478672 -34.637511194762439,-58.451441029484954 -34.63746688877076,-58.451243280190653 -34.637356796388119,-58.450583836634443 -34.636982917790739,-58.45043891392438 -34.636895858244458,-58.450304641310339 -34.636815137840465,-58.449481725521927 -34.636260667302473,-58.449324386437112 -34.636572420801649,-58.448989612217595 -34.637097682281279,-58.448433918602717 -34.63796954801191,-58.448517925442182 -34.638012657784593)));;2925;7_12_7;COMUNA 7;12;7;612;302;310;97,42%;251;251;100,00%;0;0,00%;218;1;0,46%;217;99,54%
MULTIPOLYGON (((-58.445251604334295 -34.642039686092581,-58.445309059982009 -34.641928211920991,-58.446052762018745 -34.641361997899779,-58.446204414602114 -34.641245216688105,-58.446338990931643 -34.641141569081157,-58.447150990773437 -34.640520599326578,-58.447338989839672 -34.64037688620035,-58.448126856700732 -34.639778513179309,-58.44724014956045 -34.63898436460866,-58.446264966797166 -34.639726021301172,-58.445295647062594 -34.640463234179798,-58.444318895642304 -34.641206001698357,-58.443312382837931 -34.641971433342285,-58.444244067101209 -34.642806815368054,-58.445251604334295 -34.642039686092581)));;2926;7_12_8;COMUNA 7;12;8;595;303;292;103,77%;241;241;100,00%;0;0,00%;213;4;1,88%;209;98,12%
MULTIPOLYGON (((-58.444977886086328 -34.638527563390276,-58.444853714068593 -34.639039603905431,-58.444731274134369 -34.639415161285783,-58.44449662260584 -34.639746404639453,-58.444405335566969 -34.639875338741923,-58.443794446789163 -34.640737667290722,-58.443180391539229 -34.641604358483285,-58.443078012539054 -34.641777727794747,-58.443312382837931 -34.641971433342285,-58.444318895642304 -34.641206001698357,-58.445295647062594 -34.640463234179798,-58.446264966797166 -34.639726021301172,-58.44724014956045 -34.63898436460866,-58.447135872263267 -34.63889103850569,-58.446342639836182 -34.638180841544184,-58.44531463547893 -34.637260528915675,-58.445266136665097 -34.637338904799087,-58.444977886086328 -34.638527563390276)));;2927;7_12_9;COMUNA 7;12;9;823;396;427;92,74%;327;327;100,00%;0;0,00%;290;4;1,38%;286;98,62%
MULTIPOLYGON (((-58.461764260198336 -34.63483879853699,-58.461232736386869 -34.636089960759051,-58.461797812130172 -34.636537727229197,-58.462970749056012 -34.63544551173397,-58.463388924689674 -34.634473647409784,-58.463457086089925 -34.634319346184981,-58.462152284655254 -34.633925249891853,-58.461764260198336 -34.63483879853699)));;2928;7_13_1;COMUNA 7;13;1;721;344;377;91,25%;373;373;100,00%;0;0,00%;320;45;14,06%;275;85,94%
MULTIPOLYGON (((-58.456765792407268 -34.634591677868741,-58.455577148902066 -34.634214489236193,-58.455101794762101 -34.635206746467034,-58.456307492460681 -34.635567461157621,-58.456483766677145 -34.635757053894203,-58.456602960194253 -34.635866640933713,-58.456688585465102 -34.63594538013367,-58.456751888632773 -34.636003554138632,-58.456837088139494 -34.636082574911086,-58.456892212306109 -34.636133705966657,-58.457672917788678 -34.635214837547785,-58.457481987747215 -34.635011935593717,-58.457290888241623 -34.634808822052001,-58.457223155915536 -34.634736844849108,-58.456765792407268 -34.634591677868741)));;2929;7_13_10;COMUNA 7;13;10;497;230;267;86,14%;231;231;100,00%;0;0,00%;193;2;1,04%;191;98,96%
MULTIPOLYGON (((-58.458845200932473 -34.637970321461111,-58.45807692961408 -34.637233087939855,-58.457973409375519 -34.637137094961325,-58.457732033490458 -34.636913134479144,-58.457538882601938 -34.636733824891799,-58.457327840424952 -34.636538034800253,-58.457064060404569 -34.636293226239744,-58.456892212306109 -34.636133705966657,-58.456837088139494 -34.636082574911086,-58.456751888632773 -34.636003554138632,-58.456688585465102 -34.63594538013367,-58.456602960194253 -34.635866640933713,-58.456483766677145 -34.635757053894203,-58.456307492460681 -34.635567461157621,-58.455101794762101 -34.635206746467034,-58.454630775640183 -34.636189987593085,-58.455538527619801 -34.63647892686658,-58.455764303387369 -34.636706552909551,-58.455856062428666 -34.636798955445016,-58.455984712852121 -34.636928685095704,-58.456049719812121 -34.636994183729584,-58.456115578869017 -34.637060527471803,-58.456207679679309 -34.637150817011673,-58.456244230378708 -34.637186665178177,-58.456464983640643 -34.637403162512982,-58.456643734137003 -34.637578388428565,-58.456838332765528 -34.637769178720568,-58.45697874424156 -34.637906795444231,-58.457063945290102 -34.637994971257285,-58.457162608328794 -34.638097091731026,-58.457827098177091 -34.638800945455792,-58.458751895630812 -34.638045250459832,-58.458845200932473 -34.637970321461111)));;2930;7_13_11;COMUNA 7;13;11;750;353;397;88,92%;277;277;100,00%;0;0,00%;253;1;0,40%;252;99,60%
MULTIPOLYGON (((-58.456643734137003 -34.637578388428565,-58.456464983640643 -34.637403162512982,-58.455929672881609 -34.637938925852374,-58.455887747335503 -34.637983924963038,-58.455596482895594 -34.638295890187614,-58.455473431965132 -34.638427647744905,-58.454498971342701 -34.63956881975075,-58.454707370854521 -34.639787713793389,-58.454912278228193 -34.640002945160973,-58.455216457583724 -34.640195928081035,-58.455462529711113 -34.640339679888314,-58.455743962968846 -34.640504067674691,-58.455861645494146 -34.640406958574921,-58.456794403481197 -34.639644799989853,-58.457361497677866 -34.639181431077887,-58.457827098177091 -34.638800945455792,-58.457162608328794 -34.638097091731026,-58.457063945290102 -34.637994971257285,-58.45697874424156 -34.637906795444231,-58.456838332765528 -34.637769178720568,-58.456643734137003 -34.637578388428565)));;2931;7_13_12;COMUNA 7;13;12;692;331;361;91,69%;244;244;100,00%;0;0,00%;222;7;3,15%;215;96,85%
MULTIPOLYGON (((-58.453666403257806 -34.638725353721057,-58.453796333961641 -34.638830789182535,-58.453897634980166 -34.638937208387809,-58.454089758317387 -34.639138989110137,-58.454282308584908 -34.639341192101362,-58.454328486697996 -34.639389788378487,-58.454498971342701 -34.63956881975075,-58.455473431965132 -34.638427647744905,-58.455596482895594 -34.638295890187614,-58.455887747335503 -34.637983924963038,-58.455929672881609 -34.637938925852374,-58.456464983640643 -34.637403162512982,-58.456244230378708 -34.637186665178177,-58.456207679679309 -34.637150817011673,-58.456115578869017 -34.637060527471803,-58.456049719812121 -34.636994183729584,-58.455984712852121 -34.636928685095704,-58.455856062428666 -34.636798955445016,-58.455764303387369 -34.636706552909551,-58.455538527619801 -34.63647892686658,-58.455066689110204 -34.637083213547619,-58.454896428310185 -34.637284688142209,-58.454591387735405 -34.637648299309902,-58.454493533077667 -34.637586821294434,-58.45427390377575 -34.637456105446027,-58.454079388533707 -34.637339764787903,-58.453477852544601 -34.638596532670789,-58.453572086555418 -34.638648794953539,-58.453666403257806 -34.638725353721057)));;2932;7_13_13;COMUNA 7;13;13;565;287;278;103,24%;229;229;100,00%;0;0,00%;196;1;0,51%;195;99,49%
MULTIPOLYGON (((-58.455577148902066 -34.634214489236193,-58.454521513663316 -34.633879552894868,-58.454107337922707 -34.634749130331151,-58.454049897932016 -34.634870890807612,-58.453584150709361 -34.63585680446208,-58.45328978255457 -34.636479900890514,-58.453106801634746 -34.636867223099266,-58.453051273819341 -34.636984234417326,-58.452536541356871 -34.638074469298722,-58.453477852544601 -34.638596532670789,-58.454079388533707 -34.637339764787903,-58.45427390377575 -34.637456105446027,-58.454493533077667 -34.637586821294434,-58.454591387735405 -34.637648299309902,-58.454896428310185 -34.637284688142209,-58.455066689110204 -34.637083213547619,-58.455538527619801 -34.63647892686658,-58.454630775640183 -34.636189987593085,-58.455101794762101 -34.635206746467034,-58.455577148902066 -34.634214489236193)));;2933;7_13_14;COMUNA 7;13;14;709;320;389;82,26%;256;254;99,22%;2;0,79%;220;4;1,82%;216;98,18%
MULTIPOLYGON (((-58.452536541356871 -34.638074469298722,-58.453051273819341 -34.636984234417326,-58.453106801634746 -34.636867223099266,-58.45328978255457 -34.636479900890514,-58.453584150709361 -34.63585680446208,-58.454049897932016 -34.634870890807612,-58.454107337922707 -34.634749130331151,-58.454521513663316 -34.633879552894868,-58.453384180570708 -34.63351861441766,-58.453322650319933 -34.633643261682437,-58.452899262355132 -34.634503538262074,-58.452416207564362 -34.635485291058309,-58.451923681104383 -34.636486126070125,-58.451441029484954 -34.63746688877076,-58.451442388377195 -34.637467946833638,-58.452536541356871 -34.638074469298722)));;2934;7_13_15;COMUNA 7;13;15;503;220;283;77,74%;217;216;99,54%;1;0,46%;185;5;2,70%;180;97,30%
MULTIPOLYGON (((-58.462152284655254 -34.633925249891853,-58.460925881395077 -34.633554803529172,-58.460765275706422 -34.63350557411831,-58.460675723400215 -34.633689381516994,-58.460002410301271 -34.634966875064677,-58.46015066110634 -34.635103079876515,-58.461096325210036 -34.635971645345073,-58.461232736386869 -34.636089960759051,-58.461764260198336 -34.63483879853699,-58.462152284655254 -34.633925249891853)));;2935;7_13_2;COMUNA 7;13;2;713;322;391;82,35%;376;376;100,00%;0;0,00%;294;10;3,40%;284;96,60%
MULTIPOLYGON (((-58.460765275706422 -34.63350557411831,-58.459025037931617 -34.63297157287365,-58.457899113843744 -34.632626099830283,-58.457718745838086 -34.632562358099968,-58.457233625661672 -34.63359532907311,-58.458542913723441 -34.634003492703172,-58.459240121117851 -34.634218662364759,-58.459450139066817 -34.63442487207061,-58.459672767752281 -34.634643335642899,-58.459894289987638 -34.63486081282791,-58.460002410301271 -34.634966875064677,-58.460675723400215 -34.633689381516994,-58.460765275706422 -34.63350557411831)));;2936;7_13_3;COMUNA 7;13;3;1000;451;549;82,15%;541;539;99,63%;2;0,37%;415;3;0,72%;412;99,28%
MULTIPOLYGON (((-58.456545718443145 -34.63218968661036,-58.456376172134469 -34.632136788864841,-58.455487293605543 -34.631851589258076,-58.455346375437159 -34.631806368078408,-58.454573969015087 -34.631562226466961,-58.454378099168615 -34.631500521073228,-58.453941694143616 -34.632389745304955,-58.453870280075016 -34.632534322394392,-58.454992691972869 -34.63289025528956,-58.4560507873882 -34.633225821564324,-58.456206448014093 -34.633275127346941,-58.457233625661672 -34.63359532907311,-58.457718745838086 -34.632562358099968,-58.457555929231333 -34.632504814231424,-58.456545718443145 -34.63218968661036)));;2937;7_13_4;COMUNA 7;13;4;562;252;310;81,29%;264;264;100,00%;0;0,00%;216;1;0,46%;215;99,54%
MULTIPOLYGON (((-58.457233625661672 -34.63359532907311,-58.456206448014093 -34.633275127346941,-58.4560507873882 -34.633225821564324,-58.454992691972869 -34.63289025528956,-58.453870280075016 -34.632534322394392,-58.453384180570708 -34.63351861441766,-58.454521513663316 -34.633879552894868,-58.455577148902066 -34.634214489236193,-58.456765792407268 -34.634591677868741,-58.457233625661672 -34.63359532907311)));;2938;7_13_5;COMUNA 7;13;5;819;361;458;78,82%;399;399;100,00%;0;0,00%;329;3;0,91%;326;99,09%
MULTIPOLYGON (((-58.459894289987638 -34.63486081282791,-58.459672767752281 -34.634643335642899,-58.459450139066817 -34.63442487207061,-58.459240121117851 -34.634218662364759,-58.458542913723441 -34.634003492703172,-58.457233625661672 -34.63359532907311,-58.456765792407268 -34.634591677868741,-58.457223155915536 -34.634736844849108,-58.457290888241623 -34.634808822052001,-58.457481987747215 -34.635011935593717,-58.457672917788678 -34.635214837547785,-58.45786555273903 -34.63541964073417,-58.457920080274768 -34.635477602515209,-58.458106752461674 -34.635675996419089,-58.458172782321618 -34.635746071586865,-58.458341052454507 -34.63592488633892,-58.458540677145557 -34.636137083290784,-58.458771827281879 -34.636382732715354,-58.458908587872443 -34.636254493453407,-58.46015066110634 -34.635103079876515,-58.460002410301271 -34.634966875064677,-58.459894289987638 -34.63486081282791)));;2939;7_13_6;COMUNA 7;13;6;744;351;393;89,31%;299;299;100,00%;0;0,00%;265;1;0,38%;264;99,62%
MULTIPOLYGON (((-58.461232736386869 -34.636089960759051,-58.461096325210036 -34.635971645345073,-58.46015066110634 -34.635103079876515,-58.458908587872443 -34.636254493453407,-58.458771827281879 -34.636382732715354,-58.459960419273628 -34.637115817064263,-58.460529928105849 -34.637478234572576,-58.460673328394208 -34.637575986665155,-58.461797812130172 -34.636537727229197,-58.461232736386869 -34.636089960759051)));;2940;7_13_7;COMUNA 7;13;7;549;240;309;77,67%;257;256;99,61%;1;0,39%;202;1;0,50%;201;99,50%
MULTIPOLYGON (((-58.457827098177091 -34.638800945455792,-58.457361497677866 -34.639181431077887,-58.456794403481197 -34.639644799989853,-58.455861645494146 -34.640406958574921,-58.455743962968846 -34.640504067674691,-58.456021818687859 -34.6406664122932,-58.456264485353294 -34.640808119966763,-58.4568388642139 -34.641115412161433,-58.457547854343623 -34.640460986839223,-58.458552351574191 -34.639533812569894,-58.45954668637188 -34.638615996119903,-58.460673328394208 -34.637575986665155,-58.460529928105849 -34.637478234572576,-58.459960419273628 -34.637115817064263,-58.45892495766163 -34.637906237390311,-58.458845200932473 -34.637970321461111,-58.458751895630812 -34.638045250459832,-58.457827098177091 -34.638800945455792)));;2941;7_13_8;COMUNA 7;13;8;560;268;292;91,78%;257;257;100,00%;0;0,00%;194;5;2,58%;189;97,42%
MULTIPOLYGON (((-58.459960419273628 -34.637115817064263,-58.458771827281879 -34.636382732715354,-58.458540677145557 -34.636137083290784,-58.458341052454507 -34.63592488633892,-58.458172782321618 -34.635746071586865,-58.458106752461674 -34.635675996419089,-58.457920080274768 -34.635477602515209,-58.45786555273903 -34.63541964073417,-58.457672917788678 -34.635214837547785,-58.456892212306109 -34.636133705966657,-58.457064060404569 -34.636293226239744,-58.457327840424952 -34.636538034800253,-58.457538882601938 -34.636733824891799,-58.457732033490458 -34.636913134479144,-58.457973409375519 -34.637137094961325,-58.45807692961408 -34.637233087939855,-58.458845200932473 -34.637970321461111,-58.45892495766163 -34.637906237390311,-58.459960419273628 -34.637115817064263)));;2942;7_13_9;COMUNA 7;13;9;493;245;248;98,79%;186;186;100,00%;0;0,00%;166;0;0,00%;166;100,00%
MULTIPOLYGON (((-58.466502751870507 -34.63776855604884,-58.468050475492532 -34.638173370127909,-58.468463239990683 -34.637236560632346,-58.468519467312802 -34.637109793311431,-58.469722523591557 -34.637465304812956,-58.470666042516243 -34.637744199472714,-58.470808853385698 -34.637787290038368,-58.471223627995407 -34.636831878859894,-58.471302936456219 -34.636655177440893,-58.470210484370696 -34.63632925314306,-58.469022438581575 -34.635974801982755,-58.467751412046901 -34.635595623580365,-58.467491959461547 -34.635518659716567,-58.467393390256682 -34.635740290470551,-58.46699058921196 -34.636657658977462,-58.466502751870507 -34.63776855604884)));;2943;7_14_1;COMUNA 7;14;1;833;410;423;96,93%;341;341;100,00%;0;0,00%;313;28;8,95%;285;91,05%
MULTIPOLYGON (((-58.463589585048879 -34.643025891516416,-58.464670651815048 -34.642136343901377,-58.46534303694164 -34.641583074330931,-58.465916742854546 -34.641111073820397,-58.464604144630293 -34.640284032932293,-58.464418555967754 -34.640163257206531,-58.463972054684682 -34.639872549216655,-58.463290901991449 -34.641034985644644,-58.463198790685148 -34.641190976901093,-58.463135819998705 -34.641148722286353,-58.461995954357405 -34.64198466287985,-58.462330577630397 -34.642221080235778,-58.462519235466615 -34.642341647828516,-58.462337393101222 -34.642552639960215,-58.461979843089125 -34.642719685863526,-58.462133905998201 -34.642759687929363,-58.462239568638665 -34.642797929008665,-58.462312254344717 -34.642828845722747,-58.462384854851386 -34.642870678227887,-58.462442032028875 -34.642914412125855,-58.462499294456869 -34.642967160363469,-58.462587318513265 -34.643067234030219,-58.462642365594625 -34.643152800124845,-58.462692981737412 -34.64327836744323,-58.462714966589623 -34.643418512664859,-58.462758851222148 -34.643584292473236,-58.462807763279251 -34.643505416739352,-58.462864770494718 -34.643450978356782,-58.462941546981476 -34.64340203303879,-58.463013892384929 -34.643369355797269,-58.463127991955183 -34.643349425250292,-58.463180653214977 -34.643329494854136,-58.463259559826184 -34.643296817440458,-58.463322701924177 -34.643245407077302,-58.463589585048879 -34.643025891516416)));;2944;7_14_10;COMUNA 7;14;10;766;349;417;83,69%;258;257;99,61%;1;0,39%;233;8;3,43%;225;96,57%
MULTIPOLYGON (((-58.463972054684682 -34.639872549216655,-58.463795159237087 -34.639757406425161,-58.463356756976943 -34.63944824479789,-58.462752372179409 -34.639021965347141,-58.46214560776194 -34.63859399266569,-58.461540042468393 -34.63816686204445,-58.461431148694558 -34.638092703650869,-58.460673328394208 -34.637575986665155,-58.45954668637188 -34.638615996119903,-58.459694432444614 -34.63873093310584,-58.460261904987554 -34.639133493846408,-58.460848895497179 -34.639549785049759,-58.461351535811254 -34.639906352287511,-58.461457279188821 -34.639977693707131,-58.461567112751013 -34.640051852063209,-58.462065583947584 -34.64040207806076,-58.462965910237507 -34.641034564237714,-58.463135819998705 -34.641148722286353,-58.463198790685148 -34.641190976901093,-58.463290901991449 -34.641034985644644,-58.463972054684682 -34.639872549216655)));;2945;7_14_11;COMUNA 7;14;11;922;448;474;94,51%;349;349;100,00%;0;0,00%;323;14;4,33%;309;95,67%
MULTIPOLYGON (((-58.460848895497179 -34.639549785049759,-58.460261904987554 -34.639133493846408,-58.459694432444614 -34.63873093310584,-58.45954668637188 -34.638615996119903,-58.458552351574191 -34.639533812569894,-58.458706488005198 -34.639660371040797,-58.459243287750098 -34.640039695276315,-58.459723685063643 -34.640379155342991,-58.460331387309999 -34.640808548462019,-58.460936028292195 -34.641235755310987,-58.461995954357405 -34.64198466287985,-58.463135819998705 -34.641148722286353,-58.462965910237507 -34.641034564237714,-58.462065583947584 -34.64040207806076,-58.461567112751013 -34.640051852063209,-58.461457279188821 -34.639977693707131,-58.461351535811254 -34.639906352287511,-58.460848895497179 -34.639549785049759)));;2946;7_14_12;COMUNA 7;14;12;924;438;486;90,12%;358;358;100,00%;0;0,00%;339;14;4,13%;325;95,87%
MULTIPOLYGON (((-58.462519235466615 -34.642341647828516,-58.462330577630397 -34.642221080235778,-58.461995954357405 -34.64198466287985,-58.460936028292195 -34.641235755310987,-58.460331387309999 -34.640808548462019,-58.459723685063643 -34.640379155342991,-58.459243287750098 -34.640039695276315,-58.458706488005198 -34.639660371040797,-58.458552351574191 -34.639533812569894,-58.457547854343623 -34.640460986839223,-58.4568388642139 -34.641115412161433,-58.457661716823303 -34.641499193439486,-58.457997438094779 -34.641655761077736,-58.458724014822714 -34.641994600413746,-58.459423585899074 -34.642320828650149,-58.46071580437431 -34.642923340199012,-58.461212250007044 -34.64294137599915,-58.4612584354565 -34.642914967276454,-58.461560088124074 -34.642790318678323,-58.461759825681092 -34.642736375029664,-58.461979843089125 -34.642719685863526,-58.462337393101222 -34.642552639960215,-58.462519235466615 -34.642341647828516)));;2947;7_14_13;COMUNA 7;14;13;747;365;382;95,55%;275;274;99,64%;1;0,36%;251;0;0,00%;251;100,00%
MULTIPOLYGON (((-58.464200574521271 -34.634543853687148,-58.463457086089925 -34.634319346184981,-58.463388924689674 -34.634473647409784,-58.462970749056012 -34.63544551173397,-58.463084752915009 -34.635498048347742,-58.464304292615267 -34.635860162845873,-58.465728849054081 -34.63628303682588,-58.46699058921196 -34.636657658977462,-58.467393390256682 -34.635740290470551,-58.467491959461547 -34.635518659716567,-58.466218305592982 -34.635141226032246,-58.46605258147482 -34.635092074168924,-58.464805354075082 -34.634725188698624,-58.464635456616357 -34.634675189880305,-58.464200574521271 -34.634543853687148)));;2948;7_14_2;COMUNA 7;14;2;817;359;458;78,38%;380;380;100,00%;0;0,00%;298;34;11,41%;264;88,59%
MULTIPOLYGON (((-58.465728849054081 -34.63628303682588,-58.464304292615267 -34.635860162845873,-58.463084752915009 -34.635498048347742,-58.462970749056012 -34.63544551173397,-58.461797812130172 -34.636537727229197,-58.462098161350418 -34.63661625274775,-58.463776633986868 -34.637055418596688,-58.465226172387212 -34.637434634763856,-58.466502751870507 -34.63776855604884,-58.46699058921196 -34.636657658977462,-58.465728849054081 -34.63628303682588)));;2949;7_14_3;COMUNA 7;14;3;725;327;398;82,16%;291;290;99,66%;1;0,34%;257;11;4,28%;246;95,72%
MULTIPOLYGON (((-58.46254353067259 -34.637063099552307,-58.463429083314743 -34.637647905046911,-58.463495715411995 -34.637691849705881,-58.46355851324715 -34.637733399912008,-58.464059193905221 -34.638057560704539,-58.464196038207476 -34.638146153495441,-58.464252957350467 -34.638183407500385,-58.464750405566541 -34.638509255667387,-58.464995978388039 -34.638670101511565,-58.465796439626146 -34.639187213018424,-58.465914790902367 -34.639107277827065,-58.466502751870507 -34.63776855604884,-58.465226172387212 -34.637434634763856,-58.463776633986868 -34.637055418596688,-58.462098161350418 -34.63661625274775,-58.461797812130172 -34.636537727229197,-58.46254353067259 -34.637063099552307)));;2950;7_14_4;COMUNA 7;14;4;696;323;373;86,60%;279;279;100,00%;0;0,00%;258;9;3,49%;249;96,51%
MULTIPOLYGON (((-58.464750405566541 -34.638509255667387,-58.464252957350467 -34.638183407500385,-58.464196038207476 -34.638146153495441,-58.464059193905221 -34.638057560704539,-58.46355851324715 -34.637733399912008,-58.463495715411995 -34.637691849705881,-58.463429083314743 -34.637647905046911,-58.46254353067259 -34.637063099552307,-58.461797812130172 -34.636537727229197,-58.460673328394208 -34.637575986665155,-58.461431148694558 -34.638092703650869,-58.461540042468393 -34.63816686204445,-58.46214560776194 -34.63859399266569,-58.462752372179409 -34.639021965347141,-58.463356756976943 -34.63944824479789,-58.464302218059508 -34.638749763034554,-58.464568835843671 -34.638854128775421,-58.464668610367298 -34.638683840068921,-58.464750405566541 -34.638509255667387)));;2951;7_14_5;COMUNA 7;14;5;929;425;504;84,33%;322;321;99,69%;1;0,31%;295;1;0,34%;294;99,66%
MULTIPOLYGON (((-58.468050475492532 -34.638173370127909,-58.466502751870507 -34.63776855604884,-58.465914790902367 -34.639107277827065,-58.465796439626146 -34.639187213018424,-58.464995978388039 -34.638670101511565,-58.464750405566541 -34.638509255667387,-58.464668610367298 -34.638683840068921,-58.464568835843671 -34.638854128775421,-58.464302218059508 -34.638749763034554,-58.463356756976943 -34.63944824479789,-58.463795159237087 -34.639757406425161,-58.463972054684682 -34.639872549216655,-58.464418555967754 -34.640163257206531,-58.464604144630293 -34.640284032932293,-58.465916742854546 -34.641111073820397,-58.466559800397164 -34.640581813064379,-58.46717677692066 -34.64007431108687,-58.467255249353798 -34.639977967091404,-58.468050475492532 -34.638173370127909)));;2952;7_14_6;COMUNA 7;14;6;1125;525;600;87,50%;399;399;100,00%;0;0,00%;379;7;1,85%;372;98,15%
MULTIPOLYGON (((-58.470375071984904 -34.638786927621346,-58.470442031026394 -34.638632200129415,-58.470808853385698 -34.637787290038368,-58.470666042516243 -34.637744199472714,-58.469722523591557 -34.637465304812956,-58.468519467312802 -34.637109793311431,-58.468463239990683 -34.637236560632346,-58.468050475492532 -34.638173370127909,-58.467255249353798 -34.639977967091404,-58.46717677692066 -34.64007431108687,-58.468302354237032 -34.64079689312414,-58.46835236452813 -34.640679563158244,-58.468821875066325 -34.639578097061211,-58.46990549975115 -34.639871286622729,-58.469971097526034 -34.639720362435128,-58.470375071984904 -34.638786927621346)));;2953;7_14_7;COMUNA 7;14;7;939;443;496;89,31%;312;311;99,68%;1;0,32%;272;3;1,10%;269;98,90%
MULTIPOLYGON (((-58.468302354237032 -34.64079689312414,-58.46717677692066 -34.64007431108687,-58.466559800397164 -34.640581813064379,-58.465916742854546 -34.641111073820397,-58.46534303694164 -34.641583074330931,-58.464670651815048 -34.642136343901377,-58.465768625670776 -34.642835216384,-58.466454132184055 -34.642292363282834,-58.467046753670637 -34.641823033068327,-58.467989821746961 -34.642417169415779,-58.469242352527552 -34.641396865281941,-58.469292958400409 -34.641280450431871,-58.46990549975115 -34.639871286622729,-58.468821875066325 -34.639578097061211,-58.46835236452813 -34.640679563158244,-58.468302354237032 -34.64079689312414)));;2954;7_14_8;COMUNA 7;14;8;936;466;470;99,15%;320;320;100,00%;0;0,00%;300;8;2,67%;292;97,33%
MULTIPOLYGON (((-58.466708202247389 -34.643426756916035,-58.466850246143551 -34.64331421343902,-58.467989821746961 -34.642417169415779,-58.467046753670637 -34.641823033068327,-58.466454132184055 -34.642292363282834,-58.465768625670776 -34.642835216384,-58.464670651815048 -34.642136343901377,-58.463589585048879 -34.643025891516416,-58.463322701924177 -34.643245407077302,-58.463259559826184 -34.643296817440458,-58.463180653214977 -34.643329494854136,-58.463127991955183 -34.643349425250292,-58.463013892384929 -34.643369355797269,-58.462941546981476 -34.64340203303879,-58.462864770494718 -34.643450978356782,-58.462807763279251 -34.643505416739352,-58.462758851222148 -34.643584292473236,-58.462583482841062 -34.643867258998831,-58.462880109893497 -34.643966909912002,-58.463107373904265 -34.644043320193688,-58.463166426830057 -34.644063954427054,-58.463830753956763 -34.644369663807154,-58.464866197098608 -34.64484621389262,-58.465085619591839 -34.644711980284598,-58.46559646329667 -34.644307308772376,-58.466708202247389 -34.643426756916035)));;2955;7_14_9;COMUNA 7;14;9;856;400;456;87,72%;331;329;99,40%;2;0,61%;289;9;3,11%;280;96,89%
MULTIPOLYGON (((-58.459071929623761 -34.655745169114603,-58.459655363212015 -34.656253157635888,-58.460355391246132 -34.65684135921687,-58.461279266792978 -34.656158676267296,-58.461998787868659 -34.655532785651047,-58.462958666705433 -34.654723270462242,-58.463766456962013 -34.654092846012141,-58.464593198139198 -34.653533734969429,-58.465684362785296 -34.652678124413015,-58.466459597703036 -34.651996815096254,-58.466629263750619 -34.651788775372331,-58.467008823476917 -34.651487908493515,-58.466338347685692 -34.650505788223633,-58.465892741789823 -34.649962755124356,-58.465747406527726 -34.649785641888975,-58.465040317510685 -34.648874714458977,-58.464914120202529 -34.648730318676733,-58.464409517329742 -34.648152942438315,-58.463883205530919 -34.647551169766452,-58.463357411675382 -34.646827771314335,-58.463000257237198 -34.646171596712698,-58.462579050725303 -34.646543637898574,-58.462580666968208 -34.646547694011005,-58.461746822629081 -34.647178695604275,-58.460711167938541 -34.647957087166361,-58.460834901278616 -34.648054063907288,-58.461200392965651 -34.648371472976081,-58.461673687109339 -34.648782546702364,-58.462124829232579 -34.649174392527321,-58.462592252400675 -34.649580392030785,-58.462053143870946 -34.650002221742284,-58.461859789649885 -34.650157871391251,-58.462143400454636 -34.650134914577677,-58.460546804243414 -34.651388306128709,-58.459360129557687 -34.652291413554757,-58.458570519534661 -34.652910351424715,-58.457833141861741 -34.653488369511535,-58.457478852622202 -34.653766109541188,-58.457112970180468 -34.654050397486849,-58.458016790611516 -34.654832106130669,-58.458337406449623 -34.655108013734534,-58.458369960892902 -34.655134142421041,-58.45892603138568 -34.655581568357988,-58.459071929623761 -34.655745169114603)));;2956;7_15_1;COMUNA 7;15;1;688;340;348;97,70%;194;194;100,00%;0;0,00%;225;15;6,67%;210;93,33%
MULTIPOLYGON (((-58.452620435793627 -34.650331899572919,-58.452844727921722 -34.65038417299926,-58.452975790831943 -34.650427917230736,-58.453074126317063 -34.650498772232993,-58.453149792981819 -34.650573780436282,-58.453225373144626 -34.650661253748048,-58.453280840562854 -34.650757105993016,-58.453338598272893 -34.650948876756573,-58.453821035598786 -34.650902995969261,-58.454636260814745 -34.650823050204089,-58.457395027249042 -34.650552418651095,-58.457338615550441 -34.650491710134027,-58.45746440604691 -34.650397205715855,-58.458495348986368 -34.649622363112357,-58.459603226928806 -34.648789765441002,-58.460711167938555 -34.647957087166361,-58.460581469801191 -34.647855462165786,-58.459874184318778 -34.647348530939865,-58.459291404591589 -34.646930897625317,-58.458630064482122 -34.646456848717087,-58.457976849771008 -34.64709015445051,-58.457651303956908 -34.647405855290927,-58.456678401564808 -34.648349079326131,-58.456615165553252 -34.648410416080424,-58.456176515755359 -34.648844420667281,-58.456256984991789 -34.648543852441627,-58.456252073024011 -34.648147713374364,-58.456171486642958 -34.647773120206502,-58.456022380739363 -34.647473384672338,-58.455908119662368 -34.647293724982859,-58.45553320037039 -34.646900733747643,-58.455283530994791 -34.646742051982365,-58.455004550400211 -34.646560691103154,-58.454744481845097 -34.646453206325027,-58.454536986892876 -34.646397979648093,-58.454428850815034 -34.646371351825259,-58.454355993024699 -34.64635529003035,-58.454257059462741 -34.646337395347146,-58.454119779074738 -34.646317948548159,-58.454003801907376 -34.646305616010345,-58.453942617592482 -34.646300963601668,-58.453874019303818 -34.646298423366929,-58.453770312194656 -34.646295880527823,-58.453646749254354 -34.646298899679394,-58.453591444054645 -34.646301430850286,-58.453528384084457 -34.646305299482414,-58.453434304930028 -34.646315433527342,-58.453246657015043 -34.646343025607749,-58.453160672722255 -34.646357948948314,-58.453096162829354 -34.646372169674322,-58.452975834798096 -34.646402161060607,-58.452687114236511 -34.646483337373709,-58.452005462041114 -34.645906289920049,-58.451718125671171 -34.645835980527146,-58.451515575981837 -34.645786383125731,-58.451219899823577 -34.645640224382575,-58.450193788216808 -34.646465571412563,-58.449217599717045 -34.647250702726787,-58.449836519737957 -34.647853816166865,-58.45007764509851 -34.648113004188509,-58.450141204818308 -34.648195900597727,-58.450165996433689 -34.648240341120207,-58.450211150114505 -34.648317953747274,-58.450246586340008 -34.648413734930983,-58.450267368329392 -34.64848838720733,-58.450284229061658 -34.648571560465584,-58.450307565557715 -34.648660368352459,-58.450319828335552 -34.648718329103502,-58.450334387377168 -34.648807558639724,-58.450341449730878 -34.648880026341843,-58.450352601719622 -34.64895826927976,-58.450376024094624 -34.649043837621882,-58.450401659068163 -34.649150604006323,-58.450416394329757 -34.6492017337997,-58.450431215512808 -34.649248215571554,-58.450460603897362 -34.649330122410866,-58.45053021055152 -34.649446611772397,-58.450626576197386 -34.649562751620998,-58.450684431187462 -34.649622829572216,-58.450744332165485 -34.649678400517715,-58.450815907749217 -34.649737423379939,-58.45088944502352 -34.649785530567357,-58.450981387849929 -34.64984702016546,-58.451085432678084 -34.649903299422185,-58.451261909976679 -34.649989515884826,-58.451367320025113 -34.650035935575822,-58.45147579775017 -34.650084890745418,-58.451586832742905 -34.650129690996494,-58.451700254570291 -34.650170195457491,-58.451815807559477 -34.650206404099031,-58.451933236054728 -34.65023817604321,-58.452052369609056 -34.650265440845168,-58.452172782106452 -34.650288198463194,-58.452294388317497 -34.650306378461579,-58.452416932581201 -34.650319839965952,-58.452538454814992 -34.650328653234823,-58.452620435793627 -34.650331899572919)));;2957;7_15_10;COMUNA 7;15;10;1023;504;519;97,11%;324;324;100,00%;0;0,00%;327;18;5,50%;309;94,50%
MULTIPOLYGON (((-58.461859789649907 -34.650157871391265,-58.462053143870953 -34.650002221742284,-58.46259225240069 -34.649580392030785,-58.462124829232579 -34.649174392527321,-58.461673687109354 -34.648782546702378,-58.461200392965672 -34.648371472976095,-58.460834901278631 -34.648054063907303,-58.460711167938555 -34.647957087166361,-58.459603226928806 -34.648789765441002,-58.458495348986368 -34.649622363112357,-58.45746440604691 -34.650397205715855,-58.457338615550441 -34.650491710134027,-58.457395027249042 -34.650552418651095,-58.454636260814745 -34.650823050204089,-58.45469988851189 -34.651154191081858,-58.454764794444522 -34.651491458935361,-58.454798259585367 -34.651772596266774,-58.454860535774699 -34.651990423685426,-58.454941991221077 -34.652164659438768,-58.455061800438813 -34.652299318898663,-58.455312490275816 -34.652523175517274,-58.456995199430892 -34.653931163166185,-58.457112970180468 -34.654050397486849,-58.457478852622202 -34.653766109541195,-58.457833141861769 -34.653488369511535,-58.458570519534689 -34.652910351424744,-58.459360129557709 -34.652291413554757,-58.460546804243414 -34.651388306128716,-58.462143400454657 -34.650134914577677,-58.461859789649907 -34.650157871391265)));;2958;7_15_11;COMUNA 7;15;11;1148;537;611;87,89%;354;354;100,00%;0;0,00%;367;16;4,36%;351;95,64%
MULTIPOLYGON (((-58.461212250007044 -34.64294137599915,-58.46071580437431 -34.642923340199012,-58.460590880656348 -34.643030524555442,-58.460935298884415 -34.643488572507678,-58.460926262846151 -34.643652450728553,-58.460917397266279 -34.643813159834032,-58.460915605571387 -34.643916825008702,-58.460910831977969 -34.643993940015733,-58.460907592501854 -34.644057744770812,-58.46089634319425 -34.644110915273345,-58.460878617101514 -34.644189297729433,-58.460904519907452 -34.644285779986198,-58.460659355569497 -34.644489374003854,-58.459541906629092 -34.645572834431213,-58.458630064482122 -34.646456848717087,-58.459291404591589 -34.646930897625317,-58.459874184318778 -34.647348530939865,-58.460581469801191 -34.647855462165786,-58.460711167938555 -34.647957087166361,-58.461746822629081 -34.647178695604296,-58.462580666968208 -34.646547694011005,-58.462579050725303 -34.646543637898596,-58.463000257237212 -34.646171596712712,-58.462998941310879 -34.646169179033066,-58.463330490956452 -34.645970929925284,-58.46333207728398 -34.645970034878282,-58.463416543867403 -34.645920137449373,-58.464118878563859 -34.645387790931011,-58.464695941797565 -34.644950304529594,-58.464866197098608 -34.64484621389262,-58.463830753956763 -34.644369663807154,-58.463166426830057 -34.644063954427054,-58.463107373904265 -34.644043320193688,-58.462880109893497 -34.643966909912002,-58.462583482841062 -34.643867258998831,-58.462758851222148 -34.643584292473236,-58.462714966589623 -34.643418512664859,-58.462692981737412 -34.64327836744323,-58.462642365594625 -34.643152800124845,-58.462587318513265 -34.643067234030219,-58.462499294456869 -34.642967160363469,-58.462442032028875 -34.642914412125855,-58.462384854851386 -34.642870678227887,-58.462312254344717 -34.642828845722747,-58.462239568638665 -34.642797929008665,-58.462133905998201 -34.642759687929363,-58.461979843089125 -34.642719685863526,-58.461759825681092 -34.642736375029664,-58.461560088124074 -34.642790318678323,-58.4612584354565 -34.642914967276454,-58.461212250007044 -34.64294137599915)));;2959;7_15_2;COMUNA 7;15;2;1067;509;558;91,22%;302;302;100,00%;0;0,00%;360;52;14,44%;308;85,56%
MULTIPOLYGON (((-58.458666447592115 -34.643020475776503,-58.457520532707498 -34.64407933876862,-58.458559841491542 -34.644847219223799,-58.459541906629092 -34.645572834431213,-58.460659355569497 -34.644489374003854,-58.460904519907452 -34.644285779986198,-58.460878617101514 -34.644189297729433,-58.46089634319425 -34.644110915273345,-58.460907592501854 -34.644057744770812,-58.460910831977969 -34.643993940015733,-58.460915605571387 -34.643916825008702,-58.460917397266279 -34.643813159834032,-58.460926262846151 -34.643652450728553,-58.460935298884415 -34.643488572507678,-58.460590880656348 -34.643030524555442,-58.46071580437431 -34.642923340199012,-58.459423585899074 -34.642320828650149,-58.458666447592115 -34.643020475776503)));;2960;7_15_3;COMUNA 7;15;3;960;450;510;88,24%;329;329;100,00%;0;0,00%;316;28;8,86%;288;91,14%
MULTIPOLYGON (((-58.456502771732943 -34.641425616608082,-58.455358640984656 -34.642481642664158,-58.456307334152847 -34.643182915226085,-58.457520532707498 -34.64407933876862,-58.458666447592115 -34.643020475776503,-58.459423585899074 -34.642320828650149,-58.458724014822714 -34.641994600413746,-58.457997438094779 -34.641655761077736,-58.457661716823303 -34.641499193439486,-58.4568388642139 -34.641115412161433,-58.456502771732943 -34.641425616608082)));;2961;7_15_4;COMUNA 7;15;4;655;311;344;90,41%;273;272;99,63%;1;0,37%;232;9;3,88%;223;96,12%
MULTIPOLYGON (((-58.459541906629092 -34.645572834431213,-58.458559841491542 -34.644847219223799,-58.457520532707498 -34.64407933876862,-58.456307334152847 -34.643182915226085,-58.455358640984656 -34.642481642664158,-58.45442122638741 -34.643346750557122,-58.455369069393235 -34.64404788941134,-58.456116005462249 -34.644600413979902,-58.456582866846972 -34.644945660260426,-58.457620984788655 -34.645713478123376,-58.458501819396666 -34.646364940136863,-58.458630064482122 -34.646456848717087,-58.459541906629092 -34.645572834431213)));;2962;7_15_5;COMUNA 7;15;5;705;335;370;90,54%;256;255;99,61%;1;0,39%;233;4;1,72%;229;98,28%
MULTIPOLYGON (((-58.456582866846972 -34.644945660260426,-58.456116005462249 -34.644600413979902,-58.455369069393235 -34.64404788941134,-58.45442122638741 -34.643346750557122,-58.45405920869652 -34.64368089080056,-58.453956772862867 -34.64377525263798,-58.453354936393005 -34.644329239327227,-58.452968025113314 -34.644685417303826,-58.454718712794076 -34.645917624783998,-58.455442249177217 -34.645237437728596,-58.455834726406927 -34.645489933045305,-58.455939823387517 -34.646205101803744,-58.456433149003615 -34.646031319987181,-58.456867550310825 -34.646408536238411,-58.456929761750487 -34.646351213492437,-58.457620984788655 -34.645713478123376,-58.456582866846972 -34.644945660260426)));;2963;7_15_6;COMUNA 7;15;6;1110;509;601;84,69%;373;372;99,73%;1;0,27%;334;4;1,20%;330;98,80%
MULTIPOLYGON (((-58.452968025113314 -34.644685417303826,-58.452468529686591 -34.645145249817446,-58.451718125671171 -34.645835980527146,-58.452005462041114 -34.645906289920049,-58.452687114236511 -34.646483337373709,-58.452975834798096 -34.646402161060607,-58.453096162829354 -34.646372169674322,-58.453160672722255 -34.646357948948314,-58.453246657015043 -34.646343025607749,-58.453434304930028 -34.646315433527342,-58.453528384084457 -34.646305299482414,-58.453591444054645 -34.646301430850286,-58.453646749254354 -34.646298899679394,-58.453770312194656 -34.646295880527823,-58.453874019303818 -34.646298423366929,-58.453942617592482 -34.646300963601668,-58.454003801907376 -34.646305616010345,-58.454119779074738 -34.646317948548159,-58.454257059462741 -34.646337395347146,-58.454718712794076 -34.645917624783998,-58.452968025113314 -34.644685417303826)));;2964;7_15_7;COMUNA 7;15;7;714;337;377;89,39%;334;334;100,00%;0;0,00%;285;1;0,35%;284;99,65%
MULTIPOLYGON (((-58.455442249177217 -34.645237437728596,-58.454718712794076 -34.645917624783998,-58.454257059462741 -34.646337395347146,-58.454355993024699 -34.64635529003035,-58.454428850815034 -34.646371351825259,-58.454536986892876 -34.646397979648093,-58.454744481845097 -34.646453206325027,-58.455004550400211 -34.646560691103154,-58.455283530994791 -34.646742051982365,-58.45553320037039 -34.646900733747643,-58.455908119662368 -34.647293724982859,-58.456867550310825 -34.646408536238411,-58.456433149003615 -34.646031319987181,-58.455939823387517 -34.646205101803744,-58.455834726406927 -34.645489933045305,-58.455442249177217 -34.645237437728596)));;2965;7_15_8;COMUNA 7;15;8;797;371;426;87,09%;292;292;100,00%;0;0,00%;293;7;2,39%;286;97,61%
MULTIPOLYGON (((-58.457620984788655 -34.645713478123376,-58.456929761750487 -34.646351213492437,-58.456867550310825 -34.646408536238411,-58.455908119662368 -34.647293724982859,-58.456022380739363 -34.647473384672338,-58.456171486642958 -34.647773120206502,-58.456252073024011 -34.648147713374364,-58.456256984991789 -34.648543852441627,-58.456176515755359 -34.648844420667281,-58.456615165553252 -34.648410416080424,-58.456678401564808 -34.648349079326131,-58.457651303956908 -34.647405855290927,-58.457976849771008 -34.64709015445051,-58.458630064482122 -34.646456848717087,-58.458501819396666 -34.646364940136863,-58.457620984788655 -34.645713478123376)));;2966;7_15_9;COMUNA 7;15;9;1218;566;652;86,81%;386;386;100,00%;0;0,00%;397;10;2,52%;387;97,48%
MULTIPOLYGON (((-58.454418667981329 -34.641652894431324,-58.45312060629383 -34.642784243373001,-58.453003599419837 -34.642876983509233,-58.453232965810692 -34.643093205478053,-58.453430978477293 -34.643279775815422,-58.453629673655797 -34.643467050123732,-58.453956772862867 -34.64377525263798,-58.45405920869652 -34.64368089080056,-58.45442122638741 -34.643346750557122,-58.455358640984656 -34.642481642664158,-58.456502771732943 -34.641425616608082,-58.4568388642139 -34.641115412161433,-58.456264485353294 -34.640808119966763,-58.456021818687859 -34.6406664122932,-58.455743962968846 -34.640504067674691,-58.455603697984756 -34.640619908335253,-58.454418667981329 -34.641652894431324)));;2967;7_16_1;COMUNA 7;16;1;722;342;380;90,00%;276;276;100,00%;0;0,00%;248;1;0,40%;247;99,60%
MULTIPOLYGON (((-58.454707370854521 -34.639787713793389,-58.454498971342701 -34.63956881975075,-58.454328486697996 -34.639389788378487,-58.454282308584908 -34.639341192101362,-58.454089758317387 -34.639138989110137,-58.453897634980166 -34.638937208387809,-58.453796333961641 -34.638830789182535,-58.453666403257806 -34.638725353721057,-58.45230243299801 -34.639794293250525,-58.452408081472626 -34.639880220437369,-58.45277367501636 -34.640202584926087,-58.453086957962554 -34.640478815967327,-58.453291866753716 -34.640659471473121,-58.453498650874948 -34.640841746540445,-58.453726992026162 -34.641043107950054,-58.453983365932373 -34.641269119597951,-58.454187852594188 -34.641449421421292,-58.454418667981329 -34.641652894431324,-58.455603697984756 -34.640619908335253,-58.455743962968846 -34.640504067674691,-58.455462529711113 -34.640339679888314,-58.455216457583724 -34.640195928081035,-58.454912278228193 -34.640002945160973,-58.454707370854521 -34.639787713793389)));;2968;7_16_2;COMUNA 7;16;2;796;371;425;87,29%;255;255;100,00%;0;0,00%;253;3;1,19%;250;98,81%
MULTIPOLYGON (((-58.453086957962554 -34.640478815967327,-58.45277367501636 -34.640202584926087,-58.452408081472626 -34.639880220437369,-58.45230243299801 -34.639794293250525,-58.451308965431394 -34.640538101363461,-58.451704439437442 -34.641064210646114,-58.451984732134015 -34.641445163114447,-58.452142515036535 -34.641659690679788,-58.452303110259869 -34.641877880360347,-58.452488583870711 -34.642129946211504,-58.452685901059162 -34.642398280859545,-58.452846839926728 -34.642616892374598,-58.453003599419837 -34.642876983509233,-58.45312060629383 -34.642784243373001,-58.454418667981329 -34.641652894431324,-58.454187852594188 -34.641449421421292,-58.453983365932373 -34.641269119597951,-58.453726992026162 -34.641043107950054,-58.453498650874948 -34.640841746540445,-58.453291866753716 -34.640659471473121,-58.453086957962554 -34.640478815967327)));;2969;7_16_3;COMUNA 7;16;3;815;381;434;87,79%;256;256;100,00%;0;0,00%;264;0;0,00%;264;100,00%
MULTIPOLYGON (((-58.451442388377195 -34.637467946833638,-58.451441029484954 -34.63746688877076,-58.451302806478672 -34.637511194762439,-58.450934854836532 -34.637760864849234,-58.450516367532416 -34.638045805662692,-58.450322416607186 -34.638182578023752,-58.449558964275695 -34.638690894718806,-58.449407531642805 -34.638805881985853,-58.449519123810198 -34.638902319703625,-58.449581928036928 -34.638959849450487,-58.450371018652334 -34.639680940679007,-58.451308965431394 -34.640538101363461,-58.45230243299801 -34.639794293250525,-58.453666403257806 -34.638725353721057,-58.453572086555418 -34.638648794953539,-58.453477852544601 -34.638596532670789,-58.452536541356871 -34.638074469298722,-58.451442388377195 -34.637467946833638)));;2970;7_16_4;COMUNA 7;16;4;726;335;391;85,68%;225;225;100,00%;0;0,00%;241;11;4,56%;230;95,44%
MULTIPOLYGON (((-58.450371018652334 -34.639680940679007,-58.449581928036928 -34.638959849450487,-58.449519123810198 -34.638902319703625,-58.449407531642805 -34.638805881985853,-58.448126856700732 -34.639778513179309,-58.447338989839672 -34.64037688620035,-58.447150990773437 -34.640520599326578,-58.447256596619802 -34.640615160193484,-58.448123848418199 -34.641387929997101,-58.448927265704924 -34.642104172684753,-58.449038195207592 -34.642199399421159,-58.450023691270282 -34.641467370119258,-58.450160128791829 -34.641365972575031,-58.451144493619019 -34.640661258806503,-58.451308965431394 -34.640538101363461,-58.450371018652334 -34.639680940679007)));;2971;7_16_5;COMUNA 7;16;5;795;411;384;107,03%;315;315;100,00%;0;0,00%;274;20;7,30%;254;92,70%
MULTIPOLYGON (((-58.453003599419837 -34.642876983509233,-58.452846839926728 -34.642616892374598,-58.452685901059162 -34.642398280859545,-58.452488583870711 -34.642129946211504,-58.452303110259869 -34.641877880360347,-58.452142515036535 -34.641659690679788,-58.451984732134015 -34.641445163114447,-58.451704439437442 -34.641064210646114,-58.451308965431394 -34.640538101363461,-58.451144493619019 -34.640661258806503,-58.450160128791829 -34.641365972575031,-58.450023691270282 -34.641467370119258,-58.45014586915719 -34.641561540655459,-58.450440831514257 -34.641814747650962,-58.450803104298487 -34.642125849651066,-58.450939596310178 -34.64224297924526,-58.451153792400731 -34.642426878724628,-58.451197756392212 -34.642464630542264,-58.451354271944957 -34.642598945190187,-58.451604340018655 -34.642813622811381,-58.452226320715596 -34.643347567749899,-58.452313654132354 -34.643423563507092,-58.451462288718538 -34.64409794566231,-58.451351158542295 -34.644185825428174,-58.452468529686591 -34.645145249817446,-58.452968025113314 -34.644685417303826,-58.453354936393005 -34.644329239327227,-58.453956772862867 -34.64377525263798,-58.453629673655797 -34.643467050123732,-58.453430978477293 -34.643279775815422,-58.453232965810692 -34.643093205478053,-58.453003599419837 -34.642876983509233)));;2972;7_16_6;COMUNA 7;16;6;1007;481;526;91,44%;378;378;100,00%;0;0,00%;352;28;7,95%;324;92,05%
MULTIPOLYGON (((-58.449511741631568 -34.644183879760973,-58.450395378850814 -34.644937305351895,-58.451219899823577 -34.645640224382575,-58.451515575981837 -34.645786383125731,-58.451718125671171 -34.645835980527146,-58.452468529686591 -34.645145249817446,-58.451351158542295 -34.644185825428174,-58.451462288718538 -34.64409794566231,-58.452313654132354 -34.643423563507092,-58.452226320715596 -34.643347567749899,-58.451604340018655 -34.642813622811381,-58.451354271944957 -34.642598945190187,-58.451197756392212 -34.642464630542264,-58.451153792400731 -34.642426878724628,-58.450939596310178 -34.64224297924526,-58.450803104298487 -34.642125849651066,-58.450440831514257 -34.641814747650962,-58.45014586915719 -34.641561540655459,-58.450023691270282 -34.641467370119258,-58.449038195207592 -34.642199399421159,-58.448171056843407 -34.642843474327869,-58.448054385461162 -34.642934871684062,-58.448212429448233 -34.643076092161159,-58.449461131714422 -34.644140703921046,-58.449511741631568 -34.644183879760973)));;2973;7_16_7;COMUNA 7;16;7;947;473;474;99,79%;336;336;100,00%;0;0,00%;320;9;2,81%;311;97,19%
MULTIPOLYGON (((-58.447440867579779 -34.645673191387722,-58.448350311544239 -34.64648860857325,-58.449047444692958 -34.647113637349356,-58.449217599717045 -34.647250702726787,-58.450193788216808 -34.646465571412563,-58.451219899823577 -34.645640224382575,-58.450395378850814 -34.644937305351895,-58.449511741631568 -34.644183879760973,-58.449461131714422 -34.644140703921046,-58.448212429448233 -34.643076092161159,-58.448054385461162 -34.642934871684062,-58.447088534200354 -34.643692029036472,-58.446097523436428 -34.644468753292635,-58.447440867579779 -34.645673191387722)));;2974;7_16_8;COMUNA 7;16;8;1106;535;571;93,70%;382;382;100,00%;0;0,00%;352;13;3,69%;339;96,31%
MULTIPOLYGON (((-58.448123848418199 -34.641387929997101,-58.447256596619802 -34.640615160193484,-58.447150990773437 -34.640520599326578,-58.446338990931643 -34.641141569081157,-58.446204414602114 -34.641245216688105,-58.446052762018745 -34.641361997899779,-58.445309059982009 -34.641928211920991,-58.445251604334295 -34.642039686092581,-58.444244067101209 -34.642806815368054,-58.444300125504114 -34.642857107102834,-58.445167761537832 -34.643635076118493,-58.446097523436428 -34.644468753292635,-58.447088534200354 -34.643692029036472,-58.448054385461162 -34.642934871684062,-58.448171056843407 -34.642843474327869,-58.449038195207592 -34.642199399421159,-58.448927265704924 -34.642104172684753,-58.448123848418199 -34.641387929997101)));;2975;7_16_9;COMUNA 7;16;9;1057;498;559;89,09%;351;351;100,00%;0;0,00%;335;27;8,06%;308;91,94%
MULTIPOLYGON (((-58.445520171000204 -34.647503485060732,-58.445183852214505 -34.647756332257046,-58.445511196140458 -34.648047655317953,-58.445742604626176 -34.648253609475752,-58.445803183391064 -34.648307563187025,-58.445743606575505 -34.648355091573833,-58.445552518089478 -34.648502745396726,-58.445398680867036 -34.648594205318524,-58.44534234437986 -34.64862983219701,-58.445286078793373 -34.648733700566382,-58.445331063602382 -34.648783285950508,-58.445443610420817 -34.648910418458641,-58.445612388676231 -34.649101152227644,-58.445998339780637 -34.649542627497631,-58.446155620009243 -34.649713217467216,-58.44522052351283 -34.650465292762,-58.445087046516491 -34.650572600723685,-58.444965928186953 -34.650670050884408,-58.444620215232376 -34.650948036624477,-58.444950686484773 -34.651010340561271,-58.445804758141733 -34.65104666015413,-58.448828188057099 -34.651175073581825,-58.45197471500753 -34.651078486621067,-58.453338598272893 -34.650948876756573,-58.453280840562854 -34.650757105993016,-58.453225373144626 -34.650661253748048,-58.453149792981819 -34.650573780436282,-58.453074126317063 -34.650498772232993,-58.452975790831943 -34.650427917230736,-58.452844727921722 -34.65038417299926,-58.452620435793627 -34.650331899572919,-58.452538454814992 -34.650328653234823,-58.452416932581201 -34.650319839965952,-58.452294388317497 -34.650306378461579,-58.452172782106452 -34.650288198463194,-58.452052369609056 -34.650265440845168,-58.451933236054728 -34.65023817604321,-58.451815807559477 -34.650206404099031,-58.451700254570291 -34.650170195457491,-58.451586832742905 -34.650129690996494,-58.45147579775017 -34.650084890745418,-58.451367320025113 -34.650035935575822,-58.451261909976679 -34.649989515884826,-58.451085432678084 -34.649903299422185,-58.450981387849929 -34.64984702016546,-58.45088944502352 -34.649785530567357,-58.450815907749217 -34.649737423379939,-58.450744332165485 -34.649678400517715,-58.450684431187462 -34.649622829572216,-58.450626576197386 -34.649562751620998,-58.45053021055152 -34.649446611772397,-58.450460603897362 -34.649330122410866,-58.450431215512808 -34.649248215571554,-58.450416394329757 -34.6492017337997,-58.450401659068163 -34.649150604006323,-58.450376024094624 -34.649043837621882,-58.450352601719622 -34.64895826927976,-58.450341449730878 -34.648880026341843,-58.450334387377168 -34.648807558639724,-58.450319828335552 -34.648718329103502,-58.450307565557715 -34.648660368352459,-58.450284229061658 -34.648571560465584,-58.450267368329392 -34.64848838720733,-58.450246586340008 -34.648413734930983,-58.450211150114505 -34.648317953747274,-58.450165996433689 -34.648240341120207,-58.450141204818308 -34.648195900597727,-58.45007764509851 -34.648113004188509,-58.449836519737957 -34.647853816166865,-58.449217599717045 -34.647250702726787,-58.449047444692958 -34.647113637349356,-58.448350311544239 -34.64648860857325,-58.447440867579779 -34.645673191387722,-58.446097523436428 -34.644468753292635,-58.446014256538085 -34.644534096068753,-58.445874739473339 -34.644643446488992,-58.445127455906444 -34.645250472567895,-58.445046232481417 -34.645316448791291,-58.444994583518323 -34.645358414431037,-58.444408969268963 -34.645834258175469,-58.444038387221127 -34.646131957673454,-58.443975572102829 -34.6461824425554,-58.444868722289407 -34.646946895653222,-58.445250032218674 -34.646696872726139,-58.445293399774727 -34.64673223212084,-58.445895011458767 -34.647221768118257,-58.445520171000204 -34.647503485060732)));;2976;7_17_1;COMUNA 7;17;1;1605;822;783;104,98%;346;346;100,00%;0;0,00%;439;107;24,37%;332;75,63%
MULTIPOLYGON (((-58.442629031726455 -34.64969081178667,-58.442836050142432 -34.649755583149201,-58.443094579330236 -34.649951855460493,-58.443199673014256 -34.650120946090354,-58.44339417084133 -34.65012296474935,-58.443624265443795 -34.650114550002201,-58.443831176979941 -34.650120779564126,-58.443899605618427 -34.650132410201401,-58.444287937235821 -34.650194513574988,-58.444349889821922 -34.650203818967888,-58.444419253125879 -34.650228618864396,-58.444593668354749 -34.650363508097925,-58.444965928186953 -34.650670050884408,-58.445087046516491 -34.650572600723685,-58.44522052351283 -34.650465292762,-58.446155620009243 -34.649713217467216,-58.445998339780637 -34.649542627497631,-58.445448668161433 -34.649589031250841,-58.445302344616614 -34.649601405202965,-58.445189256625397 -34.649612868235963,-58.44514195906423 -34.649617720736586,-58.445096881835909 -34.649600601045073,-58.44479297630707 -34.649668798292346,-58.444770473810017 -34.649690485781235,-58.44455665106166 -34.649727708800008,-58.444489752588083 -34.649734459595443,-58.44395345648131 -34.649788816590195,-58.443691486693865 -34.649815396556498,-58.443650492605919 -34.649831376556904,-58.443498545313268 -34.649837620520032,-58.443179426495391 -34.649721791713475,-58.442979676504592 -34.649706688696675,-58.442629031726455 -34.64969081178667)));;2977;7_17_10;COMUNA 7;17;10;1507;733;774;94,70%;221;221;100,00%;0;0,00%;500;190;38,00%;310;62,00%
MULTIPOLYGON (((-58.443366009316563 -34.650714623619507,-58.443461997688743 -34.650732431722908,-58.443669225200011 -34.650770274199225,-58.444125843296582 -34.650857085100405,-58.444620215232376 -34.650948036624477,-58.444965928186953 -34.650670050884408,-58.444593668354749 -34.650363508097925,-58.444419253125879 -34.650228618864396,-58.444349889821922 -34.650203818967888,-58.444287937235821 -34.650194513574988,-58.443899605618427 -34.650132410201401,-58.443831176979941 -34.650120779564126,-58.443624265443795 -34.650114550002201,-58.44339417084133 -34.65012296474935,-58.443199673014256 -34.650120946090354,-58.443373055295773 -34.6504631574021,-58.443366009316563 -34.650714623619507)));;2978;7_17_11;COMUNA 7;17;11;560;270;290;93,10%;93;93;100,00%;0;0,00%;190;49;25,79%;141;74,21%
MULTIPOLYGON (((-58.445293399774727 -34.64673223212084,-58.445250032218674 -34.646696872726139,-58.444868722289407 -34.646946895653222,-58.444770450298194 -34.647028855585084,-58.444986258833893 -34.647237907603539,-58.444294689212434 -34.647792117884919,-58.444284875851757 -34.64785268162975,-58.4440371815814 -34.648089763871418,-58.444005559261193 -34.648119407817397,-58.444232538618394 -34.648299588727234,-58.444562252068543 -34.648661550614683,-58.444900525403057 -34.648460185893768,-58.445351130739652 -34.648177988730964,-58.445359320140703 -34.648137073157812,-58.445511196140458 -34.648047655317953,-58.445183852214505 -34.647756332257046,-58.445520171000204 -34.647503485060732,-58.445895011458767 -34.647221768118257,-58.445293399774727 -34.64673223212084)));;2979;7_17_2;COMUNA 7;17;2;1587;750;837;89,61%;312;312;100,00%;0;0,00%;500;185;37,00%;315;63,00%
MULTIPOLYGON (((-58.444831207421359 -34.649024699921021,-58.445189256625397 -34.649612868235963,-58.445302344616614 -34.649601405202965,-58.445448668161433 -34.649589031250841,-58.445998339780637 -34.649542627497631,-58.445612388676231 -34.649101152227644,-58.445443610420817 -34.648910418458641,-58.445331063602382 -34.648783285950508,-58.445286078793373 -34.648733700566382,-58.44534234437986 -34.64862983219701,-58.445398680867036 -34.648594205318524,-58.445552518089478 -34.648502745396726,-58.445743606575505 -34.648355091573833,-58.445803183391064 -34.648307563187025,-58.445742604626176 -34.648253609475752,-58.445511196140458 -34.648047655317953,-58.445359320140703 -34.648137073157812,-58.445351130739652 -34.648177988730964,-58.444900525403057 -34.648460185893768,-58.444562252068543 -34.648661550614683,-58.444831207421359 -34.649024699921021)));;2980;7_17_3;COMUNA 7;17;3;1374;679;695;97,70%;220;220;100,00%;0;0,00%;416;174;41,83%;242;58,17%
MULTIPOLYGON (((-58.444005559261193 -34.648119407817397,-58.443701182659886 -34.648404580716409,-58.443680382340176 -34.64843605730362,-58.443663066775322 -34.648507606070716,-58.443863636853251 -34.648652430344775,-58.444064864523 -34.648908314090512,-58.444216488854153 -34.649197500852203,-58.444298528028781 -34.649316530943921,-58.444489752588083 -34.649734459595443,-58.44455665106166 -34.649727708800008,-58.444770473810017 -34.649690485781235,-58.44479297630707 -34.649668798292346,-58.445096881835909 -34.649600601045073,-58.44514195906423 -34.649617720736586,-58.445189256625397 -34.649612868235963,-58.444831207421359 -34.649024699921021,-58.444562252068543 -34.648661550614683,-58.444232538618394 -34.648299588727234,-58.444005559261193 -34.648119407817397)));;2981;7_17_4;COMUNA 7;17;4;1645;827;818;101,10%;252;252;100,00%;0;0,00%;509;206;40,47%;303;59,53%
MULTIPOLYGON (((-58.444294689212434 -34.647792117884919,-58.444084125551612 -34.64737573518758,-58.44389713371713 -34.647115205576156,-58.443055574747426 -34.648035805238138,-58.443032900973201 -34.648061013618559,-58.443680382340176 -34.64843605730362,-58.443701182659886 -34.648404580716409,-58.444005559261193 -34.648119407817397,-58.4440371815814 -34.648089763871418,-58.444284875851757 -34.64785268162975,-58.444294689212434 -34.647792117884919)));;2982;7_17_5;COMUNA 7;17;5;891;429;462;92,86%;104;104;100,00%;0;0,00%;268;60;22,39%;208;77,61%
MULTIPOLYGON (((-58.443975572102829 -34.6461824425554,-58.443655614420763 -34.646439513584831,-58.443393782882531 -34.646649971831664,-58.443180788111277 -34.646821069932159,-58.442943927339783 -34.647011389732278,-58.442308258967707 -34.647522004930714,-58.442362191221136 -34.647563001103833,-58.442381361601441 -34.647577018811717,-58.442441429100931 -34.647619847013353,-58.442531487686963 -34.647684793499522,-58.442622909733927 -34.647750373965145,-58.442720979031122 -34.64781525120398,-58.442819815368757 -34.647880410187064,-58.442918396058687 -34.64794620287001,-58.443055574747426 -34.648035805238138,-58.44389713371713 -34.647115205576156,-58.444084125551612 -34.64737573518758,-58.444294689212434 -34.647792117884919,-58.444986258833893 -34.647237907603539,-58.444770450298194 -34.647028855585084,-58.444868722289407 -34.646946895653222,-58.443975572102829 -34.6461824425554)));;2983;7_17_6;COMUNA 7;17;6;1313;635;678;93,66%;364;364;100,00%;0;0,00%;375;162;43,20%;213;56,80%
MULTIPOLYGON (((-58.442308258967707 -34.647522004930714,-58.442094663077818 -34.6476936644058,-58.44191490431816 -34.647838145346952,-58.440699279009635 -34.648814863187468,-58.441873715403496 -34.649380870110313,-58.442137370641227 -34.649018218908402,-58.442185883159482 -34.648923787599053,-58.442379889552093 -34.648720574484074,-58.442631003710844 -34.648464481535292,-58.443032900973201 -34.648061013618559,-58.443055574747426 -34.648035805238138,-58.442918396058687 -34.64794620287001,-58.442819815368757 -34.647880410187064,-58.442720979031122 -34.64781525120398,-58.442622909733927 -34.647750373965145,-58.442531487686963 -34.647684793499522,-58.442441429100931 -34.647619847013353,-58.442381361601441 -34.647577018811717,-58.442362191221136 -34.647563001103833,-58.442308258967707 -34.647522004930714)));;2984;7_17_7;COMUNA 7;17;7;2416;1200;1216;98,68%;466;466;100,00%;0;0,00%;764;282;36,91%;482;63,09%
MULTIPOLYGON (((-58.443680382340176 -34.64843605730362,-58.443032900973201 -34.648061013618559,-58.442631003710844 -34.648464481535292,-58.442379889552093 -34.648720574484074,-58.442185883159482 -34.648923787599053,-58.442137370641227 -34.649018218908402,-58.441873715403496 -34.649380870110313,-58.442086316508323 -34.649491884749857,-58.442234250850341 -34.649418247305633,-58.44229144335489 -34.649374593599603,-58.442559828657615 -34.649244423017159,-58.442878518940354 -34.649001158012602,-58.442899319704296 -34.648969681565248,-58.443127919643111 -34.648780839506486,-58.443313944711939 -34.648807137623791,-58.44345006072335 -34.648709339319026,-58.443663066775322 -34.648507606070716,-58.443680382340176 -34.64843605730362)));;2985;7_17_8;COMUNA 7;17;8;1103;517;586;88,23%;155;155;100,00%;0;0,00%;338;152;44,97%;186;55,03%
MULTIPOLYGON (((-58.443313944711939 -34.648807137623791,-58.443127919643111 -34.648780839506486,-58.442899319704296 -34.648969681565248,-58.442878518940354 -34.649001158012602,-58.442559828657615 -34.649244423017159,-58.44229144335489 -34.649374593599603,-58.442234250850341 -34.649418247305633,-58.442086316508323 -34.649491884749857,-58.442354878865892 -34.64957978784286,-58.442629031726455 -34.64969081178667,-58.442979676504592 -34.649706688696675,-58.443179426495391 -34.649721791713475,-58.443498545313268 -34.649837620520032,-58.443650492605919 -34.649831376556904,-58.443691486693865 -34.649815396556498,-58.44395345648131 -34.649788816590195,-58.444489752588083 -34.649734459595443,-58.444298528028781 -34.649316530943921,-58.444216488854153 -34.649197500852203,-58.444064864523 -34.648908314090512,-58.443863636853251 -34.648652430344775,-58.443663066775322 -34.648507606070716,-58.44345006072335 -34.648709339319026,-58.443313944711939 -34.648807137623791)));;2986;7_17_9;COMUNA 7;17;9;1846;865;981;88,18%;341;341;100,00%;0;0,00%;618;237;38,35%;381;61,65%
MULTIPOLYGON (((-58.441937833520157 -34.650891340120531,-58.442793823677356 -34.651090925455449,-58.442987095227586 -34.651127014270486,-58.443323957379896 -34.651189887044104,-58.443521503948602 -34.651167241538822,-58.443638685318 -34.651153808805716,-58.444406201079076 -34.651065684287232,-58.444619947754795 -34.650948117302079,-58.444620215232376 -34.650948036624477,-58.444125843296582 -34.650857085100405,-58.443669225200011 -34.650770274199225,-58.443461997688743 -34.650732431722908,-58.443366009316563 -34.650714623619507,-58.443373055295773 -34.6504631574021,-58.443199673014256 -34.650120946090354,-58.443094579330236 -34.649951855460493,-58.442836050142432 -34.649755583149201,-58.442629031726455 -34.64969081178667,-58.442354878865892 -34.64957978784286,-58.442086316508323 -34.649491884749857,-58.440787361483828 -34.650560072539825,-58.440437201294301 -34.650846637430853,-58.441937833520157 -34.650891340120531)));;2987;7_18_1;COMUNA 7;18;1;1545;758;787;96,32%;437;437;100,00%;0;0,00%;395;164;41,52%;231;58,48%
MULTIPOLYGON (((-58.433573182365663 -34.649496911098694,-58.43348080944638 -34.649484564684258,-58.433358183595601 -34.649472985595395,-58.433281155993996 -34.649444022501136,-58.433154987019364 -34.649331030840131,-58.433130534381633 -34.649316587857363,-58.432566396187525 -34.64929039263189,-58.432292110379812 -34.649199899276688,-58.431114183438559 -34.65019350305198,-58.431310893762436 -34.650357150310235,-58.430983059440102 -34.650341290359705,-58.431797850395832 -34.651016449375888,-58.432030771937733 -34.651209471698095,-58.432092157180207 -34.651137653988052,-58.432190859978348 -34.651090142090155,-58.432393995404283 -34.650939061461671,-58.432864619520799 -34.650596843315576,-58.432920891908836 -34.650520798450842,-58.43293582870082 -34.650455588872724,-58.433545905208661 -34.650490948582345,-58.433550796582459 -34.6499073406573,-58.433573182365663 -34.649496911098694)));;2988;7_18_10;COMUNA 7;18;10;1493;723;770;93,90%;393;393;100,00%;0;0,00%;414;185;44,69%;229;55,31%
MULTIPOLYGON (((-58.440699279009635 -34.648814863187468,-58.439558519613378 -34.648305763355879,-58.438812094781014 -34.648911975846872,-58.439682739161661 -34.649639630073864,-58.440787361483828 -34.650560072539825,-58.442086316508323 -34.649491884749857,-58.441873715403496 -34.649380870110313,-58.440699279009635 -34.648814863187468)));;2989;7_18_2;COMUNA 7;18;2;487;241;246;97,97%;134;134;100,00%;0;0,00%;124;55;44,35%;69;55,65%
MULTIPOLYGON (((-58.438812094781014 -34.648911975846872,-58.438598146657085 -34.649085671402538,-58.4380452016294 -34.649534799789684,-58.43848311889834 -34.649905884646195,-58.438510973595754 -34.649947229448166,-58.438657024755109 -34.64999838663239,-58.438711811198303 -34.650031778708922,-58.438771452684534 -34.650073904370679,-58.438788748573565 -34.65008665462593,-58.439006369856912 -34.650189446674965,-58.438919255243448 -34.650260206493691,-58.438884672032536 -34.650800356807245,-58.440437201294301 -34.650846637430853,-58.440787361483828 -34.650560072539825,-58.439682739161661 -34.649639630073864,-58.438812094781014 -34.648911975846872)));;2990;7_18_3;COMUNA 7;18;3;942;474;468;101,28%;235;235;100,00%;0;0,00%;288;54;18,75%;234;81,25%
MULTIPOLYGON (((-58.439558519613378 -34.648305763355879,-58.437725648084914 -34.64748770079909,-58.437678156383939 -34.647574031726336,-58.437641480720956 -34.647681703535667,-58.437639592427082 -34.647726634094795,-58.437609583868294 -34.647766981266763,-58.43769767601561 -34.647841367823041,-58.437759605213294 -34.647920467420313,-58.437821454423343 -34.647982453771832,-58.437894627924784 -34.648077049021346,-58.437980832053263 -34.648197985696676,-58.438164706365122 -34.648283307113395,-58.43817313492459 -34.648310422308931,-58.438111115781368 -34.648533656035376,-58.438208654234963 -34.64865614416847,-58.43830245608661 -34.648735249876857,-58.438391490668245 -34.648798016038569,-58.438468430463331 -34.648839934029866,-58.438419669848692 -34.648894151325827,-58.438415914372762 -34.648914292033162,-58.43848152115352 -34.648953109072643,-58.438571578947872 -34.649015100632568,-58.438598146657085 -34.649085671402538,-58.438812094781014 -34.648911975846872,-58.439558519613378 -34.648305763355879)));;2991;7_18_4;COMUNA 7;18;4;813;400;413;96,85%;124;124;100,00%;0;0,00%;254;89;35,04%;165;64,96%
MULTIPOLYGON (((-58.437725648084914 -34.64748770079909,-58.437422317315331 -34.647352352479686,-58.437406417358964 -34.647365215888222,-58.436460487222824 -34.648130482892341,-58.436423322921087 -34.648160546226826,-58.437237194977115 -34.648849753882004,-58.4380452016294 -34.649534799789684,-58.438598146657085 -34.649085671402538,-58.438571578947872 -34.649015100632568,-58.43848152115352 -34.648953109072643,-58.438415914372762 -34.648914292033162,-58.438419669848692 -34.648894151325827,-58.438468430463331 -34.648839934029866,-58.438391490668245 -34.648798016038569,-58.43830245608661 -34.648735249876857,-58.438208654234963 -34.64865614416847,-58.438111115781368 -34.648533656035376,-58.43817313492459 -34.648310422308931,-58.438164706365122 -34.648283307113395,-58.437980832053263 -34.648197985696676,-58.437894627924784 -34.648077049021346,-58.437821454423343 -34.647982453771832,-58.437759605213294 -34.647920467420313,-58.43769767601561 -34.647841367823041,-58.437609583868294 -34.647766981266763,-58.437639592427082 -34.647726634094795,-58.437641480720956 -34.647681703535667,-58.437678156383939 -34.647574031726336,-58.437725648084914 -34.64748770079909)));;2992;7_18_5;COMUNA 7;18;5;1003;503;500;100,60%;106;106;100,00%;0;0,00%;292;91;31,16%;201;68,84%
MULTIPOLYGON (((-58.435546427048862 -34.649491309934461,-58.435747236968325 -34.649912000970303,-58.435660395497969 -34.649921277799514,-58.435450681643673 -34.649888131528563,-58.435432341516368 -34.649943058660625,-58.435366155456649 -34.650113260233276,-58.435387713909208 -34.650119603282612,-58.435403044254386 -34.650147565302788,-58.435393824727491 -34.650195804126,-58.435389212454133 -34.650227564611441,-58.435349634923618 -34.650595524538964,-58.433931261802833 -34.650513294294768,-58.433545905208661 -34.650490948582345,-58.43293582870082 -34.650455588872724,-58.432920891908836 -34.650520798450842,-58.432864619520799 -34.650596843315576,-58.432393995404283 -34.650939061461671,-58.432190859978348 -34.651090142090155,-58.432092157180207 -34.651137653988052,-58.432030771937733 -34.651209471698095,-58.432990679599328 -34.651974802594076,-58.433678142924109 -34.652514702505371,-58.434433517654433 -34.653113066690914,-58.435061016849986 -34.653610197054405,-58.436021237223308 -34.654370785428625,-58.437097901142032 -34.655101601051193,-58.438001925182725 -34.655806174289914,-58.438418086940395 -34.655491671230052,-58.438845687108603 -34.655102307625263,-58.4394861186206 -34.654603543368154,-58.440403491651587 -34.653889045654992,-58.441533180575618 -34.653009080135305,-58.441631546679965 -34.652932475182148,-58.442652190894059 -34.65213755321853,-58.442748083060714 -34.652062848411639,-58.442822921919735 -34.65200257714821,-58.442908415115639 -34.651934842556742,-58.442951631163702 -34.651897665356472,-58.443005417593845 -34.651847883838649,-58.443060143701878 -34.65178831342368,-58.443111717526484 -34.651724587423651,-58.44315715614772 -34.651657480035432,-58.443204728897591 -34.65157466827641,-58.443243012227136 -34.651492911385411,-58.443266121178389 -34.651432561154408,-58.443295372819421 -34.651342915245507,-58.443323957379896 -34.651189887044104,-58.442987095227586 -34.651127014270486,-58.442793823677356 -34.651090925455449,-58.441937833520157 -34.650891340120531,-58.440437201294301 -34.650846637430853,-58.438884672032536 -34.650800356807245,-58.438919255243448 -34.650260206493691,-58.439006369856912 -34.650189446674965,-58.438788748573565 -34.65008665462593,-58.438771452684534 -34.650073904370679,-58.438711811198303 -34.650031778708922,-58.438657024755109 -34.64999838663239,-58.438510973595754 -34.649947229448166,-58.43848311889834 -34.649905884646195,-58.4380452016294 -34.649534799789684,-58.437237194977115 -34.648849753882004,-58.436423322921087 -34.648160546226826,-58.435638945208062 -34.648795393960796,-58.435605871885144 -34.648822077566393,-58.435320400685285 -34.649051809494424,-58.435356005168146 -34.649103016215399,-58.435546427048862 -34.649491309934461)));;2993;7_18_6;COMUNA 7;18;6;1674;823;851;96,71%;302;301;99,67%;1;0,33%;485;188;38,76%;297;61,24%
MULTIPOLYGON (((-58.434335875143276 -34.649043696905153,-58.434727532620528 -34.649404779859644,-58.434763202166977 -34.649437433594564,-58.434801419644785 -34.649472194066838,-58.434962898785358 -34.649339695153969,-58.435320400685285 -34.649051809494424,-58.435605871885144 -34.648822077566393,-58.435638945208062 -34.648795393960796,-58.436423322921087 -34.648160546226826,-58.436460487222824 -34.648130482892341,-58.437406417358964 -34.647365215888222,-58.437422317315331 -34.647352352479686,-58.43740965406986 -34.647346700602519,-58.435012576932365 -34.646276796245672,-58.434923113905626 -34.646236845097015,-58.434817221599097 -34.6463460108993,-58.434605548408939 -34.646573622552424,-58.435120218450542 -34.647005786643625,-58.435523606487322 -34.647346662271723,-58.4346963528983 -34.648018326571638,-58.43389696005724 -34.648667455871617,-58.434335875143276 -34.649043696905153)));;2994;7_18_7;COMUNA 7;18;7;1216;579;637;90,89%;267;267;100,00%;0;0,00%;286;14;4,90%;272;95,10%
MULTIPOLYGON (((-58.435120218450542 -34.647005786643625,-58.434605548408939 -34.646573622552424,-58.434502426825965 -34.646675283130037,-58.433765108725268 -34.647250620978404,-58.432967003287978 -34.647874462109733,-58.433422265704195 -34.648267964508484,-58.433453019860409 -34.64829473326472,-58.43389696005724 -34.648667455871617,-58.4346963528983 -34.648018326571638,-58.435523606487322 -34.647346662271723,-58.435120218450542 -34.647005786643625)));;2995;7_18_8;COMUNA 7;18;8;1010;508;502;101,20%;224;224;100,00%;0;0,00%;246;9;3,66%;237;96,34%
MULTIPOLYGON (((-58.445167761537832 -34.643635076118493,-58.444300125504114 -34.642857107102834,-58.444244067101209 -34.642806815368054,-58.443312382837931 -34.641971433342285,-58.443078012539054 -34.641777727794747,-58.442952020142563 -34.641991094451434,-58.442439483587961 -34.642655819974038,-58.442388851718519 -34.642721517835163,-58.441475246612889 -34.643578501708625,-58.441592578690589 -34.643602043932759,-58.44192259149898 -34.643668229425991,-58.442272373256621 -34.643738431548122,-58.442421403477184 -34.643768316505358,-58.442569755538443 -34.643783975373303,-58.442804604925783 -34.643774365725278,-58.442928937928826 -34.643743962462977,-58.443080801341281 -34.643685041490464,-58.443226622015935 -34.643593653562796,-58.443316282099907 -34.643524088212594,-58.443185803007708 -34.643966193851185,-58.443499373988175 -34.644025329969445,-58.443811921912143 -34.644088620181236,-58.444127452670372 -34.644152403018808,-58.444439149460777 -34.644215480218136,-58.444750079847374 -34.644278345233246,-58.445060925475154 -34.64434127986749,-58.445375946880986 -34.644404988974046,-58.446014256538085 -34.644534096068753,-58.446097523436428 -34.644468753292635,-58.445167761537832 -34.643635076118493)));;2996;7_19_1;COMUNA 7;19;1;878;421;457;92,12%;198;198;100,00%;0;0,00%;274;29;10,58%;245;89,42%
MULTIPOLYGON (((-58.438554565033272 -34.647148843300798,-58.438253939718372 -34.647086246282583,-58.437870250053777 -34.646952784399645,-58.437422317315331 -34.647352352479686,-58.437725648084914 -34.64748770079909,-58.439558519613378 -34.648305763355879,-58.440699279009635 -34.648814863187468,-58.44191490431816 -34.647838145346952,-58.441722493657444 -34.647799590098792,-58.441410955752374 -34.647737280690102,-58.441094305549647 -34.647673983633744,-58.440750728706632 -34.647605258210334,-58.440667220532319 -34.647588552500864,-58.440420020026004 -34.647537097567465,-58.440107973504198 -34.647472108596752,-58.43979507534128 -34.647406977817617,-58.439480899477211 -34.647341634717698,-58.439171666390337 -34.647277277707133,-58.438860644355685 -34.647212497013996,-58.438554565033272 -34.647148843300798)));;2997;7_19_6;COMUNA 7;19;6;1927;935;992;94,25%;448;448;100,00%;0;0,00%;440;19;4,32%;421;95,68%
MULTIPOLYGON (((-58.470704939224859 -34.621332097874877,-58.470830853944555 -34.621371034566103,-58.47210397949565 -34.621766097662885,-58.472242418994583 -34.621809046152116,-58.473220870581613 -34.622110525460343,-58.473461883852899 -34.622174943292066,-58.473904829498956 -34.621190009998145,-58.474189694351523 -34.620497494529708,-58.472934266360618 -34.619848217367213,-58.472788840409514 -34.619773085998958,-58.471621181048953 -34.619155267935298,-58.471142629827789 -34.6203331602416,-58.469796692510855 -34.619915625697629,-58.469745079632439 -34.620050844698326,-58.469362821690538 -34.620916882387391,-58.470704939224859 -34.621332097874877)));;2998;7_2_1;COMUNA 7;2;1;828;387;441;87,76%;343;343;100,00%;0;0,00%;289;4;1,38%;285;98,62%
MULTIPOLYGON (((-58.469093638786269 -34.617797843436996,-58.468796837982602 -34.617644895464046,-58.468425808621269 -34.618258949263954,-58.467808436444074 -34.619282040926912,-58.467949852295064 -34.61934260043391,-58.468391731999162 -34.619479698114652,-58.469796692510855 -34.619915625697629,-58.471142629827789 -34.6203331602416,-58.471621181048953 -34.619155267935298,-58.471399595231254 -34.619038026288798,-58.470386833093173 -34.618490680637116,-58.469339837755037 -34.617924736188115,-58.469093638786269 -34.617797843436996)));;2999;7_2_2;COMUNA 7;2;2;989;467;522;89,46%;428;428;100,00%;0;0,00%;370;2;0,54%;368;99,46%
MULTIPOLYGON (((-58.469796692510855 -34.619915625697629,-58.468391731999162 -34.619479698114652,-58.467949852295064 -34.61934260043391,-58.467808436444074 -34.619282040926912,-58.467585691549473 -34.619651640507691,-58.467235513841992 -34.620232660323332,-58.467797261818788 -34.620430039421684,-58.467952990632959 -34.620478485214797,-58.467516283060377 -34.621472763294307,-58.467077520715513 -34.622471476495896,-58.467213402993984 -34.622513233554699,-58.468485932657423 -34.622910447108715,-58.468870848807747 -34.622031524543736,-58.468923572985986 -34.621912081096127,-58.469362821690538 -34.620916882387391,-58.469745079632439 -34.620050844698326,-58.469796692510855 -34.619915625697629)));;3000;7_2_3;COMUNA 7;2;3;824;401;423;94,80%;347;346;99,71%;1;0,29%;303;57;18,81%;246;81,19%
MULTIPOLYGON (((-58.468923572985986 -34.621912081096127,-58.468870848807747 -34.622031524543736,-58.468485932657423 -34.622910447108715,-58.468627098408888 -34.62295452636301,-58.469830889792945 -34.623331869337349,-58.469952717834595 -34.623370032486235,-58.471218968994897 -34.623763485322442,-58.471660414942669 -34.622767503815929,-58.472043594783074 -34.621903149320261,-58.47210397949565 -34.621766097662885,-58.470830853944555 -34.621371034566103,-58.470704939224859 -34.621332097874877,-58.469362821690538 -34.620916882387391,-58.468923572985986 -34.621912081096127)));;3001;7_2_4;COMUNA 7;2;4;1777;859;918;93,57%;707;706;99,86%;1;0,14%;660;79;11,97%;581;88,03%
MULTIPOLYGON (((-58.471218968994897 -34.623763485322442,-58.471167609646109 -34.623879267533077,-58.470778535062095 -34.624761929875639,-58.471002260330785 -34.624831635553356,-58.472117227280783 -34.625165439243673,-58.472563355970628 -34.624173186860027,-58.473014073179193 -34.623171002375791,-58.473461883852899 -34.622174943292066,-58.473220870581613 -34.622110525460343,-58.472242418994583 -34.621809046152116,-58.47210397949565 -34.621766097662885,-58.472043594783074 -34.621903149320261,-58.471660414942669 -34.622767503815929,-58.471218968994897 -34.623763485322442)));;3002;7_2_5;COMUNA 7;2;5;985;472;513;92,01%;456;454;99,56%;2;0,44%;358;93;25,98%;265;74,02%
MULTIPOLYGON (((-58.473748409790957 -34.625606373818719,-58.472327578503652 -34.625228382722995,-58.472117227280783 -34.625165439243673,-58.471002260330785 -34.624831635553356,-58.470778535062095 -34.624761929875639,-58.470251295210332 -34.62595820172784,-58.470436343687837 -34.626016149853669,-58.47157569212937 -34.62636953500995,-58.472966131190411 -34.626800778597186,-58.473166773560223 -34.626853298539864,-58.473522962885355 -34.626089790795533,-58.473748409790957 -34.625606373818719)));;3003;7_2_6;COMUNA 7;2;6;1100;503;597;84,25%;492;490;99,59%;2;0,41%;396;4;1,01%;392;98,99%
MULTIPOLYGON (((-58.468867870031929 -34.625524884455039,-58.470251295210332 -34.62595820172784,-58.470778535062095 -34.624761929875639,-58.471167609646109 -34.623879267533077,-58.471218968994897 -34.623763485322442,-58.469952717834595 -34.623370032486235,-58.469830889792945 -34.623331869337349,-58.468627098408888 -34.62295452636301,-58.468485932657423 -34.622910447108715,-58.468048452260135 -34.623909233930931,-58.467524927097159 -34.625104578481178,-58.4677323782063 -34.625169220198899,-58.468867870031929 -34.625524884455039)));;3004;7_2_7;COMUNA 7;2;7;724;324;400;81,00%;282;282;100,00%;0;0,00%;245;56;22,86%;189;77,14%
MULTIPOLYGON (((-58.468485932657423 -34.622910447108715,-58.467213402993984 -34.622513233554699,-58.467077520715513 -34.622471476495896,-58.466636022012487 -34.623476667141141,-58.466205075608876 -34.624457559111484,-58.466115205222167 -34.624665174419093,-58.467524927097159 -34.625104578481178,-58.468048452260135 -34.623909233930931,-58.468485932657423 -34.622910447108715)));;3005;7_2_8;COMUNA 7;2;8;712;356;356;100,00%;344;343;99,71%;1;0,29%;296;72;24,32%;224;75,68%
MULTIPOLYGON (((-58.465990552575967 -34.622137344138579,-58.46567859709922 -34.622517154059757,-58.465195580141717 -34.623105142990461,-58.465422192670779 -34.623170210814742,-58.466636022012487 -34.623476667141141,-58.467077520715513 -34.622471476495896,-58.467516283060377 -34.621472763294307,-58.467952990632959 -34.620478485214797,-58.467797261818788 -34.620430039421684,-58.467235513841992 -34.620232660323332,-58.467160213497827 -34.620357597051914,-58.466631739913552 -34.621193630353204,-58.466562655946362 -34.621302932145092,-58.466060661239283 -34.622051987150947,-58.465990552575967 -34.622137344138579)));;3006;7_2_9;COMUNA 7;2;9;998;462;536;86,19%;447;447;100,00%;0;0,00%;394;46;11,68%;348;88,32%
MULTIPOLYGON (((-58.437287967668283 -34.634940242688906,-58.436942402413678 -34.634868829847022,-58.436638670671449 -34.634804326604801,-58.43632922981152 -34.634742779214307,-58.435707536170227 -34.634624540767739,-58.435473836443073 -34.635364301647847,-58.435256366403628 -34.635967864047238,-58.436214971640496 -34.636618871682529,-58.436296921881258 -34.636674525050573,-58.436592182187134 -34.636875017616426,-58.437793768285559 -34.637690928976497,-58.437941913334726 -34.637790398953562,-58.438221110148454 -34.637009444264145,-58.438591033572784 -34.635974766188816,-58.438857249411861 -34.635255851513328,-58.43794570485872 -34.635066508825716,-58.437635152201999 -34.635012288707244,-58.437287967668283 -34.634940242688906)));;3007;7_20_1;COMUNA 7;20;1;1021;491;530;92,64%;433;433;100,00%;0;0,00%;380;8;2,11%;372;97,89%
MULTIPOLYGON (((-58.437738236456447 -34.645467033780754,-58.437411908983592 -34.647333801585845,-58.437422317315331 -34.647352352479686,-58.437870250053777 -34.646952784399645,-58.438850755569604 -34.646034923758627,-58.439118061659968 -34.645784756772144,-58.439652583847618 -34.645284280143137,-58.439761601364062 -34.645182255291473,-58.439870448146117 -34.645080371158073,-58.439961565524214 -34.644995244703168,-58.440184371867254 -34.644787110585675,-58.440521988686747 -34.644471740139736,-58.440565543734536 -34.644430972139872,-58.440625293306475 -34.644375206591114,-58.440745474104062 -34.644262971279652,-58.441475246612889 -34.643578501708625,-58.44128795827239 -34.643541848108946,-58.440499527295707 -34.643381138741731,-58.439859360728455 -34.643250664343242,-58.439225416312006 -34.64312145542506,-58.438655379259053 -34.6430052844023,-58.438161354935268 -34.644328818777375,-58.437945739074557 -34.644279963388563,-58.437738236456447 -34.645467033780754)));;3008;7_20_10;COMUNA 7;20;10;1327;622;705;88,23%;375;367;97,87%;8;2,18%;368;109;29,62%;259;70,38%
MULTIPOLYGON (((-58.435791142274468 -34.64379182327044,-58.437325467417722 -34.644139416489445,-58.437945739074557 -34.644279963388563,-58.438161354935268 -34.644328818777375,-58.438655379259053 -34.6430052844023,-58.437940747631721 -34.642859573477793,-58.43778533008156 -34.642828554940699,-58.436246583335034 -34.642521319855916,-58.434679474471309 -34.642208354425719,-58.434444665824003 -34.642861771423043,-58.434236891725057 -34.643439698899144,-58.434198850660522 -34.643545538383911,-58.433837020122795 -34.644578513552382,-58.435387370857022 -34.644929163166736,-58.435791142274468 -34.64379182327044)));;3009;7_20_11;COMUNA 7;20;11;1089;510;579;88,08%;364;364;100,00%;0;0,00%;363;19;5,23%;344;94,77%
MULTIPOLYGON (((-58.433120471874282 -34.641896990580761,-58.432516454141023 -34.64177641626322,-58.432344426019498 -34.641741231615342,-58.432306134206357 -34.642296309931538,-58.432252795288797 -34.642986177374432,-58.432216183552278 -34.643604074826072,-58.432174976968511 -34.644202252131905,-58.432107560872296 -34.645163673459251,-58.432618146857898 -34.645215985186645,-58.433481578067358 -34.645593389851271,-58.433536447859325 -34.645617910783002,-58.434923113905626 -34.646236845097015,-58.435387370857022 -34.644929163166736,-58.433837020122795 -34.644578513552382,-58.434198850660522 -34.643545538383911,-58.434236891725057 -34.643439698899144,-58.434444665824003 -34.642861771423043,-58.434679474471309 -34.642208354425719,-58.433120471874282 -34.641896990580761)));;3010;7_20_12;COMUNA 7;20;12;659;318;341;93,26%;244;244;100,00%;0;0,00%;223;21;9,42%;202;90,58%
MULTIPOLYGON (((-58.437325467417722 -34.644139416489445,-58.435791142274468 -34.64379182327044,-58.435387370857022 -34.644929163166736,-58.434923113905626 -34.646236845097015,-58.435012576932365 -34.646276796245672,-58.43740965406986 -34.647346700602519,-58.437422317315331 -34.647352352479686,-58.437411908983592 -34.647333801585845,-58.437738236456447 -34.645467033780754,-58.437945739074557 -34.644279963388563,-58.437325467417722 -34.644139416489445)));;3011;7_20_13;COMUNA 7;20;13;1617;768;849;90,46%;653;653;100,00%;0;0,00%;575;5;0,87%;570;99,13%
MULTIPOLYGON (((-58.440204841976708 -34.637459981626407,-58.43969782347024 -34.637294459196532,-58.439139837315508 -34.637186743584081,-58.438221110148454 -34.637009444264145,-58.437941913334726 -34.637790398953562,-58.438267339577855 -34.638008922296422,-58.438998271032922 -34.638520702644612,-58.439052452333968 -34.638558601698243,-58.439220789491571 -34.638676454891211,-58.43955277969382 -34.638908920144615,-58.440369576128575 -34.639573811934753,-58.440493187200573 -34.639674260235665,-58.44075053129864 -34.638976326832967,-58.44079632074741 -34.638851964896226,-58.441187964136489 -34.637755379754061,-58.440746883165652 -34.63762283211117,-58.440603832462578 -34.637579917575309,-58.440204841976708 -34.637459981626407)));;3012;7_20_2;COMUNA 7;20;2;552;259;293;88,40%;213;213;100,00%;0;0,00%;192;4;2,08%;188;97,92%
MULTIPOLYGON (((-58.444977886086328 -34.638527563390276,-58.443633883307598 -34.638253830799862,-58.442357966456612 -34.63799389802282,-58.441881086584061 -34.637896772182827,-58.441187964136489 -34.637755379754061,-58.44079632074741 -34.638851964896226,-58.44075053129864 -34.638976326832967,-58.441584496236331 -34.639181480614795,-58.442056010308676 -34.639297480528256,-58.443265815440391 -34.63959508315078,-58.443322305604951 -34.63960896582045,-58.444405335566969 -34.639875338741923,-58.44449662260584 -34.639746404639453,-58.444731274134369 -34.639415161285783,-58.444853714068593 -34.639039603905431,-58.444977886086328 -34.638527563390276)));;3013;7_20_3;COMUNA 7;20;3;722;349;373;93,57%;287;287;100,00%;0;0,00%;259;5;1,93%;254;98,07%
MULTIPOLYGON (((-58.440913007081839 -34.640015262284614,-58.441237671295589 -34.64027891976604,-58.441550836435638 -34.640533982557187,-58.442602628735678 -34.641390525510261,-58.442980890756935 -34.641698625133195,-58.443078012539054 -34.641777727794747,-58.443180391539229 -34.641604358483285,-58.443794446789163 -34.640737667290722,-58.444405335566969 -34.639875338741923,-58.443322305604951 -34.63960896582045,-58.443265815440391 -34.63959508315078,-58.442056010308676 -34.639297480528256,-58.441584496236331 -34.639181480614795,-58.44075053129864 -34.638976326832967,-58.440493187200573 -34.639674260235665,-58.440913007081839 -34.640015262284614)));;3014;7_20_4;COMUNA 7;20;4;541;266;275;96,73%;218;218;100,00%;0;0,00%;190;4;2,11%;186;97,89%
MULTIPOLYGON (((-58.440413970676339 -34.639889323046127,-58.440913007081839 -34.640015262284614,-58.440493187200573 -34.639674260235665,-58.440369576128575 -34.639573811934753,-58.43955277969382 -34.638908920144615,-58.439220789491571 -34.638676454891211,-58.439052452333968 -34.638558601698243,-58.438998271032922 -34.638520702644612,-58.438267339577855 -34.638008922296422,-58.437941913334726 -34.637790398953562,-58.437816213403991 -34.638141863522122,-58.437457698362593 -34.639144427536721,-58.436111515685262 -34.638805750402838,-58.435917598026926 -34.638757255720677,-58.435730909381185 -34.639278076269576,-58.435547373976178 -34.639790164517805,-58.437082715994606 -34.640190227680826,-58.438565246703291 -34.640576528223626,-58.438779277546011 -34.640632346804914,-58.440024447524323 -34.640948369311602,-58.440372528999532 -34.64000157255326,-58.440413970676339 -34.639889323046127)));;3015;7_20_5;COMUNA 7;20;5;806;384;422;91,00%;302;302;100,00%;0;0,00%;278;7;2,52%;271;97,48%
MULTIPOLYGON (((-58.43510183272948 -34.636397068423165,-58.434785852611007 -34.637274207911148,-58.434582189076828 -34.637839390562505,-58.434389183695281 -34.638375208158102,-58.435917598026926 -34.638757255720677,-58.436111515685262 -34.638805750402838,-58.437457698362593 -34.639144427536721,-58.437816213403991 -34.638141863522122,-58.437941913334726 -34.637790398953562,-58.437793768285559 -34.637690928976497,-58.436592182187134 -34.636875017616426,-58.436296921881258 -34.636674525050573,-58.436214971640496 -34.636618871682529,-58.435256366403628 -34.635967864047238,-58.43510183272948 -34.636397068423165)));;3016;7_20_6;COMUNA 7;20;6;815;374;441;84,81%;313;313;100,00%;0;0,00%;283;16;5,65%;267;94,35%
MULTIPOLYGON (((-58.433484166044749 -34.640887398549701,-58.433120471874282 -34.641896990580761,-58.434679474471309 -34.642208354425719,-58.435041872466464 -34.641200236418413,-58.435082896547868 -34.641085946333966,-58.435547373976178 -34.639790164517805,-58.435730909381185 -34.639278076269576,-58.435917598026926 -34.638757255720677,-58.434389183695281 -34.638375208158102,-58.434157539845216 -34.639018273307606,-58.433923760128252 -34.639667323550221,-58.433484166044749 -34.640887398549701)));;3017;7_20_7;COMUNA 7;20;7;816;379;437;86,73%;255;255;100,00%;0;0,00%;279;33;11,83%;246;88,17%
MULTIPOLYGON (((-58.43778533008156 -34.642828554940699,-58.437940747631721 -34.642859573477793,-58.438655379259053 -34.6430052844023,-58.439225416312006 -34.64312145542506,-58.439272233796736 -34.642993784381353,-58.439598928129293 -34.642105509007202,-58.440024447524323 -34.640948369311602,-58.438779277546011 -34.640632346804914,-58.438565246703291 -34.640576528223626,-58.437082715994606 -34.640190227680826,-58.435547373976178 -34.639790164517805,-58.435082896547868 -34.641085946333966,-58.435041872466464 -34.641200236418413,-58.434679474471309 -34.642208354425719,-58.436246583335034 -34.642521319855916,-58.43778533008156 -34.642828554940699)));;3018;7_20_8;COMUNA 7;20;8;1189;576;613;93,96%;495;495;100,00%;0;0,00%;441;27;6,12%;414;93,88%
MULTIPOLYGON (((-58.442439483587961 -34.642655819974038,-58.442952020142563 -34.641991094451434,-58.443078012539054 -34.641777727794747,-58.442980890756935 -34.641698625133195,-58.442602628735678 -34.641390525510261,-58.441550836435638 -34.640533982557187,-58.441237671295589 -34.64027891976604,-58.440913007081839 -34.640015262284614,-58.440413970676339 -34.639889323046127,-58.440372528999532 -34.64000157255326,-58.440024447524323 -34.640948369311602,-58.439598928129293 -34.642105509007202,-58.439272233796736 -34.642993784381353,-58.439225416312006 -34.64312145542506,-58.439859360728455 -34.643250664343242,-58.440499527295707 -34.643381138741731,-58.44128795827239 -34.643541848108946,-58.441475246612889 -34.643578501708625,-58.442388851718519 -34.642721517835163,-58.442439483587961 -34.642655819974038)));;3019;7_20_9;COMUNA 7;20;9;909;417;492;84,76%;307;307;100,00%;0;0,00%;302;21;6,95%;281;93,05%
MULTIPOLYGON (((-58.448589412216869 -34.631986835871992,-58.449647469753863 -34.632326331105155,-58.449983998434469 -34.632434327966131,-58.450195628235896 -34.632504422581697,-58.451048006915023 -34.631730678582031,-58.451100671649705 -34.631653779644736,-58.451576396947573 -34.630639071928073,-58.450497963839851 -34.630480653675413,-58.44935895958465 -34.630313345738536,-58.449054038814502 -34.6302685217793,-58.448222260758484 -34.630143280864537,-58.44798216333372 -34.630662142672513,-58.447529403805021 -34.631646697376276,-58.448589412216869 -34.631986835871992)));;3020;7_21_1;COMUNA 7;21;1;1138;486;652;74,54%;478;477;99,79%;1;0,21%;424;12;2,83%;412;97,17%
MULTIPOLYGON (((-58.441862678589381 -34.635865717578206,-58.441202204806565 -34.635730880268405,-58.440300702174945 -34.635547824772985,-58.440051793942629 -34.636268928951537,-58.440246903582086 -34.636308191648226,-58.440585406095934 -34.636377692362061,-58.441024787099828 -34.636467985425185,-58.441605091874052 -34.63658710510785,-58.442157281807901 -34.636700512885554,-58.44263483656627 -34.636798623721845,-58.442806362356365 -34.636058275757904,-58.441862678589381 -34.635865717578206)));;3021;7_21_10;COMUNA 7;21;10;911;406;505;80,40%;443;443;100,00%;0;0,00%;376;2;0,53%;374;99,47%
MULTIPOLYGON (((-58.438591033572784 -34.635974766188816,-58.438221110148454 -34.637009444264145,-58.439139837315508 -34.637186743584081,-58.43969782347024 -34.637294459196532,-58.440051793942629 -34.636268928951537,-58.440300702174945 -34.635547824772985,-58.438857249411861 -34.635255851513328,-58.438591033572784 -34.635974766188816)));;3022;7_21_11;COMUNA 7;21;11;811;361;450;80,22%;352;352;100,00%;0;0,00%;339;9;2,65%;330;97,35%
MULTIPOLYGON (((-58.440585406095934 -34.636377692362061,-58.440246903582086 -34.636308191648226,-58.440051793942629 -34.636268928951537,-58.43969782347024 -34.637294459196532,-58.440204841976708 -34.637459981626407,-58.440603832462578 -34.637579917575309,-58.440746883165652 -34.63762283211117,-58.441187964136489 -34.637755379754061,-58.441881086584061 -34.637896772182827,-58.442357966456612 -34.63799389802282,-58.443633883307598 -34.638253830799862,-58.444977886086328 -34.638527563390276,-58.445266136665097 -34.637338904799087,-58.443908264652222 -34.637060102612566,-58.44263483656627 -34.636798623721845,-58.442157281807901 -34.636700512885554,-58.441605091874052 -34.63658710510785,-58.441024787099828 -34.636467985425185,-58.440585406095934 -34.636377692362061)));;3023;7_21_12;COMUNA 7;21;12;917;412;505;81,58%;295;294;99,66%;1;0,34%;313;12;3,83%;301;96,17%
MULTIPOLYGON (((-58.446060910306656 -34.629818416862378,-58.44447754315599 -34.629583041878647,-58.442925196071201 -34.629352088134787,-58.44281422744023 -34.629878848286566,-58.442757854411568 -34.630115466705398,-58.444072551772344 -34.630537378772615,-58.445545127452185 -34.631009934435639,-58.44645705078014 -34.63130260421439,-58.447529403805021 -34.631646697376276,-58.44798216333372 -34.630662142672513,-58.448222260758484 -34.630143280864537,-58.447513509117648 -34.630036500975592,-58.446423676018377 -34.629872340850291,-58.446060910306656 -34.629818416862378)));;3024;7_21_2;COMUNA 7;21;2;1121;499;622;80,23%;561;560;99,82%;1;0,18%;466;2;0,43%;464;99,57%
MULTIPOLYGON (((-58.444072551772344 -34.630537378772615,-58.442757854411568 -34.630115466705398,-58.442451708303246 -34.630572896311548,-58.442153149757246 -34.630997367550847,-58.44235214122984 -34.631143180401239,-58.44242139656621 -34.631193897844362,-58.443468414505091 -34.631961205526977,-58.444727570487636 -34.632883892803086,-58.445101702642489 -34.632026242993604,-58.443640016480458 -34.631556782449778,-58.444072551772344 -34.630537378772615)));;3025;7_21_3;COMUNA 7;21;3;959;438;521;84,07%;512;512;100,00%;0;0,00%;433;34;7,85%;399;92,15%
MULTIPOLYGON (((-58.445545127452185 -34.631009934435639,-58.444072551772344 -34.630537378772615,-58.443640016480458 -34.631556782449778,-58.445101702642489 -34.632026242993604,-58.445545127452185 -34.631009934435639)));;3026;7_21_4;COMUNA 7;21;4;565;263;302;87,09%;289;288;99,65%;1;0,35%;240;0;0,00%;240;100,00%
MULTIPOLYGON (((-58.447529403805021 -34.631646697376276,-58.44645705078014 -34.63130260421439,-58.445545127452185 -34.631009934435639,-58.445101702642489 -34.632026242993604,-58.445998641021021 -34.632314336373341,-58.44706401900428 -34.632656460719978,-58.448122419557201 -34.632996391738637,-58.449244130820972 -34.633356532487966,-58.450195628235896 -34.632504422581697,-58.449983998434469 -34.632434327966131,-58.449647469753863 -34.632326331105155,-58.448589412216869 -34.631986835871992,-58.447529403805021 -34.631646697376276)));;3027;7_21_5;COMUNA 7;21;5;686;343;343;100,00%;293;292;99,66%;1;0,34%;250;10;4,00%;240;96,00%
MULTIPOLYGON (((-58.445998641021021 -34.632314336373341,-58.445101702642489 -34.632026242993604,-58.444727570487636 -34.632883892803086,-58.445093967023936 -34.6331524057819,-58.445552324334557 -34.633299447747305,-58.446607148669301 -34.633637842029856,-58.447665219097388 -34.633977283945207,-58.448122419557201 -34.632996391738637,-58.44706401900428 -34.632656460719978,-58.445998641021021 -34.632314336373341)));;3028;7_21_6;COMUNA 7;21;6;927;430;497;86,52%;505;505;100,00%;0;0,00%;423;1;0,24%;422;99,76%
MULTIPOLYGON (((-58.448317241495943 -34.634186524354547,-58.449244130820972 -34.633356532487966,-58.448122419557201 -34.632996391738637,-58.447665219097388 -34.633977283945207,-58.446607148669301 -34.633637842029856,-58.445552324334557 -34.633299447747305,-58.445093967023936 -34.6331524057819,-58.446390728180937 -34.634102617249027,-58.446456495599271 -34.634150796616467,-58.447296825856284 -34.634766559558436,-58.447503928627327 -34.63491828062643,-58.447668399447139 -34.634767591866272,-58.448317241495943 -34.634186524354547)));;3029;7_21_7;COMUNA 7;21;7;722;334;388;86,08%;362;361;99,72%;1;0,28%;303;3;0,99%;300;99,01%
MULTIPOLYGON (((-58.44242139656621 -34.631193897844362,-58.44235214122984 -34.631143180401239,-58.442153149757246 -34.630997367550847,-58.442005360870915 -34.631207490391823,-58.441656864255052 -34.631655614643975,-58.44092926212366 -34.632591292520672,-58.440174454581076 -34.633561962037227,-58.439522165998717 -34.634400810957615,-58.438857249411861 -34.635255851513328,-58.440300702174945 -34.635547824772985,-58.441202204806565 -34.635730880268405,-58.441862678589381 -34.635865717578206,-58.442806362356365 -34.636058275757904,-58.444078842801581 -34.636317992122571,-58.445876608109188 -34.636656574153449,-58.4468875252442 -34.635567307905362,-58.446989217098029 -34.635340623534915,-58.447115945063715 -34.635185353048961,-58.447193768789823 -34.635011977038282,-58.447296825856284 -34.634766559558436,-58.446456495599271 -34.634150796616467,-58.446390728180937 -34.634102617249027,-58.445093967023936 -34.6331524057819,-58.444727570487636 -34.632883892803086,-58.443468414505091 -34.631961205526977,-58.44242139656621 -34.631193897844362)));;3030;7_21_8;COMUNA 7;21;8;432;186;246;75,61%;201;201;100,00%;0;0,00%;175;3;1,71%;172;98,29%
MULTIPOLYGON (((-58.444078842801581 -34.636317992122571,-58.442806362356365 -34.636058275757904,-58.44263483656627 -34.636798623721845,-58.443908264652222 -34.637060102612566,-58.445266136665097 -34.637338904799087,-58.44531463547893 -34.637260528915675,-58.445876608109188 -34.636656574153449,-58.444078842801581 -34.636317992122571)));;3031;7_21_9;COMUNA 7;21;9;709;326;383;85,12%;368;368;100,00%;0;0,00%;307;1;0,33%;306;99,67%
MULTIPOLYGON (((-58.442925196071201 -34.629352088134787,-58.441759385837365 -34.629181676586846,-58.441003680996538 -34.630154957352865,-58.442153149757246 -34.630997367550847,-58.442451708303246 -34.630572896311548,-58.442757854411568 -34.630115466705398,-58.44281422744023 -34.629878848286566,-58.442925196071201 -34.629352088134787)));;3032;7_22_1;COMUNA 7;22;1;634;284;350;81,14%;347;347;100,00%;0;0,00%;297;0;0,00%;297;100,00%
MULTIPOLYGON (((-58.434970405493395 -34.634470285869654,-58.435293134560865 -34.634536487735588,-58.435468044506109 -34.634576176095116,-58.435707536170227 -34.634624540767739,-58.436722283130592 -34.633076330118264,-58.436779310366617 -34.632989367559318,-58.437024210564225 -34.632616449331287,-58.437365257952884 -34.632104038946288,-58.436428681453513 -34.631980526877506,-58.434856461379233 -34.631746297128259,-58.434778221194087 -34.632077980352214,-58.434778875048188 -34.632415104307604,-58.434763739038758 -34.632580247132083,-58.434712306017005 -34.63274840989547,-58.43466724478246 -34.632970519533806,-58.434456680173895 -34.633563448179899,-58.434190591836462 -34.634312636151677,-58.434970405493395 -34.634470285869654)));;3033;7_22_10;COMUNA 7;22;10;778;384;394;97,46%;312;312;100,00%;0;0,00%;268;11;4,10%;257;95,90%
MULTIPOLYGON (((-58.439167167042861 -34.633039219469737,-58.438879908399279 -34.632890144719212,-58.438594695319495 -34.632742126065843,-58.438342706823505 -34.632611367471519,-58.438091485827655 -34.632480960633103,-58.437835921023144 -34.632348298793701,-58.437365257952884 -34.632104038946288,-58.437024210564225 -34.632616449331287,-58.436779310366617 -34.632989367559318,-58.436722283130592 -34.633076330118264,-58.435707536170227 -34.634624540767739,-58.43632922981152 -34.634742779214307,-58.437434837341449 -34.633326699291935,-58.437686826912376 -34.633456332949407,-58.437938987630822 -34.63358610696811,-58.43822513989037 -34.633733352649855,-58.438512571000373 -34.633881302158954,-58.438765501017556 -34.634011426737182,-58.439018176255452 -34.634141409889146,-58.43967115000212 -34.633300732712343,-58.439419243329162 -34.633169976368862,-58.439167167042861 -34.633039219469737)));;3034;7_22_11;COMUNA 7;22;11;753;348;405;85,93%;336;336;100,00%;0;0,00%;286;5;1,75%;281;98,25%
MULTIPOLYGON (((-58.440174454581076 -34.633561962037227,-58.43967115000212 -34.633300732712343,-58.439018176255452 -34.634141409889146,-58.439522165998717 -34.634400810957615,-58.440174454581076 -34.633561962037227)));;3035;7_22_12;COMUNA 7;22;12;582;259;323;80,19%;298;298;100,00%;0;0,00%;256;0;0,00%;256;100,00%
MULTIPOLYGON (((-58.437686826912376 -34.633456332949407,-58.437434837341449 -34.633326699291935,-58.43632922981152 -34.634742779214307,-58.436638670671449 -34.634804326604801,-58.436942402413678 -34.634868829847022,-58.437287967668283 -34.634940242688906,-58.437635152201999 -34.635012288707244,-58.43794570485872 -34.635066508825716,-58.438857249411861 -34.635255851513328,-58.439522165998717 -34.634400810957615,-58.439018176255452 -34.634141409889146,-58.438765501017556 -34.634011426737182,-58.438512571000373 -34.633881302158954,-58.43822513989037 -34.633733352649855,-58.437938987630822 -34.63358610696811,-58.437686826912376 -34.633456332949407)));;3036;7_22_13;COMUNA 7;22;13;753;349;404;86,39%;343;343;100,00%;0;0,00%;289;2;0,69%;287;99,31%
MULTIPOLYGON (((-58.438716961091721 -34.630073188419871,-58.43934342004863 -34.630410363484302,-58.439594294698075 -34.630545345339172,-58.439842529339195 -34.630678988107817,-58.440092894464811 -34.630813757561455,-58.440374439070581 -34.630965293329893,-58.441003680996538 -34.630154957352865,-58.441759385837365 -34.629181676586846,-58.43952762742385 -34.628855276168657,-58.43859279199831 -34.628718541107929,-58.438306054744579 -34.630044373580006,-58.438716961091721 -34.630073188419871)));;3037;7_22_2;COMUNA 7;22;2;923;449;474;94,73%;501;501;100,00%;0;0,00%;365;22;6,03%;343;93,97%
MULTIPOLYGON (((-58.440374439070581 -34.630965293329893,-58.440092894464811 -34.630813757561455,-58.439842529339195 -34.630678988107817,-58.439594294698075 -34.630545345339172,-58.43934342004863 -34.630410363484302,-58.438716961091721 -34.630073188419871,-58.438044868217922 -34.631083017624334,-58.438595943868897 -34.631371235926657,-58.438849973240238 -34.631504036743983,-58.439100510715555 -34.631635005307373,-58.439352497154132 -34.631766818729268,-58.439636685677463 -34.631915398839077,-58.439923942008882 -34.632065598628074,-58.440175164356241 -34.632196987649749,-58.44042638749599 -34.632328376151456,-58.44092926212366 -34.632591292520672,-58.441656864255052 -34.631655614643975,-58.442005360870915 -34.631207490391823,-58.442153149757246 -34.630997367550847,-58.441003680996538 -34.630154957352865,-58.440374439070581 -34.630965293329893)));;3038;7_22_3;COMUNA 7;22;3;874;386;488;79,10%;424;424;100,00%;0;0,00%;361;7;1,94%;354;98,06%
MULTIPOLYGON (((-58.44092926212366 -34.632591292520672,-58.44042638749599 -34.632328376151456,-58.440175164356241 -34.632196987649749,-58.439923942008882 -34.632065598628074,-58.439636685677463 -34.631915398839077,-58.439352497154132 -34.631766818729268,-58.439100510715555 -34.631635005307373,-58.438849973240238 -34.631504036743983,-58.438595943868897 -34.631371235926657,-58.438044868217922 -34.631083017624334,-58.437365257952884 -34.632104038946288,-58.437835921023144 -34.632348298793701,-58.438091485827655 -34.632480960633103,-58.438342706823505 -34.632611367471519,-58.438594695319495 -34.632742126065843,-58.438879908399279 -34.632890144719212,-58.439167167042861 -34.633039219469737,-58.439419243329162 -34.633169976368862,-58.43967115000212 -34.633300732712343,-58.440174454581076 -34.633561962037227,-58.44092926212366 -34.632591292520672)));;3039;7_22_4;COMUNA 7;22;4;932;426;506;84,19%;448;448;100,00%;0;0,00%;378;1;0,26%;377;99,74%
MULTIPOLYGON (((-58.436879803223846 -34.629836326583394,-58.436678105243587 -34.630759060963399,-58.436648324912099 -34.630905045376238,-58.436428681453513 -34.631980526877506,-58.437365257952884 -34.632104038946288,-58.438044868217922 -34.631083017624334,-58.438716961091721 -34.630073188419871,-58.438306054744579 -34.630044373580006,-58.43859279199831 -34.628718541107929,-58.43716954439877 -34.628510357202821,-58.436879803223846 -34.629836326583394)));;3040;7_22_5;COMUNA 7;22;5;1000;466;534;87,27%;501;500;99,80%;1;0,20%;386;6;1,55%;380;98,45%
MULTIPOLYGON (((-58.435344595127546 -34.629612322491681,-58.435099294250776 -34.630684556522574,-58.434856461379233 -34.631746297128259,-58.436428681453513 -34.631980526877506,-58.436648324912099 -34.630905045376238,-58.436678105243587 -34.630759060963399,-58.436879803223846 -34.629836326583394,-58.43716954439877 -34.628510357202821,-58.435647479873076 -34.628287697703733,-58.435344595127546 -34.629612322491681)));;3041;7_22_6;COMUNA 7;22;6;903;420;483;86,96%;419;419;100,00%;0;0,00%;365;6;1,64%;359;98,36%
MULTIPOLYGON (((-58.435647479873076 -34.628287697703733,-58.434763176558263 -34.628158339094817,-58.434719754477165 -34.628327489767251,-58.434458403866358 -34.629482961274505,-58.434214965156215 -34.630558715222023,-58.435099294250776 -34.630684556522574,-58.435344595127546 -34.629612322491681,-58.435647479873076 -34.628287697703733)));;3042;7_22_7;COMUNA 7;22;7;561;266;295;90,17%;267;267;100,00%;0;0,00%;221;2;0,90%;219;99,10%
MULTIPOLYGON (((-58.433512068425067 -34.629344916977558,-58.433262823479147 -34.630423132527341,-58.434214965156215 -34.630558715222023,-58.434458403866358 -34.629482961274505,-58.434719754477165 -34.628327489767251,-58.434763176558263 -34.628158339094817,-58.433818304069767 -34.628020086207854,-58.433512068425067 -34.629344916977558)));;3043;7_22_8;COMUNA 7;22;8;569;258;311;82,96%;275;275;100,00%;0;0,00%;235;2;0,85%;233;99,15%
MULTIPOLYGON (((-58.434214965156215 -34.630558715222023,-58.433262823479147 -34.630423132527341,-58.433020739972662 -34.631470291751022,-58.432911486067745 -34.632499101938087,-58.432809348277615 -34.633396852959152,-58.432738491751707 -34.63401910948523,-58.433271484379162 -34.634125439907898,-58.433714509058269 -34.634216464462561,-58.434190591836462 -34.634312636151677,-58.434456680173895 -34.633563448179899,-58.43466724478246 -34.632970519533806,-58.434712306017005 -34.63274840989547,-58.434763739038758 -34.632580247132083,-58.434778875048188 -34.632415104307604,-58.434778221194087 -34.632077980352214,-58.434856461379233 -34.631746297128259,-58.435099294250776 -34.630684556522574,-58.434214965156215 -34.630558715222023)));;3044;7_22_9;COMUNA 7;22;9;606;288;318;90,57%;255;255;100,00%;0;0,00%;224;1;0,45%;223;99,55%
MULTIPOLYGON (((-58.431783683214967 -34.630177899266663,-58.431208962033807 -34.630093242379274,-58.431061746243422 -34.630071865542497,-58.430393567292299 -34.629976968926265,-58.430153746438677 -34.631031799437125,-58.430366989176093 -34.631064814991511,-58.430847832508348 -34.63113163386231,-58.43133063611036 -34.631198733040669,-58.431539363922816 -34.631232308782451,-58.432200478500903 -34.631338465318528,-58.432412018471872 -34.631372462818781,-58.433020739972662 -34.631470291751022,-58.433262823479147 -34.630423132527341,-58.433512068425067 -34.629344916977558,-58.433818304069767 -34.628020086207854,-58.432545103791831 -34.62783378590894,-58.432333741883212 -34.627803239487193,-58.43202680183196 -34.629128136818487,-58.431783683214967 -34.630177899266663)));;3045;7_23_1;COMUNA 7;23;1;822;386;436;88,53%;354;354;100,00%;0;0,00%;303;14;4,62%;289;95,38%
MULTIPOLYGON (((-58.4306327847045 -34.628924672897213,-58.430393567292299 -34.629976968926265,-58.431061746243422 -34.630071865542497,-58.431208962033807 -34.630093242379274,-58.431783683214967 -34.630177899266663,-58.43202680183196 -34.629128136818487,-58.432333741883212 -34.627803239487193,-58.430933782006065 -34.62760083386182,-58.429633843617097 -34.62741287642676,-58.429374216753828 -34.628562774095158,-58.429324307773577 -34.628733752107443,-58.4306327847045 -34.628924672897213)));;3046;7_23_2;COMUNA 7;23;2;984;449;535;83,93%;450;449;99,78%;1;0,22%;388;8;2,06%;380;97,94%
MULTIPOLYGON (((-58.429633843617097 -34.62741287642676,-58.428367135599764 -34.627229703386128,-58.428160121350153 -34.627200136902744,-58.428110870435937 -34.62742372205382,-58.427890574678386 -34.628391368056185,-58.427862831637697 -34.628520378556871,-58.429324307773577 -34.628733752107443,-58.429374216753828 -34.628562774095158,-58.429633843617097 -34.62741287642676)));;3047;7_23_3;COMUNA 7;23;3;728;324;404;80,20%;379;379;100,00%;0;0,00%;318;8;2,52%;310;97,48%
MULTIPOLYGON (((-58.428160121350153 -34.627200136902744,-58.427080071613759 -34.627045877420507,-58.42675583645687 -34.626998456761918,-58.426502066023836 -34.628110954483816,-58.42645579995628 -34.62831629976737,-58.426723388068403 -34.628354056308424,-58.427862831637697 -34.628520378556871,-58.427890574678386 -34.628391368056185,-58.428110870435937 -34.62742372205382,-58.428160121350153 -34.627200136902744)));;3048;7_23_4;COMUNA 7;23;4;633;275;358;76,82%;331;331;100,00%;0;0,00%;272;3;1,10%;269;98,90%
MULTIPOLYGON (((-58.426212771371375 -34.629394784613289,-58.426015407906171 -34.63026940249808,-58.425979714215593 -34.630451933046132,-58.427402288235122 -34.630653345620743,-58.427602385031058 -34.629729781032424,-58.427630299542827 -34.62960013684215,-58.427862831637697 -34.628520378556871,-58.426723388068403 -34.628354056308424,-58.42645579995628 -34.62831629976737,-58.426250758254767 -34.629226410053839,-58.426212771371375 -34.629394784613289)));;3049;7_23_5;COMUNA 7;23;5;735;320;415;77,11%;307;307;100,00%;0;0,00%;290;4;1,38%;286;98,62%
MULTIPOLYGON (((-58.428712242981653 -34.630835202579568,-58.42893800966992 -34.630866604350004,-58.430153746438677 -34.631031799437125,-58.430393567292299 -34.629976968926265,-58.4306327847045 -34.628924672897213,-58.429324307773577 -34.628733752107443,-58.427862831637697 -34.628520378556871,-58.427630299542827 -34.62960013684215,-58.427602385031058 -34.629729781032424,-58.427402288235122 -34.630653345620743,-58.427550526891423 -34.630673811643646,-58.428712242981653 -34.630835202579568)));;3050;7_23_6;COMUNA 7;23;6;760;348;412;84,47%;347;346;99,71%;1;0,29%;276;2;0,72%;274;99,28%
MULTIPOLYGON (((-58.426934043627952 -34.632609752826873,-58.428171682022153 -34.632815186640499,-58.428422493993729 -34.631833323592979,-58.428495614493819 -34.631581363953401,-58.428712242981653 -34.630835202579568,-58.427550526891423 -34.630673811643646,-58.427402288235122 -34.630653345620743,-58.425979714215593 -34.630451933046132,-58.425932577745535 -34.630693124051405,-58.425802727456983 -34.631284090370308,-58.425752882102223 -34.63148351850753,-58.425686307312439 -34.631750197287339,-58.425528752456152 -34.632365240101379,-58.426934043627952 -34.632609752826873)));;3051;7_23_7;COMUNA 7;23;7;821;358;463;77,32%;362;361;99,72%;1;0,28%;313;8;2,56%;305;97,44%
MULTIPOLYGON (((-58.429815353062637 -34.632058291961478,-58.430637157143956 -34.632175345604331,-58.430847832508348 -34.63113163386231,-58.430366989176093 -34.631064814991511,-58.430153746438677 -34.631031799437125,-58.42893800966992 -34.630866604350004,-58.428712242981653 -34.630835202579568,-58.428495614493819 -34.631581363953401,-58.428422493993729 -34.631833323592979,-58.428171682022153 -34.632815186640499,-58.42942593982275 -34.633023358994805,-58.430542611121609 -34.633208664597696,-58.431565826165944 -34.633378442686464,-58.431592118947478 -34.633243304113527,-58.431266050000453 -34.633017368023204,-58.430259908316543 -34.632338068126195,-58.429815353062637 -34.632058291961478)));;3052;7_23_8;COMUNA 7;23;8;814;372;442;84,16%;326;326;100,00%;0;0,00%;322;34;10,56%;288;89,44%
MULTIPOLYGON (((-58.432108485170126 -34.633596756171066,-58.432466674972652 -34.633836923773316,-58.432738491751707 -34.63401910948523,-58.432809348277615 -34.633396852959152,-58.432911486067745 -34.632499101938087,-58.433020739972662 -34.631470291751022,-58.432412018471872 -34.631372462818781,-58.432200478500903 -34.631338465318528,-58.431539363922816 -34.631232308782451,-58.43133063611036 -34.631198733040669,-58.430847832508348 -34.63113163386231,-58.430637157143956 -34.632175345604331,-58.429815353062637 -34.632058291961478,-58.430259908316543 -34.632338068126195,-58.431266050000453 -34.633017368023204,-58.431592118947478 -34.633243304113527,-58.431916486055904 -34.633468041672373,-58.432108485170126 -34.633596756171066)));;3053;7_23_9;COMUNA 7;23;9;735;342;393;87,02%;285;285;100,00%;0;0,00%;289;9;3,11%;280;96,89%
MULTIPOLYGON (((-58.433271484379162 -34.634125439907898,-58.432738491751707 -34.63401910948523,-58.432552080361937 -34.634925572013373,-58.432305837176976 -34.636103718167469,-58.433611873978322 -34.636313339193904,-58.43510183272948 -34.636397068423165,-58.435256366403628 -34.635967864047238,-58.435473836443073 -34.635364301647847,-58.435707536170227 -34.634624540767739,-58.435468044506109 -34.634576176095116,-58.435293134560865 -34.634536487735588,-58.434970405493395 -34.634470285869654,-58.434190591836462 -34.634312636151677,-58.433714509058269 -34.634216464462561,-58.433271484379162 -34.634125439907898)));;3054;7_24_1;COMUNA 7;24;1;894;432;462;93,51%;413;413;100,00%;0;0,00%;345;11;3,19%;334;96,81%
MULTIPOLYGON (((-58.427684961021207 -34.639823654689522,-58.427468420842871 -34.640686788682189,-58.42742275872375 -34.64086354162967,-58.427996437490876 -34.640960469841069,-58.428354465537851 -34.641020925212146,-58.428566368518666 -34.641056971755326,-58.4292509860134 -34.641173291870508,-58.429731880843512 -34.641255115534022,-58.429922401016206 -34.641281435321666,-58.429956465645567 -34.641114396952041,-58.430112084959909 -34.640396176499394,-58.430141200784156 -34.640244278056073,-58.430170487167977 -34.640091745824549,-58.430347129018948 -34.639206130859058,-58.430384437585531 -34.639019162960011,-58.430503095417919 -34.638453753750724,-58.430593154837489 -34.638024467973089,-58.430620130100898 -34.637895104726368,-58.429357794012063 -34.63766828001701,-58.429331072990948 -34.637796375412044,-58.429120884991143 -34.6388102234081,-58.429081622677799 -34.638975429130333,-58.428121314859318 -34.638800295905924,-58.427951763774793 -34.638769894634656,-58.427907130084826 -34.638937422466441,-58.427684961021207 -34.639823654689522)));;3055;7_24_10;COMUNA 7;24;10;962;442;520;85,00%;374;374;100,00%;0;0,00%;323;14;4,33%;309;95,67%
MULTIPOLYGON (((-58.423759604867044 -34.639168570500161,-58.423491906062658 -34.640200348482139,-58.424918372340905 -34.640440031658102,-58.425069607649512 -34.640465994728835,-58.426166770677312 -34.640651404602053,-58.426768308150592 -34.640752994969233,-58.42742275872375 -34.64086354162967,-58.427468420842871 -34.640686788682189,-58.427684961021207 -34.639823654689522,-58.427907130084826 -34.638937422466441,-58.427951763774793 -34.638769894634656,-58.426702372159212 -34.63854565187593,-58.426533759335051 -34.638515389758886,-58.425467555451782 -34.638326541771896,-58.42523990240965 -34.639226852902944,-58.425177875885119 -34.639404585970368,-58.423759604867044 -34.639168570500161)));;3056;7_24_11;COMUNA 7;24;11;1040;495;545;90,83%;426;425;99,77%;1;0,24%;371;4;1,08%;367;98,92%
MULTIPOLYGON (((-58.431592118947478 -34.633243304113527,-58.431565826165944 -34.633378442686464,-58.431283301115862 -34.634718343644231,-58.431102509969179 -34.634688788937027,-58.430183135610442 -34.634537697302775,-58.430016147417049 -34.634510186983917,-58.429082889793506 -34.63435675931219,-58.428782754201826 -34.635524460709917,-58.429770807420226 -34.635686919835976,-58.431037381935809 -34.635895149284522,-58.432305837176976 -34.636103718167469,-58.432552080361937 -34.634925572013373,-58.432738491751707 -34.63401910948523,-58.432466674972652 -34.633836923773316,-58.432108485170126 -34.633596756171066,-58.431916486055904 -34.633468041672373,-58.431592118947478 -34.633243304113527)));;3057;7_24_2;COMUNA 7;24;2;913;443;470;94,26%;331;331;100,00%;0;0,00%;318;45;14,15%;273;85,85%
MULTIPOLYGON (((-58.428171682022153 -34.632815186640499,-58.426934043627952 -34.632609752826873,-58.426889152843607 -34.632783689042057,-58.426590527776057 -34.6339469490174,-58.427829208352826 -34.634150625954788,-58.429082889793506 -34.63435675931219,-58.430016147417049 -34.634510186983917,-58.430183135610442 -34.634537697302775,-58.431102509969179 -34.634688788937027,-58.431283301115862 -34.634718343644231,-58.431565826165944 -34.633378442686464,-58.430542611121609 -34.633208664597696,-58.42942593982275 -34.633023358994805,-58.428171682022153 -34.632815186640499)));;3058;7_24_3;COMUNA 7;24;3;1214;567;647;87,64%;417;417;100,00%;0;0,00%;384;70;18,23%;314;81,77%
MULTIPOLYGON (((-58.426934043627952 -34.632609752826873,-58.425528752456152 -34.632365240101379,-58.425456460841801 -34.632647340017151,-58.425222773398907 -34.633548706490487,-58.425183085603692 -34.633701093646913,-58.425092024877685 -34.634032203196121,-58.424859804031982 -34.634876384259222,-58.424673789535753 -34.635654661547015,-58.424525613355208 -34.636223929462382,-58.424385877747859 -34.636777495064187,-58.42427748501413 -34.637170642639433,-58.424043430146128 -34.638074400502326,-58.423759604867044 -34.639168570500161,-58.425177875885119 -34.639404585970368,-58.42523990240965 -34.639226852902944,-58.425467555451782 -34.638326541771896,-58.425518599693795 -34.638124438200371,-58.425805039663892 -34.637030335128145,-58.42585718872126 -34.636831048697765,-58.42608927094134 -34.635903975955728,-58.426254981935571 -34.635932899759894,-58.427323119065086 -34.636116177928329,-58.427485699953863 -34.635489091979842,-58.427529481931806 -34.635318394844511,-58.426290784733325 -34.635114714891813,-58.426590527776057 -34.6339469490174,-58.426889152843607 -34.632783689042057,-58.426934043627952 -34.632609752826873)));;3059;7_24_4;COMUNA 7;24;4;1036;488;548;89,05%;471;471;100,00%;0;0,00%;379;32;8,44%;347;91,56%
MULTIPOLYGON (((-58.427829208352826 -34.634150625954788,-58.426590527776057 -34.6339469490174,-58.426290784733325 -34.635114714891813,-58.427529481931806 -34.635318394844511,-58.427485699953863 -34.635489091979842,-58.427323119065086 -34.636116177928329,-58.426254981935571 -34.635932899759894,-58.42608927094134 -34.635903975955728,-58.42585718872126 -34.636831048697765,-58.425805039663892 -34.637030335128145,-58.425518599693795 -34.638124438200371,-58.425467555451782 -34.638326541771896,-58.426533759335051 -34.638515389758886,-58.426702372159212 -34.63854565187593,-58.427951763774793 -34.638769894634656,-58.428003224782927 -34.638576241129037,-58.428281968065363 -34.637474946791272,-58.428327286602588 -34.637295939732184,-58.428575376779897 -34.636330978283645,-58.428782754201826 -34.635524460709917,-58.429082889793506 -34.63435675931219,-58.427829208352826 -34.634150625954788)));;3060;7_24_5;COMUNA 7;24;5;931;441;490;90,00%;396;396;100,00%;0;0,00%;344;18;5,23%;326;94,77%
MULTIPOLYGON (((-58.428575376779897 -34.636330978283645,-58.428327286602588 -34.637295939732184,-58.428281968065363 -34.637474946791272,-58.428003224782927 -34.638576241129037,-58.427951763774793 -34.638769894634656,-58.428121314859318 -34.638800295905924,-58.429081622677799 -34.638975429130333,-58.429120884991143 -34.6388102234081,-58.429331072990948 -34.637796375412044,-58.429357794012063 -34.63766828001701,-58.430620130100898 -34.637895104726368,-58.430864525349897 -34.636723652204687,-58.432130944646246 -34.636940884601223,-58.432305837176976 -34.636103718167469,-58.431037381935809 -34.635895149284522,-58.429770807420226 -34.635686919835976,-58.428782754201826 -34.635524460709917,-58.428575376779897 -34.636330978283645)));;3061;7_24_6;COMUNA 7;24;6;1059;502;557;90,13%;456;456;100,00%;0;0,00%;371;13;3,50%;358;96,50%
MULTIPOLYGON (((-58.432888502602282 -34.637679828289492,-58.43259160984362 -34.638240900113537,-58.432542634421864 -34.638895134280894,-58.432496896233502 -34.63954915788554,-58.433923760128252 -34.639667323550221,-58.434157539845216 -34.639018273307606,-58.434389183695281 -34.638375208158102,-58.434582189076828 -34.637839390562505,-58.434785852611007 -34.637274207911148,-58.43510183272948 -34.636397068423165,-58.433611873978322 -34.636313339193904,-58.432305837176976 -34.636103718167469,-58.432130944646246 -34.636940884601223,-58.433184027087819 -34.637121501926167,-58.432888502602282 -34.637679828289492)));;3062;7_24_7;COMUNA 7;24;7;852;416;436;95,41%;294;294;100,00%;0;0,00%;289;18;6,23%;271;93,77%
MULTIPOLYGON (((-58.430620130100898 -34.637895104726368,-58.430593154837489 -34.638024467973089,-58.430503095417919 -34.638453753750724,-58.430384437585531 -34.639019162960011,-58.430347129018948 -34.639206130859058,-58.431405173674584 -34.639399089135644,-58.431611026491019 -34.639428579340624,-58.431820798813533 -34.639458704013506,-58.432319840169704 -34.639528338600329,-58.432496896233502 -34.63954915788554,-58.432542634421864 -34.638895134280894,-58.43259160984362 -34.638240900113537,-58.432888502602282 -34.637679828289492,-58.433184027087819 -34.637121501926167,-58.432130944646246 -34.636940884601223,-58.430864525349897 -34.636723652204687,-58.430620130100898 -34.637895104726368)));;3063;7_24_8;COMUNA 7;24;8;877;406;471;86,20%;369;369;100,00%;0;0,00%;331;3;0,91%;328;99,09%
MULTIPOLYGON (((-58.432496896233502 -34.63954915788554,-58.432319840169704 -34.639528338600329,-58.431820798813533 -34.639458704013506,-58.431611026491019 -34.639428579340624,-58.431405173674584 -34.639399089135644,-58.430347129018948 -34.639206130859058,-58.430170487167977 -34.640091745824549,-58.430141200784156 -34.640244278056073,-58.430112084959909 -34.640396176499394,-58.429956465645567 -34.641114396952041,-58.429922401016206 -34.641281435321666,-58.430123827699965 -34.641309166220452,-58.43092364689911 -34.641444592768117,-58.431158298038241 -34.641494584831946,-58.431421663171996 -34.641550710765152,-58.432113777348796 -34.641694059829234,-58.432344426019498 -34.641741231615342,-58.432516454141023 -34.64177641626322,-58.433120471874282 -34.641896990580761,-58.433484166044749 -34.640887398549701,-58.433923760128252 -34.639667323550221,-58.432496896233502 -34.63954915788554)));;3064;7_24_9;COMUNA 7;24;9;950;443;507;87,38%;383;383;100,00%;0;0,00%;341;9;2,64%;332;97,36%
MULTIPOLYGON (((-58.468796837982602 -34.617644895464046,-58.468635233643191 -34.617561661045286,-58.467960795944634 -34.617269709800688,-58.467687210077507 -34.617793049713114,-58.46762528704776 -34.617920380682008,-58.467490878494715 -34.618196663415652,-58.467226062047814 -34.618740425125452,-58.467107068115723 -34.61898438174385,-58.466990884391464 -34.619222563286513,-58.466689348959584 -34.619844989758676,-58.466614304314817 -34.619982743500778,-58.467063088242547 -34.62017203068519,-58.467235513841992 -34.620232660323332,-58.467585691549473 -34.619651640507691,-58.467808436444074 -34.619282040926912,-58.468425808621269 -34.618258949263954,-58.468796837982602 -34.617644895464046)));;3065;7_3_1;COMUNA 7;3;1;689;319;370;86,22%;371;371;100,00%;0;0,00%;301;9;2,99%;292;97,01%
MULTIPOLYGON (((-58.465195580141717 -34.623105142990461,-58.464986858386617 -34.623045145008199,-58.463782580894772 -34.622588948670639,-58.463728997111893 -34.622716840887286,-58.463431769895493 -34.623385880242147,-58.463276041021423 -34.623734555071529,-58.46343271055693 -34.623789485700875,-58.464371368807448 -34.624108501515863,-58.464655319028651 -34.624204979485441,-58.464838570782035 -34.624267302496229,-58.466115205222167 -34.624665174419093,-58.466205075608876 -34.624457559111484,-58.466636022012487 -34.623476667141141,-58.465422192670779 -34.623170210814742,-58.465195580141717 -34.623105142990461)));;3066;7_3_10;COMUNA 7;3;10;1062;474;588;80,61%;527;526;99,81%;1;0,19%;425;4;0,94%;421;99,06%
MULTIPOLYGON (((-58.466651631893413 -34.616703048938774,-58.465677437292165 -34.616281371434042,-58.465350945123205 -34.616960346812171,-58.464832191956766 -34.618022155214618,-58.465606635858826 -34.618358559568044,-58.465783401672311 -34.618432219802607,-58.46694691188771 -34.618917483658585,-58.467107068115723 -34.61898438174385,-58.467226062047814 -34.618740425125452,-58.467490878494715 -34.618196663415652,-58.46762528704776 -34.617920380682008,-58.467687210077507 -34.617793049713114,-58.467960795944634 -34.617269709800688,-58.466762971479334 -34.616751216010556,-58.466651631893413 -34.616703048938774)));;3067;7_3_2;COMUNA 7;3;2;953;426;527;80,83%;442;442;100,00%;0;0,00%;381;20;5,25%;361;94,75%
MULTIPOLYGON (((-58.463364941252799 -34.618623883441387,-58.46434025864567 -34.619029029356582,-58.464832191956766 -34.618022155214618,-58.465350945123205 -34.616960346812171,-58.465677437292165 -34.616281371434042,-58.465542672776138 -34.616222992283888,-58.464538589360799 -34.615787714308901,-58.464465926514876 -34.615761798962644,-58.464373160063033 -34.615728700494856,-58.463918455420966 -34.61637112319297,-58.463239707544744 -34.617330246718709,-58.463123599886323 -34.617494196657709,-58.462552340175478 -34.618286267605981,-58.463364941252799 -34.618623883441387)));;3068;7_3_3;COMUNA 7;3;3;1134;519;615;84,39%;580;579;99,83%;1;0,17%;477;47;9,85%;430;90,15%
MULTIPOLYGON (((-58.467107068115723 -34.61898438174385,-58.46694691188771 -34.618917483658585,-58.465783401672311 -34.618432219802607,-58.465606635858826 -34.618358559568044,-58.464832191956766 -34.618022155214618,-58.46434025864567 -34.619029029356582,-58.46508208208212 -34.619337196988674,-58.465285939702781 -34.61942304092711,-58.465209786091265 -34.619574737990213,-58.464735566497829 -34.620538301730186,-58.464307677620567 -34.621407775088926,-58.465354423765987 -34.621872984258694,-58.465967249600745 -34.620967163185369,-58.46653627806576 -34.620125990437636,-58.466614304314817 -34.619982743500778,-58.466689348959584 -34.619844989758676,-58.466990884391464 -34.619222563286513,-58.467107068115723 -34.61898438174385)));;3069;7_3_4;COMUNA 7;3;4;1174;553;621;89,05%;395;393;99,49%;2;0,51%;395;38;9,62%;357;90,38%
MULTIPOLYGON (((-58.462794190382638 -34.622212461511104,-58.46363826612636 -34.622534300085327,-58.463782580894772 -34.622588948670639,-58.464986858386617 -34.623045145008199,-58.465195580141717 -34.623105142990461,-58.46567859709922 -34.622517154059757,-58.465990552575967 -34.622137344138579,-58.466060661239283 -34.622051987150947,-58.466562655946362 -34.621302932145092,-58.466631739913552 -34.621193630353204,-58.467160213497827 -34.620357597051914,-58.467235513841992 -34.620232660323332,-58.467063088242547 -34.62017203068519,-58.466614304314817 -34.619982743500778,-58.46653627806576 -34.620125990437636,-58.465967249600745 -34.620967163185369,-58.465354423765987 -34.621872984258694,-58.464307677620567 -34.621407775088926,-58.464179556260703 -34.621668137886822,-58.464109873204279 -34.621827862576936,-58.463179760132434 -34.621417292112667,-58.462843941737113 -34.622113162241142,-58.462794190382638 -34.622212461511104)));;3070;7_3_5;COMUNA 7;3;5;787;369;418;88,28%;390;390;100,00%;0;0,00%;309;1;0,32%;308;99,68%
MULTIPOLYGON (((-58.462552340175478 -34.618286267605981,-58.462428137030415 -34.618458456574913,-58.461795357487489 -34.619335667541044,-58.461680777645661 -34.619494545463418,-58.46276096418655 -34.619862942925074,-58.463765426972344 -34.620205555933786,-58.46370519989226 -34.620328729772751,-58.463179760132434 -34.621417292112667,-58.464109873204279 -34.621827862576936,-58.464179556260703 -34.621668137886822,-58.464307677620567 -34.621407775088926,-58.464735566497829 -34.620538301730186,-58.465209786091265 -34.619574737990213,-58.465285939702781 -34.61942304092711,-58.46508208208212 -34.619337196988674,-58.46434025864567 -34.619029029356582,-58.463364941252799 -34.618623883441387,-58.462552340175478 -34.618286267605981)));;3071;7_3_6;COMUNA 7;3;6;924;408;516;79,07%;370;369;99,73%;1;0,27%;338;9;2,66%;329;97,34%
MULTIPOLYGON (((-58.46101697250235 -34.620423514354592,-58.460510588645953 -34.621169940844396,-58.460417472402291 -34.621304310019298,-58.461800015865698 -34.621833430977958,-58.462794190382638 -34.622212461511104,-58.462843941737113 -34.622113162241142,-58.463179760132434 -34.621417292112667,-58.46370519989226 -34.620328729772751,-58.463765426972344 -34.620205555933786,-58.46276096418655 -34.619862942925074,-58.461680777645661 -34.619494545463418,-58.46101697250235 -34.620423514354592)));;3072;7_3_7;COMUNA 7;3;7;1170;558;612;91,18%;501;501;100,00%;0;0,00%;448;34;7,59%;414;92,41%
MULTIPOLYGON (((-58.461800015865698 -34.621833430977958,-58.460417472402291 -34.621304310019298,-58.45962175503066 -34.622452290182714,-58.460176599513424 -34.622647027978566,-58.461202127279407 -34.623006846064065,-58.461800015865698 -34.621833430977958)));;3073;7_3_8;COMUNA 7;3;8;736;302;434;69,59%;363;362;99,72%;1;0,28%;307;13;4,23%;294;95,77%
MULTIPOLYGON (((-58.462794190382638 -34.622212461511104,-58.461800015865698 -34.621833430977958,-58.461202127279407 -34.623006846064065,-58.462217952013297 -34.62336327507051,-58.463276041021423 -34.623734555071529,-58.463431769895493 -34.623385880242147,-58.463728997111893 -34.622716840887286,-58.463782580894772 -34.622588948670639,-58.46363826612636 -34.622534300085327,-58.462794190382638 -34.622212461511104)));;3074;7_3_9;COMUNA 7;3;9;711;338;373;90,62%;323;323;100,00%;0;0,00%;273;31;11,36%;242;88,64%
MULTIPOLYGON (((-58.462696135867048 -34.615959635716138,-58.462631736209836 -34.616099640697691,-58.462217562780339 -34.617016573842108,-58.463239707544744 -34.617330246718709,-58.463918455420966 -34.61637112319297,-58.464373160063033 -34.615728700494856,-58.464134812804005 -34.615643630064994,-58.463204087520914 -34.615298343406238,-58.463030141729767 -34.615233200820988,-58.462962421042612 -34.615380671058873,-58.462696135867048 -34.615959635716138)));;3075;7_4_1;COMUNA 7;4;1;1069;496;573;86,56%;651;651;100,00%;0;0,00%;534;88;16,48%;446;83,52%
MULTIPOLYGON (((-58.459068082250525 -34.620842993608136,-58.458498514599377 -34.620648320631929,-58.456623032157246 -34.620007092413225,-58.456076025478417 -34.621204359320757,-58.45771470410893 -34.621790161914603,-58.458273458237542 -34.621989908720984,-58.459068082250525 -34.620842993608136)));;3076;7_4_10;COMUNA 7;4;10;928;428;500;85,60%;485;483;99,59%;2;0,41%;365;2;0,55%;363;99,45%
MULTIPOLYGON (((-58.461508157420546 -34.615560249414727,-58.461450315511101 -34.615684126508199,-58.461068673610008 -34.616514362913726,-58.46100887097446 -34.616645634381818,-58.462217562780339 -34.617016573842108,-58.462631736209836 -34.616099640697691,-58.462696135867048 -34.615959635716138,-58.462962421042612 -34.615380671058873,-58.463030141729767 -34.615233200820988,-58.461864916380264 -34.614796703873267,-58.461508157420546 -34.615560249414727)));;3077;7_4_2;COMUNA 7;4;2;770;356;414;85,99%;381;381;100,00%;0;0,00%;334;0;0,00%;334;100,00%
MULTIPOLYGON (((-58.461864916380264 -34.614796703873267,-58.460667419190344 -34.614348011694609,-58.460393473713609 -34.614245397495068,-58.459448384254372 -34.613885644692253,-58.459033082429059 -34.614734466290216,-58.460296594591917 -34.615155991727477,-58.4597790642947 -34.616268203315684,-58.46100887097446 -34.616645634381818,-58.461068673610008 -34.616514362913726,-58.461450315511101 -34.615684126508199,-58.461508157420546 -34.615560249414727,-58.461864916380264 -34.614796703873267)));;3078;7_4_3;COMUNA 7;4;3;1012;450;562;80,07%;549;549;100,00%;0;0,00%;450;3;0,67%;447;99,33%
MULTIPOLYGON (((-58.460296594591917 -34.615155991727477,-58.459033082429059 -34.614734466290216,-58.45849917976804 -34.615900476772211,-58.458719209354605 -34.615942950456514,-58.4597790642947 -34.616268203315684,-58.460296594591917 -34.615155991727477)));;3079;7_4_4;COMUNA 7;4;4;1302;571;731;78,11%;683;683;100,00%;0;0,00%;560;0;0,00%;560;100,00%
MULTIPOLYGON (((-58.458198613144624 -34.61656063045406,-58.457765731224669 -34.617506069860852,-58.457978777016997 -34.617590729181465,-58.458953457886679 -34.618039440874057,-58.459193764928429 -34.618150085734392,-58.460228174426355 -34.618623437661029,-58.460280824236996 -34.618483574623951,-58.460543731012876 -34.617741018074732,-58.460582834376282 -34.617630521885296,-58.460615293406732 -34.61750833501241,-58.46100887097446 -34.616645634381818,-58.4597790642947 -34.616268203315684,-58.458719209354605 -34.615942950456514,-58.45849917976804 -34.615900476772211,-58.458198613144624 -34.61656063045406)));;3080;7_4_5;COMUNA 7;4;5;833;364;469;77,61%;489;489;100,00%;0;0,00%;397;0;0,00%;397;100,00%
MULTIPOLYGON (((-58.461074587944147 -34.619008747150495,-58.461795357487489 -34.619335667541044,-58.462428137030415 -34.618458456574913,-58.462552340175478 -34.618286267605981,-58.463123599886323 -34.617494196657709,-58.463239707544744 -34.617330246718709,-58.462217562780339 -34.617016573842108,-58.46100887097446 -34.616645634381818,-58.460615293406732 -34.61750833501241,-58.460582834376282 -34.617630521885296,-58.460543731012876 -34.617741018074732,-58.460280824236996 -34.618483574623951,-58.460228174426355 -34.618623437661029,-58.460579908702847 -34.618784365450821,-58.461074587944147 -34.619008747150495)));;3081;7_4_6;COMUNA 7;4;6;1174;550;624;88,14%;439;439;100,00%;0;0,00%;436;5;1,15%;431;98,85%
MULTIPOLYGON (((-58.461074587944147 -34.619008747150495,-58.460579908702847 -34.618784365450821,-58.460228174426355 -34.618623437661029,-58.459815830020368 -34.619718044605847,-58.459746567411607 -34.61984290648644,-58.459690509704366 -34.619943824149836,-58.459122180981936 -34.620764823461933,-58.459068082250525 -34.620842993608136,-58.458273458237542 -34.621989908720984,-58.459435954964491 -34.622401931494373,-58.45962175503066 -34.622452290182714,-58.460417472402291 -34.621304310019298,-58.460510588645953 -34.621169940844396,-58.46101697250235 -34.620423514354592,-58.461680777645661 -34.619494545463418,-58.461795357487489 -34.619335667541044,-58.461074587944147 -34.619008747150495)));;3082;7_4_7;COMUNA 7;4;7;1191;561;630;89,05%;501;501;100,00%;0;0,00%;472;2;0,42%;470;99,58%
MULTIPOLYGON (((-58.460228174426355 -34.618623437661029,-58.459193764928429 -34.618150085734392,-58.458953457886679 -34.618039440874057,-58.457978777016997 -34.617590729181465,-58.457765731224669 -34.617506069860852,-58.45729475530775 -34.618536861029249,-58.457224636153903 -34.618690314022174,-58.4583996830386 -34.619227281429794,-58.459222497457368 -34.619603377221019,-58.459746567411607 -34.61984290648644,-58.459815830020368 -34.619718044605847,-58.460228174426355 -34.618623437661029)));;3083;7_4_8;COMUNA 7;4;8;951;429;522;82,18%;338;338;100,00%;0;0,00%;396;1;0,25%;395;99,75%
MULTIPOLYGON (((-58.459746567411607 -34.61984290648644,-58.459222497457368 -34.619603377221019,-58.4583996830386 -34.619227281429794,-58.457224636153903 -34.618690314022174,-58.456623032157246 -34.620007092413225,-58.458498514599377 -34.620648320631929,-58.459068082250525 -34.620842993608136,-58.459122180981936 -34.620764823461933,-58.459690509704366 -34.619943824149836,-58.459746567411607 -34.61984290648644)));;3084;7_4_9;COMUNA 7;4;9;612;292;320;91,25%;264;264;100,00%;0;0,00%;223;15;6,73%;208;93,27%
MULTIPOLYGON (((-58.459450110993409 -34.626405520069738,-58.459372151355069 -34.626555311793389,-58.458854032243856 -34.627548710523676,-58.459687070483518 -34.627891280733635,-58.459857461836712 -34.62795558276909,-58.460419276827345 -34.626967603386674,-58.460505073110852 -34.626812529275718,-58.460576981568046 -34.626682526133727,-58.460731448437627 -34.626370898412397,-58.460743802329496 -34.626345968185483,-58.460809064843417 -34.626213922466924,-58.460727618949022 -34.626189342875527,-58.460224120746766 -34.626039680710136,-58.45996717552724 -34.625962207795332,-58.459791846547773 -34.625907131441238,-58.459725566177191 -34.625875156921836,-58.459655275590066 -34.626010652764435,-58.459529092765074 -34.626253826845961,-58.459450110993409 -34.626405520069738)));;3085;7_5_1;COMUNA 7;5;1;746;324;422;76,78%;444;444;100,00%;0;0,00%;341;1;0,29%;340;99,71%
MULTIPOLYGON (((-58.458426425457688 -34.626002939583572,-58.457838089268087 -34.62713098406077,-58.458854032243856 -34.627548710523676,-58.459372151355069 -34.626555311793389,-58.459450110993409 -34.626405520069738,-58.459529092765074 -34.626253826845961,-58.459655275590066 -34.626010652764435,-58.459725566177191 -34.625875156921836,-58.459992327510136 -34.625361413199485,-58.460052478294855 -34.625245283788182,-58.459886266580959 -34.625188587987196,-58.459008952061154 -34.624885948600486,-58.458675558245304 -34.625525185277873,-58.458611315660121 -34.625648356361665,-58.458426425457688 -34.626002939583572)));;3086;7_5_2;COMUNA 7;5;2;648;260;388;67,01%;313;311;99,36%;2;0,64%;243;0;0,00%;243;100,00%
MULTIPOLYGON (((-58.458142463272964 -34.624586965391629,-58.457960067324862 -34.62453223825289,-58.456801894032978 -34.624105975925453,-58.456450009042555 -34.624616750596175,-58.456483914970384 -34.624630907743864,-58.45651569098974 -34.624646191573355,-58.456608378772813 -34.624683098911397,-58.45689717619026 -34.624805581979274,-58.45763229364465 -34.625106329259673,-58.457748580233186 -34.62515887104454,-58.457647531281175 -34.625305562059602,-58.457524429519744 -34.625245061872029,-58.457014387223651 -34.62503115860644,-58.456710595318704 -34.624900857916025,-58.456422820157897 -34.624778515310844,-58.456354411977479 -34.624748651592803,-58.456114990839289 -34.62509336902189,-58.457435548848885 -34.625613310089513,-58.456709786841877 -34.626667044889672,-58.457838089268087 -34.62713098406077,-58.458426425457688 -34.626002939583572,-58.458611315660121 -34.625648356361665,-58.458675558245304 -34.625525185277873,-58.459008952061154 -34.624885948600486,-58.458142463272964 -34.624586965391629)));;3087;7_5_3;COMUNA 7;5;3;866;377;489;77,10%;459;455;99,13%;4;0,88%;328;7;2,13%;321;97,87%
MULTIPOLYGON (((-58.457435548848885 -34.625613310089513,-58.456114990839289 -34.62509336902189,-58.455376947883586 -34.626155123759936,-58.456709786841877 -34.626667044889672,-58.457435548848885 -34.625613310089513)));;3088;7_5_4;COMUNA 7;5;4;1024;444;580;76,55%;614;614;100,00%;0;0,00%;457;5;1,09%;452;98,91%
MULTIPOLYGON (((-58.457557707307892 -34.623019493792889,-58.458273458237542 -34.621989908720984,-58.45771470410893 -34.621790161914603,-58.456076025478417 -34.621204359320757,-58.455557803092148 -34.622338665298443,-58.455048598802712 -34.62345310958856,-58.454830121189822 -34.623926773982319,-58.454762560259468 -34.624073117102228,-58.454762549427812 -34.624073112667382,-58.45457491507932 -34.624479874854003,-58.454031262200857 -34.625631003597974,-58.455376947883586 -34.626155123759936,-58.456114990839289 -34.62509336902189,-58.456354411977479 -34.624748651592803,-58.456422820157897 -34.624778515310844,-58.456710595318704 -34.624900857916025,-58.457014387223651 -34.62503115860644,-58.457524429519744 -34.625245061872029,-58.457647531281175 -34.625305562059602,-58.457748580233186 -34.62515887104454,-58.45763229364465 -34.625106329259673,-58.45689717619026 -34.624805581979274,-58.456608378772813 -34.624683098911397,-58.45651569098974 -34.624646191573355,-58.456483914970384 -34.624630907743864,-58.456450009042555 -34.624616750596175,-58.456801894032978 -34.624105975925453,-58.457557707307892 -34.623019493792889)));;3089;7_5_5;COMUNA 7;5;5;1129;527;602;87,54%;544;544;100,00%;0;0,00%;462;6;1,30%;456;98,70%
MULTIPOLYGON (((-58.459617193027754 -34.623719657809858,-58.458916666377988 -34.62346948862551,-58.458748244641434 -34.623398847045792,-58.457557707307892 -34.623019493792889,-58.456801894032978 -34.624105975925453,-58.457960067324862 -34.62453223825289,-58.458142463272964 -34.624586965391629,-58.459008952061154 -34.624885948600486,-58.459617193027754 -34.623719657809858)));;3090;7_5_6;COMUNA 7;5;6;640;281;359;78,27%;324;323;99,69%;1;0,31%;269;21;7,81%;248;92,19%
MULTIPOLYGON (((-58.460176599513424 -34.622647027978566,-58.45962175503066 -34.622452290182714,-58.459435954964491 -34.622401931494373,-58.458273458237542 -34.621989908720984,-58.457557707307892 -34.623019493792889,-58.458748244641434 -34.623398847045792,-58.458916666377988 -34.62346948862551,-58.459617193027754 -34.623719657809858,-58.460176599513424 -34.622647027978566)));;3091;7_5_7;COMUNA 7;5;7;660;290;370;78,38%;311;311;100,00%;0;0,00%;269;0;0,00%;269;100,00%
MULTIPOLYGON (((-58.459617193027754 -34.623719657809858,-58.459008952061154 -34.624885948600486,-58.459886266580959 -34.625188587987196,-58.460052478294855 -34.625245283788182,-58.460582837349172 -34.62422251259764,-58.460646479616983 -34.624097509387624,-58.461202127279407 -34.623006846064065,-58.460176599513424 -34.622647027978566,-58.459617193027754 -34.623719657809858)));;3092;7_5_8;COMUNA 7;5;8;740;300;440;68,18%;415;415;100,00%;0;0,00%;345;14;4,06%;331;95,94%
MULTIPOLYGON (((-58.460052478294855 -34.625245283788182,-58.459992327510136 -34.625361413199485,-58.459725566177191 -34.625875156921836,-58.459791846547773 -34.625907131441238,-58.45996717552724 -34.625962207795332,-58.460224120746766 -34.626039680710136,-58.460727618949022 -34.626189342875527,-58.460809064843417 -34.626213922466924,-58.461109474228159 -34.625605596153306,-58.462176361878228 -34.625968927653219,-58.462268031326161 -34.626000900933008,-58.462699372812843 -34.625034530658255,-58.46277298015616 -34.624867975635624,-58.462239839127854 -34.624679658474399,-58.461669641669388 -34.624471478833101,-58.46074649521308 -34.624134343282925,-58.460646479616983 -34.624097509387624,-58.460582837349172 -34.62422251259764,-58.460052478294855 -34.625245283788182)));;3093;7_5_9;COMUNA 7;5;9;1098;501;597;83,92%;493;492;99,80%;1;0,20%;460;134;29,13%;326;70,87%
MULTIPOLYGON (((-58.463276041021423 -34.623734555071529,-58.462217952013297 -34.62336327507051,-58.461202127279407 -34.623006846064065,-58.460646479616983 -34.624097509387624,-58.46074649521308 -34.624134343282925,-58.461669641669388 -34.624471478833101,-58.462239839127854 -34.624679658474399,-58.46277298015616 -34.624867975635624,-58.463074562728295 -34.624185768568537,-58.463276041021423 -34.623734555071529)));;3094;7_6_1;COMUNA 7;6;1;927;410;517;79,30%;457;456;99,78%;1;0,22%;372;44;11,83%;328;88,17%
MULTIPOLYGON (((-58.464371368807448 -34.624108501515863,-58.46343271055693 -34.623789485700875,-58.463276041021423 -34.623734555071529,-58.463074562728295 -34.624185768568537,-58.46277298015616 -34.624867975635624,-58.462938000486524 -34.624926287282328,-58.464191973542263 -34.625281572241491,-58.464655319028651 -34.624204979485441,-58.464371368807448 -34.624108501515863)));;3095;7_6_2;COMUNA 7;6;2;801;355;446;79,60%;300;298;99,33%;2;0,67%;299;4;1,34%;295;98,66%
MULTIPOLYGON (((-58.466115205222167 -34.624665174419093,-58.464838570782035 -34.624267302496229,-58.464655319028651 -34.624204979485441,-58.464191973542263 -34.625281572241491,-58.465421335858089 -34.625629872771469,-58.465664057601252 -34.625706419023871,-58.466115205222167 -34.624665174419093)));;3096;7_6_3;COMUNA 7;6;3;631;301;330;91,21%;283;283;100,00%;0;0,00%;243;58;23,87%;185;76,13%
MULTIPOLYGON (((-58.465664057601252 -34.625706419023871,-58.465421335858089 -34.625629872771469,-58.464191973542263 -34.625281572241491,-58.463756559294367 -34.626293442296614,-58.463706125143602 -34.626407108562177,-58.463837837454612 -34.626439714147487,-58.46517652258882 -34.626828510341987,-58.465238711167217 -34.626688222609779,-58.465664057601252 -34.625706419023871)));;3097;7_6_4;COMUNA 7;6;4;834;391;443;88,26%;333;329;98,80%;4;1,22%;305;57;18,69%;248;81,31%
MULTIPOLYGON (((-58.464191973542263 -34.625281572241491,-58.462938000486524 -34.624926287282328,-58.46277298015616 -34.624867975635624,-58.462699372812843 -34.625034530658255,-58.462268031326161 -34.626000900933008,-58.462760713216269 -34.62617287937254,-58.463706125143602 -34.626407108562177,-58.463756559294367 -34.626293442296614,-58.464191973542263 -34.625281572241491)));;3098;7_6_5;COMUNA 7;6;5;899;396;503;78,73%;493;492;99,80%;1;0,20%;414;98;23,67%;316;76,33%
MULTIPOLYGON (((-58.463474400653695 -34.627118190736816,-58.46382958427931 -34.627234248235865,-58.46388402480828 -34.627249741202199,-58.46396836936529 -34.627276079274694,-58.464215950629921 -34.627345867544953,-58.464786684579479 -34.627525653934221,-58.464858164894665 -34.627546357616261,-58.464858529729028 -34.627546468111063,-58.464913029076037 -34.627422997928434,-58.464912942917088 -34.627422972178088,-58.46517652258882 -34.626828510341987,-58.463837837454612 -34.626439714147487,-58.463706125143602 -34.626407108562177,-58.462760713216269 -34.62617287937254,-58.462268031326161 -34.626000900933008,-58.462176361878228 -34.625968927653219,-58.461109474228159 -34.625605596153306,-58.460809064843417 -34.626213922466924,-58.460743802329496 -34.626345968185483,-58.460818603099007 -34.62637301253573,-58.461024859513714 -34.62643351055808,-58.461358738305975 -34.626528095367036,-58.461891378346344 -34.626680006631474,-58.461899301698885 -34.626662541301691,-58.461969026823539 -34.626683443008432,-58.461969076644017 -34.626683457943251,-58.462032973021756 -34.626717966523771,-58.462202682313183 -34.626766842232932,-58.462555221626744 -34.626869100153272,-58.462701502692944 -34.626907904372921,-58.46332045134325 -34.627095444367043,-58.463331697045533 -34.627073753433095,-58.463400373158095 -34.627095603542266,-58.463400535547116 -34.627095655208173,-58.463474400653695 -34.627118190736816)));;3099;7_6_6;COMUNA 7;6;6;908;414;494;83,81%;435;435;100,00%;0;0,00%;394;13;3,30%;381;96,70%
MULTIPOLYGON (((-58.463400535547116 -34.627095655208173,-58.463400373158095 -34.627095603542266,-58.463331697045533 -34.627073753433095,-58.46332045134325 -34.627095444367043,-58.462701502692944 -34.626907904372921,-58.462555221626744 -34.626869100153272,-58.462202682313183 -34.626766842232932,-58.462032973021756 -34.626717966523771,-58.461969076644017 -34.626683457943251,-58.461969026823539 -34.626683443008432,-58.461899301698885 -34.626662541301691,-58.461891378346344 -34.626680006631474,-58.461358738305975 -34.626528095367036,-58.461024859513714 -34.62643351055808,-58.460818603099007 -34.62637301253573,-58.460743802329496 -34.626345968185483,-58.460731448437627 -34.626370898412397,-58.460576981568046 -34.626682526133727,-58.460505073110852 -34.626812529275718,-58.460681341470746 -34.626873731580531,-58.461741683754902 -34.627205023359224,-58.461915057250039 -34.627259251787372,-58.463175621364563 -34.627647928511344,-58.46338716487228 -34.627713140975224,-58.46464424793438 -34.628028701454262,-58.464858164894665 -34.627546357616261,-58.464786684579479 -34.627525653934221,-58.464215950629921 -34.627345867544953,-58.46396836936529 -34.627276079274694,-58.46388402480828 -34.627249741202199,-58.46382958427931 -34.627234248235865,-58.463474400653695 -34.627118190736816,-58.463400535547116 -34.627095655208173)));;3100;7_6_7;COMUNA 7;6;7;869;390;479;81,42%;499;499;100,00%;0;0,00%;379;2;0,53%;377;99,47%
MULTIPOLYGON (((-58.46464424793438 -34.628028701454262,-58.46338716487228 -34.627713140975224,-58.463175621364563 -34.627647928511344,-58.461915057250039 -34.627259251787372,-58.461741683754902 -34.627205023359224,-58.461675484537388 -34.627357140649565,-58.461206971521953 -34.628415692690382,-58.461386907336895 -34.628472950209606,-58.462711896853811 -34.628849730516585,-58.463242509446339 -34.629001424548697,-58.463540532593491 -34.629087200387538,-58.46411204353555 -34.629251707673838,-58.464168186535048 -34.629104659822637,-58.46464424793438 -34.628028701454262)));;3101;7_6_8;COMUNA 7;6;8;439;202;237;85,23%;239;239;100,00%;0;0,00%;185;1;0,54%;184;99,46%
MULTIPOLYGON (((-58.461741683754902 -34.627205023359224,-58.460681341470746 -34.626873731580531,-58.460505073110852 -34.626812529275718,-58.460419276827345 -34.626967603386674,-58.459857461836712 -34.62795558276909,-58.460018567103532 -34.628016363116465,-58.460988697440179 -34.628346321289115,-58.461206971521953 -34.628415692690382,-58.461675484537388 -34.627357140649565,-58.461741683754902 -34.627205023359224)));;3102;7_6_9;COMUNA 7;6;9;687;282;405;69,63%;352;351;99,72%;1;0,28%;289;22;7,61%;267;92,39%
MULTIPOLYGON (((-58.469787754548889 -34.627009814591453,-58.469333486978023 -34.628040297535392,-58.470415346656992 -34.628354892399692,-58.470659528569371 -34.62842403396931,-58.471104413420292 -34.627425026738365,-58.471447247712142 -34.626655117376117,-58.47157569212937 -34.62636953500995,-58.470436343687837 -34.626016149853669,-58.470251295210332 -34.62595820172784,-58.469787754548889 -34.627009814591453)));;3103;7_7_1;COMUNA 7;7;1;641;285;356;80,06%;314;313;99,68%;1;0,32%;245;3;1,22%;242;98,78%
MULTIPOLYGON (((-58.46802193399693 -34.628881023923078,-58.467456979323501 -34.628738014286661,-58.46607522985321 -34.628388189416022,-58.465519871528016 -34.629651696657859,-58.466909563526144 -34.630009626334832,-58.467081497309024 -34.630053847110005,-58.467444535418196 -34.630145878857341,-58.46802193399693 -34.628881023923078)));;3104;7_7_10;COMUNA 7;7;10;789;354;435;81,38%;430;430;100,00%;0;0,00%;355;3;0,85%;352;99,15%
MULTIPOLYGON (((-58.46607522985321 -34.628388189416022,-58.465900488531609 -34.628343967283918,-58.46464424793438 -34.628028701454262,-58.464168186535048 -34.629104659822637,-58.46411204353555 -34.629251707673838,-58.465343679438902 -34.629606276547641,-58.465519871528016 -34.629651696657859,-58.46607522985321 -34.628388189416022)));;3105;7_7_11;COMUNA 7;7;11;613;244;369;66,12%;354;354;100,00%;0;0,00%;282;0;0,00%;282;100,00%
MULTIPOLYGON (((-58.470251295210332 -34.62595820172784,-58.468867870031929 -34.625524884455039,-58.468407040428552 -34.626574308837519,-58.468580161415524 -34.626629302483877,-58.469787754548889 -34.627009814591453,-58.470251295210332 -34.62595820172784)));;3106;7_7_2;COMUNA 7;7;2;586;268;318;84,28%;239;237;99,16%;2;0,84%;204;2;0,98%;202;99,02%
MULTIPOLYGON (((-58.468867870031929 -34.625524884455039,-58.4677323782063 -34.625169220198899,-58.467524927097159 -34.625104578481178,-58.467067490446105 -34.626148997571541,-58.467264635059223 -34.626211105144598,-58.468407040428552 -34.626574308837519,-58.468867870031929 -34.625524884455039)));;3107;7_7_3;COMUNA 7;7;3;958;425;533;79,74%;464;464;100,00%;0;0,00%;409;1;0,24%;408;99,76%
MULTIPOLYGON (((-58.467524927097159 -34.625104578481178,-58.466115205222167 -34.624665174419093,-58.465664057601252 -34.625706419023871,-58.467067490446105 -34.626148997571541,-58.467524927097159 -34.625104578481178)));;3108;7_7_4;COMUNA 7;7;4;639;301;338;89,05%;287;285;99,30%;2;0,70%;266;51;19,17%;215;80,83%
MULTIPOLYGON (((-58.467067490446105 -34.626148997571541,-58.465664057601252 -34.625706419023871,-58.465238711167217 -34.626688222609779,-58.46517652258882 -34.626828510341987,-58.46533217653851 -34.62687379030956,-58.466585423291164 -34.627249614642096,-58.467067490446105 -34.626148997571541)));;3109;7_7_5;COMUNA 7;7;5;637;302;335;90,15%;292;291;99,66%;1;0,34%;287;113;39,37%;174;60,63%
MULTIPOLYGON (((-58.469787754548889 -34.627009814591453,-58.468580161415524 -34.626629302483877,-58.468407040428552 -34.626574308837519,-58.467264635059223 -34.626211105144598,-58.467067490446105 -34.626148997571541,-58.466585423291164 -34.627249614642096,-58.466720972273741 -34.627290245428306,-58.467939299302138 -34.627639577202167,-58.469077549719508 -34.627965872053466,-58.469333486978023 -34.628040297535392,-58.469787754548889 -34.627009814591453)));;3110;7_7_6;COMUNA 7;7;6;959;455;504;90,28%;451;450;99,78%;1;0,22%;365;22;6,03%;343;93,97%
MULTIPOLYGON (((-58.464945832091068 -34.627549313880188,-58.465357419908841 -34.627671492838267,-58.465786133647079 -34.627798599716982,-58.46619993971867 -34.627936832651116,-58.466264434491144 -34.627955070835931,-58.466658730266772 -34.628069376717534,-58.466881609170606 -34.628130127569889,-58.467554251293564 -34.628330531948272,-58.46762735166736 -34.628350107141721,-58.467627824971032 -34.62835024084594,-58.467701133729662 -34.628370949911684,-58.467873406105994 -34.628427493927511,-58.468045934159122 -34.628481713666339,-58.468158482333187 -34.628518963457175,-58.468332885000684 -34.628571633357502,-58.46841263158317 -34.628597193889377,-58.468793387912456 -34.62871654567595,-58.468872112121453 -34.62873830301308,-58.4689359265438 -34.628756891941833,-58.469008090452171 -34.628776607204074,-58.469064396512188 -34.628650825400889,-58.469133408049032 -34.628670540753781,-58.469856412659084 -34.628880577963422,-58.469845169341035 -34.628913114927144,-58.470372132224703 -34.629069355774504,-58.470437806173123 -34.628921881884324,-58.470659528569371 -34.62842403396931,-58.470415346656992 -34.628354892399692,-58.469333486978023 -34.628040297535392,-58.469077549719508 -34.627965872053466,-58.467939299302138 -34.627639577202167,-58.466720972273741 -34.627290245428306,-58.466585423291164 -34.627249614642096,-58.46533217653851 -34.62687379030956,-58.46517652258882 -34.626828510341987,-58.464912942917088 -34.627422972178088,-58.464913029076037 -34.627422997928434,-58.464858529729028 -34.627546468111063,-58.464936290647159 -34.627570018981174,-58.464945832091068 -34.627549313880188)));;3111;7_7_7;COMUNA 7;7;7;665;301;364;82,69%;277;275;99,28%;2;0,73%;248;12;4,84%;236;95,16%
MULTIPOLYGON (((-58.464945832091068 -34.627549313880188,-58.464936290647159 -34.627570018981174,-58.464858529729028 -34.627546468111063,-58.464858164894665 -34.627546357616261,-58.46464424793438 -34.628028701454262,-58.465900488531609 -34.628343967283918,-58.46607522985321 -34.628388189416022,-58.467456979323501 -34.628738014286661,-58.46762735166736 -34.628350107141721,-58.467554251293564 -34.628330531948272,-58.466881609170606 -34.628130127569889,-58.466658730266772 -34.628069376717534,-58.466264434491144 -34.627955070835931,-58.46619993971867 -34.627936832651116,-58.465786133647079 -34.627798599716982,-58.465357419908841 -34.627671492838267,-58.464945832091068 -34.627549313880188)));;3112;7_7_8;COMUNA 7;7;8;506;231;275;84,00%;282;282;100,00%;0;0,00%;220;9;4,09%;211;95,91%
MULTIPOLYGON (((-58.470209437016294 -34.629434800692835,-58.47031770189227 -34.62919161681058,-58.470372132224703 -34.629069355774504,-58.469845169341035 -34.628913114927144,-58.469856412659084 -34.628880577963422,-58.469133408049032 -34.628670540753781,-58.469064396512188 -34.628650825400889,-58.469008090452171 -34.628776607204074,-58.4689359265438 -34.628756891941833,-58.468872112121453 -34.62873830301308,-58.468793387912456 -34.62871654567595,-58.46841263158317 -34.628597193889377,-58.468332885000684 -34.628571633357502,-58.468158482333187 -34.628518963457175,-58.468045934159122 -34.628481713666339,-58.467873406105994 -34.628427493927511,-58.467701133729662 -34.628370949911684,-58.467627824971032 -34.62835024084594,-58.46762735166736 -34.628350107141721,-58.467456979323501 -34.628738014286661,-58.46802193399693 -34.628881023923078,-58.467444535418196 -34.630145878857341,-58.468303612363592 -34.630363666588352,-58.469639651187983 -34.630707060045232,-58.470209437016294 -34.629434800692835)));;3113;7_7_9;COMUNA 7;7;9;936;418;518;80,69%;521;521;100,00%;0;0,00%;410;80;19,51%;330;80,49%
MULTIPOLYGON (((-58.469639651187983 -34.630707060045232,-58.468303612363592 -34.630363666588352,-58.467692049457142 -34.631747119431893,-58.468791760130578 -34.632089756867281,-58.468991305979557 -34.632155382711517,-58.469639651187983 -34.630707060045232)));;3114;7_8_1;COMUNA 7;8;1;682;295;387;76,23%;404;403;99,75%;1;0,25%;326;24;7,36%;302;92,64%
MULTIPOLYGON (((-58.466330268001244 -34.631324054937899,-58.465791504983628 -34.632498474865571,-58.467177159619197 -34.632924995236522,-58.467638209816826 -34.631868815795698,-58.467692049457142 -34.631747119431893,-58.468303612363592 -34.630363666588352,-58.467444535418196 -34.630145878857341,-58.467081497309024 -34.630053847110005,-58.466909563526144 -34.630009626334832,-58.466824883216312 -34.630159845514228,-58.466330268001244 -34.631324054937899)));;3115;7_8_2;COMUNA 7;8;2;879;388;491;79,02%;458;456;99,56%;2;0,44%;356;18;5,06%;338;94,94%
MULTIPOLYGON (((-58.468991305979557 -34.632155382711517,-58.468791760130578 -34.632089756867281,-58.467692049457142 -34.631747119431893,-58.467638209816826 -34.631868815795698,-58.467177159619197 -34.632924995236522,-58.468484778592611 -34.633286853548221,-58.468991305979557 -34.632155382711517)));;3116;7_8_3;COMUNA 7;8;3;583;239;344;69,48%;311;310;99,68%;1;0,32%;247;2;0,81%;245;99,19%
MULTIPOLYGON (((-58.470527610001675 -34.632606858004031,-58.470387024806769 -34.632579049126008,-58.469196475559173 -34.632222768550754,-58.468991305979557 -34.632155382711517,-58.468484778592611 -34.633286853548221,-58.470009855471133 -34.633755449046795,-58.471196085574427 -34.634119961598593,-58.47128007647995 -34.633931639690601,-58.471744915561544 -34.632886853463617,-58.470665468791353 -34.632634173923982,-58.470527610001675 -34.632606858004031)));;3117;7_8_4;COMUNA 7;8;4;821;358;463;77,32%;458;457;99,78%;1;0,22%;358;13;3,63%;345;96,37%
MULTIPOLYGON (((-58.472874298755755 -34.633151209809135,-58.471744915561544 -34.632886853463617,-58.47128007647995 -34.633931639690601,-58.471196085574427 -34.634119961598593,-58.470669728223008 -34.635299894804618,-58.469633360888395 -34.634977130703199,-58.46948467618008 -34.634931715048353,-58.469022438581575 -34.635974801982755,-58.470210484370696 -34.63632925314306,-58.471302936456219 -34.636655177440893,-58.471755950747252 -34.635644971059662,-58.472280251249735 -34.634475808395472,-58.472874298755755 -34.633151209809135)));;3118;7_8_5;COMUNA 7;8;5;1040;485;555;87,39%;471;470;99,79%;1;0,21%;392;20;5,10%;372;94,90%
MULTIPOLYGON (((-58.470009855471133 -34.633755449046795,-58.468484778592611 -34.633286853548221,-58.468396181734967 -34.633484681121367,-58.467963244180979 -34.634458464877973,-58.468147458309268 -34.63452254339127,-58.46948467618008 -34.634931715048353,-58.469633360888395 -34.634977130703199,-58.470669728223008 -34.635299894804618,-58.471196085574427 -34.634119961598593,-58.470009855471133 -34.633755449046795)));;3119;7_8_6;COMUNA 7;8;6;896;414;482;85,89%;466;466;100,00%;0;0,00%;373;24;6,43%;349;93,57%
MULTIPOLYGON (((-58.468484778592611 -34.633286853548221,-58.467177159619197 -34.632924995236522,-58.466682446219657 -34.63405793693417,-58.467753383567995 -34.63438551362146,-58.467963244180979 -34.634458464877973,-58.468396181734967 -34.633484681121367,-58.468484778592611 -34.633286853548221)));;3120;7_8_7;COMUNA 7;8;7;678;297;381;77,95%;390;390;100,00%;0;0,00%;319;33;10,34%;286;89,66%
MULTIPOLYGON (((-58.46948467618008 -34.634931715048353,-58.468147458309268 -34.63452254339127,-58.467963244180979 -34.634458464877973,-58.467753383567995 -34.63438551362146,-58.466682446219657 -34.63405793693417,-58.466281775593806 -34.634975655408049,-58.466218305592982 -34.635141226032246,-58.467491959461547 -34.635518659716567,-58.467751412046901 -34.635595623580365,-58.469022438581575 -34.635974801982755,-58.46948467618008 -34.634931715048353)));;3121;7_8_8;COMUNA 7;8;8;818;373;445;83,82%;501;500;99,80%;1;0,20%;368;22;5,98%;346;94,02%
MULTIPOLYGON (((-58.461246518702445 -34.632404629044821,-58.459543447579172 -34.631892326397058,-58.459025037931617 -34.63297157287365,-58.460765275706422 -34.63350557411831,-58.460837189930253 -34.633357823903673,-58.461246518702445 -34.632404629044821)));;3122;7_9_1;COMUNA 7;9;1;667;309;358;86,31%;293;292;99,66%;1;0,34%;259;10;3,86%;249;96,14%
MULTIPOLYGON (((-58.466909563526144 -34.630009626334832,-58.465519871528016 -34.629651696657859,-58.464963047871201 -34.630911679892776,-58.466330268001244 -34.631324054937899,-58.466824883216312 -34.630159845514228,-58.466909563526144 -34.630009626334832)));;3123;7_9_10;COMUNA 7;9;10;692;303;389;77,89%;387;387;100,00%;0;0,00%;307;14;4,56%;293;95,44%
MULTIPOLYGON (((-58.466330268001244 -34.631324054937899,-58.464963047871201 -34.630911679892776,-58.46444369411045 -34.632086938683592,-58.46459501218051 -34.632130177293462,-58.465791504983628 -34.632498474865571,-58.466330268001244 -34.631324054937899)));;3124;7_9_11;COMUNA 7;9;11;577;257;320;80,31%;292;292;100,00%;0;0,00%;263;26;9,89%;237;90,11%
MULTIPOLYGON (((-58.462621327894006 -34.632820566896775,-58.462527094753085 -34.63278986156206,-58.461246518702445 -34.632404629044821,-58.460837189930253 -34.633357823903673,-58.460765275706422 -34.63350557411831,-58.460925881395077 -34.633554803529172,-58.462152284655254 -34.633925249891853,-58.462588099081387 -34.632899301859929,-58.462621327894006 -34.632820566896775)));;3125;7_9_2;COMUNA 7;9;2;625;290;335;86,57%;345;344;99,71%;1;0,29%;276;2;0,72%;274;99,28%
MULTIPOLYGON (((-58.463941280378862 -34.633223742896305,-58.46380197423575 -34.633185503539778,-58.462780570131734 -34.632872470014604,-58.462621327894006 -34.632820566896775,-58.462588099081387 -34.632899301859929,-58.462152284655254 -34.633925249891853,-58.463457086089925 -34.634319346184981,-58.463941280378862 -34.633223742896305)));;3126;7_9_3;COMUNA 7;9;3;543;225;318;70,75%;276;275;99,64%;1;0,36%;226;1;0,44%;225;99,56%
MULTIPOLYGON (((-58.465288595824561 -34.633631481621826,-58.464078286177056 -34.633261277870979,-58.463941280378862 -34.633223742896305,-58.463457086089925 -34.634319346184981,-58.464200574521271 -34.634543853687148,-58.464635456616357 -34.634675189880305,-58.464805354075082 -34.634725188698624,-58.46605258147482 -34.635092074168924,-58.466218305592982 -34.635141226032246,-58.466281775593806 -34.634975655408049,-58.466682446219657 -34.63405793693417,-58.465288595824561 -34.633631481621826)));;3127;7_9_4;COMUNA 7;9;4;826;374;452;82,74%;478;478;100,00%;0;0,00%;415;10;2,41%;405;97,59%
MULTIPOLYGON (((-58.467177159619197 -34.632924995236522,-58.465791504983628 -34.632498474865571,-58.46573118711121 -34.632629818742394,-58.465288595824561 -34.633631481621826,-58.466682446219657 -34.63405793693417,-58.467177159619197 -34.632924995236522)));;3128;7_9_5;COMUNA 7;9;5;494;221;273;80,95%;292;291;99,66%;1;0,34%;197;1;0,51%;196;99,49%
MULTIPOLYGON (((-58.46444369411045 -34.632086938683592,-58.464309160891808 -34.63204855898114,-58.463104927813305 -34.631674612876679,-58.462621327894006 -34.632820566896775,-58.462780570131734 -34.632872470014604,-58.46380197423575 -34.633185503539778,-58.463941280378862 -34.633223742896305,-58.464078286177056 -34.633261277870979,-58.465288595824561 -34.633631481621826,-58.46573118711121 -34.632629818742394,-58.465791504983628 -34.632498474865571,-58.46459501218051 -34.632130177293462,-58.46444369411045 -34.632086938683592)));;3129;7_9_6;COMUNA 7;9;6;893;404;489;82,62%;446;445;99,78%;1;0,22%;356;39;10,96%;317;89,04%
MULTIPOLYGON (((-58.463104927813305 -34.631674612876679,-58.462971077471373 -34.631633062574252,-58.461737206692938 -34.631261990422779,-58.461246518702445 -34.632404629044821,-58.462527094753085 -34.63278986156206,-58.462621327894006 -34.632820566896775,-58.463104927813305 -34.631674612876679)));;3130;7_9_7;COMUNA 7;9;7;753;333;420;79,29%;413;412;99,76%;1;0,24%;329;8;2,43%;321;97,57%
MULTIPOLYGON (((-58.46411204353555 -34.629251707673838,-58.463540532593491 -34.629087200387538,-58.463242509446339 -34.629001424548697,-58.462711896853811 -34.628849730516585,-58.462293740930264 -34.629947724395514,-58.462237338492457 -34.630088644397354,-58.462184684686768 -34.630219916176301,-58.461737206692938 -34.631261990422779,-58.462971077471373 -34.631633062574252,-58.463104927813305 -34.631674612876679,-58.464309160891808 -34.63204855898114,-58.46444369411045 -34.632086938683592,-58.464963047871201 -34.630911679892776,-58.463594137276544 -34.630498726107305,-58.463842485442569 -34.629900746319898,-58.46411204353555 -34.629251707673838)));;3131;7_9_8;COMUNA 7;9;8;972;441;531;83,05%;472;470;99,58%;2;0,43%;397;19;4,79%;378;95,21%
MULTIPOLYGON (((-58.465519871528016 -34.629651696657859,-58.465343679438902 -34.629606276547641,-58.46411204353555 -34.629251707673838,-58.463842485442569 -34.629900746319898,-58.463594137276544 -34.630498726107305,-58.464963047871201 -34.630911679892776,-58.465519871528016 -34.629651696657859)));;3132;7_9_9;COMUNA 7;9;9;685;318;367;86,65%;361;361;100,00%;0;0,00%;298;48;16,11%;250;83,89%
MULTIPOLYGON (((-58.49639963271143 -34.676734169865497,-58.495639897692989 -34.676048021828024,-58.494618431301198 -34.676811200534971,-58.4947347445001 -34.676906031614386,-58.495390444310324 -34.677506999695069,-58.496115315334933 -34.678171397564356,-58.496117350948971 -34.678169787357767,-58.496405767776686 -34.678421462440774,-58.496820022172201 -34.67878294062362,-58.497845956176036 -34.67800774596094,-58.49744023090863 -34.677641647368752,-58.497149474186571 -34.677379285661431,-58.497130129458014 -34.677393912222463,-58.496541450187692 -34.676862302882526,-58.496458815671772 -34.676787675991328,-58.49639963271143 -34.676734169865497)));;3133;8_1_1;COMUNA 8;1;1;1147;578;569;101,58%;271;271;100,00%;0;0,00%;331;21;6,34%;310;93,66%
MULTIPOLYGON (((-58.489361051644622 -34.67084378631376,-58.489280779811594 -34.671188672189253,-58.489232003818756 -34.671399251797602,-58.489202037958776 -34.671521937632882,-58.489181096631505 -34.671610113539792,-58.489568497733053 -34.671807357952517,-58.489716757133266 -34.671881482081773,-58.489868828262402 -34.67161975120144,-58.489884503888611 -34.671592775159667,-58.49011299647217 -34.671213066012044,-58.490194700703299 -34.671086001975624,-58.49031841315287 -34.670912941230469,-58.490296155498271 -34.670883368017265,-58.490336541349741 -34.670828357401312,-58.490404955938295 -34.670727141988621,-58.490522189098492 -34.670553941650176,-58.490573156476323 -34.670534844990634,-58.490645063354123 -34.670427572139928,-58.490683999243622 -34.670371294097663,-58.49080293628959 -34.670198586059215,-58.49089724297977 -34.670039052966494,-58.491030900020633 -34.669791268853224,-58.491102967131482 -34.669657586522121,-58.49114071744728 -34.669626027577522,-58.490568350394973 -34.669164809316399,-58.490533975760101 -34.669095096979959,-58.490517598798704 -34.669061930809328,-58.490282098789095 -34.668593027989523,-58.490173303376572 -34.668498542956087,-58.490026925836773 -34.668687031656475,-58.489953148381609 -34.668806417594531,-58.489882532852938 -34.66895122600215,-58.489375428315014 -34.669423745114905,-58.489495393495098 -34.669527876538261,-58.489486113851534 -34.669563442914267,-58.489731158882627 -34.669769591551514,-58.489672209864231 -34.669883128782573,-58.489641620086495 -34.669917995637,-58.489551810366763 -34.670020271715536,-58.489468050681552 -34.670381989965058,-58.489427447385737 -34.670557285251412,-58.489396633122482 -34.670690605424184,-58.489361051644622 -34.67084378631376)));;3134;8_1_10;COMUNA 8;1;10;1514;758;756;100,26%;396;396;100,00%;0;0,00%;440;81;18,41%;359;81,59%
MULTIPOLYGON (((-58.489868828262402 -34.67161975120144,-58.489716757133266 -34.671881482081773,-58.490323779414219 -34.672185016057803,-58.49042814664589 -34.672021959879082,-58.490909831602565 -34.672222699752936,-58.491147178840869 -34.672319618993669,-58.491708408166012 -34.672548225173671,-58.491598189496578 -34.672302329362189,-58.491512183291931 -34.67206537161961,-58.491485552082302 -34.671962135740117,-58.491468218815449 -34.671877771398947,-58.491419634428702 -34.671640734313243,-58.491397974179485 -34.671367774415913,-58.491406107559143 -34.671223472887831,-58.491438659436561 -34.670947049405264,-58.491455165832939 -34.670859296694246,-58.491481626910257 -34.670718230347809,-58.491490645794826 -34.670670198766828,-58.491586430703478 -34.670351294345302,-58.491724838898307 -34.670044070145742,-58.491794353410739 -34.66992609266606,-58.49114071744728 -34.669626027577522,-58.491102967131482 -34.669657586522121,-58.491030900020633 -34.669791268853224,-58.49089724297977 -34.670039052966494,-58.49080293628959 -34.670198586059215,-58.490683999243622 -34.670371294097663,-58.490645063354123 -34.670427572139928,-58.490573156476323 -34.670534844990634,-58.490522189098492 -34.670553941650176,-58.490404955938295 -34.670727141988621,-58.490336541349741 -34.670828357401312,-58.490296155498271 -34.670883368017265,-58.49031841315287 -34.670912941230469,-58.490194700703299 -34.671086001975624,-58.49011299647217 -34.671213066012044,-58.489884503888611 -34.671592775159667,-58.489868828262402 -34.67161975120144)));;3135;8_1_11;COMUNA 8;1;11;665;338;327;103,36%;71;71;100,00%;0;0,00%;182;57;31,32%;125;68,68%
MULTIPOLYGON (((-58.489181096631505 -34.671610113539792,-58.489162368584985 -34.671688992940041,-58.48914304475133 -34.67177083029059,-58.488917633320021 -34.672749989380776,-58.48888455909762 -34.672749785216197,-58.488814747592706 -34.673028539929547,-58.488776105711963 -34.67321496155639,-58.488718482890761 -34.673492516371113,-58.48866092978956 -34.673721548732864,-58.488598688980474 -34.673680011586875,-58.48859247399799 -34.673705083986881,-58.488497319443141 -34.673632074076714,-58.488362080599757 -34.674255202174713,-58.488217966550351 -34.674398641244302,-58.488097981501475 -34.674524866267092,-58.488005267401903 -34.674628549803806,-58.48791800461175 -34.674718710716419,-58.487855187237798 -34.674785266574737,-58.488019668263703 -34.674929461628146,-58.488150773912452 -34.674926124381159,-58.488645161055402 -34.675366031590656,-58.488309165439773 -34.676885789760661,-58.48828189422526 -34.676911148250859,-58.488338277672646 -34.677025435114793,-58.488331468345066 -34.677059310655636,-58.488355352318777 -34.677107264608331,-58.488379318089109 -34.677143950644108,-58.488621764403753 -34.677154674253316,-58.488749172623997 -34.677038658202079,-58.489354165131537 -34.676487949881931,-58.489971164182052 -34.675921601618967,-58.491067316505429 -34.674848154621209,-58.491279742842138 -34.674632508345823,-58.491708812488177 -34.674196930342504,-58.492106504862136 -34.673794852711886,-58.492273266957483 -34.673626286828011,-58.492430399346532 -34.673467441625313,-58.492168856689553 -34.67318193424947,-58.492050918342251 -34.673048367639474,-58.491973399675182 -34.672955144388197,-58.491888455004975 -34.672833260137473,-58.491836260447997 -34.67275904531526,-58.491756768062594 -34.672626736855335,-58.491708408166012 -34.672548225173671,-58.491147178840869 -34.672319618993669,-58.490909831602565 -34.672222699752936,-58.49042814664589 -34.672021959879082,-58.490323779414219 -34.672185016057803,-58.489716757133266 -34.671881482081773,-58.489568497733053 -34.671807357952517,-58.489181096631505 -34.671610113539792)));;3136;8_1_12;COMUNA 8;1;12;3404;1703;1701;100,12%;902;902;100,00%;0;0,00%;1019;231;22,67%;788;77,33%
MULTIPOLYGON (((-58.495639897692989 -34.676048021828024,-58.49639963271143 -34.676734169865497,-58.496458815671772 -34.676787675991328,-58.496541450187692 -34.676862302882526,-58.497130129458014 -34.677393912222463,-58.497149474186571 -34.677379285661431,-58.49744023090863 -34.677641647368752,-58.497845956176036 -34.67800774596094,-58.502522626279266 -34.674473765367807,-58.502004305240682 -34.674185404644213,-58.501641882017026 -34.673983773002675,-58.50164187158515 -34.673983768279541,-58.500681450386878 -34.673468671325828,-58.500118111461227 -34.6731668657876,-58.499741929165396 -34.672965285232706,-58.49912752472801 -34.672636025083044,-58.498928260007403 -34.6725146023877,-58.498723794167319 -34.672388744164287,-58.498252856492357 -34.672050704467885,-58.497916389569376 -34.671809316864142,-58.497407941066079 -34.671444453001357,-58.497233249024134 -34.671319073576342,-58.497039930458619 -34.67118032484565,-58.495873184400615 -34.670195621632757,-58.495738025996424 -34.670062344907087,-58.494549910433939 -34.671290017805077,-58.493450207624782 -34.672426104903842,-58.492984533332091 -34.672907220077931,-58.49269234214033 -34.67320265219864,-58.492430399346532 -34.673467441625313,-58.492273266957483 -34.673626286828011,-58.492106504862136 -34.673794852711886,-58.491708812488177 -34.674196930342504,-58.493324214854603 -34.675656009793649,-58.493848311841504 -34.676129339940211,-58.494462210476321 -34.676683843700324,-58.494618431301198 -34.676811200534971,-58.495639897692989 -34.676048021828024)));;3137;8_1_2;COMUNA 8;1;2;1625;808;817;98,90%;475;475;100,00%;0;0,00%;517;91;17,60%;426;82,40%
MULTIPOLYGON (((-58.491946130150296 -34.671280810848756,-58.491406107559143 -34.671223472887831,-58.491397974179485 -34.671367774415913,-58.491419634428702 -34.671640734313243,-58.491468218815449 -34.671877771398947,-58.491485552082302 -34.671962135740117,-58.491512183291931 -34.67206537161961,-58.491598189496578 -34.672302329362189,-58.491708408166012 -34.672548225173671,-58.491756768062594 -34.672626736855335,-58.491836260447997 -34.67275904531526,-58.491888455004975 -34.672833260137473,-58.491973399675182 -34.672955144388197,-58.492050918342251 -34.673048367639474,-58.492168856689553 -34.67318193424947,-58.492430399346532 -34.673467441625313,-58.49269234214033 -34.67320265219864,-58.492984533332091 -34.672907220077931,-58.493450207624782 -34.672426104903842,-58.493050155366369 -34.672165141920068,-58.492710727345141 -34.671945220128187,-58.492643367333095 -34.671892559240057,-58.492603887654354 -34.671857145456812,-58.492543766707904 -34.671786031543427,-58.492484918690408 -34.671698719675703,-58.492444493332385 -34.671640418139361,-58.49238103959545 -34.671545008536405,-58.492281255394836 -34.671399535966664,-58.492217207289151 -34.671309619522617,-58.491946130150296 -34.671280810848756)));;3138;8_1_3;COMUNA 8;1;3;1321;702;619;113,41%;266;266;100,00%;0;0,00%;351;58;16,52%;293;83,48%
MULTIPOLYGON (((-58.492390981832301 -34.669069094789258,-58.4923307439106 -34.669142069158305,-58.492264290113042 -34.669233848327728,-58.492111786583109 -34.669444383839753,-58.491907058549138 -34.669734933825936,-58.491794353410739 -34.66992609266606,-58.491724838898307 -34.670044070145742,-58.491586430703478 -34.670351294345302,-58.491490645794826 -34.670670198766828,-58.491481626910257 -34.670718230347809,-58.491455165832939 -34.670859296694246,-58.491438659436561 -34.670947049405264,-58.491406107559143 -34.671223472887831,-58.491946130150296 -34.671280810848756,-58.492217207289151 -34.671309619522617,-58.492281255394836 -34.671399535966664,-58.49238103959545 -34.671545008536405,-58.492444493332385 -34.671640418139361,-58.492484918690408 -34.671698719675703,-58.492543766707904 -34.671786031543427,-58.492603887654354 -34.671857145456812,-58.492643367333095 -34.671892559240057,-58.492710727345141 -34.671945220128187,-58.493050155366369 -34.672165141920068,-58.493450207624782 -34.672426104903842,-58.494549910433939 -34.671290017805077,-58.493770729286176 -34.67017124536207,-58.493640791404765 -34.670314239982652,-58.493583327950866 -34.670283056535496,-58.493402227446751 -34.670377400576456,-58.493375552289301 -34.670391069628735,-58.493153282288702 -34.670491057604103,-58.493029363889427 -34.670548906942734,-58.492963825179721 -34.670579628275895,-58.492894194061101 -34.670608097006053,-58.492818141869769 -34.670559241273708,-58.492776271691717 -34.67051185597802,-58.492741457541833 -34.67041193231303,-58.492694849466389 -34.670462860643838,-58.492401737023734 -34.670783081805084,-58.492183553544415 -34.670634539251729,-58.492031184410777 -34.670508727573925,-58.492178810073845 -34.670237980499223,-58.49223419074022 -34.670166415883386,-58.492252594131216 -34.670142607969048,-58.492384919113775 -34.669994754957024,-58.492517073197291 -34.669847042688538,-58.492651186560764 -34.669697217059209,-58.492782828492111 -34.66955013844138,-58.492882347792083 -34.669438984094249,-58.492915663537673 -34.669403693202113,-58.493055827906758 -34.66925513325701,-58.4931913907051 -34.669111574433025,-58.493331724489906 -34.668962802848178,-58.493468308809355 -34.668818187086408,-58.493605915071427 -34.668672373693795,-58.493729717675876 -34.668541141515725,-58.493959006476594 -34.668307837191335,-58.493608634684527 -34.667962283350541,-58.493458726728079 -34.667800063337211,-58.493335440371922 -34.667942563037656,-58.493008867326736 -34.668335894763437,-58.492707080097311 -34.668686190159974,-58.492517591873927 -34.668915679468959,-58.492390981832301 -34.669069094789258)));;3139;8_1_4;COMUNA 8;1;4;1894;966;928;104,09%;403;403;100,00%;0;0,00%;482;124;25,73%;358;74,27%
MULTIPOLYGON (((-58.492517073197291 -34.669847042688538,-58.492384919113775 -34.669994754957024,-58.492252594131216 -34.670142607969048,-58.49223419074022 -34.670166415883386,-58.492178810073845 -34.670237980499223,-58.492031184410777 -34.670508727573925,-58.492183553544415 -34.670634539251729,-58.492401737023734 -34.670783081805084,-58.492694849466389 -34.670462860643838,-58.492741457541833 -34.67041193231303,-58.492776271691717 -34.67051185597802,-58.492818141869769 -34.670559241273708,-58.492894194061101 -34.670608097006053,-58.492963825179721 -34.670579628275895,-58.493029363889427 -34.670548906942734,-58.493153282288702 -34.670491057604103,-58.493375552289301 -34.670391069628735,-58.493402227446751 -34.670377400576456,-58.493583327950866 -34.670283056535496,-58.493640791404765 -34.670314239982652,-58.493770729286176 -34.67017124536207,-58.494549910433939 -34.671290017805077,-58.495738025996424 -34.670062344907087,-58.495093449980615 -34.669426655746015,-58.49474076644816 -34.669078852257485,-58.494353039668297 -34.668696478432587,-58.493959006476594 -34.668307837191335,-58.493729717675876 -34.668541141515725,-58.493605915071427 -34.668672373693795,-58.493468308809355 -34.668818187086408,-58.493331724489906 -34.668962802848178,-58.4931913907051 -34.669111574433025,-58.493055827906758 -34.66925513325701,-58.492915663537673 -34.669403693202113,-58.492882347792083 -34.669438984094249,-58.492782828492111 -34.66955013844138,-58.492651186560764 -34.669697217059209,-58.492517073197291 -34.669847042688538)));;3140;8_1_5;COMUNA 8;1;5;1762;838;924;90,69%;411;411;100,00%;0;0,00%;449;65;14,48%;384;85,52%
MULTIPOLYGON (((-58.491682711038187 -34.668275300104092,-58.491605505881218 -34.668334474966031,-58.49108022238542 -34.66869946740654,-58.490783990949666 -34.668870385692898,-58.490533975760101 -34.669095096979959,-58.490568350394973 -34.669164809316399,-58.49114071744728 -34.669626027577522,-58.491794353410739 -34.66992609266606,-58.491907058549138 -34.669734933825936,-58.492111786583109 -34.669444383839753,-58.492264290113042 -34.669233848327728,-58.4923307439106 -34.669142069158305,-58.492390981832301 -34.669069094789258,-58.492517591873927 -34.668915679468959,-58.492707080097311 -34.668686190159974,-58.493008867326736 -34.668335894763437,-58.493335440371922 -34.667942563037656,-58.493458726728079 -34.667800063337211,-58.492896108191594 -34.667191455022561,-58.492320863130345 -34.667724709250628,-58.491991104453291 -34.668038811537862,-58.491682711038187 -34.668275300104092)));;3141;8_1_6;COMUNA 8;1;6;2255;1097;1158;94,73%;429;429;100,00%;0;0,00%;627;126;20,10%;501;79,90%
MULTIPOLYGON (((-58.492896108191594 -34.667191455022561,-58.492598089121984 -34.666869054880898,-58.492566113553224 -34.666836104071145,-58.492188377483409 -34.666447030443436,-58.491211955747616 -34.667322990860342,-58.490573207494222 -34.66788780182155,-58.490565384986525 -34.667945622081419,-58.490173303376572 -34.668498542956087,-58.490282098789095 -34.668593027989523,-58.490517598798704 -34.669061930809328,-58.490533975760101 -34.669095096979959,-58.490783990949666 -34.668870385692898,-58.49108022238542 -34.66869946740654,-58.491605505881218 -34.668334474966031,-58.491682711038187 -34.668275300104092,-58.491991104453291 -34.668038811537862,-58.492320863130345 -34.667724709250628,-58.492896108191594 -34.667191455022561)));;3142;8_1_7;COMUNA 8;1;7;1451;645;806;80,02%;360;360;100,00%;0;0,00%;460;32;6,96%;428;93,04%
MULTIPOLYGON (((-58.491761701957238 -34.666007472950767,-58.491135093259786 -34.66538978680282,-58.491000037831782 -34.665263406289831,-58.489869942032705 -34.666154392115239,-58.488710848668745 -34.667068261479933,-58.488622138363276 -34.667136521673669,-58.487369185956247 -34.668101737484129,-58.487483349193056 -34.668201364920399,-58.488169785221281 -34.668805042606046,-58.488887693200688 -34.669436386409423,-58.490130246630557 -34.668463974250706,-58.490173303376572 -34.668498542956087,-58.490565384986525 -34.667945622081419,-58.490573207494222 -34.66788780182155,-58.491211955747616 -34.667322990860342,-58.492188377483409 -34.666447030443436,-58.491935390087406 -34.666186450423467,-58.491761701957238 -34.666007472950767)));;3143;8_1_8;COMUNA 8;1;8;1183;581;602;96,51%;384;384;100,00%;0;0,00%;374;76;20,32%;298;79,68%
MULTIPOLYGON (((-58.488361633998714 -34.674257259923323,-58.48841301995855 -34.674204501238293,-58.488362080599757 -34.674255202174713,-58.488361633998714 -34.674257259923323)),((-58.488887693200688 -34.669436386409423,-58.488789436426281 -34.669513310954059,-58.488272017605709 -34.670016321418274,-58.487801801874085 -34.670473473639632,-58.487710621318527 -34.670562015873912,-58.487337104155742 -34.670871607240244,-58.486280452197434 -34.671747191613591,-58.485334312654693 -34.672531124100509,-58.485514985080989 -34.672690390401591,-58.485885970308509 -34.673029906822499,-58.486450681993745 -34.673546783529808,-58.486629996261662 -34.673710907697817,-58.487220120124611 -34.674228339184857,-58.487855187237798 -34.674785266574737,-58.48791800461175 -34.674718710716419,-58.488005267401903 -34.674628549803806,-58.488097981501475 -34.674524866267092,-58.488217966550351 -34.674398641244302,-58.488362080599757 -34.674255202174713,-58.488497319443141 -34.673632074076714,-58.48859247399799 -34.673705083986881,-58.488598688980474 -34.673680011586875,-58.48866092978956 -34.673721548732864,-58.488718482890761 -34.673492516371113,-58.488776105711963 -34.67321496155639,-58.488814747592706 -34.673028539929547,-58.48888455909762 -34.672749785216197,-58.488917633320021 -34.672749989380776,-58.48914304475133 -34.67177083029059,-58.489162368584985 -34.671688992940041,-58.489181096631505 -34.671610113539792,-58.489202037958776 -34.671521937632882,-58.489232003818756 -34.671399251797602,-58.489280779811594 -34.671188672189253,-58.489361051644622 -34.67084378631376,-58.489396633122482 -34.670690605424184,-58.489427447385737 -34.670557285251412,-58.489468050681552 -34.670381989965058,-58.489551810366763 -34.670020271715536,-58.489641620086495 -34.669917995637,-58.489672209864231 -34.669883128782573,-58.489731158882627 -34.669769591551514,-58.489486113851534 -34.669563442914267,-58.489495393495098 -34.669527876538261,-58.489375428315014 -34.669423745114905,-58.489882532852938 -34.66895122600215,-58.489953148381609 -34.668806417594531,-58.490026925836773 -34.668687031656475,-58.490173303376572 -34.668498542956087,-58.490130246630557 -34.668463974250706,-58.488887693200688 -34.669436386409423)));;3144;8_1_9;COMUNA 8;1;9;2671;1325;1346;98,44%;629;629;100,00%;0;0,00%;810;183;22,59%;627;77,41%
MULTIPOLYGON (((-58.466490701232189 -34.689370208057262,-58.466604518765358 -34.689281117847237,-58.466904961800878 -34.68904638397678,-58.467099600922026 -34.688894331242771,-58.467582742787165 -34.688516909502091,-58.468058122137897 -34.688145542647135,-58.468672119100738 -34.687665925173661,-58.468761805361751 -34.687595707796149,-58.468811337351077 -34.687556971999825,-58.469562836792235 -34.686968819283422,-58.46909278235762 -34.686562778718823,-58.468943762807548 -34.68668793030804,-58.468609790657787 -34.686397658261299,-58.467402352109673 -34.687310197595444,-58.467011001955754 -34.686967457346157,-58.466896666931163 -34.686867318080118,-58.466484688192132 -34.686511196219605,-58.466937383824217 -34.686160327769834,-58.466835244137869 -34.686110189219093,-58.466418014020249 -34.686435844339044,-58.465777157878911 -34.68693594468656,-58.464682731347317 -34.687790001990685,-58.46410775836658 -34.688238682682929,-58.463585468813868 -34.688646302943518,-58.463680192504633 -34.688728980241734,-58.464353409696983 -34.689317015093977,-58.465395568004716 -34.690227229259555,-58.465878043261533 -34.689849673524904,-58.466423689444426 -34.689422605729568,-58.466490701232189 -34.689370208057262)));;3145;8_10_1;COMUNA 8;10;1;876;424;452;93,81%;257;257;100,00%;0;0,00%;278;5;1,80%;273;98,20%
MULTIPOLYGON (((-58.470515601821255 -34.686223955208362,-58.471096152697484 -34.685770314060157,-58.471213370347513 -34.685678683987007,-58.471741144844152 -34.685265185223983,-58.472129108178358 -34.684961204758821,-58.472301905206528 -34.684829145792435,-58.472376411496839 -34.684772166677817,-58.471241051847045 -34.683758564705407,-58.470627682662794 -34.683210916590866,-58.470467419139339 -34.683348676786792,-58.470422401733387 -34.683310580115915,-58.469938620979384 -34.683688154319668,-58.469632067940715 -34.6839274033739,-58.46929908591855 -34.684187287390486,-58.468236189291375 -34.685016867633429,-58.468036019987849 -34.685173077551873,-58.467605244233418 -34.685509301014989,-58.466835244137869 -34.686110189219093,-58.466937383824217 -34.686160327769834,-58.466484688192132 -34.686511196219605,-58.466896666931163 -34.686867318080118,-58.467011001955754 -34.686967457346157,-58.467402352109673 -34.687310197595444,-58.468609790657787 -34.686397658261299,-58.468943762807548 -34.68668793030804,-58.46909278235762 -34.686562778718823,-58.469562836792235 -34.686968819283422,-58.469808787500142 -34.686776265338082,-58.469929247530509 -34.686682101053272,-58.470038368914963 -34.686596881208956,-58.470515601821255 -34.686223955208362)));;3146;8_10_2;COMUNA 8;10;2;759;372;387;96,12%;233;232;99,57%;1;0,43%;237;8;3,38%;229;96,62%
MULTIPOLYGON (((-58.467021206058043 -34.681529577183156,-58.466385683583226 -34.682178698733097,-58.466551845361352 -34.682285949781843,-58.466500952004317 -34.682337501955544,-58.466642386784741 -34.682356019049742,-58.467550674090255 -34.682474932902359,-58.468050154658911 -34.683572192645762,-58.468280544296434 -34.684078251095755,-58.467588576529621 -34.684780621954957,-58.468036019987849 -34.685173077551873,-58.468236189291375 -34.685016867633429,-58.46929908591855 -34.684187287390486,-58.469632067940715 -34.6839274033739,-58.469938620979384 -34.683688154319668,-58.470422401733387 -34.683310580115915,-58.470467419139339 -34.683348676786792,-58.470627682662794 -34.683210916590866,-58.470595113104025 -34.683181833479736,-58.470228328089867 -34.682905370979469,-58.469115284344234 -34.682066258896974,-58.468188622873555 -34.681232198833207,-58.467465057283562 -34.680582635519151,-58.467080041833299 -34.680140737437021,-58.467044828701184 -34.680049257518718,-58.467014056893177 -34.680116725100667,-58.46697603898091 -34.680188488811353,-58.466931284851498 -34.680233280233331,-58.466881074089493 -34.68026694478521,-58.466780736204981 -34.680303920947118,-58.466723704488963 -34.680320754252534,-58.466667865083842 -34.68031300940919,-58.466471952076354 -34.680147095958631,-58.466293943019998 -34.679996252464676,-58.466160265391231 -34.679864844566907,-58.466117558880534 -34.679955481861342,-58.466089088234881 -34.680026047815986,-58.4660321457295 -34.680140488889691,-58.46593914100427 -34.680225211840217,-58.465722266920032 -34.680301627784502,-58.465798825713648 -34.680406839776765,-58.467021206058043 -34.681529577183156)));;3147;8_10_3;COMUNA 8;10;3;1009;448;561;79,86%;446;444;99,55%;2;0,45%;380;0;0,00%;380;100,00%
MULTIPOLYGON (((-58.465930751046557 -34.683702904267051,-58.466511077594909 -34.683773452619839,-58.466754916920806 -34.684039225930967,-58.466720656778776 -34.684288810653342,-58.466556005986078 -34.685602510003463,-58.466478529302584 -34.686062171467427,-58.466835244137869 -34.686110189219093,-58.467605244233418 -34.685509301014989,-58.468036019987849 -34.685173077551873,-58.467588576529621 -34.684780621954957,-58.468280544296434 -34.684078251095755,-58.468050154658911 -34.683572192645762,-58.467550674090255 -34.682474932902359,-58.466642386784741 -34.682356019049742,-58.466500952004317 -34.682337501955544,-58.46523882780582 -34.68361883406628,-58.465387766808114 -34.683636929910165,-58.465930751046557 -34.683702904267051)));;3148;8_10_4;COMUNA 8;10;4;2202;1020;1182;86,29%;830;830;100,00%;0;0,00%;719;7;0,97%;712;99,03%
MULTIPOLYGON (((-58.465387766808114 -34.683636929910165,-58.46523882780582 -34.68361883406628,-58.46501973156866 -34.683836519845016,-58.464666958645012 -34.684187168461918,-58.464576164745004 -34.684277383372994,-58.4645478618122 -34.684347526369471,-58.464569689781058 -34.684472106552569,-58.464695446891525 -34.684740561829223,-58.465239346814506 -34.685897269270129,-58.466478529302584 -34.686062171467427,-58.466556005986078 -34.685602510003463,-58.466720656778776 -34.684288810653342,-58.466754916920806 -34.684039225930967,-58.466511077594909 -34.683773452619839,-58.465930751046557 -34.683702904267051,-58.465387766808114 -34.683636929910165)));;3149;8_10_5;COMUNA 8;10;5;2401;1105;1296;85,26%;958;958;100,00%;0;0,00%;842;7;0,83%;835;99,17%
MULTIPOLYGON (((-58.465798825713648 -34.680406839776765,-58.465656801208837 -34.680487549559111,-58.46503934355885 -34.680931940323752,-58.464603973800578 -34.681256040522868,-58.464298778174033 -34.68148323368424,-58.463519243006274 -34.682063537570158,-58.462562193574911 -34.682780516930869,-58.463863163217233 -34.682974965829814,-58.46393605503976 -34.683000106579136,-58.463979790513953 -34.683038557782531,-58.464011249805459 -34.683092643291808,-58.464435318758937 -34.684010618350982,-58.464490395551941 -34.68412991625754,-58.464524325915932 -34.684090548591143,-58.464666958645012 -34.684187168461918,-58.46501973156866 -34.683836519845016,-58.46523882780582 -34.68361883406628,-58.466500952004317 -34.682337501955544,-58.466551845361352 -34.682285949781843,-58.466385683583226 -34.682178698733097,-58.467021206058043 -34.681529577183156,-58.465798825713648 -34.680406839776765)));;3150;8_10_6;COMUNA 8;10;6;1601;732;869;84,23%;655;655;100,00%;0;0,00%;579;7;1,21%;572;98,79%
MULTIPOLYGON (((-58.464435318758937 -34.684010618350982,-58.464011249805459 -34.683092643291808,-58.463979790513953 -34.683038557782531,-58.46393605503976 -34.683000106579136,-58.463863163217233 -34.682974965829814,-58.462562193574911 -34.682780516930869,-58.460287517240445 -34.684468998350162,-58.461225401612126 -34.684607256124693,-58.462059278155273 -34.684730153689138,-58.462124753881398 -34.684741703593772,-58.462188694882371 -34.684778254067631,-58.462346926727712 -34.685118403774595,-58.462491434664813 -34.685073543858948,-58.462755641275422 -34.685689192807729,-58.462711990265632 -34.685903493794335,-58.462836208934526 -34.686175753835258,-58.462892478468788 -34.686299066601691,-58.462975433726754 -34.686486606185866,-58.463345786143421 -34.686108919596826,-58.463241943397996 -34.686034059134791,-58.463738810635327 -34.685518902566308,-58.463854418440945 -34.685590170863939,-58.464216237486809 -34.685221143837815,-58.464244627026247 -34.685192692084016,-58.464695446891525 -34.684740561829223,-58.464569689781058 -34.684472106552569,-58.4645478618122 -34.684347526369471,-58.464576164745004 -34.684277383372994,-58.464666958645012 -34.684187168461918,-58.464524325915932 -34.684090548591143,-58.464490395551941 -34.68412991625754,-58.464435318758937 -34.684010618350982)));;3151;8_10_7;COMUNA 8;10;7;1627;739;888;83,22%;644;644;100,00%;0;0,00%;543;8;1,47%;535;98,53%
MULTIPOLYGON (((-58.464361279086773 -34.677788843695197,-58.464296404323882 -34.677728631753972,-58.463918240569875 -34.677414332294376,-58.463184341653822 -34.676804251323411,-58.462361456756241 -34.67612155814767,-58.461978704372164 -34.675803942630402,-58.461197267763474 -34.675155608813235,-58.4610855131858 -34.675062576794765,-58.460978362006777 -34.674973347653442,-58.460685289156999 -34.67500179460712,-58.460609763782223 -34.674934819760381,-58.460667309488372 -34.674714322028272,-58.460320542277813 -34.674427829400159,-58.459963377730254 -34.674139645354146,-58.45961149909202 -34.673896743259654,-58.459425157913195 -34.673848849816515,-58.45900363143037 -34.673755877578643,-58.458698542664656 -34.673787699767111,-58.45845073540309 -34.673860228494938,-58.458419791155187 -34.673874664410661,-58.458354919022248 -34.673904874175356,-58.457936012350956 -34.674225078178331,-58.457727154699775 -34.674382116197577,-58.455051397144722 -34.676482806869942,-58.453825194822883 -34.677437748319377,-58.453519300570179 -34.677675971203705,-58.453085180078823 -34.678014044970332,-58.452930099653216 -34.678134810370516,-58.451478424671329 -34.679276122844968,-58.450939759303836 -34.679699674329129,-58.450775804055191 -34.67983839429764,-58.450712192467826 -34.67994339070713,-58.450641165406026 -34.680038386096207,-58.450824253640846 -34.680242071172671,-58.451197857845983 -34.680589932645226,-58.451373281569886 -34.680753263030553,-58.451731121758108 -34.681079360265954,-58.451791557580684 -34.681134930460431,-58.452171733975597 -34.68148469094173,-58.452657955271469 -34.681931926215974,-58.452813608563659 -34.682075111516625,-58.453298472846335 -34.682521217294514,-58.454023477416087 -34.683188118544656,-58.454660945474949 -34.683774514731468,-58.455423395676227 -34.684475847445896,-58.456226439726379 -34.68518471286859,-58.456312714053404 -34.685238873668936,-58.456469747260897 -34.685337405322301,-58.456905209473739 -34.685671519432248,-58.457000264829482 -34.68574441300786,-58.457507679506328 -34.686209024403233,-58.457774347208577 -34.686454534364337,-58.45779046472871 -34.686386786898929,-58.457811782857696 -34.686319321336271,-58.457872148096762 -34.686257702533844,-58.459189914252484 -34.685277794247959,-58.459280287628452 -34.685216316446521,-58.459354206367877 -34.685160119945735,-58.45996192164867 -34.684710124130014,-58.460287517240445 -34.684468998350162,-58.462562193574911 -34.682780516930869,-58.463519243006274 -34.682063537570158,-58.464298778174033 -34.68148323368424,-58.464603973800578 -34.681256040522868,-58.46503934355885 -34.680931940323752,-58.465656801208837 -34.680487549559111,-58.465798825713648 -34.680406839776765,-58.465722266920032 -34.680301627784502,-58.46593914100427 -34.680225211840217,-58.4660321457295 -34.680140488889691,-58.466089088234881 -34.680026047815986,-58.466117558880534 -34.679955481861342,-58.466160265391231 -34.679864844566907,-58.465884300849496 -34.679593366357423,-58.465837838044024 -34.679547662181271,-58.465459998525866 -34.679152943016689,-58.465111827432032 -34.678697657151709,-58.465055134888686 -34.678623149322796,-58.464625468542138 -34.678065114474649,-58.464484464674072 -34.677903351924378,-58.464361279086773 -34.677788843695197)));;3152;8_10_8;COMUNA 8;10;8;1196;579;617;93,84%;369;369;100,00%;0;0,00%;320;9;2,81%;311;97,19%
MULTIPOLYGON (((-58.463854418440945 -34.685590170863939,-58.463738810635327 -34.685518902566308,-58.463241943397996 -34.686034059134791,-58.463345786143421 -34.686108919596826,-58.462975433726754 -34.686486606185866,-58.46301976762998 -34.686588016976636,-58.463477692016269 -34.687634871075986,-58.464301797245746 -34.687740992334305,-58.464682731347317 -34.687790001990685,-58.465777157878911 -34.68693594468656,-58.466418014020249 -34.686435844339044,-58.466835244137869 -34.686110189219093,-58.466478529302584 -34.686062171467427,-58.465239346814506 -34.685897269270129,-58.464695446891525 -34.684740561829223,-58.464244627026247 -34.685192692084016,-58.464216237486809 -34.685221143837815,-58.463854418440945 -34.685590170863939)));;3153;8_11_1;COMUNA 8;11;1;2885;1326;1559;85,05%;910;910;100,00%;0;0,00%;910;17;1,87%;893;98,13%
MULTIPOLYGON (((-58.462975433726754 -34.686486606185866,-58.462955227938821 -34.686507240530972,-58.462680274765283 -34.686786191188119,-58.462574044301022 -34.686893940199475,-58.462197887345511 -34.68727556812776,-58.461290560738256 -34.688195935164238,-58.460928801373854 -34.688548614908647,-58.460893673571988 -34.688601432551984,-58.460732622012884 -34.688493681014094,-58.460694425128366 -34.688532484132658,-58.460538567894709 -34.688688259824026,-58.460409484347799 -34.688739103746265,-58.460243399588194 -34.688742480873934,-58.460078082137883 -34.688746139488615,-58.460641461287679 -34.68926334568139,-58.461002017390491 -34.689594344987114,-58.461795609011659 -34.690322891765682,-58.462037236037645 -34.690544729518798,-58.462691954561194 -34.69114580174471,-58.463396049714227 -34.691792152866611,-58.464095361061439 -34.691244810156576,-58.465262138397293 -34.690331671214466,-58.465395568004716 -34.690227229259555,-58.464353409696983 -34.689317015093977,-58.463680192504633 -34.688728980241734,-58.463585468813868 -34.688646302943518,-58.46410775836658 -34.688238682682929,-58.464682731347317 -34.687790001990685,-58.464301797245746 -34.687740992334305,-58.463477692016269 -34.687634871075986,-58.46301976762998 -34.686588016976636,-58.462975433726754 -34.686486606185866)));;3154;8_11_2;COMUNA 8;11;2;2048;912;1136;80,28%;817;817;100,00%;0;0,00%;718;5;0,70%;713;99,30%
MULTIPOLYGON (((-58.461225401612126 -34.684607256124693,-58.460287517240445 -34.684468998350162,-58.45996192164867 -34.684710124130014,-58.459354206367877 -34.685160119945735,-58.459280287628452 -34.685216316446521,-58.459738861412582 -34.685646127636645,-58.460324313807966 -34.68564029524147,-58.460796959121382 -34.686222993719291,-58.461191951365151 -34.686281240091908,-58.461142583461118 -34.686514273271442,-58.461070875657015 -34.686863858229991,-58.462027374520382 -34.68699056045314,-58.460760677368967 -34.688270436705089,-58.460930682521656 -34.688292341222535,-58.460732622012884 -34.688493681014094,-58.460893673571988 -34.688601432551984,-58.460928801373854 -34.688548614908647,-58.461290560738256 -34.688195935164238,-58.462197887345511 -34.68727556812776,-58.462574044301022 -34.686893940199475,-58.462680274765283 -34.686786191188119,-58.462955227938821 -34.686507240530972,-58.462975433726754 -34.686486606185866,-58.462892478468788 -34.686299066601691,-58.462836208934526 -34.686175753835258,-58.462711990265632 -34.685903493794335,-58.462755641275422 -34.685689192807729,-58.462491434664813 -34.685073543858948,-58.462346926727712 -34.685118403774595,-58.462188694882371 -34.684778254067631,-58.462124753881398 -34.684741703593772,-58.462059278155273 -34.684730153689138,-58.461225401612126 -34.684607256124693)));;3155;8_11_3;COMUNA 8;11;3;2969;1330;1639;81,15%;1118;1118;100,00%;0;0,00%;1057;5;0,47%;1052;99,53%
MULTIPOLYGON (((-58.462027374520382 -34.68699056045314,-58.461070875657015 -34.686863858229991,-58.461142583461118 -34.686514273271442,-58.461191951365151 -34.686281240091908,-58.460796959121382 -34.686222993719291,-58.460324313807966 -34.68564029524147,-58.459738861412582 -34.685646127636645,-58.459118939032919 -34.686267816208641,-58.459081934946788 -34.686331056081656,-58.459077072458399 -34.686396761750714,-58.459317560139979 -34.686922133447254,-58.459361038118217 -34.687001714026522,-58.459388914897673 -34.687060800715706,-58.459526423865981 -34.687352431100429,-58.459884650764927 -34.688112176403891,-58.45991798555248 -34.688149713276978,-58.459969481045668 -34.688168517707375,-58.460760677368967 -34.688270436705089,-58.462027374520382 -34.68699056045314)));;3156;8_11_4;COMUNA 8;11;4;1915;896;1019;87,93%;711;711;100,00%;0;0,00%;643;6;0,93%;637;99,07%
MULTIPOLYGON (((-58.459738861412582 -34.685646127636645,-58.459280287628452 -34.685216316446521,-58.459189914252484 -34.685277794247959,-58.457872148096762 -34.686257702533844,-58.457811782857696 -34.686319321336271,-58.45779046472871 -34.686386786898929,-58.457774347208577 -34.686454534364337,-58.458288163894835 -34.686936819197186,-58.458364720334949 -34.687023936717068,-58.45838322007387 -34.687045064642582,-58.45849720256286 -34.687174860479807,-58.45861851580495 -34.687340431960344,-58.458776914942732 -34.687542695535697,-58.459006504550118 -34.687762285435063,-58.459399359392151 -34.68812300955738,-58.459461936847696 -34.688180406972577,-58.460078082137883 -34.688746139488615,-58.460243399588194 -34.688742480873934,-58.460409484347799 -34.688739103746265,-58.460538567894709 -34.688688259824026,-58.460694425128366 -34.688532484132658,-58.460732622012884 -34.688493681014094,-58.460930682521656 -34.688292341222535,-58.460760677368967 -34.688270436705089,-58.459969481045668 -34.688168517707375,-58.45991798555248 -34.688149713276978,-58.459884650764927 -34.688112176403891,-58.459526423865981 -34.687352431100429,-58.459388914897673 -34.687060800715706,-58.459361038118217 -34.687001714026522,-58.459317560139979 -34.686922133447254,-58.459077072458399 -34.686396761750714,-58.459081934946788 -34.686331056081656,-58.459118939032919 -34.686267816208641,-58.459738861412582 -34.685646127636645)));;3157;8_11_5;COMUNA 8;11;5;1290;566;724;78,18%;498;498;100,00%;0;0,00%;449;6;1,34%;443;98,66%
MULTIPOLYGON (((-58.475212060927582 -34.691458547090797,-58.474453474342141 -34.690771353016345,-58.47327050452563 -34.691667186513428,-58.472083843227367 -34.692565825649716,-58.472847116325973 -34.693254794485014,-58.473606735280512 -34.693940519277149,-58.474337116163746 -34.694592861008438,-58.474346079361794 -34.694586109978914,-58.474586315590393 -34.694794987088834,-58.475067613193488 -34.695213454139704,-58.477426779865738 -34.693431984633811,-58.4770061425492 -34.693068375512922,-58.476703336657046 -34.692806619857869,-58.476707013105965 -34.692803838214722,-58.475974071060563 -34.692148905079442,-58.475212060927582 -34.691458547090797)));;3158;8_12_1;COMUNA 8;12;1;915;427;488;87,50%;354;354;100,00%;0;0,00%;306;10;3,27%;296;96,73%
MULTIPOLYGON (((-58.4705612573309 -34.69119125350683,-58.470659998794901 -34.691280615383306,-58.471322970348787 -34.691879034934743,-58.472083843227367 -34.692565825649716,-58.47327050452563 -34.691667186513428,-58.474453474342141 -34.690771353016345,-58.473694388667731 -34.690083661217081,-58.472934036505755 -34.689394767506066,-58.472173611683225 -34.688705868978083,-58.471130803210642 -34.689494907947385,-58.470987492236077 -34.689603441469131,-58.469800324208151 -34.690502833376563,-58.4705612573309 -34.69119125350683)));;3159;8_12_2;COMUNA 8;12;2;1004;461;543;84,90%;378;378;100,00%;0;0,00%;356;3;0,84%;353;99,16%
MULTIPOLYGON (((-58.470649901709692 -34.687334677515913,-58.469929247530509 -34.686682101053272,-58.469808787500142 -34.686776265338082,-58.469562836792235 -34.686968819283422,-58.468811337351077 -34.687556971999825,-58.468761805361751 -34.687595707796149,-58.468672119100738 -34.687665925173661,-58.468058122137897 -34.688145542647135,-58.467582742787165 -34.688516909502091,-58.468279518941479 -34.689126964518039,-58.469040085814939 -34.689815042198454,-58.469800324208151 -34.690502833376563,-58.470987492236077 -34.689603441469131,-58.471130803210642 -34.689494907947385,-58.472173611683225 -34.688705868978083,-58.471558237860371 -34.688148296336053,-58.471411153540636 -34.688019641892332,-58.471270720417657 -34.68789683201107,-58.470649901709692 -34.687334677515913)));;3160;8_12_3;COMUNA 8;12;3;1003;488;515;94,76%;361;361;100,00%;0;0,00%;331;13;3,93%;318;96,07%
MULTIPOLYGON (((-58.466661242395205 -34.691616241313085,-58.467425484815408 -34.692302004670459,-58.468609208670735 -34.691405242020103,-58.469800324208151 -34.690502833376563,-58.469040085814939 -34.689815042198454,-58.468279518941479 -34.689126964518039,-58.467582742787165 -34.688516909502091,-58.467099600922026 -34.688894331242771,-58.466904961800878 -34.68904638397678,-58.466604518765358 -34.689281117847237,-58.466490701232189 -34.689370208057262,-58.466423689444426 -34.689422605729568,-58.465878043261533 -34.689849673524904,-58.465395568004716 -34.690227229259555,-58.465262138397293 -34.690331671214466,-58.464095361061439 -34.691244810156576,-58.463396049714227 -34.691792152866611,-58.464014294869415 -34.692359696164615,-58.464766841322337 -34.693050546775339,-58.465483718544711 -34.692507773483769,-58.466661242395205 -34.691616241313085)));;3161;8_12_4;COMUNA 8;12;4;979;488;491;99,39%;270;270;100,00%;0;0,00%;302;12;3,97%;290;96,03%
MULTIPOLYGON (((-58.468609208670735 -34.691405242020103,-58.467425484815408 -34.692302004670459,-58.468189142961201 -34.692987199790714,-58.468301100603284 -34.693087689973268,-58.468953154814002 -34.69367323511986,-58.469605900379868 -34.694259410499079,-58.469717435135287 -34.694360040231572,-58.470896644742538 -34.693464946106502,-58.471021120600355 -34.693370498878586,-58.472083843227367 -34.692565825649716,-58.471322970348787 -34.691879034934743,-58.470659998794901 -34.691280615383306,-58.4705612573309 -34.69119125350683,-58.469800324208151 -34.690502833376563,-58.468609208670735 -34.691405242020103)));;3162;8_12_5;COMUNA 8;12;5;978;475;503;94,43%;397;397;100,00%;0;0,00%;341;5;1,47%;336;98,53%
MULTIPOLYGON (((-58.470143169092658 -34.698140966555201,-58.470630678017159 -34.698563570033656,-58.472695665422222 -34.697004451483366,-58.475067613193488 -34.695213454139704,-58.474586315590393 -34.694794987088834,-58.474346079361794 -34.694586109978914,-58.474337116163746 -34.694592861008438,-58.473606735280512 -34.693940519277149,-58.472847116325973 -34.693254794485014,-58.472083843227367 -34.692565825649716,-58.471021120600355 -34.693370498878586,-58.470896644742538 -34.693464946106502,-58.469717435135287 -34.694360040231572,-58.470475247659877 -34.695044235191816,-58.469293965208735 -34.695945452020247,-58.470053920319472 -34.696628945064369,-58.469297475533786 -34.697201325147475,-58.470015402476712 -34.697858270670849,-58.469912953568127 -34.697941399038918,-58.470143169092658 -34.698140966555201)));;3163;8_12_6;COMUNA 8;12;6;744;349;395;88,35%;285;284;99,65%;1;0,35%;249;8;3,21%;241;96,79%
MULTIPOLYGON (((-58.468953154814002 -34.69367323511986,-58.468301100603284 -34.693087689973268,-58.468189142961201 -34.692987199790714,-58.467425484815408 -34.692302004670459,-58.466661242395205 -34.691616241313085,-58.465483718544711 -34.692507773483769,-58.464766841322337 -34.693050546775339,-58.464014294869415 -34.692359696164615,-58.463396049714227 -34.691792152866611,-58.462691954561194 -34.69114580174471,-58.462037236037645 -34.690544729518798,-58.461795609011659 -34.690322891765682,-58.461002017390491 -34.689594344987114,-58.460641461287679 -34.68926334568139,-58.460078082137883 -34.688746139488615,-58.459461936847696 -34.688180406972577,-58.459399359392151 -34.68812300955738,-58.459006504550118 -34.687762285435063,-58.458776914942732 -34.687542695535697,-58.45861851580495 -34.687340431960344,-58.45849720256286 -34.687174860479807,-58.45838322007387 -34.687045064642582,-58.458364720334949 -34.687023936717068,-58.458288163894835 -34.686936819197186,-58.457774347208577 -34.686454534364337,-58.457507679506328 -34.686209024403233,-58.457000264829482 -34.68574441300786,-58.456905209473739 -34.685671519432248,-58.456469747260897 -34.685337405322301,-58.456312714053404 -34.685238873668936,-58.456226439726379 -34.68518471286859,-58.455423395676227 -34.684475847445896,-58.454660945474949 -34.683774514731468,-58.454023477416087 -34.683188118544656,-58.453298472846335 -34.682521217294514,-58.452813608563659 -34.682075111516625,-58.452657955271469 -34.681931926215974,-58.452171733975597 -34.68148469094173,-58.451791557580684 -34.681134930460431,-58.451731121758108 -34.681079360265954,-58.451373281569886 -34.680753263030553,-58.451197857845983 -34.680589932645226,-58.451163657621507 -34.680695847565076,-58.451115561428367 -34.680801620305026,-58.45104761042144 -34.680844572651779,-58.450931492979009 -34.680884280801685,-58.450808049272041 -34.680885959004151,-58.450318861798095 -34.6804284340257,-58.450133270405018 -34.680434753220766,-58.449935052672046 -34.680501213168093,-58.449783289630851 -34.68061028442753,-58.449295678806948 -34.680994325919478,-58.444519600153946 -34.684755560712659,-58.444295340477716 -34.684932151084531,-58.444295301575792 -34.68493215038216,-58.444181921547191 -34.685020233011855,-58.444253533085735 -34.685078063814366,-58.444283022252449 -34.685119477733188,-58.444359732173865 -34.685209702764197,-58.444398090691699 -34.685238934593464,-58.444474798193681 -34.685341272520631,-58.44454255988034 -34.685416847851613,-58.444592755835266 -34.685506998354704,-58.444654628770735 -34.685611798808097,-58.444771149097193 -34.685725128612475,-58.444853741732317 -34.685820213461696,-58.44490386396739 -34.685859165396224,-58.444954062128573 -34.685942062047545,-58.444968798987887 -34.686000516312127,-58.445072037071647 -34.686034687043509,-58.445116261902001 -34.686144343972437,-58.445257848768641 -34.686258874127539,-58.445346330281261 -34.686329592691543,-58.445400879045003 -34.686403898015151,-58.445442130630873 -34.686464820826743,-58.445471609267955 -34.686562292137786,-58.445530585359769 -34.686667091719166,-58.445613184312926 -34.686740203679868,-58.445716413627352 -34.686823107428324,-58.445810859197827 -34.686918122838961,-58.445891920315098 -34.687009544694284,-58.445983379840271 -34.687116742947985,-58.446021730995085 -34.687189918974049,-58.446104321173983 -34.687311764158764,-58.446201669396288 -34.687392201839842,-58.446269524882013 -34.687440944569211,-58.446325526745284 -34.687504263482744,-58.446378627521575 -34.687579835796136,-58.446439052715128 -34.687695621293223,-58.446557029434537 -34.68780042821605,-58.446642609746753 -34.687897906640387,-58.446713355315396 -34.687995383058194,-58.446778303950623 -34.688090393828702,-58.446846063928376 -34.688197658742347,-58.446916901263855 -34.688263444152774,-58.44699208482696 -34.688340216258879,-58.447051073266046 -34.688396281520781,-58.447124805167498 -34.68848643395728,-58.447186768308676 -34.688593697933705,-58.447269373793752 -34.68864976609138,-58.447328359944606 -34.688720409027361,-58.447431588513233 -34.688830072495769,-58.447474377675007 -34.688889797576742,-58.447530383640903 -34.688941002958806,-58.44758348554592 -34.68902143400009,-58.447607090000609 -34.689089677980476,-58.44765132861653 -34.689150600387762,-58.4477309557141 -34.689179836238168,-58.447769314188037 -34.689226109645105,-58.447757537852333 -34.689284630714695,-58.44781653925029 -34.689274919394016,-58.447869650776305 -34.689304151912367,-58.447860774649591 -34.68935527880285,-58.447872530052173 -34.689413802745129,-58.447946270231142 -34.689467404510815,-58.448062800866495 -34.689578336676497,-58.448104140816397 -34.689641652989216,-58.448183765555981 -34.689688001621406,-58.44823686856985 -34.689768432368403,-58.448295852956811 -34.689858582325542,-58.448413838436338 -34.689943879913507,-58.44845807100527 -34.6900462114451,-58.44848755610677 -34.690133963432174,-58.448543657511301 -34.690133969961352,-58.448609975509029 -34.690220528978919,-58.448660102155607 -34.690259479341712,-58.448701441653967 -34.690330189984849,-58.448763321725686 -34.690444706809721,-58.44879877351682 -34.690544642782534,-58.448896130152406 -34.690612894886179,-58.448963907399857 -34.690644593428125,-58.449052481205541 -34.690720098106809,-58.449109930251808 -34.690823698503507,-58.449160135613063 -34.690906522932558,-58.449189624529431 -34.690977232085565,-58.449263366943825 -34.691030833041118,-58.449334124509519 -34.691089363317033,-58.449369498254654 -34.691150284108474,-58.449440340494611 -34.69121360317515,-58.449481595488329 -34.691286707955641,-58.449552439455445 -34.6913403788434,-58.449618758711885 -34.691431726139399,-58.449704345964612 -34.691531667203627,-58.44976631849196 -34.691614563051786,-58.449822328467775 -34.691660837666305,-58.449875432827199 -34.69175098620989,-58.449940305728546 -34.691826558157764,-58.450014044544922 -34.691911849529177,-58.450073033854586 -34.691992280059715,-58.450130575104353 -34.692064189086643,-58.450201335631284 -34.69211292988998,-58.45023381517256 -34.692149483360822,-58.450269190396249 -34.692207939034866,-58.45027805479436 -34.692227447433517,-58.45035767960487 -34.692298161388479,-58.450399021570526 -34.692368801008506,-58.450484527614734 -34.692454093274883,-58.450499270940583 -34.692502828274669,-58.450552380841508 -34.69256375048306,-58.450623222700756 -34.692644181919597,-58.450757399639933 -34.692833072747213,-58.450878371226061 -34.692952523919047,-58.450975728952002 -34.693045141094387,-58.451034715213517 -34.693159656437089,-58.451146822624345 -34.693261993417231,-58.451199932130628 -34.693332704293631,-58.451273674242515 -34.6934131356157,-58.451376912842285 -34.69353011977222,-58.451516978121191 -34.693704362059719,-58.451567194465262 -34.693736057525577,-58.451593700893739 -34.693816413900549,-58.451661565100608 -34.693862759157199,-58.451714680267024 -34.693896849245078,-58.451747156670756 -34.693967558014144,-58.451783984661198 -34.694015097618774,-58.451819365279789 -34.694046721225249,-58.451840078180048 -34.694095527007178,-58.451901974238936 -34.694141801171746,-58.451949201377047 -34.694214905611183,-58.452031815974308 -34.694268505645944,-58.452070177000991 -34.694331890728577,-58.452099664021382 -34.694446402955343,-58.452158657450092 -34.694524438022825,-58.452238289134783 -34.694570713546128,-58.452267783805944 -34.694626773691304,-58.452331215719006 -34.694669456134172,-58.452387223737873 -34.694759603786217,-58.452425587376908 -34.694805875686285,-58.452472821044317 -34.694832711256247,-58.452528835288824 -34.694874125337634,-58.452552450517281 -34.694900958902991,-58.452537692159865 -34.694961874552554,-58.452596690225235 -34.695008148116116,-58.452640935645469 -34.695069068654384,-58.452682283559106 -34.695117875986483,-58.45276190620357 -34.695246969944989,-58.452834200124919 -34.695343245609727,-58.452872565713875 -34.69537740441401,-58.452946314694422 -34.69542853825893,-58.452996441670706 -34.695508966618938,-58.453061319491624 -34.69559186096938,-58.453108552973923 -34.695625949974911,-58.453146914606066 -34.6956966588141,-58.453191163582886 -34.69573321239757,-58.453232428006352 -34.695772160153282,-58.45327667926415 -34.695789276646131,-58.453359303949021 -34.695774634788272,-58.453406625891624 -34.695782173787798,-58.453431861564233 -34.695810415784912,-58.453464259126278 -34.695843165463785,-58.453480456108842 -34.695875843485247,-58.453449840015701 -34.695924926781629,-58.453406520762762 -34.695959853852543,-58.453409415462623 -34.695998869038981,-58.453387327208304 -34.696036614684338,-58.453428594316811 -34.69605366046909,-58.453464061413392 -34.696087818862686,-58.453517089708782 -34.696155993422224,-58.453564322622746 -34.696199871201102,-58.453602686772285 -34.696253537252716,-58.453676433539265 -34.696336361503278,-58.453673446025974 -34.696365587292512,-58.453711815066022 -34.696375379081246,-58.453735430578696 -34.69640707167521,-58.453747193220707 -34.696446017078657,-58.453813611626764 -34.696488698956728,-58.453837224875464 -34.696542293431371,-58.45389324301803 -34.696564199393478,-58.453907991126087 -34.696593496891843,-58.453969973924615 -34.696654418210215,-58.453975854803033 -34.696678785376179,-58.454011238147046 -34.696703154648752,-58.454028970175983 -34.696737241184501,-58.454073221358769 -34.696761611069483,-58.454117467783462 -34.696832320006507,-58.454273830590914 -34.697005362968795,-58.454315178714289 -34.697071141942871,-58.454321058005561 -34.697112551725724,-58.454384493355526 -34.697150373819177,-58.454440508175722 -34.697211294485342,-58.45444936659311 -34.697306297211334,-58.454502483415212 -34.697357499124088,-58.454567368238258 -34.697398912847923,-58.454632248396358 -34.697489060019905,-58.454723732345094 -34.697579279324266,-58.454824083933879 -34.697674287971282,-58.454859464270434 -34.697737671948097,-58.454912581851652 -34.697786408834865,-58.454946513311938 -34.69784366579556,-58.455020267323988 -34.697877826156251,-58.455067415848795 -34.697931421861256,-58.455073379952474 -34.697982550133524,-58.45517365068504 -34.698038613953017,-58.455179529147088 -34.698094671901003,-58.455200162402647 -34.698114180648645,-58.455268032348776 -34.698158059021544,-58.455306397856567 -34.698218978202114,-58.455374262358696 -34.698326238204082,-58.455445114862364 -34.698394412969989,-58.455440678213122 -34.698424906340172,-58.455546826789323 -34.698556535254298,-58.455573426164214 -34.698610129549692,-58.455611792939131 -34.698661259680485,-58.455679580129669 -34.698683235922047,-58.45567957848214 -34.698702743396169,-58.45574454592699 -34.698795354805107,-58.455821198056888 -34.698856275996476,-58.455824178858194 -34.698900150374328,-58.455871413750657 -34.698953745764221,-58.455874310515185 -34.698982971924458,-58.455937748996043 -34.699008539406258,-58.455984983033424 -34.69907438854284,-58.456064615759239 -34.699188902474461,-58.456117733234422 -34.699259611139937,-58.456173836015942 -34.699320530993241,-58.456223971122363 -34.699366802293049,-58.456256367283352 -34.699449693159998,-58.456321340256231 -34.699486246678667,-58.456356723623372 -34.699534981992542,-58.456397991230176 -34.699576393495434,-58.456433460136665 -34.699622663947821,-58.45647327740766 -34.699675061507037,-58.456544048131448 -34.699723798568051,-58.456585398144362 -34.699806689794677,-58.456668020051303 -34.699877329265959,-58.456842041657616 -34.700096708763773,-58.4569836649164 -34.700262423343709,-58.457079589141017 -34.700344049309749,-58.457141492279177 -34.700397644870364,-58.457135604990945 -34.700451237322504,-58.457194609506999 -34.700497579043223,-58.457265466942893 -34.700541456421597,-58.457300851948567 -34.700580402506915,-58.457327365622909 -34.7006681520729,-58.457356866984568 -34.700707168305676,-58.457436594763955 -34.700721749558099,-58.457454242396473 -34.700777807879497,-58.457513247779019 -34.700816825340212,-58.45752799610311 -34.700875277944995,-58.45757821591608 -34.700958169195268,-58.457709446929371 -34.700991062680117,-58.457747814950615 -34.701061770009353,-58.457777312611917 -34.701168956634028,-58.457848171071646 -34.701210368826558,-58.457939576918903 -34.701307839337588,-58.458013417345995 -34.701398055425692,-58.45802518160113 -34.701456507849933,-58.458119574735896 -34.701512568988228,-58.458119573257264 -34.701539400555767,-58.458205185092297 -34.701566164887069,-58.458180110222486 -34.701655109548625,-58.45822726292333 -34.701708774422279,-58.458321742654789 -34.701747722358412,-58.458389531311333 -34.701803782326138,-58.458395496091093 -34.701886671653575,-58.458427896405844 -34.701949984021404,-58.458484004796823 -34.7019694934393,-58.458563646406084 -34.702030412977521,-58.458631520370574 -34.702093796912706,-58.458702293247264 -34.702166899424107,-58.458798221013737 -34.70225584811363,-58.458833605311803 -34.70234113276971,-58.45888672872389 -34.70237768452683,-58.458972337730792 -34.702492267107424,-58.459046097738991 -34.702521495322443,-58.459134606512272 -34.702633613031558,-58.459211263132289 -34.702731082133589,-58.459261486654214 -34.702792000362379,-58.45929832065795 -34.702893130327347,-58.459407551678503 -34.703005177984032,-58.459484209901362 -34.703078350613325,-58.459572721602264 -34.703144128973776,-58.459628830797506 -34.703170961961249,-58.459675983789587 -34.703265965173749,-58.459761596094225 -34.703343926682095,-58.459761593940506 -34.703404843477188,-58.459853089885662 -34.703497453261384,-58.459957803832012 -34.703581541965036,-58.460064052272315 -34.703686335277673,-58.460108307404489 -34.703759436376956,-58.460182068198556 -34.70381303061469,-58.460235192419766 -34.703874018915307,-58.460235190974473 -34.703922752347211,-58.460246957365555 -34.703973880433317,-58.46032660350901 -34.7039885302096,-58.460418100859755 -34.704076280302523,-58.46058335987842 -34.704215159475687,-58.460712122061516 -34.704339530481583,-58.460872948886418 -34.704428267275588,-58.460945772479711 -34.704494185236001,-58.461084256705952 -34.704635105628718,-58.461231866199114 -34.704758067844836,-58.461279960672812 -34.704811097705111,-58.461332574730342 -34.704869268550453,-58.461715457199354 -34.705293084003394,-58.461752211483997 -34.705265971047652,-58.470630678017159 -34.698563570033656,-58.470143169092658 -34.698140966555201,-58.469912953568127 -34.697941399038918,-58.470015402476712 -34.697858270670849,-58.469297475533786 -34.697201325147475,-58.470053920319472 -34.696628945064369,-58.469293965208735 -34.695945452020247,-58.470475247659877 -34.695044235191816,-58.469717435135287 -34.694360040231572,-58.469605900379868 -34.694259410499079,-58.468953154814002 -34.69367323511986)));;3164;8_12_7;COMUNA 8;12;7;826;408;418;97,61%;272;272;100,00%;0;0,00%;278;11;3,96%;267;96,04%
MULTIPOLYGON (((-58.450318861798095 -34.6804284340257,-58.450808049272041 -34.680885959004151,-58.450931492979009 -34.680884280801685,-58.45104761042144 -34.680844572651779,-58.451115561428367 -34.680801620305026,-58.451163657621507 -34.680695847565076,-58.451197857845983 -34.680589932645226,-58.450824253640846 -34.680242071172671,-58.450641165406026 -34.680038386096207,-58.450712192467826 -34.67994339070713,-58.450775804055191 -34.67983839429764,-58.450939759303836 -34.679699674329129,-58.451478424671329 -34.679276122844968,-58.452930099653216 -34.678134810370516,-58.453085180078823 -34.678014044970332,-58.453519300570179 -34.677675971203705,-58.453825194822883 -34.677437748319377,-58.455051397144722 -34.676482806869942,-58.457727154699775 -34.674382116197577,-58.457936012350956 -34.674225078178331,-58.458354919022248 -34.673904874175356,-58.458419791155187 -34.673874664410661,-58.45845073540309 -34.673860228494938,-58.458698542664656 -34.673787699767111,-58.45900363143037 -34.673755877578643,-58.458782681748993 -34.673713123078024,-58.458612284720466 -34.673610157033522,-58.458457149694226 -34.673448316494195,-58.45840115053695 -34.673336973575843,-58.45839723400767 -34.673246830220336,-58.458393572909955 -34.673162602521138,-58.458315930845728 -34.672889282689717,-58.458210924034518 -34.672660470010335,-58.458153645756859 -34.672573705031354,-58.454057463312417 -34.668707816667144,-58.453560986954599 -34.668360658379136,-58.452529831353651 -34.667903029081195,-58.452300647649544 -34.667738920775051,-58.452109740455022 -34.667543194784642,-58.451995208251198 -34.667334939665807,-58.451941704623565 -34.667139295811253,-58.451942659980439 -34.667001968198306,-58.452165030524192 -34.667098680400805,-58.452077529237386 -34.666808805724685,-58.451932634821844 -34.666748580097654,-58.451838153982742 -34.666708936061639,-58.451789058345881 -34.666504309704244,-58.451678320665884 -34.66625863736251,-58.451593806000702 -34.666106897040819,-58.45155578759973 -34.666047398885958,-58.451456830348157 -34.665892532002843,-58.451280508999012 -34.665636015162008,-58.451061902698555 -34.66551557173846,-58.451024010441031 -34.665498708930002,-58.450916163015833 -34.665452937907446,-58.450706297064187 -34.665371029969158,-58.450481855649826 -34.665296345574127,-58.450283646769343 -34.665238522625614,-58.450132697197184 -34.665188178830299,-58.450121336384051 -34.665203293742117,-58.450077694531991 -34.665213571205925,-58.449957339623978 -34.665234122634565,-58.449843209455054 -34.665237561452017,-58.449791301886385 -34.665234105167499,-58.449741529461669 -34.665203253964584,-58.449700282787276 -34.665158177905212,-58.449170481895891 -34.665564046963709,-58.449148999913191 -34.665580523905575,-58.449004165660035 -34.665698539143776,-58.44896537831054 -34.66573015536985,-58.446974318658803 -34.667315803356608,-58.446334428695273 -34.667825380910145,-58.445572876108777 -34.668431842065338,-58.444482916525068 -34.669292974951858,-58.444321626650215 -34.669371896533313,-58.444118492231553 -34.669413838702816,-58.443955436989121 -34.669380714257962,-58.443749608915581 -34.66927244008324,-58.443508244737707 -34.669129370299167,-58.443438282244152 -34.669048582437455,-58.443415103486146 -34.6690217470628,-58.443088386624929 -34.668644431224315,-58.442685378054492 -34.668294497095481,-58.442647455037388 -34.668261532223411,-58.442617798389982 -34.668235822419234,-58.442445824325809 -34.668086564567496,-58.441983679227562 -34.667684715428187,-58.441461545010441 -34.66723066955312,-58.441337127361976 -34.667120010992228,-58.440947088700639 -34.666773101556174,-58.440356881283392 -34.666248050855828,-58.440155184739545 -34.666037233288023,-58.439932428502864 -34.666165505276375,-58.439751951713433 -34.666282728178992,-58.437848217245694 -34.667381821663625,-58.436856219610078 -34.667954518322567,-58.435487639471695 -34.668744523621697,-58.434144695481066 -34.669519730325732,-58.434085527621171 -34.669553872300469,-58.434030196239192 -34.669585831991284,-58.432291626997952 -34.670589381296921,-58.432366009181827 -34.670679190957905,-58.432365988922413 -34.67067919494994,-58.432180272142567 -34.670811648985321,-58.432180477118798 -34.670811753824331,-58.432221971403493 -34.670860709172587,-58.432260394389665 -34.670916987878428,-58.432301800883138 -34.670973196891232,-58.432366898139989 -34.671046595342787,-58.432429006747945 -34.671134641293939,-58.432507482213339 -34.671221494051913,-58.432557751427048 -34.671285099732593,-58.432628730824689 -34.671358429070551,-58.432667216604493 -34.671478300898272,-58.432753040591649 -34.671517407556664,-58.432800324948921 -34.671585942109409,-58.432905391350133 -34.67168744939994,-58.432952763814647 -34.671748589350919,-58.433006015412658 -34.671817054852902,-58.433065147025488 -34.671890451468535,-58.433115415341717 -34.671958916195941,-58.433174635867225 -34.672022523786772,-58.433216040907908 -34.672086127040735,-58.433254554710274 -34.672130151598836,-58.433298870190526 -34.672159529268988,-58.433298854637975 -34.67220354451409,-58.433366954467282 -34.672227998185235,-58.433412797953459 -34.672275686524458,-58.433448318145729 -34.672349077274106,-58.433545990350254 -34.672393115919114,-58.433575559150007 -34.672422489959899,-58.433655519038808 -34.672415114475235,-58.433714673802186 -34.672424917545612,-58.433762046423787 -34.672488522028829,-58.433733893876926 -34.672553305785556,-58.433727912412202 -34.672594925180839,-58.433757555542591 -34.672656060595436,-58.433816690981182 -34.672722062276485,-58.433861075253731 -34.672800384707884,-58.433908443132168 -34.672878637402434,-58.433958715268865 -34.672939777635705,-58.434008987479423 -34.673000917847709,-58.434008971452108 -34.673047397940387,-58.434041533418728 -34.673049870453255,-58.434082955618962 -34.6730669933104,-58.434173294334357 -34.673122015930645,-58.434229444394461 -34.673195411268566,-58.434279798040038 -34.673268734804175,-58.434330063169355 -34.673351917711393,-58.434368499569878 -34.673376363911821,-58.4344306972772 -34.673464408831251,-58.434525371216694 -34.673557390934704,-58.434602311418921 -34.673660087441746,-58.434668854949713 -34.673754260158333,-58.434742816899877 -34.673842307617726,-58.434825644369859 -34.673930357058524,-58.43489073717403 -34.674030656239005,-58.434991380177955 -34.674121174480575,-58.435053496290365 -34.674201894918212,-58.435103773314445 -34.674253245679466,-58.435128986557352 -34.67431071767399,-58.435173383443306 -34.674357207793811,-58.435244362095553 -34.674447719119819,-58.435300605686486 -34.674501535994573,-58.435368612307165 -34.674557749909475,-58.435407117950106 -34.674633605583828,-58.435463361771937 -34.674687422381957,-58.435513636143654 -34.674748561956932,-58.435534341021217 -34.674777933534486,-58.435534327454583 -34.674819483908813,-58.435590584242689 -34.674834144701066,-58.435634976900694 -34.674895282916395,-58.435663005366528 -34.674947896138249,-58.435674838534972 -34.674996773272476,-58.435742938154611 -34.675031085017032,-58.43579321927092 -34.675072646501313,-58.435849457320877 -34.675146041089633,-58.435908667259568 -34.675256056973296,-58.43597377575329 -34.675314805183937,-58.436029939874913 -34.675353903005693,-58.436071355021227 -34.675397927285751,-58.436098016492465 -34.675461526305035,-58.436139434853445 -34.675495761575796,-58.436177949445522 -34.67554710932005,-58.436186796264039 -34.675605845160355,-58.436192672757755 -34.6756229595576,-58.436217818263394 -34.675629091942113,-58.436288898354839 -34.675675587439741,-58.436336196533475 -34.675717148049515,-58.43641911511498 -34.675797872267935,-58.436469399341576 -34.675832109335857,-58.436516780640204 -34.675880994025448,-58.436602591781551 -34.675981296708954,-58.436649884160474 -34.67604243516427,-58.436720943471329 -34.676157382873924,-58.436806763516614 -34.676230783308753,-58.436873319183718 -34.676300517536056,-58.436902879933612 -34.67636411698431,-58.436935424375825 -34.676427646631076,-58.436964988987064 -34.676479062651374,-58.437068629886987 -34.676540212822403,-58.437092313385072 -34.67658909229764,-58.437169180297893 -34.676672279575392,-58.437269822259225 -34.676784768293672,-58.437314209713264 -34.676870413549381,-58.437371905114126 -34.67692542696394,-58.437431134652343 -34.67698170830694,-58.437445863101438 -34.67704523411669,-58.437493244896366 -34.677096653693717,-58.437546511040807 -34.677140679910373,-58.43758494054827 -34.677196886458567,-58.437670759482835 -34.67728007525605,-58.437712182336483 -34.677304521000281,-58.437774390167718 -34.677380380749838,-58.437851258514499 -34.677463497162975,-58.437935613855124 -34.677596827599899,-58.437971146858899 -34.677648174154569,-58.438042134993452 -34.677726429971621,-58.438148661493287 -34.677838989559909,-58.43819901059571 -34.677949002498622,-58.438293698166937 -34.678027262926612,-58.438388381614885 -34.678120241964372,-58.438459371960555 -34.678193638254243,-58.438469751242401 -34.67826575483101,-58.438543734005435 -34.678309784719957,-58.438602959650773 -34.678385643443484,-58.438667976668228 -34.678481010817656,-58.438742049194865 -34.678510392342659,-58.438777491519168 -34.678583711026455,-58.438845587660772 -34.67864485268548,-58.438863297659523 -34.678720703147,-58.438957987437384 -34.678796498198551,-58.439021635967471 -34.6789102458592,-58.439089725619937 -34.678995824616692,-58.439131138651057 -34.679059425792133,-58.43919625516228 -34.679108383267263,-58.43925837770729 -34.679193960777098,-58.439258349447478 -34.679294245000058,-58.439308635589363 -34.679333340156063,-58.439400426606653 -34.679414064002309,-58.439432971390659 -34.679487452355296,-58.439570618516356 -34.679598748967884,-58.439641608453059 -34.679681933531299,-58.439751132828412 -34.679760195611351,-58.4398221264535 -34.679831126238092,-58.439899095073571 -34.679875155853914,-58.439916800276286 -34.679972978530984,-58.439907924890839 -34.680007203086021,-58.440017447275729 -34.680095253901193,-58.440076590285351 -34.680171111871637,-58.44016242340372 -34.680222467091632,-58.440357391927556 -34.680218700071862,-58.440412443428855 -34.680294134582027,-58.440589113020735 -34.680499171907641,-58.440555342922849 -34.680539941448764,-58.440515518189343 -34.680587470611499,-58.440527271748401 -34.680628882239716,-58.440577469528804 -34.680684949104553,-58.440592201072278 -34.680748333648111,-58.440589204337819 -34.680797066720331,-58.44061569086044 -34.680896933178495,-58.44067176214125 -34.680987156850605,-58.440720422829735 -34.681054139141594,-58.440758771074627 -34.681110203790645,-58.440814765111071 -34.681171130873039,-58.440817730954358 -34.681239372547623,-58.440832457020974 -34.681324659010883,-58.440873695701868 -34.68141241507174,-58.440965155965905 -34.68146848915142,-58.441041872894793 -34.68150505301444,-58.441168632008328 -34.681544020104766,-58.441224712506902 -34.681602552583989,-58.441227686882634 -34.681639103314787,-58.441195207847478 -34.681631773462776,-58.441156834444392 -34.681670781743456,-58.441195190841839 -34.681697549746659,-58.441239427099134 -34.681734178173549,-58.441345651573045 -34.681731731979326,-58.441397213050223 -34.68179385522437,-58.441444424556657 -34.681864569451641,-58.441524039394196 -34.681905992790064,-58.441588906931479 -34.681942554247108,-58.441594860354122 -34.681998613010165,-58.441597746563438 -34.682047347115756,-58.441674459373267 -34.682103418103573,-58.441759951431088 -34.682166814676727,-58.441883879033718 -34.682283810638822,-58.44196790910167 -34.682399532056124,-58.442023906099486 -34.682455599295608,-58.442100608707165 -34.682555544336374,-58.442189083005452 -34.682628659658462,-58.442221549322575 -34.682689582118428,-58.44227166484076 -34.682743183403488,-58.442348370389247 -34.682833409734066,-58.442395489135656 -34.682940603340434,-58.442427952155413 -34.683016173990964,-58.442514977635241 -34.683090486042786,-58.442582820381979 -34.683168456929295,-58.442650669112638 -34.683222131404172,-58.44271254551775 -34.683295241960558,-58.442771525756214 -34.683358563037579,-58.442777397741537 -34.683402438317962,-58.442747895319933 -34.683421941015062,-58.442733137671091 -34.683458488794471,-58.442736115108403 -34.68348532092881,-58.442800979742991 -34.683541389253634,-58.442907193726136 -34.683592534566166,-58.442992689989445 -34.683648606136522,-58.443096004433087 -34.683704680513515,-58.443153451526491 -34.683764409517408,-58.443197687483 -34.683810685345883,-58.44324192291208 -34.683859426007146,-58.443280270153693 -34.683932602933673,-58.443303873050425 -34.683986199556678,-58.44336873732896 -34.684047126848938,-58.443401205063481 -34.684108048981003,-58.443454313986592 -34.684127564898859,-58.443507414500296 -34.684183630983917,-58.443551647504201 -34.684244554926558,-58.443551631793042 -34.684312796032188,-58.443659291810697 -34.684384645642432,-58.443674034154107 -34.684413944436187,-58.443703516668378 -34.684482190140912,-58.443735905119134 -34.684518745374149,-58.443765477978367 -34.684565018708675,-58.443794963390552 -34.684621080993722,-58.443815587322256 -34.684655169530743,-58.443842092182948 -34.684696653520909,-58.443889315697632 -34.684730746157527,-58.443945313908294 -34.68479413661597,-58.44401027495514 -34.684808724414822,-58.444054504823164 -34.684886761261922,-58.444055171258881 -34.684887118597636,-58.44411349429398 -34.684918390761112,-58.444122263586806 -34.684972055378452,-58.444181921547191 -34.685020233011855,-58.444295301575792 -34.68493215038216,-58.444295340477716 -34.684932151084531,-58.444519600153946 -34.684755560712659,-58.449295678806948 -34.680994325919478,-58.449783289630851 -34.68061028442753,-58.449935052672046 -34.680501213168093,-58.450133270405018 -34.680434753220766,-58.450318861798095 -34.6804284340257)));;3165;8_13_1;COMUNA 8;13;1;45;29;16;181,25%;11;11;100,00%;0;0,00%;20;14;70,00%;6;30,00%
MULTIPOLYGON (((-58.425946459930387 -34.661410057670906,-58.425797602314972 -34.661317474886353,-58.425028706592421 -34.660812577599188,-58.424941978750454 -34.66091945520369,-58.424697935964574 -34.66122118094772,-58.424612375626381 -34.661334200698526,-58.424124693195161 -34.661944027136144,-58.424011149990648 -34.662087324029592,-58.424086132898488 -34.662120699878429,-58.424125995847263 -34.66217578446502,-58.424191086965628 -34.662232003801158,-58.424256171374104 -34.662302941822574,-58.42438049889936 -34.662359250144654,-58.424436642065913 -34.66241307210219,-58.42451953249396 -34.662501128723278,-58.424546103623634 -34.662547617216255,-58.424620065046071 -34.662591655656001,-58.424735549195653 -34.662603875110172,-58.424806542096604 -34.662616151059666,-58.424877527242487 -34.662645540120444,-58.424972264555038 -34.66273606496285,-58.425089081172466 -34.662818004753973,-58.425177858154612 -34.66289627373181,-58.425275502792168 -34.662967221218082,-58.425376135130627 -34.663028380534278,-58.425432275009442 -34.663091991032481,-58.42555659687293 -34.663165411300547,-58.425630546300532 -34.663238816135966,-58.42568080763224 -34.663297495015215,-58.425778458604768 -34.663356188233557,-58.425846532738106 -34.663417337293822,-58.425924918535308 -34.663482221924603,-58.425981151953252 -34.663528648616698,-58.426022548329151 -34.663589859964091,-58.426072811233787 -34.663646073821688,-58.426140900853625 -34.663672996415144,-58.426197122691953 -34.663746395584006,-58.426202988791552 -34.663780623644122,-58.426188135646214 -34.663831958652466,-58.426229633635486 -34.663856478796461,-58.426241467186983 -34.663888243781798,-58.426306472606434 -34.663951856519716,-58.426347948298755 -34.664027645645767,-58.426421907723309 -34.664081471986051,-58.426518027490374 -34.664136572500347,-58.426538723403183 -34.664173199374936,-58.426609785126786 -34.664227024740548,-58.426692597594361 -34.664307755689599,-58.426772508037786 -34.664398274729884,-58.426849360749685 -34.664464355520884,-58.426973690145275 -34.664527914902798,-58.427050631507939 -34.664586671445214,-58.427086041877828 -34.664696755262341,-58.427183693409489 -34.664760306631997,-58.427262168847193 -34.664820260701852,-58.427315408189394 -34.664896123331665,-58.427380490081163 -34.664984172803678,-58.427460311528648 -34.665086874792593,-58.427543130852598 -34.665155351295901,-58.427694017022858 -34.665309483468825,-58.427782792936682 -34.66540246923455,-58.427816773568082 -34.665469734335332,-58.427896699660245 -34.665528420764659,-58.427955899392998 -34.66562132753004,-58.428062399807075 -34.665726571995513,-58.428160030963532 -34.665843926862699,-58.42823397392565 -34.665944232233649,-58.428305394278652 -34.666047519449521,-58.428386291141244 -34.66614850615575,-58.428475067738439 -34.666243885837119,-58.428501617153053 -34.66635150186989,-58.428528259910983 -34.666439539920368,-58.428605193145998 -34.66652512718214,-58.428643605691853 -34.666596055351761,-58.428676146979598 -34.666642544582139,-58.428778214843334 -34.666753843671792,-58.428875849186596 -34.666868803515918,-58.428970495546729 -34.666996016308715,-58.4290532942954 -34.66712315533178,-58.429118372832292 -34.667228387410987,-58.429189421109299 -34.66732622652713,-58.429307803698087 -34.667355555581956,-58.429383207722466 -34.667432620562828,-58.429421706587071 -34.667503548500633,-58.429483817250585 -34.667572018005195,-58.429554786846964 -34.667655208596166,-58.429614006461101 -34.667706564105586,-58.429738217826532 -34.667870475442605,-58.429818135975552 -34.66795852758225,-58.429920187728683 -34.668118700252947,-58.429982299233501 -34.668187239921544,-58.430100645008721 -34.668314387743798,-58.430162761599156 -34.668370673466882,-58.430260395935065 -34.668495421170029,-58.430257374459984 -34.668593239912489,-58.430349154350203 -34.668649533428329,-58.430428991495077 -34.668730260993691,-58.430503040142625 -34.668791408983758,-58.430542912436401 -34.668841561706238,-58.430566580476203 -34.668914879784523,-58.430622811629704 -34.668983417568064,-58.430661234566095 -34.669034767084341,-58.430708596346129 -34.669115485922731,-58.430773698256168 -34.669169307255643,-58.430832833516732 -34.669223126993828,-58.430868346414606 -34.66930623710055,-58.430909744602388 -34.669379630159312,-58.431005951269555 -34.669454234679705,-58.431059207215576 -34.669503193491458,-58.431065068276183 -34.66955699927572,-58.431068031203054 -34.669610804307297,-58.431109437177277 -34.669664548881656,-58.431115380714594 -34.669725749248187,-58.431126615610722 -34.66976983784896,-58.431180063008725 -34.669764147301017,-58.431245524870846 -34.669769868587061,-58.431317894895862 -34.669765661772423,-58.431390599035836 -34.669779624502446,-58.431470555652432 -34.669774715301116,-58.431482306778278 -34.669806550151065,-58.43147938479779 -34.669870072234012,-58.431470492328025 -34.669943452206233,-58.431420111931935 -34.669953228284861,-58.431420091707324 -34.670007032538976,-58.431458603597619 -34.670051057678471,-58.43150002102729 -34.670075505559822,-58.431541431150599 -34.6701195314144,-58.43160210782483 -34.670157505670581,-58.431658358954778 -34.670177027571292,-58.431705647131523 -34.670230843860374,-58.43176486171096 -34.670304241146297,-58.431809162987406 -34.670367845630388,-58.431862495287447 -34.670443635806855,-58.431903904873465 -34.670490126390192,-58.43193346517895 -34.670539078823886,-58.431980842593461 -34.670583106031792,-58.432025146000584 -34.670641780726029,-58.432060675085346 -34.670685804920346,-58.432097655551061 -34.670723702544265,-58.432118348335067 -34.670779976844074,-58.432180272142567 -34.670811648985321,-58.432365988922413 -34.67067919494994,-58.432366009181827 -34.670679190957905,-58.432291626997952 -34.670589381296921,-58.434030196239192 -34.669585831991284,-58.434085527621171 -34.669553872300469,-58.434144695481066 -34.669519730325732,-58.435487639471695 -34.668744523621697,-58.436856219610078 -34.667954518322567,-58.437848217245694 -34.667381821663625,-58.439751951713433 -34.666282728178992,-58.439932428502864 -34.666165505276375,-58.439800688094699 -34.6660406884426,-58.439663744651277 -34.665930518771106,-58.439473871615498 -34.665815550007707,-58.439225448983912 -34.665677047912681,-58.438840664472146 -34.665490559630157,-58.437807663134883 -34.665039143457136,-58.436573800962272 -34.664507321283445,-58.436358954761793 -34.664414737277056,-58.435266495339278 -34.663938426792647,-58.435155452704883 -34.663887625695772,-58.434710586127672 -34.66499790728016,-58.433553920474857 -34.664354238156278,-58.432434426953726 -34.663731272030702,-58.432311374487774 -34.663663845179229,-58.431059471545979 -34.662978648451592,-58.430355539138084 -34.663845248470075,-58.430199680396107 -34.663759641261692,-58.429289076363382 -34.663259451613243,-58.428221350439905 -34.662672870349269,-58.427156025456938 -34.66208768887315,-58.426127015198126 -34.661522368650303,-58.425946459930387 -34.661410057670906)));;3166;8_13_2;COMUNA 8;13;2;365;174;191;91,10%;100;100;100,00%;0;0,00%;118;7;5,93%;111;94,07%
MULTIPOLYGON (((-58.435745314431706 -34.661642342532652,-58.43486830562378 -34.662343503248614,-58.433747426394916 -34.661833227891357,-58.432539043156623 -34.661283060294998,-58.431806787658537 -34.662070575202755,-58.431730133652216 -34.662153022862007,-58.431059471545979 -34.662978648451592,-58.432311374487774 -34.663663845179229,-58.432434426953726 -34.663731272030702,-58.433553920474857 -34.664354238156278,-58.434710586127672 -34.66499790728016,-58.435155452704883 -34.663887625695772,-58.435266495339278 -34.663938426792647,-58.436358954761793 -34.664414737277056,-58.436573800962272 -34.664507321283445,-58.437807663134883 -34.665039143457136,-58.438840664472146 -34.665490559630157,-58.439225448983912 -34.665677047912681,-58.439473871615498 -34.665815550007707,-58.439663744651277 -34.665930518771106,-58.439800688094699 -34.6660406884426,-58.439932428502864 -34.666165505276375,-58.440155184739545 -34.666037233288023,-58.440356881283392 -34.666248050855828,-58.440947088700639 -34.666773101556174,-58.442158452635397 -34.66580990495558,-58.441336026549891 -34.66509939190788,-58.440384173841686 -34.664277156369238,-58.440262828902199 -34.664172272030214,-58.439430721395283 -34.663451743884188,-58.438698921802676 -34.662818063182741,-58.437536399103479 -34.66181132164828,-58.436575164110515 -34.660978912875649,-58.435745314431706 -34.661642342532652)));;3167;8_13_3;COMUNA 8;13;3;998;489;509;96,07%;341;340;99,71%;1;0,29%;311;9;2,89%;302;97,11%
MULTIPOLYGON (((-58.44456310902082 -34.663897627810677,-58.443562051303928 -34.663478941989617,-58.443442140312285 -34.663426668128402,-58.443244155319746 -34.663377198695038,-58.442117492889608 -34.662896577729725,-58.442022780737979 -34.662972056775097,-58.440712983834551 -34.662427375723823,-58.440643078695459 -34.662483280159925,-58.440552146027606 -34.662445516137005,-58.440513249066917 -34.662242475192969,-58.440476520036192 -34.66222028478159,-58.440064553253087 -34.662057810061157,-58.43979653024229 -34.661945996298293,-58.439901380746271 -34.661860746678094,-58.440072713218392 -34.661718819653082,-58.439981810715416 -34.661681516467993,-58.438445700782019 -34.661046695601449,-58.437156664821579 -34.660514022907861,-58.435577392449034 -34.659861339333055,-58.434420649936996 -34.659383316423614,-58.4343734169314 -34.659430771603489,-58.434243739021433 -34.65956109724015,-58.435424426957049 -34.660056099487349,-58.435588982993465 -34.660125081811628,-58.436936546136074 -34.660689967501881,-58.438251999476655 -34.661241380731433,-58.437536399103479 -34.66181132164828,-58.438698921802676 -34.662818063182741,-58.439430721395283 -34.663451743884188,-58.440262828902199 -34.664172272030214,-58.440384173841686 -34.664277156369238,-58.441336026549891 -34.66509939190788,-58.442158452635397 -34.66580990495558,-58.443130234575271 -34.66503715616863,-58.444339331544363 -34.664075557014741,-58.44456310902082 -34.663897627810677)));;3168;8_13_4;COMUNA 8;13;4;1064;502;562;89,32%;317;317;100,00%;0;0,00%;333;35;10,51%;298;89,49%
MULTIPOLYGON (((-58.433658094571975 -34.660149567463066,-58.433589886799773 -34.660218074271825,-58.432979763999718 -34.660828859899702,-58.432715113226081 -34.66109373217504,-58.432539043156623 -34.661283060294998,-58.433747426394916 -34.661833227891357,-58.43486830562378 -34.662343503248614,-58.435745314431706 -34.661642342532652,-58.436575164110515 -34.660978912875649,-58.437536399103479 -34.66181132164828,-58.438251999476655 -34.661241380731433,-58.436936546136074 -34.660689967501881,-58.435588982993465 -34.660125081811628,-58.435424426957049 -34.660056099487349,-58.434243739021433 -34.65956109724015,-58.433658094571975 -34.660149567463066)));;3169;8_13_5;COMUNA 8;13;5;963;457;506;90,32%;315;315;100,00%;0;0,00%;315;5;1,59%;310;98,41%
MULTIPOLYGON (((-58.432357738293874 -34.658060599513973,-58.432167013511375 -34.658253022225345,-58.431479305587352 -34.658947022909231,-58.430916068881729 -34.659515344332824,-58.430796446286635 -34.659635739060036,-58.430658489349099 -34.659559855651054,-58.429724837595813 -34.659044310314371,-58.429073338990655 -34.659704292064006,-58.429255697304733 -34.659784978320474,-58.430134255522198 -34.66018593176652,-58.430213845999376 -34.660222221634761,-58.43126224810112 -34.660700608621724,-58.431350020245119 -34.660740702779449,-58.432307253539371 -34.661177577222446,-58.432539043156623 -34.661283060294998,-58.432715113226081 -34.66109373217504,-58.432979763999718 -34.660828859899702,-58.433589886799773 -34.660218074271825,-58.433658094571975 -34.660149567463066,-58.434243739021433 -34.65956109724015,-58.434135865605249 -34.659483252894134,-58.433697620890101 -34.659229268947485,-58.43326203288845 -34.65894148027273,-58.433279255247875 -34.658923948716357,-58.433216206803763 -34.658865621957823,-58.433131091574332 -34.658786796271791,-58.432631667772647 -34.658510750728631,-58.432357738293874 -34.658060599513973)));;3170;8_13_6;COMUNA 8;13;6;657;302;355;85,07%;224;223;99,55%;1;0,45%;221;4;1,81%;217;98,19%
MULTIPOLYGON (((-58.429633509778313 -34.656590059971201,-58.429483806809237 -34.656705093040124,-58.428905888833398 -34.657122129410091,-58.428794720860587 -34.657201678313228,-58.42866547929173 -34.657294180191094,-58.427969478468398 -34.657794843443646,-58.427828896213448 -34.657895932990961,-58.427280547801267 -34.658284659351736,-58.427137320432472 -34.65838898685417,-58.426878329999568 -34.658577516252393,-58.426779995742379 -34.658691640279422,-58.426781388943631 -34.658692255661244,-58.427705832758768 -34.659100580171476,-58.427742134086216 -34.65911509804171,-58.429073338990655 -34.659704292064006,-58.429724837595813 -34.659044310314371,-58.430658489349099 -34.659559855651054,-58.430796446286635 -34.659635739060036,-58.430916068881729 -34.659515344332824,-58.431479305587352 -34.658947022909231,-58.432167013511375 -34.658253022225345,-58.432357738293874 -34.658060599513973,-58.432631667772647 -34.658510750728631,-58.433131091574332 -34.658786796271791,-58.433216206803763 -34.658865621957823,-58.433279255247875 -34.658923948716357,-58.43326203288845 -34.65894148027273,-58.433697620890101 -34.659229268947485,-58.434135865605249 -34.659483252894134,-58.434243739021433 -34.65956109724015,-58.4343734169314 -34.659430771603489,-58.434281129713703 -34.659384410776703,-58.434248322068179 -34.659368275904313,-58.434125023944034 -34.659286132048585,-58.433854905350401 -34.659121697548294,-58.433609250556671 -34.658951141348744,-58.433476070468686 -34.658859628007882,-58.433402879956034 -34.658800735517524,-58.433344776499467 -34.658737480293617,-58.433294852531041 -34.658681339894287,-58.433208202509825 -34.658604767475367,-58.433135700538053 -34.658528128000711,-58.43302290007879 -34.658411547956277,-58.432773127756761 -34.658088449453778,-58.43276898314955 -34.658000699432776,-58.432636790716025 -34.657777068922307,-58.432017403543931 -34.656729560419507,-58.431630805562889 -34.656075570296302,-58.431313797998477 -34.655539417152013,-58.431277600399149 -34.655478349709256,-58.431288272677932 -34.65542757632884,-58.430958445587606 -34.65566841343697,-58.429784917327019 -34.6564738299585,-58.429633509778313 -34.656590059971201)));;3171;8_13_7;COMUNA 8;13;7;728;332;396;83,84%;272;271;99,63%;1;0,37%;253;27;10,67%;226;89,33%
MULTIPOLYGON (((-58.430134255522198 -34.66018593176652,-58.429255697304733 -34.659784978320474,-58.429073338990655 -34.659704292064006,-58.427742134086216 -34.65911509804171,-58.427705832758768 -34.659100580171476,-58.426781388943631 -34.658692255661244,-58.426440334231032 -34.659072295966489,-58.426441136289668 -34.659072745060918,-58.42571808680583 -34.659963327936673,-58.425028706592421 -34.660812577599188,-58.425797602314972 -34.661317474886353,-58.425946459930387 -34.661410057670906,-58.426127015198126 -34.661522368650303,-58.427156025456938 -34.66208768887315,-58.428221350439905 -34.662672870349269,-58.429289076363382 -34.663259451613243,-58.430199680396107 -34.663759641261692,-58.430355539138084 -34.663845248470075,-58.431059471545979 -34.662978648451592,-58.431730133652216 -34.662153022862007,-58.431806787658537 -34.662070575202755,-58.432539043156623 -34.661283060294998,-58.432307253539371 -34.661177577222446,-58.431350020245119 -34.660740702779449,-58.43126224810112 -34.660700608621724,-58.430213845999376 -34.660222221634761,-58.430134255522198 -34.66018593176652)));;3172;8_13_8;COMUNA 8;13;8;893;425;468;90,81%;316;316;100,00%;0;0,00%;297;24;8,08%;273;91,92%
MULTIPOLYGON (((-58.455587146848892 -34.658592219575809,-58.456708595300334 -34.659579174582895,-58.456728216714872 -34.659562299784355,-58.457121825168251 -34.659261816876757,-58.45740727049828 -34.659043795188744,-58.457662968234601 -34.658848589155319,-58.457715727056048 -34.658808238053005,-58.458022392001745 -34.65857401812562,-58.458230186772653 -34.658415429811967,-58.458349681188338 -34.658324304751908,-58.458654808411694 -34.65809128037791,-58.458707395807082 -34.658051140109421,-58.45895132565547 -34.657864945300794,-58.459246903764395 -34.657639172864094,-58.459519809228318 -34.657430864407068,-58.459595919097126 -34.657372766096238,-58.459850072449647 -34.657178682176195,-58.45995788565321 -34.657136570752535,-58.460260617669256 -34.656903964807888,-58.459645813273937 -34.65637992164983,-58.45961786005509 -34.65635611743695,-58.459266377042901 -34.656633510477413,-58.459021172785107 -34.656827100496471,-58.458903556158603 -34.656919916485435,-58.458779035662893 -34.657018154830133,-58.458530760855552 -34.657214138187435,-58.458286064561413 -34.657407304179557,-58.458107506293565 -34.657548217152275,-58.458031991733044 -34.657607793471065,-58.457481283985992 -34.657125433245689,-58.457231982845691 -34.65732500556409,-58.45698574885445 -34.657522112650007,-58.456125185518317 -34.656765427647002,-58.45584451702814 -34.656987108762074,-58.456123530192947 -34.657221497117895,-58.455876015433084 -34.657419165293426,-58.455628584725112 -34.657616832964912,-58.455332399338999 -34.657853371552655,-58.455180598486301 -34.657973084048173,-58.455486360415371 -34.658250394187831,-58.455733427617751 -34.658474469349692,-58.455587146848892 -34.658592219575809)));;3173;8_14_1;COMUNA 8;14;1;1805;876;929;94,29%;330;330;100,00%;0;0,00%;464;97;20,91%;367;79,09%
MULTIPOLYGON (((-58.435180434749498 -34.656900601958533,-58.434186331736733 -34.656217607245807,-58.43313947205948 -34.655587198746318,-58.431992596945562 -34.654896543020783,-58.431388787826165 -34.655334641720081,-58.431288272677932 -34.65542757632884,-58.431277600399149 -34.655478349709256,-58.431313797998477 -34.655539417152013,-58.431630805562889 -34.656075570296302,-58.432017403543931 -34.656729560419507,-58.432636790716025 -34.657777068922307,-58.43276898314955 -34.658000699432776,-58.432773127756761 -34.658088449453778,-58.43302290007879 -34.658411547956277,-58.433135700538053 -34.658528128000711,-58.433208202509825 -34.658604767475367,-58.433294852531041 -34.658681339894287,-58.433344776499467 -34.658737480293617,-58.433402879956034 -34.658800735517524,-58.433476070468686 -34.658859628007882,-58.433609250556671 -34.658951141348744,-58.433854905350401 -34.659121697548294,-58.434125023944034 -34.659286132048585,-58.434248322068179 -34.659368275904313,-58.434281129713703 -34.659384410776703,-58.4343734169314 -34.659430771603489,-58.434420649936996 -34.659383316423614,-58.434573091127923 -34.659230107870037,-58.435228206692663 -34.658571787673317,-58.435366832958877 -34.658433857121793,-58.43620207641041 -34.657602538690305,-58.435180434749498 -34.656900601958533)));;3174;8_14_10;COMUNA 8;14;10;979;477;502;95,02%;287;287;100,00%;0;0,00%;313;44;14,06%;269;85,94%
MULTIPOLYGON (((-58.458530760855574 -34.657214138187435,-58.458779035662907 -34.657018154830148,-58.458261563598711 -34.656574391817429,-58.458215458247558 -34.656537698923167,-58.457352932789696 -34.655795600281103,-58.457113607414151 -34.655984679574615,-58.456857405333224 -34.65618699740719,-58.456619356167934 -34.656375089835294,-58.456371674804764 -34.656570716723508,-58.456125185518317 -34.656765427647017,-58.456985748854436 -34.657522112650007,-58.457231982845691 -34.657325005564104,-58.457481283986006 -34.657125433245689,-58.458031991733044 -34.65760779347108,-58.458107506293565 -34.657548217152282,-58.458286064561413 -34.657407304179557,-58.458530760855574 -34.657214138187435)));;3175;8_14_2;COMUNA 8;14;2;1473;708;765;92,55%;255;255;100,00%;0;0,00%;382;78;20,42%;304;79,58%
MULTIPOLYGON (((-58.45961786005509 -34.65635611743695,-58.459645813273937 -34.65637992164983,-58.460260617669263 -34.656903964807888,-58.460392630323291 -34.657016505852276,-58.460539216775089 -34.65714144173608,-58.461336075051463 -34.657832177449791,-58.461489482444939 -34.657964858952845,-58.461580336160921 -34.65787851930267,-58.460355391246146 -34.65684135921687,-58.459655363212015 -34.656253157635888,-58.459071929623761 -34.655745169114624,-58.45892603138568 -34.655581568357981,-58.458369960892902 -34.655134142421041,-58.458337406449623 -34.655108013734541,-58.458016790611502 -34.654832106130669,-58.457112970180468 -34.654050397486849,-58.456983337904859 -34.65415652136609,-58.456736857337773 -34.654349261715154,-58.456687254268253 -34.65438799281327,-58.456419209375838 -34.654597492503491,-58.456184743565942 -34.65478072501935,-58.456124230597005 -34.654827976679051,-58.453716099479024 -34.6567094272527,-58.454599227815379 -34.657442327260092,-58.454914370219065 -34.657731581499185,-58.455180598486301 -34.657973084048173,-58.455332399339014 -34.657853371552648,-58.455628584725112 -34.657616832964941,-58.455876015433098 -34.657419165293447,-58.456123530192947 -34.657221497117909,-58.455844517028162 -34.656987108762074,-58.456125185518317 -34.656765427647017,-58.456371674804764 -34.656570716723508,-58.456619356167934 -34.656375089835294,-58.456857405333224 -34.65618699740719,-58.457113607414151 -34.655984679574615,-58.457352932789696 -34.655795600281103,-58.458215458247558 -34.656537698923167,-58.458261563598711 -34.656574391817429,-58.458779035662907 -34.657018154830148,-58.458903556158603 -34.65691991648545,-58.459021172785107 -34.656827100496479,-58.459266377042916 -34.656633510477405,-58.45961786005509 -34.65635611743695)));;3176;8_14_3;COMUNA 8;14;3;2033;981;1052;93,25%;331;330;99,70%;1;0,30%;518;119;22,97%;399;77,03%
MULTIPOLYGON (((-58.451787095192508 -34.658006848608018,-58.452254778647188 -34.65763997157881,-58.452388854034176 -34.65753505038176,-58.452494886710689 -34.657452099157879,-58.452630214606089 -34.657556268349452,-58.452735905849188 -34.657475922597186,-58.453716099479024 -34.6567094272527,-58.456124230597005 -34.654827976679051,-58.456184743565942 -34.65478072501935,-58.456419209375838 -34.654597492503491,-58.456687254268253 -34.65438799281327,-58.456736857337773 -34.654349261715154,-58.456983337904859 -34.65415652136609,-58.457112970180468 -34.654050397486849,-58.456995199430892 -34.653931163166185,-58.455312490275816 -34.652523175517274,-58.455061800438813 -34.652299318898663,-58.454941991221077 -34.652164659438768,-58.454860535774699 -34.651990423685426,-58.454798259585367 -34.651772596266774,-58.454764794444522 -34.651491458935361,-58.45469988851189 -34.651154191081858,-58.454636260814745 -34.650823050204089,-58.453821035598786 -34.650902995969261,-58.453338598272893 -34.650948876756573,-58.45197471500753 -34.651078486621067,-58.448828188057099 -34.651175073581825,-58.445804758141733 -34.65104666015413,-58.444950686484773 -34.651010340561271,-58.444620215232376 -34.650948036624477,-58.444619947754795 -34.650948117302079,-58.444790571572646 -34.651203735588453,-58.447007275032703 -34.653009132826973,-58.447656148702073 -34.653537117553206,-58.448954091199383 -34.654592935685663,-58.448852406370925 -34.654668067232286,-58.448768364944215 -34.654730242583433,-58.446278407951489 -34.656692032196922,-58.446174500933061 -34.656773851519439,-58.445198411027484 -34.657550920920094,-58.445160711609901 -34.657688736383868,-58.44505032416545 -34.657774356728858,-58.444891689771822 -34.65789736537991,-58.444013179129342 -34.658594014514158,-58.444735179452913 -34.659233718827011,-58.444870326739412 -34.659353460398542,-58.445669629401749 -34.660062045581029,-58.444530847725567 -34.66097078025026,-58.445537683450858 -34.661766089447447,-58.44625675402142 -34.662334162280025,-58.44729648240034 -34.661504345112164,-58.448138342883659 -34.660832387293361,-58.448204397675461 -34.660825634409413,-58.448385111205617 -34.660680581222842,-58.448409916588147 -34.660661006112264,-58.44897609005023 -34.660213171102939,-58.449170694810377 -34.660059103958616,-58.449706769895435 -34.659638657315952,-58.449761238018503 -34.659595985833285,-58.451787095192508 -34.658006848608018)));;3177;8_14_4;COMUNA 8;14;4;2705;1310;1395;93,91%;671;669;99,70%;2;0,30%;793;247;31,15%;546;68,85%
MULTIPOLYGON (((-58.438784032742291 -34.656417826873628,-58.438864042001896 -34.65648037956867,-58.438987933042092 -34.65657723752264,-58.439624604925669 -34.65707385294202,-58.440030794136106 -34.65739006504208,-58.440188430807247 -34.657512773848602,-58.440560537576545 -34.657813061912861,-58.441158623686817 -34.658295647725403,-58.441551954923803 -34.658613049642049,-58.441813296915491 -34.658823875385373,-58.442770145809035 -34.659579831813531,-58.443536557765761 -34.660185253621492,-58.444530847725567 -34.66097078025026,-58.445669629401749 -34.660062045581029,-58.444870326739412 -34.659353460398542,-58.444735179452913 -34.659233718827011,-58.444013179129342 -34.658594014514158,-58.444891689771822 -34.65789736537991,-58.44505032416545 -34.657774356728858,-58.445160711609901 -34.657688736383868,-58.445198411027484 -34.657550920920094,-58.446174500933061 -34.656773851519439,-58.446278407951489 -34.656692032196922,-58.448768364944215 -34.654730242583433,-58.448852406370925 -34.654668067232286,-58.448954091199383 -34.654592935685663,-58.447656148702073 -34.653537117553206,-58.447007275032703 -34.653009132826973,-58.444790571572646 -34.651203735588453,-58.444619947754795 -34.650948117302079,-58.444406201079076 -34.651065684287232,-58.443638685318 -34.651153808805716,-58.443521503948602 -34.651167241538822,-58.443323957379896 -34.651189887044104,-58.443295372819421 -34.651342915245507,-58.443266121178389 -34.651432561154408,-58.443243012227136 -34.651492911385411,-58.443204728897591 -34.65157466827641,-58.44315715614772 -34.651657480035432,-58.443111717526484 -34.651724587423651,-58.443060143701878 -34.65178831342368,-58.443005417593845 -34.651847883838649,-58.442951631163702 -34.651897665356472,-58.442908415115639 -34.651934842556742,-58.442822921919735 -34.65200257714821,-58.442748083060714 -34.652062848411639,-58.442652190894059 -34.65213755321853,-58.441631546679965 -34.652932475182148,-58.441533180575618 -34.653009080135305,-58.440403491651587 -34.653889045654992,-58.4394861186206 -34.654603543368154,-58.438845687108603 -34.655102307625263,-58.438418086940395 -34.655491671230052,-58.438001925182725 -34.655806174289914,-58.438074349957432 -34.655862810307291,-58.438784032742291 -34.656417826873628)));;3178;8_14_5;COMUNA 8;14;5;1173;595;578;102,94%;358;358;100,00%;0;0,00%;385;53;13,77%;332;86,23%
MULTIPOLYGON (((-58.442479972102923 -34.662607334501054,-58.442294270678097 -34.662754491418411,-58.442203742948912 -34.66282538949055,-58.442117492889608 -34.662896577729725,-58.443244155319746 -34.663377198695038,-58.443442140312285 -34.663426668128402,-58.443562051303928 -34.663478941989617,-58.44456310902082 -34.663897627810677,-58.44474264301148 -34.663749269971163,-58.444786119803858 -34.66371335987305,-58.444981593224568 -34.663557468596494,-58.445369894827138 -34.663249628487137,-58.445849321865801 -34.662869544208647,-58.446390888448093 -34.66244009876511,-58.44625675402142 -34.662334162280025,-58.445537683450858 -34.661766089447447,-58.444530847725567 -34.66097078025026,-58.443536557765761 -34.660185253621492,-58.442486238843678 -34.661018980920588,-58.44148304145839 -34.661815241418594,-58.442322919551195 -34.662482516119631,-58.442479972102923 -34.662607334501054)));;3179;8_14_6;COMUNA 8;14;6;793;391;402;97,26%;220;219;99,55%;1;0,46%;250;8;3,20%;242;96,80%
MULTIPOLYGON (((-58.439981810715416 -34.661681516467993,-58.440072713218392 -34.661718819653082,-58.439901380746271 -34.661860746678094,-58.43979653024229 -34.661945996298293,-58.440064553253087 -34.662057810061157,-58.440476520036192 -34.66222028478159,-58.440513249066917 -34.662242475192969,-58.440552146027606 -34.662445516137005,-58.440643078695459 -34.662483280159925,-58.440712983834551 -34.662427375723823,-58.442022780737979 -34.662972056775097,-58.442117492889608 -34.662896577729725,-58.442203742948912 -34.66282538949055,-58.442294270678097 -34.662754491418411,-58.442479972102923 -34.662607334501054,-58.442322919551195 -34.662482516119631,-58.44148304145839 -34.661815241418594,-58.442486238843678 -34.661018980920588,-58.443536557765761 -34.660185253621492,-58.442770145809035 -34.659579831813531,-58.441813296915491 -34.658823875385373,-58.441551954923803 -34.658613049642049,-58.441158623686817 -34.658295647725403,-58.440560537576545 -34.657813061912861,-58.440188430807247 -34.657512773848602,-58.440030794136106 -34.65739006504208,-58.439624604925669 -34.65707385294202,-58.438987933042092 -34.65657723752264,-58.438864042001896 -34.65648037956867,-58.438784032742291 -34.656417826873628,-58.438074349957432 -34.655862810307291,-58.438001925182725 -34.655806174289914,-58.437643955363839 -34.656167308959247,-58.437022895503198 -34.6567855779968,-58.438345817761487 -34.657816935557882,-58.439051856825593 -34.65836272404627,-58.439464526726354 -34.658681685781154,-58.440343899914637 -34.659361447113589,-58.440480152902218 -34.659466827142914,-58.439505342155137 -34.660243146597111,-58.438928375183281 -34.660702696410105,-58.438445700782019 -34.661046695601449,-58.439981810715416 -34.661681516467993)));;3180;8_14_7;COMUNA 8;14;7;949;434;515;84,27%;302;301;99,67%;1;0,33%;297;15;5,05%;282;94,95%
MULTIPOLYGON (((-58.439505342155137 -34.660243146597111,-58.440480152902218 -34.659466827142914,-58.440343899914637 -34.659361447113589,-58.439464526726354 -34.658681685781154,-58.439051856825593 -34.65836272404627,-58.438345817761487 -34.657816935557882,-58.437022895503198 -34.6567855779968,-58.43620207641041 -34.657602538690305,-58.435366832958877 -34.658433857121793,-58.435228206692663 -34.658571787673317,-58.434573091127923 -34.659230107870037,-58.434420649936996 -34.659383316423614,-58.435577392449034 -34.659861339333055,-58.437156664821579 -34.660514022907861,-58.438445700782019 -34.661046695601449,-58.438928375183281 -34.660702696410105,-58.439505342155137 -34.660243146597111)));;3181;8_14_8;COMUNA 8;14;8;798;377;421;89,55%;298;298;100,00%;0;0,00%;259;15;5,79%;244;94,21%
MULTIPOLYGON (((-58.435180434749498 -34.656900601958533,-58.43620207641041 -34.657602538690305,-58.437022895503198 -34.6567855779968,-58.437643955363839 -34.656167308959247,-58.438001925182725 -34.655806174289914,-58.437097901142032 -34.655101601051193,-58.436021237223308 -34.654370785428625,-58.435061016849986 -34.653610197054405,-58.434433517654433 -34.653113066690914,-58.433082729650025 -34.654100451276065,-58.432117739710115 -34.654805726740179,-58.431992596945562 -34.654896543020783,-58.43313947205948 -34.655587198746318,-58.434186331736733 -34.656217607245807,-58.435180434749498 -34.656900601958533)));;3182;8_14_9;COMUNA 8;14;9;1011;499;512;97,46%;257;257;100,00%;0;0,00%;336;72;21,43%;264;78,57%
MULTIPOLYGON (((-58.458393572909941 -34.67316260252111,-58.458397234007641 -34.673246830220322,-58.45840115053695 -34.673336973575843,-58.45845714969419 -34.673448316494188,-58.458612284720466 -34.673610157033522,-58.458782681748993 -34.673713123078024,-58.459003631430349 -34.673755877578643,-58.459226971100598 -34.673728277787866,-58.459405303884381 -34.673652435676594,-58.45954655699493 -34.67353476026485,-58.459636920533576 -34.673386800932612,-58.459665226857439 -34.673234966659237,-58.459765994489921 -34.672945736152663,-58.45980955696993 -34.672848762803952,-58.459865138422373 -34.672756015181911,-58.459932142079893 -34.67266862004707,-58.460029748121805 -34.672566718122546,-58.461787548665356 -34.671186355190521,-58.461734358457292 -34.671167058491584,-58.461766835604919 -34.671139874920968,-58.461661819219138 -34.671094802447065,-58.461621585060755 -34.671126774781676,-58.461566008181393 -34.671107477987981,-58.46150412353397 -34.671085504979459,-58.461567543489245 -34.671036208495011,-58.461566957166355 -34.67103594833852,-58.461845772106294 -34.670817613374915,-58.46189828013069 -34.67084317779495,-58.462153918365665 -34.670645145744437,-58.462377590340438 -34.670427394233016,-58.462513378492829 -34.670268939565517,-58.462705083545167 -34.670004988962965,-58.46282893684144 -34.6698564637773,-58.4629532158825 -34.669704346815386,-58.463044592226474 -34.669592512595315,-58.463081245038452 -34.669559976398801,-58.463372079825717 -34.669302080867745,-58.46341435824786 -34.669279403959329,-58.463634232355226 -34.669161616381089,-58.463667687344952 -34.669143694323907,-58.463688669515477 -34.669148035911299,-58.46479575177618 -34.668871845218376,-58.464821730350167 -34.66884536178074,-58.465009506383119 -34.668673241034291,-58.465291468303455 -34.668446961630366,-58.467752010079373 -34.666525775770999,-58.467940543508803 -34.666378510250922,-58.468644897285067 -34.665849519734365,-58.468892322313195 -34.665662037464266,-58.469130796609456 -34.665475611525949,-58.469734903969282 -34.665003170742089,-58.470162411473858 -34.664668910713154,-58.470162162598868 -34.664666881220079,-58.470360305931884 -34.664453540351325,-58.470411949799512 -34.664366703698036,-58.470443214008718 -34.664283107399818,-58.470460703500962 -34.664113909741346,-58.470457943230755 -34.664012888123949,-58.470425113649618 -34.663855632307609,-58.470393862486958 -34.663768636820436,-58.470184251880511 -34.663609540951775,-58.469978977455817 -34.663584666286887,-58.469655321811324 -34.663642653194771,-58.46964132229823 -34.663651660309696,-58.469382602650214 -34.663818116713109,-58.469268329813659 -34.663856442275325,-58.468890224794187 -34.663818606189409,-58.468655658238575 -34.663764391009636,-58.468482031725863 -34.663679115298962,-58.468299110444434 -34.663524049086469,-58.467356044898075 -34.662717798577667,-58.466830564621922 -34.662264213221491,-58.465615376209954 -34.661217599086058,-58.464541016778782 -34.660116743717118,-58.464425103267999 -34.660065405921621,-58.464061252743249 -34.659760401829594,-58.461580336160893 -34.657878519302649,-58.461489482444939 -34.65796485895283,-58.461336075051463 -34.657832177449777,-58.460539216775054 -34.657141441736087,-58.46039263032327 -34.657016505852276,-58.460260617669256 -34.656903964807888,-58.45995788565321 -34.657136570752535,-58.459850072449647 -34.657178682176195,-58.459595919097126 -34.657372766096238,-58.459519809228318 -34.657430864407068,-58.459246903764395 -34.657639172864094,-58.45895132565547 -34.657864945300794,-58.458707395807082 -34.658051140109421,-58.458654808411694 -34.65809128037791,-58.458349681188338 -34.658324304751908,-58.458230186772653 -34.658415429811967,-58.458022392001745 -34.65857401812562,-58.457715727056048 -34.658808238053005,-58.457662968234601 -34.658848589155319,-58.45740727049828 -34.659043795188744,-58.457121825168251 -34.659261816876757,-58.456728216714872 -34.659562299784355,-58.455916181478464 -34.660260657502704,-58.455470495031982 -34.660625444906422,-58.456093218442909 -34.661118263007921,-58.455590134375427 -34.661472971778764,-58.455303063216796 -34.661801727678551,-58.455274669432619 -34.661906447750802,-58.455218020114771 -34.66200234872845,-58.455172231044408 -34.662160635439776,-58.454931817355821 -34.662417666837648,-58.454618128787409 -34.662031896119657,-58.454574066363222 -34.662007667156487,-58.4545245433359 -34.662042523982571,-58.454491475973711 -34.662016746386946,-58.454452944491081 -34.662084985145,-58.454432734325252 -34.66218808526969,-58.454415336007223 -34.662298791428057,-58.454409530602554 -34.662395483892418,-58.454438232177189 -34.662613449708779,-58.454485519963541 -34.662776978618282,-58.454544147946791 -34.662898957804288,-58.454508603032814 -34.662928674563879,-58.454323717927139 -34.663083243795541,-58.454356272951109 -34.663122120355233,-58.4541588567076 -34.663288167667908,-58.453974987813673 -34.663491751886049,-58.453917373354201 -34.663461606062583,-58.453831117226898 -34.663463149157607,-58.453604820878574 -34.663484118987633,-58.453060851823146 -34.663577812205453,-58.452875147901388 -34.663413426595511,-58.452535105469508 -34.663104728117212,-58.452366838002909 -34.66324908420782,-58.45205723799473 -34.663514557950727,-58.451685938343516 -34.663694037024577,-58.451291289228095 -34.663828722799231,-58.450839255346025 -34.664112349531408,-58.450544733591443 -34.66431230171294,-58.450521983511933 -34.664327746777303,-58.449952634902751 -34.664787278793227,-58.449958153454631 -34.664928973435011,-58.450246486206979 -34.665036752688813,-58.450143672423614 -34.665173576913247,-58.450132697197184 -34.665188178830327,-58.450283646769343 -34.665238522625593,-58.450481855649812 -34.665296345574127,-58.450706297064194 -34.665371029969158,-58.450916163015833 -34.665452937907446,-58.451024010441031 -34.665498708929995,-58.451061902698555 -34.665515571738446,-58.451280508999012 -34.665636015161986,-58.451456830348157 -34.66589253200285,-58.45155578759973 -34.666047398885958,-58.451593806000673 -34.666106897040812,-58.451678320665884 -34.666258637362503,-58.451789058345867 -34.666504309704237,-58.451838153982706 -34.666708936061639,-58.451932634821844 -34.666748580097639,-58.452077529237386 -34.666808805724685,-58.452165030524178 -34.667098680400812,-58.451942659980439 -34.667001968198306,-58.45194170462355 -34.667139295811232,-58.451995208251198 -34.667334939665807,-58.452109740455008 -34.667543194784628,-58.452300647649544 -34.667738920775051,-58.452529831353637 -34.667903029081195,-58.453560986954599 -34.668360658379115,-58.454057463312417 -34.668707816667137,-58.458153645756859 -34.672573705031347,-58.458210924034503 -34.672660470010335,-58.458315930845728 -34.672889282689717,-58.458393572909941 -34.67316260252111)));;3183;8_15_1;COMUNA 8;15;1;2797;1401;1396;100,36%;499;499;100,00%;0;0,00%;852;403;47,30%;449;52,70%
MULTIPOLYGON (((-58.450544733591457 -34.66431230171294,-58.450839255346011 -34.664112349531422,-58.451291289228095 -34.663828722799252,-58.451685938343516 -34.663694037024577,-58.450873588959311 -34.66302253372077,-58.450784629890734 -34.662948996354885,-58.450495201568685 -34.662709741187115,-58.449359545127365 -34.661771004268978,-58.449479225247245 -34.661675380804738,-58.45013976094792 -34.661157900803964,-58.449109372015606 -34.660320372179903,-58.44897609005023 -34.660213171102939,-58.448409916588147 -34.660661006112264,-58.448385111205617 -34.660680581222842,-58.448204397675461 -34.660825634409413,-58.448138342883659 -34.660832387293361,-58.44729648240034 -34.661504345112164,-58.44625675402142 -34.662334162280025,-58.446390888448093 -34.66244009876511,-58.445849321865801 -34.662869544208647,-58.445369894827138 -34.663249628487137,-58.444981593224568 -34.663557468596494,-58.444786119803858 -34.66371335987305,-58.44474264301148 -34.663749269971163,-58.44456310902082 -34.663897627810677,-58.44527824192884 -34.664195346010253,-58.446887501453133 -34.664865231811653,-58.447727596013756 -34.665214925009934,-58.44896537831054 -34.66573015536985,-58.449004165660035 -34.665698539143776,-58.449148999913191 -34.665580523905575,-58.449170481895891 -34.665564046963709,-58.449700282787276 -34.665158177905212,-58.449741529461669 -34.665203253964584,-58.449791301886385 -34.665234105167499,-58.449843209455054 -34.665237561452017,-58.449957339623978 -34.665234122634565,-58.450077694531991 -34.665213571205925,-58.450121336384051 -34.665203293742117,-58.450132697197184 -34.665188178830299,-58.450143672423614 -34.665173576913261,-58.450246486206986 -34.665036752688813,-58.449958153454638 -34.664928973435011,-58.449952634902751 -34.664787278793241,-58.450521983511933 -34.664327746777303,-58.450544733591457 -34.66431230171294)));;3184;8_15_10;COMUNA 8;15;10;1264;596;668;89,22%;379;377;99,47%;2;0,53%;389;56;14,40%;333;85,60%
MULTIPOLYGON (((-58.454963579795127 -34.661040341226439,-58.454668232150482 -34.661282019110494,-58.453766406592301 -34.662048738571208,-58.453635307963239 -34.662161196849517,-58.453447439085672 -34.66232238445442,-58.453252238811082 -34.662489768554785,-58.453145517626837 -34.662581312104706,-58.452535105469508 -34.663104728117212,-58.452875147901388 -34.663413426595511,-58.453060851823146 -34.663577812205453,-58.453604820878574 -34.663484118987633,-58.453831117226898 -34.663463149157607,-58.453917373354201 -34.663461606062583,-58.453974987813673 -34.663491751886049,-58.4541588567076 -34.663288167667908,-58.454356272951109 -34.663122120355233,-58.454323717927139 -34.663083243795541,-58.454508603032814 -34.662928674563879,-58.454544147946791 -34.662898957804288,-58.454485519963541 -34.662776978618282,-58.454438232177189 -34.662613449708779,-58.454409530602554 -34.662395483892418,-58.454415336007223 -34.662298791428057,-58.454432734325252 -34.66218808526969,-58.454452944491081 -34.662084985145,-58.454491475973711 -34.662016746386946,-58.4545245433359 -34.662042523982571,-58.454574066363222 -34.662007667156487,-58.454618128787409 -34.662031896119657,-58.454931817355821 -34.662417666837648,-58.455172231044408 -34.662160635439776,-58.455218020114771 -34.66200234872845,-58.455275346844054 -34.661903949370028,-58.455303063216796 -34.661801727678551,-58.455590134375427 -34.661472971778764,-58.456093218442909 -34.661118263007921,-58.455470495031982 -34.660625444906422,-58.454963579795127 -34.661040341226439)));;3185;8_15_2;COMUNA 8;15;2;2428;1201;1227;97,88%;495;495;100,00%;0;0,00%;655;242;36,95%;413;63,05%
MULTIPOLYGON (((-58.452551377568746 -34.661067911568679,-58.452065766016659 -34.661476332438433,-58.452418500455899 -34.661777638803677,-58.453252238811082 -34.662489768554785,-58.453447439085672 -34.66232238445442,-58.453635307963239 -34.662161196849517,-58.453766406592301 -34.662048738571208,-58.454668232150482 -34.661282019110494,-58.454963579795127 -34.661040341226439,-58.455470495031982 -34.660625444906422,-58.455916181478464 -34.660260657502704,-58.455787917047608 -34.660181774814411,-58.45544199468403 -34.659890197110364,-58.454702432920101 -34.659266611904108,-58.453790401820477 -34.66003459876962,-58.453370947099856 -34.660387816887365,-58.452551377568746 -34.661067911568679)));;3186;8_15_3;COMUNA 8;15;3;2431;1184;1247;94,95%;147;147;100,00%;0;0,00%;667;128;19,19%;539;80,81%
MULTIPOLYGON (((-58.454702432920101 -34.659266611904116,-58.454475991043182 -34.659079090953369,-58.454159485918616 -34.658816984734585,-58.453562344746175 -34.65832234977055,-58.45263479945551 -34.659110186671157,-58.452146386361804 -34.659525016396891,-58.45337094709987 -34.660387816887351,-58.453790401820477 -34.66003459876962,-58.454702432920101 -34.659266611904116)));;3187;8_15_4;COMUNA 8;15;4;931;476;455;104,62%;101;101;100,00%;0;0,00%;231;52;22,51%;179;77,49%
MULTIPOLYGON (((-58.455787917047608 -34.660181774814411,-58.455916181478464 -34.660260657502704,-58.456708595300334 -34.659579174582895,-58.455587146848892 -34.658592219575809,-58.455733427617751 -34.658474469349692,-58.455486360415371 -34.658250394187831,-58.455180598486301 -34.657973084048173,-58.454914370219051 -34.657731581499185,-58.454599227815365 -34.657442327260078,-58.453716099479024 -34.6567094272527,-58.452735905849167 -34.657475922597179,-58.452630214606089 -34.657556268349445,-58.453562344746175 -34.65832234977055,-58.454159485918616 -34.658816984734571,-58.454475991043182 -34.659079090953362,-58.454702432920101 -34.659266611904108,-58.45544199468403 -34.659890197110364,-58.455787917047608 -34.660181774814411)));;3188;8_15_5;COMUNA 8;15;5;3385;1673;1712;97,72%;639;639;100,00%;0;0,00%;877;188;21,44%;689;78,56%
MULTIPOLYGON (((-58.453562344746175 -34.65832234977055,-58.452630214606089 -34.657556268349452,-58.451117097522058 -34.65874419637877,-58.4510030503953 -34.658826863919771,-58.451372049149832 -34.659123034008942,-58.451463745330443 -34.659196565725523,-58.451648349913057 -34.659204047600497,-58.452146386361804 -34.659525016396891,-58.45263479945551 -34.659110186671157,-58.453562344746175 -34.65832234977055)));;3189;8_15_6;COMUNA 8;15;6;881;477;404;118,07%;188;188;100,00%;0;0,00%;233;38;16,31%;195;83,69%
MULTIPOLYGON (((-58.451372049149832 -34.659123034008942,-58.4510030503953 -34.658826863919771,-58.451117097522058 -34.65874419637877,-58.452630214606089 -34.657556268349452,-58.452494886710689 -34.657452099157879,-58.452388854034176 -34.65753505038176,-58.452254778647188 -34.65763997157881,-58.451787095192508 -34.658006848608018,-58.449761238018503 -34.659595985833285,-58.449896224138726 -34.659706144072707,-58.450249456561238 -34.659994357886603,-58.450758984786823 -34.660410124909014,-58.450917920588708 -34.660538876423509,-58.451089934226424 -34.660401565078544,-58.451373611905325 -34.66016538785874,-58.451933972866129 -34.659698946455563,-58.452146386361804 -34.659525016396891,-58.451648349913057 -34.659204047600497,-58.451463745330443 -34.659196565725523,-58.451372049149832 -34.659123034008942)));;3190;8_15_7;COMUNA 8;15;7;929;455;474;95,99%;225;225;100,00%;0;0,00%;259;58;22,39%;201;77,61%
MULTIPOLYGON (((-58.451373611905325 -34.66016538785874,-58.451089934226424 -34.660401565078544,-58.450917920588708 -34.660538876423509,-58.451102934421314 -34.660688687147037,-58.451943046729895 -34.661371529979228,-58.452065766016659 -34.661476332438433,-58.45255137756876 -34.661067911568679,-58.45337094709987 -34.660387816887351,-58.452146386361804 -34.659525016396891,-58.451933972866129 -34.659698946455563,-58.451373611905325 -34.66016538785874)));;3191;8_15_8;COMUNA 8;15;8;1357;648;709;91,40%;298;298;100,00%;0;0,00%;358;79;22,07%;279;77,93%
MULTIPOLYGON (((-58.452418500455934 -34.661777638803692,-58.452065766016659 -34.661476332438433,-58.451943046729895 -34.661371529979228,-58.451102934421314 -34.660688687147037,-58.450917920588708 -34.660538876423509,-58.450758984786823 -34.660410124909014,-58.450249456561238 -34.659994357886603,-58.449896224138726 -34.659706144072707,-58.449761238018503 -34.659595985833285,-58.449706769895435 -34.659638657315952,-58.449170694810377 -34.660059103958616,-58.44897609005023 -34.660213171102939,-58.449109372015606 -34.660320372179903,-58.45013976094792 -34.661157900803964,-58.449479225247245 -34.661675380804738,-58.449359545127365 -34.661771004268978,-58.450495201568685 -34.662709741187115,-58.450784629890734 -34.662948996354885,-58.450873588959311 -34.66302253372077,-58.451685938343516 -34.663694037024577,-58.45205723799473 -34.663514557950727,-58.452366838002924 -34.663249084207813,-58.452535105469508 -34.663104728117212,-58.453145517626837 -34.662581312104706,-58.453252238811096 -34.662489768554792,-58.452418500455934 -34.661777638803692)));;3192;8_15_9;COMUNA 8;15;9;1722;800;922;86,77%;272;272;100,00%;0;0,00%;519;95;18,30%;424;81,70%
MULTIPOLYGON (((-58.447727596013756 -34.665214925009934,-58.4466438051615 -34.665361833409875,-58.446706129729478 -34.665713259743747,-58.446862540323927 -34.665694828949825,-58.446923930352689 -34.666036325181409,-58.446717228212492 -34.666064045500519,-58.446805107887393 -34.666502308458313,-58.446974318658803 -34.667315803356608,-58.44896537831054 -34.66573015536985,-58.447727596013756 -34.665214925009934)));;3193;8_16_1;COMUNA 8;16;1;1045;501;544;92,10%;309;309;100,00%;0;0,00%;299;9;3,01%;290;96,99%
MULTIPOLYGON (((-58.445232114157072 -34.666400066637259,-58.445406340838765 -34.666145305073606,-58.444123094477035 -34.66559831289932,-58.443484913846156 -34.66532698782197,-58.443130234575271 -34.66503715616863,-58.442158452635397 -34.66580990495558,-58.440947088700639 -34.666773101556174,-58.441337127361976 -34.667120010992228,-58.442756618471556 -34.666949542573164,-58.442762153325312 -34.666972642701431,-58.442829235761828 -34.666968005639205,-58.44280130348276 -34.666861871420835,-58.443918537648905 -34.666695917346615,-58.444785113343805 -34.667074713858852,-58.445232114157072 -34.666400066637259)));;3194;8_16_10;COMUNA 8;16;10;934;440;494;89,07%;272;272;100,00%;0;0,00%;279;28;10,04%;251;89,96%
MULTIPOLYGON (((-58.446887501453133 -34.664865231811653,-58.44527824192884 -34.664195346010253,-58.445385233457181 -34.664904395002885,-58.445260103444234 -34.664930927198355,-58.445274406162675 -34.665010720183503,-58.44534941397383 -34.665004815224584,-58.445420822290856 -34.665503994083302,-58.446159057442451 -34.665440573598126,-58.446180513254788 -34.665558748780789,-58.446330700778518 -34.665543979898132,-58.446302088484835 -34.665408127235089,-58.4466438051615 -34.665361833409875,-58.447727596013756 -34.665214925009934,-58.446887501453133 -34.664865231811653)));;3195;8_16_2;COMUNA 8;16;2;617;281;336;83,63%;185;185;100,00%;0;0,00%;183;10;5,46%;173;94,54%
MULTIPOLYGON (((-58.443130234575271 -34.66503715616863,-58.443484913846156 -34.66532698782197,-58.444123094477035 -34.66559831289932,-58.445420822290856 -34.665503994083302,-58.44534941397383 -34.665004815224584,-58.445274406162675 -34.665010720183503,-58.445260103444234 -34.664930927198355,-58.445385233457181 -34.664904395002885,-58.44527824192884 -34.664195346010253,-58.44456310902082 -34.663897627810677,-58.444339331544363 -34.664075557014741,-58.443130234575271 -34.66503715616863)));;3196;8_16_3;COMUNA 8;16;3;1118;519;599;86,64%;316;316;100,00%;0;0,00%;289;1;0,35%;288;99,65%
MULTIPOLYGON (((-58.444123094477035 -34.66559831289932,-58.445406340838765 -34.666145305073606,-58.445232114157072 -34.666400066637259,-58.446133397975395 -34.666315453346058,-58.4461724718441 -34.666564690837426,-58.446805107887393 -34.666502308458313,-58.446717228212492 -34.666064045500519,-58.446923930352689 -34.666036325181409,-58.446862540323927 -34.665694828949825,-58.446706129729478 -34.665713259743747,-58.4466438051615 -34.665361833409875,-58.446302088484835 -34.665408127235089,-58.446330700778518 -34.665543979898132,-58.446180513254788 -34.665558748780789,-58.446159057442451 -34.665440573598126,-58.445420822290856 -34.665503994083302,-58.444123094477035 -34.66559831289932)));;3197;8_16_4;COMUNA 8;16;4;942;438;504;86,90%;309;309;100,00%;0;0,00%;266;2;0,75%;264;99,25%
MULTIPOLYGON (((-58.446805107887393 -34.666502308458313,-58.4461724718441 -34.666564690837426,-58.446133397975395 -34.666315453346058,-58.445232114157072 -34.666400066637259,-58.444785113343805 -34.667074713858852,-58.444732273943323 -34.667147839206628,-58.445256242351661 -34.667086126753041,-58.445284162392056 -34.66726606523536,-58.445703111001521 -34.667224644358079,-58.445775642841284 -34.667667694695865,-58.446071765182239 -34.667630833031303,-58.446334428695273 -34.667825380910145,-58.446974318658803 -34.667315803356608,-58.446805107887393 -34.666502308458313)));;3198;8_16_5;COMUNA 8;16;5;976;461;515;89,51%;348;348;100,00%;0;0,00%;294;2;0,68%;292;99,32%
MULTIPOLYGON (((-58.444640858499064 -34.667354249834467,-58.444696464009809 -34.667694562974269,-58.444752133445022 -34.667740574271896,-58.445572876108777 -34.668431842065338,-58.446334428695273 -34.667825380910145,-58.446071765182239 -34.667630833031303,-58.445775642841284 -34.667667694695865,-58.445703111001521 -34.667224644358079,-58.445284162392056 -34.66726606523536,-58.445256242351661 -34.667086126753041,-58.444732273943323 -34.667147839206628,-58.444632304771254 -34.66729762937652,-58.444640858499064 -34.667354249834467)));;3199;8_16_6;COMUNA 8;16;6;830;378;452;83,63%;271;271;100,00%;0;0,00%;267;3;1,12%;264;98,88%
MULTIPOLYGON (((-58.444752133445022 -34.667740574271896,-58.444057901708057 -34.667826673818595,-58.444082503763845 -34.667968019448587,-58.443934527539149 -34.667983278866593,-58.443895962716368 -34.667771295330247,-58.443169719100439 -34.667854211578117,-58.442617798389982 -34.668235822419234,-58.442647455037388 -34.668261532223411,-58.442685378054492 -34.668294497095481,-58.443088386624929 -34.668644431224315,-58.443415103486146 -34.6690217470628,-58.443438282244152 -34.669048582437455,-58.443508244737707 -34.669129370299167,-58.443749608915581 -34.66927244008324,-58.443955436989121 -34.669380714257962,-58.444118492231553 -34.669413838702816,-58.444321626650215 -34.669371896533313,-58.444482916525068 -34.669292974951858,-58.445572876108777 -34.668431842065338,-58.444752133445022 -34.667740574271896)));;3200;8_16_7;COMUNA 8;16;7;1041;481;560;85,89%;287;287;100,00%;0;0,00%;276;4;1,45%;272;98,55%
MULTIPOLYGON (((-58.444752133445022 -34.667740574271896,-58.444696464009809 -34.667694562974269,-58.444640858499064 -34.667354249834467,-58.44403480582401 -34.667430955284573,-58.444046893283549 -34.667503353473968,-58.443836777960172 -34.667527054185868,-58.443828950865736 -34.667462051203238,-58.443611078087535 -34.667489694094741,-58.443588771357568 -34.667378912932335,-58.442851447800351 -34.667471121580718,-58.442873755771252 -34.667572677273043,-58.441983679227562 -34.667684715428187,-58.442445824325809 -34.668086564567496,-58.442617798389982 -34.668235822419234,-58.443169719100439 -34.667854211578117,-58.443895962716368 -34.667771295330247,-58.443934527539149 -34.667983278866593,-58.444082503763845 -34.667968019448587,-58.444057901708057 -34.667826673818595,-58.444752133445022 -34.667740574271896)));;3201;8_16_8;COMUNA 8;16;8;804;359;445;80,67%;237;237;100,00%;0;0,00%;236;4;1,69%;232;98,31%
MULTIPOLYGON (((-58.444640858499064 -34.667354249834467,-58.444632304771254 -34.66729762937652,-58.444732273943323 -34.667147839206628,-58.444785113343805 -34.667074713858852,-58.443918537648905 -34.666695917346615,-58.44280130348276 -34.666861871420835,-58.442829235761828 -34.666968005639205,-58.442762153325312 -34.666972642701431,-58.442756618471556 -34.666949542573164,-58.441337127361976 -34.667120010992228,-58.441461545010441 -34.66723066955312,-58.441983679227562 -34.667684715428187,-58.442873755771252 -34.667572677273043,-58.442851447800351 -34.667471121580718,-58.443588771357568 -34.667378912932335,-58.443611078087535 -34.667489694094741,-58.443828950865736 -34.667462051203238,-58.443836777960172 -34.667527054185868,-58.444046893283549 -34.667503353473968,-58.44403480582401 -34.667430955284573,-58.444640858499064 -34.667354249834467)));;3202;8_16_9;COMUNA 8;16;9;915;440;475;92,63%;318;318;100,00%;0;0,00%;280;3;1,07%;277;98,93%
MULTIPOLYGON (((-58.496117350948971 -34.678169787357767,-58.496115315334933 -34.678171397564356,-58.495390444310324 -34.677506999695069,-58.4947347445001 -34.676906031614386,-58.494618431301198 -34.676811200534971,-58.493586889747014 -34.677581908549335,-58.494216885341416 -34.678073238707093,-58.494198309251601 -34.678769810512236,-58.495284897584185 -34.678786638002173,-58.495299370345158 -34.678775915540541,-58.495577198962721 -34.679044637389872,-58.495970371466477 -34.679424918269859,-58.496820022172201 -34.67878294062362,-58.496405767776686 -34.678421462440774,-58.496117350948971 -34.678169787357767)));;3203;8_2_1;COMUNA 8;2;1;1282;573;709;80,82%;411;411;100,00%;0;0,00%;387;9;2,33%;378;97,67%
MULTIPOLYGON (((-58.489755268913761 -34.681264391106957,-58.490259757676625 -34.681691401411697,-58.490837417838975 -34.68217684488328,-58.491119360404312 -34.68241610708742,-58.491539430678301 -34.682772583496941,-58.492332570639306 -34.682173382000215,-58.49188843804675 -34.681831409968467,-58.491560939147838 -34.681579240386519,-58.491552991326664 -34.68158553614154,-58.49145101938646 -34.681554080579119,-58.491368062453617 -34.6815336770741,-58.490801265462018 -34.68140387624571,-58.490730835708334 -34.681368328194921,-58.490611111976911 -34.681277085784856,-58.490549885857845 -34.681230478906791,-58.489831932158154 -34.681071200226214,-58.490034025314515 -34.680438392744342,-58.490108968430349 -34.680203581284594,-58.489337912470653 -34.680040790378527,-58.489557231900605 -34.679422275950031,-58.489794662592168 -34.678670232524389,-58.488516527915564 -34.678394587414992,-58.4882883026632 -34.678345408932259,-58.487859609686474 -34.678133873059963,-58.487831217806544 -34.678119864475022,-58.487658223635513 -34.678034475304564,-58.487582798691164 -34.678100055776518,-58.487020730011061 -34.678588914051076,-58.486815332038489 -34.678765860761089,-58.487549166931146 -34.679379743015062,-58.487885134933848 -34.679660807924975,-58.488315160223713 -34.68002051611915,-58.489672040237913 -34.681192506347777,-58.489755268913761 -34.681264391106957)));;3204;8_2_10;COMUNA 8;2;10;540;251;289;86,85%;191;191;100,00%;0;0,00%;188;1;0,53%;187;99,47%
MULTIPOLYGON (((-58.493848311841504 -34.676129339940211,-58.493324214854603 -34.675656009793649,-58.492386056599059 -34.676527954509034,-58.492410804239356 -34.676839857908305,-58.491787311251478 -34.677334880126814,-58.492019422287925 -34.677526942112387,-58.492319920791402 -34.677289821144413,-58.493069577749232 -34.677968386421803,-58.493586889747014 -34.677581908549335,-58.494618431301198 -34.676811200534971,-58.494462210476321 -34.676683843700324,-58.493848311841504 -34.676129339940211)));;3205;8_2_2;COMUNA 8;2;2;535;259;276;93,84%;184;183;99,46%;1;0,55%;168;1;0,60%;167;99,40%
MULTIPOLYGON (((-58.493586889747014 -34.677581908549335,-58.493069577749232 -34.677968386421803,-58.492908572267837 -34.678749854755665,-58.494198309251601 -34.678769810512236,-58.494216885341416 -34.678073238707093,-58.493586889747014 -34.677581908549335)));;3206;8_2_3;COMUNA 8;2;3;515;238;277;85,92%;182;182;100,00%;0;0,00%;161;2;1,24%;159;98,76%
MULTIPOLYGON (((-58.492319920791402 -34.677289821144413,-58.492019422287925 -34.677526942112387,-58.491667787415039 -34.677804357212331,-58.491267998038147 -34.678119741294744,-58.49164430835237 -34.67843620987469,-58.491985403355208 -34.678723107525812,-58.492244991791445 -34.678739594599499,-58.492908572267837 -34.678749854755665,-58.493069577749232 -34.677968386421803,-58.492319920791402 -34.677289821144413)));;3207;8_2_4;COMUNA 8;2;4;800;385;415;92,77%;292;292;100,00%;0;0,00%;249;7;2,81%;242;97,19%
MULTIPOLYGON (((-58.493324214854603 -34.675656009793649,-58.491708812488177 -34.674196930342504,-58.491279742842138 -34.674632508345823,-58.491067316505429 -34.674848154621209,-58.489971164182052 -34.675921601618967,-58.490359027937011 -34.676162365520952,-58.490711958488447 -34.676196229468417,-58.490867887544958 -34.676236828388134,-58.491105860731125 -34.676385931941276,-58.49120437373697 -34.676541828453722,-58.491212677505089 -34.676643519269327,-58.491188094612511 -34.676799444518586,-58.490991232109529 -34.676969001762785,-58.490884525828683 -34.677036774698877,-58.490654798678044 -34.677077532867813,-58.49036496410077 -34.677350704582146,-58.490880689416223 -34.677790879396319,-58.491123972467598 -34.67799857469101,-58.491267998038147 -34.678119741294744,-58.491667787415039 -34.677804357212331,-58.492019422287925 -34.677526942112387,-58.491787311251478 -34.677334880126814,-58.492410804239356 -34.676839857908305,-58.492386056599059 -34.676527954509034,-58.493324214854603 -34.675656009793649)));;3208;8_2_5;COMUNA 8;2;5;561;268;293;91,47%;194;194;100,00%;0;0,00%;174;3;1,72%;171;98,28%
MULTIPOLYGON (((-58.489971164182052 -34.675921601618967,-58.489354165131537 -34.676487949881931,-58.49036496410077 -34.677350704582146,-58.490654798678044 -34.677077532867813,-58.490884525828683 -34.677036774698877,-58.490991232109529 -34.676969001762785,-58.491188094612511 -34.676799444518586,-58.491212677505089 -34.676643519269327,-58.49120437373697 -34.676541828453722,-58.491105860731125 -34.676385931941276,-58.490867887544958 -34.676236828388134,-58.490711958488447 -34.676196229468417,-58.490359027937011 -34.676162365520952,-58.489971164182052 -34.675921601618967)));;3209;8_2_6;COMUNA 8;2;6;698;313;385;81,30%;261;261;100,00%;0;0,00%;249;1;0,40%;248;99,60%
MULTIPOLYGON (((-58.488749172623997 -34.677038658202079,-58.488621764403753 -34.677154674253316,-58.487964093677761 -34.677753419206113,-58.487836429439476 -34.677875772666461,-58.487742342889597 -34.677966005601853,-58.487658223635513 -34.678034475304592,-58.487831217806544 -34.678119864475022,-58.487859609686474 -34.67813387305997,-58.488288302663186 -34.678345408932273,-58.488516527915579 -34.678394587414992,-58.489794662592161 -34.678670232524389,-58.489971907249036 -34.67870843340588,-58.490085749049243 -34.678295862184072,-58.48981113388249 -34.678203174729951,-58.48978614403164 -34.677904158577,-58.490079322324291 -34.677677256300107,-58.490079296875308 -34.677599930385448,-58.49036496410077 -34.677350704582146,-58.489354165131537 -34.676487949881931,-58.488749172623997 -34.677038658202079)));;3210;8_2_7;COMUNA 8;2;7;1226;567;659;86,04%;456;456;100,00%;0;0,00%;404;2;0,50%;402;99,50%
MULTIPOLYGON (((-58.490880689416223 -34.677790879396319,-58.49036496410077 -34.677350704582146,-58.490079296875308 -34.677599930385448,-58.490079322324291 -34.677677256300107,-58.48978614403164 -34.677904158577,-58.48981113388249 -34.678203174729951,-58.490085749049243 -34.678295862184072,-58.489971907249036 -34.67870843340588,-58.490428021006345 -34.678806783708957,-58.490516259949715 -34.678825778171969,-58.491975748251008 -34.679145092371122,-58.492234329238251 -34.679201651144425,-58.492293594923702 -34.679250652094815,-58.492866642002554 -34.679723692586862,-58.492993087683622 -34.679779155584981,-58.493593636251219 -34.679909571527432,-58.493792545091381 -34.679964592761479,-58.493800859024155 -34.679958392901483,-58.494004180345016 -34.680119574348375,-58.49451500642644 -34.680524523606856,-58.495970371466477 -34.679424918269859,-58.495577198962721 -34.679044637389872,-58.495299370345158 -34.678775915540541,-58.495284897584185 -34.678786638002173,-58.494198309251601 -34.678769810512236,-58.492908572267837 -34.678749854755665,-58.492244991791445 -34.678739594599499,-58.491985403355208 -34.678723107525812,-58.49164430835237 -34.67843620987469,-58.491267998038147 -34.678119741294744,-58.491123972467598 -34.67799857469101,-58.490880689416223 -34.677790879396319)));;3211;8_2_8;COMUNA 8;2;8;910;412;498;82,73%;337;337;100,00%;0;0,00%;307;4;1,30%;303;98,70%
MULTIPOLYGON (((-58.49188843804675 -34.681831409968474,-58.49233257063932 -34.682173382000215,-58.49451500642644 -34.680524523606856,-58.494004180345016 -34.680119574348375,-58.493800859024155 -34.679958392901483,-58.493792545091381 -34.679964592761479,-58.493593636251219 -34.679909571527432,-58.492993087683622 -34.679779155584981,-58.492866642002554 -34.679723692586862,-58.492293594923702 -34.679250652094815,-58.492234329238251 -34.679201651144425,-58.491975748251008 -34.679145092371122,-58.490516259949715 -34.678825778171969,-58.490428021006345 -34.678806783708957,-58.489971907249036 -34.67870843340588,-58.489794662592161 -34.678670232524389,-58.489557231900633 -34.679422275950031,-58.489337912470653 -34.680040790378527,-58.490108968430349 -34.680203581284609,-58.490034025314529 -34.680438392744335,-58.489831932158154 -34.681071200226214,-58.490549885857845 -34.681230478906791,-58.490611111976925 -34.681277085784856,-58.490730835708334 -34.681368328194921,-58.490801265462018 -34.681403876245724,-58.491368062453631 -34.681533677074093,-58.491451019386474 -34.681554080579126,-58.491552991326671 -34.68158553614154,-58.491560939147838 -34.681579240386526,-58.49188843804675 -34.681831409968474)));;3212;8_2_9;COMUNA 8;2;9;829;410;419;97,85%;302;302;100,00%;0;0,00%;271;0;0,00%;271;100,00%
MULTIPOLYGON (((-58.487801801874085 -34.670473473639632,-58.488272017605709 -34.670016321418274,-58.488789436426281 -34.669513310954059,-58.488887693200688 -34.669436386409423,-58.488169785221281 -34.668805042606046,-58.487483349193056 -34.668201364920399,-58.487369185956247 -34.668101737484129,-58.486626757658826 -34.668673591083561,-58.486174921291514 -34.669021575647832,-58.485560308711442 -34.669495015062274,-58.485184481438019 -34.669784529359589,-58.484587328274259 -34.67024450952578,-58.48449792942651 -34.670313330203356,-58.483600694033839 -34.671003012801584,-58.4843656508449 -34.671677333822061,-58.485334312654693 -34.672531124100509,-58.486280452197434 -34.671747191613591,-58.487337104155742 -34.670871607240244,-58.487710621318527 -34.670562015873912,-58.487801801874085 -34.670473473639632)));;3213;8_3_1;COMUNA 8;3;1;951;452;499;90,58%;317;317;100,00%;0;0,00%;334;32;9,58%;302;90,42%
MULTIPOLYGON (((-58.490394847728155 -34.683637263999088,-58.489697162341109 -34.683473120711291,-58.489273095748516 -34.683372443926835,-58.489245539145934 -34.683364907379207,-58.488870936005782 -34.683638938788555,-58.488735797092112 -34.68360192456538,-58.488211870922449 -34.683466327787805,-58.48781251209126 -34.683364647652219,-58.487473433643601 -34.683280489612891,-58.487292602638519 -34.683252074826392,-58.486948249035095 -34.683200734099238,-58.486824800526527 -34.68319519507768,-58.486726753944957 -34.683472333947577,-58.486663205156766 -34.683647421187203,-58.486629215782507 -34.683740951290176,-58.486519239556849 -34.684043374620202,-58.486459588644713 -34.684138106894352,-58.486204351157006 -34.684187735060156,-58.485788673553238 -34.68426999962054,-58.485495939423402 -34.684378578503647,-58.484898233974327 -34.684432915502562,-58.484852282546193 -34.684436022529972,-58.484807180778354 -34.684428284050234,-58.484692992747362 -34.684307034134029,-58.484681747750493 -34.684339572170266,-58.484266293939207 -34.684636062086305,-58.484554073406798 -34.6848047473419,-58.4848777322267 -34.684919973382769,-58.48519719885239 -34.684977592298189,-58.485572152202032 -34.684981043727014,-58.485142491674218 -34.685076407607632,-58.484726050827874 -34.685194725889382,-58.484311582172545 -34.685361142157653,-58.484115696782624 -34.685485334679385,-58.485229074100289 -34.686828265035516,-58.485228026633827 -34.686829037042124,-58.48560767405089 -34.687253424796403,-58.490394847728155 -34.683637263999088)));;3214;8_3_10;COMUNA 8;3;10;1696;828;868;95,39%;308;308;100,00%;0;0,00%;478;86;17,99%;392;82,01%
MULTIPOLYGON (((-58.481080884084228 -34.672913962392116,-58.47986949197189 -34.672884701630565,-58.48045743278918 -34.67338308123287,-58.481206095538731 -34.674017493566232,-58.482358569156773 -34.674994310490924,-58.482567889473884 -34.674821173457566,-58.483391610988157 -34.674139751036257,-58.4842259721391 -34.673449447624428,-58.484313583482354 -34.673376824581126,-58.484764932927639 -34.673002860646285,-58.485334312654693 -34.672531124100509,-58.4843656508449 -34.671677333822061,-58.483600694033839 -34.671003012801584,-58.482690745122341 -34.671702479798782,-58.48257637145143 -34.67178855712335,-58.481538645420017 -34.672569517226727,-58.481080884084228 -34.672913962392116)));;3215;8_3_2;COMUNA 8;3;2;791;386;405;95,31%;292;292;100,00%;0;0,00%;256;8;3,13%;248;96,88%
MULTIPOLYGON (((-58.486450681993745 -34.673546783529808,-58.485885970308509 -34.673029906822499,-58.485514985080989 -34.672690390401591,-58.485334312654693 -34.672531124100509,-58.484764932927639 -34.673002860646285,-58.484313583482354 -34.673376824581126,-58.4842259721391 -34.673449447624428,-58.483391610988157 -34.674139751036257,-58.482567889473884 -34.674821173457566,-58.482358569156773 -34.674994310490924,-58.482605232888062 -34.675203360406442,-58.483531276976649 -34.675986465412031,-58.484327990702347 -34.676660287706852,-58.485117128553355 -34.677327556647214,-58.485716898865 -34.677834781797813,-58.485901077832935 -34.677990877628311,-58.486815332038496 -34.678765860761089,-58.487020730011075 -34.678588914051076,-58.487582798691193 -34.678100055776518,-58.487658223635513 -34.678034475304592,-58.487742342889597 -34.677966005601853,-58.487836429439476 -34.677875772666461,-58.487964093677761 -34.677753419206113,-58.488621764403753 -34.677154674253316,-58.488379318089109 -34.677143950644108,-58.488355352318777 -34.677107264608331,-58.488331468345066 -34.677059310655636,-58.488338277672646 -34.677025435114793,-58.48828189422526 -34.676911148250859,-58.488309165439773 -34.676885789760661,-58.488645161055402 -34.675366031590656,-58.488150773912452 -34.674926124381159,-58.488019668263703 -34.674929461628146,-58.487855187237798 -34.674785266574737,-58.487220120124611 -34.674228339184857,-58.486629996261662 -34.673710907697817,-58.486450681993745 -34.673546783529808)));;3216;8_3_3;COMUNA 8;3;3;580;286;294;97,28%;202;202;100,00%;0;0,00%;187;9;4,81%;178;95,19%
MULTIPOLYGON (((-58.481106736801912 -34.678032049007399,-58.481887421923169 -34.678698072346371,-58.482277001772161 -34.679030413204238,-58.482664282542601 -34.679360851718336,-58.484191881294294 -34.678094573880536,-58.485117128553355 -34.677327556647214,-58.484327990702347 -34.676660287706852,-58.483531276976649 -34.675986465412031,-58.482605232888062 -34.675203360406442,-58.482358569156773 -34.674994310490924,-58.481438776677763 -34.675754897624898,-58.479914843319165 -34.677015084436619,-58.481106736801912 -34.678032049007399)));;3217;8_3_4;COMUNA 8;3;4;791;380;411;92,46%;261;261;100,00%;0;0,00%;250;56;22,40%;194;77,60%
MULTIPOLYGON (((-58.476773720143967 -34.67233113867028,-58.477101092936394 -34.673068938190411,-58.477103124940825 -34.673073590599358,-58.477510937849765 -34.674007294014444,-58.478289609997034 -34.675803109960256,-58.478952537794029 -34.676182484223879,-58.478969039870599 -34.676207376625726,-58.479914843319165 -34.677015084436619,-58.481438776677763 -34.675754897624898,-58.482358569156773 -34.674994310490924,-58.481206095538731 -34.674017493566232,-58.48045743278918 -34.67338308123287,-58.47986949197189 -34.672884701630565,-58.479456761054585 -34.672534890671095,-58.478494133604315 -34.67171901165343,-58.478364631035006 -34.671609870532677,-58.477147545187457 -34.670584359693649,-58.476567913899359 -34.670095892792538,-58.476492039738943 -34.670031956021887,-58.476359724930568 -34.669894924985442,-58.476176087690078 -34.669704658617867,-58.476083846574099 -34.669630582279154,-58.475260333311596 -34.668968961922552,-58.475402987355572 -34.669293392518966,-58.476672669940498 -34.672103399154523,-58.476773720143967 -34.67233113867028)));;3218;8_3_5;COMUNA 8;3;5;728;324;404;80,20%;263;263;100,00%;0;0,00%;238;3;1,26%;235;98,74%
MULTIPOLYGON (((-58.483379609465693 -34.681714338897983,-58.483435853178982 -34.681665921632302,-58.484402394189452 -34.680843620158399,-58.48388907179023 -34.68040567131272,-58.483444139910574 -34.680026090405711,-58.483056085559106 -34.679695091141269,-58.482664282542601 -34.679360851718336,-58.482277001772161 -34.679030413204238,-58.481887421923169 -34.678698072346371,-58.481106736801912 -34.678032049007399,-58.479914843319165 -34.677015084436619,-58.478969039870599 -34.676207376625726,-58.478952537794029 -34.676182484223879,-58.478267122620302 -34.675751892491604,-58.478344900251074 -34.675930620184907,-58.47840425725844 -34.676065930423469,-58.478426515781123 -34.676116670831746,-58.479094463305429 -34.677638312100363,-58.479739808206006 -34.679123029993796,-58.479745460626617 -34.679136034029405,-58.480062318776746 -34.679864995223468,-58.480517824150162 -34.68090560749426,-58.480543055756748 -34.680960958533504,-58.480701389634802 -34.681308570029884,-58.480700045032513 -34.681307967112616,-58.480878666937102 -34.681695807965042,-58.480938777492085 -34.681826324835619,-58.481828053352828 -34.682985476155764,-58.482196676709172 -34.682714361390317,-58.48220084902799 -34.68271765409574,-58.482202335811763 -34.682718827433831,-58.483112891125813 -34.681955290789588,-58.483164946951845 -34.681909924981355,-58.483378815466267 -34.681715062339407,-58.483379792877656 -34.681714384064037,-58.483379609465693 -34.681714338897983)));;3219;8_3_6;COMUNA 8;3;6;397;198;199;99,50%;137;137;100,00%;0;0,00%;144;3;2,08%;141;97,92%
MULTIPOLYGON (((-58.484191881294294 -34.678094573880536,-58.482664282542601 -34.679360851718336,-58.483056085559106 -34.679695091141269,-58.483444139910574 -34.680026090405711,-58.48388907179023 -34.68040567131272,-58.484402394189452 -34.680843620158399,-58.484521037041645 -34.680742610530679,-58.485900149901042 -34.679554368203952,-58.486316066456723 -34.679196039837244,-58.486815332038496 -34.678765860761089,-58.485901077832935 -34.677990877628311,-58.485716898865 -34.677834781797813,-58.485117128553355 -34.677327556647214,-58.484191881294294 -34.678094573880536)));;3220;8_3_7;COMUNA 8;3;7;764;370;394;93,91%;245;245;100,00%;0;0,00%;245;7;2,86%;238;97,14%
MULTIPOLYGON (((-58.48692145426832 -34.682821434287106,-58.486876903309501 -34.682946516645153,-58.486917658524852 -34.682961015955094,-58.486839372047399 -34.68317174091019,-58.486824800526527 -34.68319519507768,-58.486948249035095 -34.683200734099238,-58.487292602638519 -34.683252074826392,-58.487473433643601 -34.683280489612891,-58.48781251209126 -34.683364647652219,-58.488211870922449 -34.683466327787805,-58.488735797092112 -34.68360192456538,-58.488870936005782 -34.683638938788555,-58.489245539145934 -34.683364907379207,-58.489273095748516 -34.683372443926835,-58.489697162341109 -34.683473120711291,-58.490394847728155 -34.683637263999088,-58.49053752656873 -34.683529482368918,-58.491539430678301 -34.682772583496956,-58.491119360404319 -34.68241610708742,-58.490837417838989 -34.68217684488328,-58.49025975767664 -34.681691401411697,-58.489755268913775 -34.681264391106957,-58.48967204023792 -34.68119250634777,-58.488315160223728 -34.68002051611915,-58.487885134933855 -34.679660807924982,-58.487549166931146 -34.679379743015062,-58.486815332038496 -34.678765860761089,-58.486316066456723 -34.679196039837244,-58.485900149901042 -34.679554368203952,-58.484521037041645 -34.680742610530679,-58.484402394189452 -34.680843620158399,-58.483435853178982 -34.681665921632302,-58.483379609465693 -34.681714338897983,-58.483378576218563 -34.681715228365526,-58.483378621374648 -34.681715239183255,-58.483164946951845 -34.681909924981355,-58.485503854007113 -34.682461487558747,-58.485526021138739 -34.682466765230636,-58.485564647336005 -34.682491336064963,-58.485614944849772 -34.682485692677169,-58.485868073870101 -34.682535575641531,-58.485972435903101 -34.682581049844913,-58.486486035197146 -34.682709475009531,-58.486673690663658 -34.682757608450984,-58.486881808740286 -34.682811512335896,-58.48692145426832 -34.682821434287106)));;3221;8_3_8;COMUNA 8;3;8;1901;986;915;107,76%;448;448;100,00%;0;0,00%;547;186;34,00%;361;66,00%
MULTIPOLYGON (((-58.481841641377038 -34.683003187540578,-58.4818704352395 -34.683040719028675,-58.482316339169238 -34.683505500478518,-58.482349739489891 -34.683540314538725,-58.482998792912049 -34.684216832881212,-58.484115696782624 -34.685485334679385,-58.484311582172545 -34.685361142157653,-58.484726050827874 -34.685194725889382,-58.485142491674218 -34.685076407607632,-58.485572152202032 -34.684981043727014,-58.48519719885239 -34.684977592298189,-58.4848777322267 -34.684919973382769,-58.484554073406798 -34.6848047473419,-58.484266293939207 -34.684636062086305,-58.484681747750493 -34.684339572170266,-58.484692992747362 -34.684307034134029,-58.484807180778354 -34.684428284050234,-58.484852282546193 -34.684436022529972,-58.484898233974327 -34.684432915502562,-58.485495939423402 -34.684378578503647,-58.485788673553238 -34.68426999962054,-58.486204351157006 -34.684187735060156,-58.486459588644713 -34.684138106894352,-58.486519239556849 -34.684043374620202,-58.486629215782507 -34.683740951290176,-58.486663205156766 -34.683647421187203,-58.486726753944957 -34.683472333947577,-58.486824800526527 -34.68319519507768,-58.486839372047399 -34.68317174091019,-58.486917658524852 -34.682961015955094,-58.486876903309501 -34.682946516645153,-58.48692145426832 -34.682821434287106,-58.486881808740286 -34.682811512335896,-58.486673690663658 -34.682757608450984,-58.486486035197146 -34.682709475009531,-58.485972435903101 -34.682581049844913,-58.485868073870101 -34.682535575641531,-58.485614944849772 -34.682485692677169,-58.485564647336005 -34.682491336064963,-58.485526021138739 -34.682466765230636,-58.485503854007113 -34.682461487558747,-58.483164946951845 -34.681909924981355,-58.483112891125813 -34.681955290789588,-58.482202335811763 -34.682718827433831,-58.48220084902799 -34.68271765409574,-58.482196676709172 -34.682714361390317,-58.481828053352828 -34.682985476155764,-58.481841641377038 -34.683003187540578)));;3222;8_3_9;COMUNA 8;3;9;2007;988;1019;96,96%;374;374;100,00%;0;0,00%;569;97;17,05%;472;82,95%
MULTIPOLYGON (((-58.488952429882161 -34.663348388692974,-58.488712299890565 -34.663529924098569,-58.487737800695818 -34.664288036530124,-58.486489314839865 -34.665259299330003,-58.486389271100506 -34.665337137859275,-58.485869450632194 -34.665744995472267,-58.48523764887755 -34.66624076133207,-58.486428095582205 -34.667280070935696,-58.487369185956247 -34.668101737484129,-58.488622138363276 -34.667136521673669,-58.488710848668745 -34.667068261479933,-58.489869942032705 -34.666154392115239,-58.491000037831782 -34.665263406289831,-58.490077084975702 -34.664400283291393,-58.488952429882161 -34.663348388692974)));;3223;8_4_1;COMUNA 8;4;1;899;426;473;90,06%;299;299;100,00%;0;0,00%;287;25;8,71%;262;91,29%
MULTIPOLYGON (((-58.480278506634839 -34.668135502176682,-58.480437022770694 -34.668011391340436,-58.480781837306452 -34.667745840509809,-58.481279027730551 -34.667363079273279,-58.481158223438193 -34.667258306032004,-58.480498197023273 -34.666691768966345,-58.479716611905921 -34.666021017083509,-58.478930862152851 -34.665346598595818,-58.478410236998229 -34.665749424380152,-58.477898214409763 -34.666145556518536,-58.477767736500951 -34.666246490979447,-58.476897337773224 -34.666930628277917,-58.477683425136675 -34.667594918533702,-58.478467308512677 -34.668257372896193,-58.479122216610115 -34.668810752130803,-58.479266719391639 -34.6689277075726,-58.480278506634839 -34.668135502176682)));;3224;8_4_10;COMUNA 8;4;10;883;409;474;86,29%;347;347;100,00%;0;0,00%;306;5;1,63%;301;98,37%
MULTIPOLYGON (((-58.475010652047388 -34.668400944264803,-58.475260333311596 -34.668968961922552,-58.476083846574099 -34.669630582279154,-58.476176087690078 -34.669704658617867,-58.476359724930568 -34.669894924985442,-58.476492039738943 -34.670031956021887,-58.476567913899359 -34.670095892792538,-58.477147545187457 -34.670584359693649,-58.477629682869676 -34.670207601372532,-58.478213066175648 -34.669751671223182,-58.478799852150289 -34.669293132095532,-58.478874425072775 -34.669234881217392,-58.479266719391639 -34.6689277075726,-58.479122216610115 -34.668810752130803,-58.478467308512677 -34.668257372896193,-58.477683425136675 -34.667594918533702,-58.476897337773224 -34.666930628277917,-58.475837717237766 -34.667738726862126,-58.475584680728488 -34.667956787967462,-58.475583815836565 -34.667951719805536,-58.475010652047388 -34.668400944264803)));;3225;8_4_11;COMUNA 8;4;11;743;362;381;95,01%;259;259;100,00%;0;0,00%;252;3;1,19%;249;98,81%
MULTIPOLYGON (((-58.485768057519564 -34.664648857664787,-58.486489314839865 -34.665259299330003,-58.487737800695818 -34.664288036530124,-58.488712299890565 -34.663529924098569,-58.488952429882161 -34.663348388692974,-58.487132288714527 -34.662803540512222,-58.48594532705458 -34.662448128818518,-58.485360874597184 -34.662077101657744,-58.48522686725844 -34.661991983250111,-58.485037364994611 -34.661871662614459,-58.483715087621363 -34.662902912567553,-58.484502386100615 -34.66357293389364,-58.485287651162416 -34.664241189823997,-58.485768057519564 -34.664648857664787)));;3226;8_4_2;COMUNA 8;4;2;622;289;333;86,79%;218;218;100,00%;0;0,00%;214;39;18,22%;175;81,78%
MULTIPOLYGON (((-58.484502386100615 -34.66357293389364,-58.483715087621363 -34.662902912567553,-58.482463763964752 -34.663878782876871,-58.48261193021456 -34.664005311586379,-58.483250464900522 -34.664548530578934,-58.483916544749263 -34.665115192739236,-58.484042376150285 -34.66521172274004,-58.484178608536652 -34.665316067894643,-58.484522951784356 -34.665616719262452,-58.484831064025244 -34.665886037334495,-58.48523764887755 -34.66624076133207,-58.485869450632194 -34.665744995472267,-58.486389271100506 -34.665337137859275,-58.486489314839865 -34.665259299330003,-58.485768057519564 -34.664648857664787,-58.485287651162416 -34.664241189823997,-58.484502386100615 -34.66357293389364)));;3227;8_4_3;COMUNA 8;4;3;663;312;351;88,89%;245;245;100,00%;0;0,00%;220;3;1,36%;217;98,64%
MULTIPOLYGON (((-58.485037364994611 -34.661871662614459,-58.484131631876068 -34.661296597690438,-58.483232387804406 -34.660717581114916,-58.482144194271044 -34.661565600401218,-58.481715046218611 -34.661899973286545,-58.480895002552643 -34.662538989625872,-58.481094057236284 -34.662708471554772,-58.481679206367595 -34.663208395868459,-58.482463763964752 -34.663878782876871,-58.483715087621363 -34.662902912567553,-58.485037364994611 -34.661871662614459)));;3228;8_4_4;COMUNA 8;4;4;663;333;330;100,91%;254;254;100,00%;0;0,00%;224;26;11,61%;198;88,39%
MULTIPOLYGON (((-58.481293625383202 -34.664791316225497,-58.482463763964752 -34.663878782876871,-58.481679206367595 -34.663208395868459,-58.480507619792718 -34.664121696668431,-58.47975495473316 -34.664708369858239,-58.47963428191165 -34.664802473792818,-58.478930862152851 -34.665346598595818,-58.479716611905921 -34.666021017083509,-58.480498197023273 -34.666691768966345,-58.481158223438193 -34.667258306032004,-58.481279027730551 -34.667363079273279,-58.48151032113303 -34.6671850107792,-58.482864566235783 -34.666129694993543,-58.482079558385998 -34.665460930650973,-58.481293625383202 -34.664791316225497)));;3229;8_4_5;COMUNA 8;4;5;960;451;509;88,61%;359;359;100,00%;0;0,00%;332;12;3,61%;320;96,39%
MULTIPOLYGON (((-58.481708026108855 -34.667735206379298,-58.48206413518858 -34.668044102397651,-58.482480522751764 -34.668405383380616,-58.482614917863877 -34.668298527618845,-58.483098636388114 -34.667919000721781,-58.483466961747055 -34.667630057439929,-58.48407142906121 -34.667155785119647,-58.48523764887755 -34.66624076133207,-58.484831064025244 -34.665886037334495,-58.484522951784356 -34.665616719262452,-58.484178608536652 -34.665316067894643,-58.484042376150285 -34.66521172274004,-58.483916544749263 -34.665115192739236,-58.483250464900522 -34.664548530578934,-58.48261193021456 -34.664005311586379,-58.482463763964752 -34.663878782876871,-58.481293625383202 -34.664791316225497,-58.482079558385998 -34.665460930650973,-58.482864566235783 -34.666129694993543,-58.48151032113303 -34.6671850107792,-58.481279027730551 -34.667363079273279,-58.481708026108855 -34.667735206379298)));;3230;8_4_6;COMUNA 8;4;6;1084;509;575;88,52%;402;402;100,00%;0;0,00%;350;8;2,29%;342;97,71%
MULTIPOLYGON (((-58.483098636388114 -34.667919000721781,-58.482614917863877 -34.668298527618845,-58.482480522751764 -34.668405383380616,-58.48367931925447 -34.669443873008142,-58.483856059217963 -34.669596945177354,-58.484587328274259 -34.67024450952578,-58.485184481438019 -34.669784529359589,-58.485560308711442 -34.669495015062274,-58.486174921291514 -34.669021575647832,-58.486626757658826 -34.668673591083561,-58.487369185956247 -34.668101737484129,-58.486428095582205 -34.667280070935696,-58.48523764887755 -34.66624076133207,-58.48407142906121 -34.667155785119647,-58.483466961747055 -34.667630057439929,-58.483098636388114 -34.667919000721781)));;3231;8_4_7;COMUNA 8;4;7;836;394;442;89,14%;300;300;100,00%;0;0,00%;278;19;6,83%;259;93,17%
MULTIPOLYGON (((-58.481538645420017 -34.672569517226727,-58.48257637145143 -34.67178855712335,-58.482690745122341 -34.671702479798782,-58.483600694033839 -34.671003012801584,-58.48449792942651 -34.670313330203356,-58.484587328274259 -34.67024450952578,-58.483856059217963 -34.669596945177354,-58.48367931925447 -34.669443873008142,-58.482480522751764 -34.668405383380616,-58.481631703478797 -34.66907997300833,-58.481515713633875 -34.669169852544904,-58.480497957940571 -34.669957984329166,-58.480022737333641 -34.670326020396317,-58.479431262455087 -34.670783932156198,-58.480549482219708 -34.671731334008079,-58.47968815943721 -34.672364009056608,-58.479456761054585 -34.672534890671095,-58.47986949197189 -34.672884701630565,-58.481080884084228 -34.672913962392116,-58.481538645420017 -34.672569517226727)));;3232;8_4_8;COMUNA 8;4;8;859;416;443;93,91%;317;317;100,00%;0;0,00%;278;9;3,24%;269;96,76%
MULTIPOLYGON (((-58.478364631035006 -34.671609870532677,-58.478494133604315 -34.67171901165343,-58.479456761054585 -34.672534890671095,-58.47968815943721 -34.672364009056608,-58.480549482219708 -34.671731334008079,-58.479431262455087 -34.670783932156198,-58.480022737333641 -34.670326020396317,-58.480497957940571 -34.669957984329166,-58.481515713633875 -34.669169852544904,-58.481631703478797 -34.66907997300833,-58.482480522751764 -34.668405383380616,-58.48206413518858 -34.668044102397651,-58.481708026108855 -34.667735206379298,-58.481279027730551 -34.667363079273279,-58.480781837306452 -34.667745840509809,-58.480437022770694 -34.668011391340436,-58.480278506634839 -34.668135502176682,-58.479266719391639 -34.6689277075726,-58.478874425072775 -34.669234881217392,-58.478799852150289 -34.669293132095532,-58.478213066175648 -34.669751671223182,-58.477629682869676 -34.670207601372532,-58.477147545187457 -34.670584359693649,-58.478364631035006 -34.671609870532677)));;3233;8_4_9;COMUNA 8;4;9;770;353;417;84,65%;292;291;99,66%;1;0,34%;258;6;2,33%;252;97,67%
MULTIPOLYGON (((-58.480572329090684 -34.660230380571221,-58.479324758091558 -34.661202204343603,-58.480110129763901 -34.661870846000497,-58.480895002552643 -34.662538989625872,-58.481715046218611 -34.661899973286545,-58.482144194271044 -34.661565600401218,-58.483232387804406 -34.660717581114916,-58.482333326733801 -34.660138698669364,-58.48143376669578 -34.659559387066444,-58.480841596564012 -34.659178057259943,-58.480533537272422 -34.658979716744582,-58.479911127077933 -34.659460101624035,-58.47978603093177 -34.659558150187635,-58.480441732536413 -34.660115818919436,-58.480572329090684 -34.660230380571221)));;3234;8_5_1;COMUNA 8;5;1;807;387;420;92,14%;333;333;100,00%;0;0,00%;277;10;3,61%;267;96,39%
MULTIPOLYGON (((-58.474202533611823 -34.66536903840057,-58.474199970955702 -34.665362681602346,-58.473673509803106 -34.665370785366015,-58.474045729813035 -34.666205695855638,-58.474056183653694 -34.666229479554325,-58.474541165204329 -34.666229433414934,-58.474543512088054 -34.666235085943406,-58.47557606466205 -34.666258432612295,-58.47573632541414 -34.666367080536354,-58.477005323339121 -34.666380318888621,-58.477131968726596 -34.666290724038937,-58.476876735795479 -34.666078424208081,-58.476623037641971 -34.665861546069259,-58.476361584978953 -34.665648259912068,-58.475895284524498 -34.665252173579873,-58.475836123467339 -34.665201685615536,-58.475602975028352 -34.665002620500751,-58.475408895501147 -34.665002500037325,-58.475398724323284 -34.665376032548124,-58.475306244214138 -34.66537604214561,-58.47530557622057 -34.665467734886377,-58.475105869717318 -34.665465149665629,-58.475112933138242 -34.665390710272398,-58.474729715231383 -34.665385748549042,-58.474745949560436 -34.665070808665654,-58.474545221579838 -34.665070828333079,-58.474524978538831 -34.665372387927569,-58.474202533611823 -34.66536903840057)));;3235;8_5_10;COMUNA 8;5;10;1137;495;642;77,10%;472;472;100,00%;0;0,00%;411;0;0,00%;411;100,00%
MULTIPOLYGON (((-58.47483938309945 -34.668011307547822,-58.475010652047388 -34.668400944264803,-58.475583815836565 -34.667951719805536,-58.475549360335876 -34.667749814234099,-58.475439721575867 -34.667597849770878,-58.475568331308175 -34.667510509940264,-58.475634807806379 -34.667455149283626,-58.476388974338249 -34.666859768985155,-58.476610390450524 -34.666688119505928,-58.476823283048105 -34.66652252711166,-58.476923676975282 -34.666438076504747,-58.477005323339121 -34.666380318888621,-58.47573632541414 -34.666367080536354,-58.47557606466205 -34.666258432612295,-58.474543512088054 -34.666235085943406,-58.474541165204329 -34.666229433414934,-58.474056183653694 -34.666229479554325,-58.47483938309945 -34.668011307547822)));;3236;8_5_11;COMUNA 8;5;11;927;412;515;80,00%;360;360;100,00%;0;0,00%;319;1;0,31%;318;99,69%
MULTIPOLYGON (((-58.480572329090684 -34.660230380571221,-58.480441732536413 -34.660115818919436,-58.47978603093177 -34.659558150187635,-58.479911127077933 -34.659460101624035,-58.480533537272422 -34.658979716744582,-58.48030014965412 -34.658829394234822,-58.480169221114245 -34.658745114871316,-58.479822466067461 -34.65852058014714,-58.479632808572696 -34.658397856626877,-58.479462586096965 -34.658287595286026,-58.479356548064771 -34.658214790821269,-58.478817836716694 -34.65784443001651,-58.478398069421537 -34.658178226793424,-58.478277405029488 -34.658275005617014,-58.477901179178062 -34.658576892765076,-58.477700155004641 -34.65873818989715,-58.477043047736551 -34.659251100562898,-58.47721660032655 -34.659403901295327,-58.477756865246782 -34.659865327822502,-58.47854067770313 -34.660534684177286,-58.479324758091558 -34.661202204343603,-58.480572329090684 -34.660230380571221)));;3237;8_5_2;COMUNA 8;5;2;776;378;398;94,97%;299;299;100,00%;0;0,00%;263;4;1,52%;259;98,48%
MULTIPOLYGON (((-58.477756865246782 -34.659865327822502,-58.47721660032655 -34.659403901295327,-58.477043047736551 -34.659251100562898,-58.475869846970937 -34.660166752014526,-58.475707930124287 -34.660293181444025,-58.475132013790699 -34.660744944499022,-58.47584659670725 -34.661356717855405,-58.476629726213361 -34.662027354046288,-58.477289433299084 -34.6625921519231,-58.477413805720403 -34.662696999073781,-58.47756737327299 -34.662578315143186,-58.478013244637957 -34.66223141922805,-58.478154878825137 -34.662117031942394,-58.478280576713374 -34.662015534214447,-58.479324758091558 -34.661202204343603,-58.47854067770313 -34.660534684177286,-58.477756865246782 -34.659865327822502)));;3238;8_5_3;COMUNA 8;5;3;821;389;432;90,05%;290;290;100,00%;0;0,00%;270;27;10,00%;243;90,00%
MULTIPOLYGON (((-58.481679206367595 -34.663208395868459,-58.481094057236284 -34.662708471554772,-58.480895002552643 -34.662538989625872,-58.480110129763901 -34.661870846000497,-58.479324758091558 -34.661202204343603,-58.478280576713374 -34.662015534214447,-58.478154878825137 -34.662117031942394,-58.478013244637957 -34.66223141922805,-58.47756737327299 -34.662578315143186,-58.477413805720403 -34.662696999073781,-58.478084262838564 -34.663262072986541,-58.478199176116476 -34.663365441602913,-58.478342050897382 -34.663494018496429,-58.478976548215044 -34.664039302751988,-58.479722905548215 -34.663453057731132,-58.480507619792718 -34.664121696668431,-58.481679206367595 -34.663208395868459)));;3239;8_5_4;COMUNA 8;5;4;872;398;474;83,97%;327;327;100,00%;0;0,00%;291;10;3,44%;281;96,56%
MULTIPOLYGON (((-58.478151859736862 -34.664678019344983,-58.477750291327879 -34.664988430285959,-58.477629019164077 -34.665082391456828,-58.477108645100984 -34.665485422943767,-58.476623037641971 -34.665861546069259,-58.476876735795479 -34.666078424208081,-58.477131968726596 -34.666290724038937,-58.477005323339121 -34.666380318888621,-58.476923676975282 -34.666438076504747,-58.476823283048105 -34.66652252711166,-58.476610390450524 -34.666688119505928,-58.476388974338249 -34.666859768985155,-58.475634807806379 -34.667455149283626,-58.475568331308175 -34.667510509940264,-58.475439721575867 -34.667597849770878,-58.475549360335876 -34.667749814234099,-58.475583815836565 -34.667951719805536,-58.475584680728488 -34.667956787967462,-58.475837717237766 -34.667738726862126,-58.476897337773224 -34.666930628277917,-58.477767736500951 -34.666246490979447,-58.477898214409763 -34.666145556518536,-58.478410236998229 -34.665749424380152,-58.478930862152851 -34.665346598595818,-58.47963428191165 -34.664802473792818,-58.47975495473316 -34.664708369858239,-58.480507619792718 -34.664121696668431,-58.479722905548215 -34.663453057731132,-58.478976548215044 -34.664039302751988,-58.478873345876742 -34.664120304654318,-58.478151859736862 -34.664678019344983)));;3240;8_5_5;COMUNA 8;5;5;617;292;325;89,85%;194;194;100,00%;0;0,00%;201;5;2,49%;196;97,51%
MULTIPOLYGON (((-58.475522468723447 -34.664159154892872,-58.475045895513198 -34.664527524174012,-58.475397021056601 -34.664826721760278,-58.475602975028352 -34.665002620500751,-58.475836123467339 -34.665201685615536,-58.475895284524498 -34.665252173579873,-58.476361584978953 -34.665648259912068,-58.476623037641971 -34.665861546069259,-58.477108645100984 -34.665485422943767,-58.477629019164077 -34.665082391456828,-58.477750291327879 -34.664988430285959,-58.478151859736862 -34.664678019344983,-58.478873345876742 -34.664120304654318,-58.478976548215044 -34.664039302751988,-58.478342050897382 -34.663494018496429,-58.478199176116476 -34.663365441602913,-58.478084262838564 -34.663262072986541,-58.477413805720403 -34.662696999073781,-58.476585368582178 -34.663337466276296,-58.475522468723447 -34.664159154892872)));;3241;8_5_6;COMUNA 8;5;6;831;389;442;88,01%;318;318;100,00%;0;0,00%;282;5;1,77%;277;98,23%
MULTIPOLYGON (((-58.472975554974909 -34.662452587881383,-58.472527187821072 -34.662783690474534,-58.473300725018007 -34.664534590004983,-58.473305118129062 -34.664544444318878,-58.473756540256609 -34.664215946919498,-58.47376563837107 -34.664237075644245,-58.474264033670536 -34.663856384994666,-58.474473818913374 -34.664036158654909,-58.474971989304692 -34.664472530109109,-58.475045895513198 -34.664527524174012,-58.475522468723447 -34.664159154892872,-58.476585368582178 -34.663337466276296,-58.477413805720403 -34.662696999073781,-58.477289433299084 -34.6625921519231,-58.476629726213361 -34.662027354046288,-58.47584659670725 -34.661356717855405,-58.475132013790699 -34.660744944499022,-58.475089147918801 -34.660778611789013,-58.474442235404439 -34.661286084545118,-58.474319348575477 -34.661402015088377,-58.474969487521115 -34.661956192387599,-58.475020121493962 -34.661999357511718,-58.475315487522785 -34.662252080899705,-58.474242365336444 -34.663104675918177,-58.473948714373066 -34.662927304031619,-58.473837387374239 -34.662828649515504,-58.473211454905758 -34.662273548655563,-58.472975554974909 -34.662452587881383)));;3242;8_5_7;COMUNA 8;5;7;1024;492;532;92,48%;368;368;100,00%;0;0,00%;336;9;2,68%;327;97,32%
MULTIPOLYGON (((-58.475020121493962 -34.661999357511718,-58.474969487521115 -34.661956192387599,-58.474319348575477 -34.661402015088377,-58.474216062021455 -34.661499492430494,-58.474011188001271 -34.661659023155217,-58.473628794170629 -34.661956812905927,-58.473211454905758 -34.662273548655563,-58.473837387374239 -34.662828649515504,-58.473948714373066 -34.662927304031619,-58.474242365336444 -34.663104675918177,-58.475315487522785 -34.662252080899705,-58.475020121493962 -34.661999357511718)));;3243;8_5_8;COMUNA 8;5;8;624;292;332;87,95%;253;253;100,00%;0;0,00%;254;1;0,39%;253;99,61%
MULTIPOLYGON (((-58.47376563837107 -34.664237075644245,-58.473756540256609 -34.664215946919498,-58.473305118129062 -34.664544444318878,-58.473321331605653 -34.664580813213398,-58.473673509803106 -34.665370785366015,-58.474199970955702 -34.665362681602346,-58.474202533611823 -34.66536903840057,-58.474524978538831 -34.665372387927569,-58.474545221579838 -34.665070828333079,-58.474745949560436 -34.665070808665654,-58.474729715231383 -34.665385748549042,-58.475112933138242 -34.665390710272398,-58.475105869717318 -34.665465149665629,-58.47530557622057 -34.665467734886377,-58.475306244214138 -34.66537604214561,-58.475398724323284 -34.665376032548124,-58.475408895501147 -34.665002500037325,-58.475602975028352 -34.665002620500751,-58.475397021056601 -34.664826721760278,-58.475045895513198 -34.664527524174012,-58.474971989304692 -34.664472530109109,-58.474473818913374 -34.664036158654909,-58.474264033670536 -34.663856384994666,-58.47376563837107 -34.664237075644245)));;3244;8_5_9;COMUNA 8;5;9;910;428;482;88,80%;313;313;100,00%;0;0,00%;298;1;0,34%;297;99,66%
MULTIPOLYGON (((-58.471502526848134 -34.664431420368309,-58.471974427236937 -34.664827100584688,-58.472036387107558 -34.66477667192332,-58.472511190327531 -34.665175307645214,-58.472852777674213 -34.664894849383749,-58.472845629448223 -34.66487880730773,-58.473305118129062 -34.664544444318878,-58.473300725018007 -34.664534590004983,-58.472527187821072 -34.662783690474534,-58.472026681961275 -34.663156770848992,-58.471400849041302 -34.663678660238361,-58.471002330980063 -34.664012077598933,-58.471502526848134 -34.664431420368309)));;3245;8_6_1;COMUNA 8;6;1;926;417;509;81,93%;349;349;100,00%;0;0,00%;302;3;0,99%;299;99,01%
MULTIPOLYGON (((-58.469456927131219 -34.672852375187666,-58.469235198038923 -34.672924187273708,-58.470003125513848 -34.673605710921606,-58.470774305117338 -34.67428997599022,-58.471537995153803 -34.674967687179354,-58.471427185967713 -34.675055866472,-58.471031936777251 -34.675376043296097,-58.472156696791352 -34.676412959904518,-58.472693358365312 -34.675997061276739,-58.47329547671108 -34.675530378621588,-58.473425718864476 -34.675429449119584,-58.474128236858888 -34.674885004929621,-58.47252162911996 -34.674181887162597,-58.471525086855571 -34.673745084519425,-58.471527139232343 -34.673743388643828,-58.471491515033144 -34.673727877342827,-58.471301644672359 -34.673645204717438,-58.470412177634671 -34.673263704907569,-58.469456927131219 -34.672852375187666)));;3246;8_6_10;COMUNA 8;6;10;640;293;347;84,44%;241;241;100,00%;0;0,00%;219;18;8,22%;201;91,78%
MULTIPOLYGON (((-58.470902538116668 -34.676279314900817,-58.471552860866595 -34.676880904631219,-58.472156696791352 -34.676412959904518,-58.471031936777237 -34.675376043296083,-58.471427185967691 -34.675055866471979,-58.471537995153803 -34.67496768717934,-58.470774305117338 -34.674289975990199,-58.470003125513834 -34.673605710921592,-58.469531248955278 -34.673992579411241,-58.469054935641303 -34.67438388301705,-58.46894702294864 -34.674472552883408,-58.469698937300883 -34.675166332932896,-58.4698274119012 -34.675284849697,-58.470442339004137 -34.675853629764546,-58.470902538116668 -34.676279314900817)));;3247;8_6_11;COMUNA 8;6;11;651;338;313;107,99%;165;165;100,00%;0;0,00%;203;28;13,79%;175;86,21%
MULTIPOLYGON (((-58.470584290510395 -34.66433901584962,-58.470162162598868 -34.664666881220086,-58.470162411473858 -34.664668910713154,-58.470671131742513 -34.665100791884214,-58.470862244179798 -34.665263107670675,-58.471145930724241 -34.665503869644624,-58.471615704947823 -34.665902720428072,-58.472030423618932 -34.66556310257274,-58.472401063917459 -34.665881744396955,-58.472597362079192 -34.665885742814275,-58.472980883445466 -34.665569646029397,-58.472511190327531 -34.665175307645214,-58.472036387107558 -34.66477667192332,-58.471974427236937 -34.664827100584688,-58.471502526848134 -34.664431420368309,-58.471002330980063 -34.664012077598933,-58.470939603815417 -34.664061167727588,-58.470584290510395 -34.66433901584962)));;3248;8_6_2;COMUNA 8;6;2;1197;531;666;79,73%;441;441;100,00%;0;0,00%;397;5;1,26%;392;98,74%
MULTIPOLYGON (((-58.472597362079192 -34.665885742814275,-58.472401063917459 -34.665881744396955,-58.472030423618932 -34.66556310257274,-58.471615704947823 -34.665902720428072,-58.472088722946658 -34.666304245254949,-58.472431746972205 -34.666595493953338,-58.472558420961391 -34.666703021934104,-58.473029998881195 -34.667103345956022,-58.473221461501346 -34.667265939658257,-58.473496125547456 -34.667499020595905,-58.474012978948181 -34.667937858918869,-58.474409381819612 -34.668274309503076,-58.475260333311596 -34.668968961922552,-58.475010652047388 -34.668400944264803,-58.47483938309945 -34.668011307547822,-58.474056183653694 -34.666229479554325,-58.474045729813035 -34.666205695855638,-58.473673509803106 -34.665370785366015,-58.473321331605653 -34.664580813213398,-58.473305118129062 -34.664544444318878,-58.472845629448223 -34.66487880730773,-58.472852777674213 -34.664894849383749,-58.472511190327531 -34.665175307645214,-58.472980883445466 -34.665569646029397,-58.472597362079192 -34.665885742814275)));;3249;8_6_3;COMUNA 8;6;3;1219;568;651;87,25%;435;435;100,00%;0;0,00%;402;5;1,24%;397;98,76%
MULTIPOLYGON (((-58.473073725988812 -34.671210706625708,-58.4738115803152 -34.671904110753111,-58.474610733126298 -34.672575250251484,-58.476073430716383 -34.672709327462584,-58.476171205466457 -34.672718260595339,-58.476364691174986 -34.672626335225104,-58.476363870333046 -34.672818664338479,-58.476388605756405 -34.672910002001011,-58.476399352928624 -34.672949931424064,-58.476558441691949 -34.673103297765884,-58.476689892874639 -34.673141452770693,-58.476697921138616 -34.67314761314487,-58.476777619392074 -34.673208768387688,-58.476778035435558 -34.673211859664548,-58.477103124940825 -34.673073590599358,-58.477101092936394 -34.673068938190411,-58.476773720143967 -34.67233113867028,-58.476672669940498 -34.672103399154523,-58.475402987355572 -34.669293392518966,-58.475260333311596 -34.668968961922552,-58.474409381819612 -34.668274309503076,-58.474611378758709 -34.668748668985025,-58.473508757722207 -34.669599146792059,-58.472327955739857 -34.670509833589158,-58.473073725988812 -34.671210706625708)));;3250;8_6_4;COMUNA 8;6;4;742;336;406;82,76%;225;225;100,00%;0;0,00%;233;9;3,86%;224;96,14%
MULTIPOLYGON (((-58.471589188405986 -34.669815504870108,-58.472327955739857 -34.670509833589158,-58.473508757722207 -34.669599146792059,-58.474611378758709 -34.668748668985025,-58.474409381819612 -34.668274309503076,-58.474012978948181 -34.667937858918869,-58.473496125547456 -34.667499020595905,-58.473221461501346 -34.667265939658257,-58.473029998881195 -34.667103345956022,-58.472558420961391 -34.666703021934104,-58.472431746972205 -34.666595493953338,-58.471271857958264 -34.667496521146361,-58.47009489734846 -34.668410637156327,-58.470236404907212 -34.668544153236731,-58.4708422497092 -34.669113495876474,-58.471589188405986 -34.669815504870108)));;3251;8_6_5;COMUNA 8;6;5;999;484;515;93,98%;352;352;100,00%;0;0,00%;320;14;4,38%;306;95,63%
MULTIPOLYGON (((-58.472088722946658 -34.666304245254949,-58.471615704947823 -34.665902720428072,-58.471145930724241 -34.665503869644624,-58.470862244179798 -34.665263107670675,-58.470671131742513 -34.665100791884214,-58.470162411473858 -34.664668910713154,-58.469734903969282 -34.665003170742089,-58.46913079660947 -34.66547561152597,-58.468892322313195 -34.665662037464266,-58.468644897285081 -34.665849519734344,-58.467940543508831 -34.666378510250929,-58.468609436302685 -34.667008144803496,-58.469352416105082 -34.667707210111473,-58.47009489734846 -34.668410637156327,-58.471271857958264 -34.667496521146361,-58.472431746972205 -34.666595493953338,-58.472088722946658 -34.666304245254949)));;3252;8_6_6;COMUNA 8;6;6;1003;491;512;95,90%;252;252;100,00%;0;0,00%;320;66;20,63%;254;79,38%
MULTIPOLYGON (((-58.462377590340452 -34.670427394233037,-58.462153918365679 -34.670645145744437,-58.46189828013069 -34.67084317779495,-58.461845772106294 -34.670817613374915,-58.461566957166369 -34.67103594833852,-58.461567543489245 -34.671036208495011,-58.461504123533985 -34.671085504979459,-58.461566008181393 -34.671107477987981,-58.461621585060769 -34.671126774781669,-58.461661819219152 -34.671094802447058,-58.461766835604919 -34.671139874920968,-58.461734358457292 -34.671167058491605,-58.461787548665356 -34.671186355190521,-58.461879523458897 -34.671219666591476,-58.461783796656029 -34.671313682499679,-58.461928961779591 -34.671384107915351,-58.462000990414651 -34.671413404904413,-58.462031539344665 -34.671363608997488,-58.462070247098659 -34.671301935243413,-58.46212830815913 -34.67127680910113,-58.462214016849465 -34.671313357005118,-58.462302490442681 -34.671345336416209,-58.462377140097075 -34.671370463064875,-58.462471143428729 -34.671402442367778,-58.462675739162748 -34.671480106084203,-58.462927337025633 -34.671532642950361,-58.463071107364009 -34.671560053245486,-58.463065577758556 -34.671564621703517,-58.463066312799107 -34.671564800310669,-58.463159581523684 -34.671587463591933,-58.463248055711574 -34.671610305432772,-58.463306116931044 -34.671626294702399,-58.463613012068308 -34.67168796674715,-58.463770607049263 -34.671719944553516,-58.463848022081336 -34.671729080731467,-58.464022206292277 -34.671770194937359,-58.464232333349742 -34.671811308447595,-58.464334632134545 -34.67183186510389,-58.464389928709501 -34.671838717011575,-58.464450755178376 -34.671856989917622,-58.464511581524746 -34.671868410131637,-58.464587563515764 -34.671889742988398,-58.464715256299698 -34.671913333119953,-58.465784816223433 -34.672093241856253,-58.465796053459862 -34.672095049790116,-58.4663113356522 -34.672177951193163,-58.46680534554929 -34.672271702453457,-58.466851605154183 -34.672280542343238,-58.467846649065294 -34.672470298151126,-58.467847958012584 -34.672470547994102,-58.469028118220365 -34.672695802615394,-58.468562420596378 -34.672167488189572,-58.468557696063677 -34.67216563732606,-58.46855541810433 -34.672165469365758,-58.468556039198752 -34.672164988239402,-58.468558521788161 -34.672163065119129,-58.46925938945234 -34.671620137354992,-58.470445780640752 -34.67070117000555,-58.471589188405986 -34.669815504870108,-58.4708422497092 -34.669113495876474,-58.470236404907212 -34.668544153236731,-58.47009489734846 -34.668410637156327,-58.469352416105082 -34.667707210111473,-58.468609436302685 -34.667008144803496,-58.467940543508831 -34.666378510250929,-58.467752010079373 -34.666525775771014,-58.465291468303469 -34.668446961630359,-58.465009506383119 -34.668673241034291,-58.464821730350167 -34.668845361780761,-58.46479575177618 -34.668871845218391,-58.463688669515477 -34.669148035911306,-58.463667687344952 -34.669143694323907,-58.463634232355226 -34.66916161638111,-58.46341435824786 -34.669279403959329,-58.463372079825731 -34.669302080867752,-58.463081245038452 -34.669559976398801,-58.463044592226488 -34.669592512595308,-58.462953215882543 -34.669704346815386,-58.462828936841454 -34.6698564637773,-58.462705083545167 -34.670004988962965,-58.462513378492851 -34.670268939565524,-58.462377590340452 -34.670427394233037)));;3253;8_6_7;COMUNA 8;6;7;612;297;315;94,29%;247;246;99,60%;1;0,41%;208;21;10,10%;187;89,90%
MULTIPOLYGON (((-58.471585197920852 -34.672358178622083,-58.471820297662717 -34.672372246139865,-58.472259299011249 -34.672403128817088,-58.473096130251896 -34.672462005545974,-58.474208895139874 -34.672540217500902,-58.474610733126298 -34.672575250251484,-58.4738115803152 -34.671904110753111,-58.473073725988812 -34.671210706625708,-58.472327955739857 -34.670509833589158,-58.471589188405986 -34.669815504870108,-58.470445780640752 -34.67070117000555,-58.46925938945234 -34.671620137354992,-58.468558521788161 -34.672163065119129,-58.468556039198752 -34.672164988239402,-58.46855541810433 -34.672165469365758,-58.468557696063677 -34.67216563732606,-58.468561004115003 -34.672165881237845,-58.469415430564489 -34.672228877409616,-58.46994180353888 -34.67226025655976,-58.470049891190804 -34.672266729135778,-58.471585197920852 -34.672358178622083)));;3254;8_6_8;COMUNA 8;6;8;764;374;390;95,90%;271;271;100,00%;0;0,00%;241;5;2,07%;236;97,93%
MULTIPOLYGON (((-58.476171205466457 -34.672718260595339,-58.476073430716383 -34.672709327462584,-58.474610733126298 -34.672575250251484,-58.474208895139874 -34.672540217500902,-58.473096130251896 -34.672462005545974,-58.472259299011249 -34.672403128817088,-58.471820297662717 -34.672372246139865,-58.471585197920852 -34.672358178622083,-58.470049891190804 -34.672266729135778,-58.46994180353888 -34.67226025655976,-58.469415430564489 -34.672228877409616,-58.468561004115003 -34.672165881237845,-58.468557696063677 -34.67216563732606,-58.468562420596378 -34.672167488189572,-58.469028118220365 -34.672695802615394,-58.469078334409389 -34.672705386989925,-58.4693188927709 -34.672751290871673,-58.469456927131219 -34.672852375187666,-58.470412177634671 -34.673263704907569,-58.471301644672359 -34.673645204717438,-58.471491515033144 -34.673727877342827,-58.471527139232343 -34.673743388643828,-58.471525086855571 -34.673745084519425,-58.47252162911996 -34.674181887162597,-58.474128236858888 -34.674885004929621,-58.47416522918023 -34.674856338737463,-58.474404144397525 -34.674671099936873,-58.474548873838273 -34.674558970353701,-58.475124974940229 -34.674112422452261,-58.475692802228309 -34.673672281297222,-58.476326151279629 -34.673180777367946,-58.476360259998842 -34.6731543073927,-58.476558441691949 -34.673103297765884,-58.476399352928624 -34.672949931424064,-58.476388605756405 -34.672910002001011,-58.476363870333046 -34.672818664338479,-58.476364691174986 -34.672626335225104,-58.476171205466457 -34.672718260595339)));;3255;8_6_9;COMUNA 8;6;9;869;401;468;85,68%;307;307;100,00%;0;0,00%;284;8;2,82%;276;97,18%
MULTIPOLYGON (((-58.46933080477173 -34.676754000230801,-58.46833602942587 -34.677559775200685,-58.469437250567815 -34.678520518493457,-58.470410208102074 -34.677766497933519,-58.471552860866595 -34.676880904631219,-58.470902538116675 -34.67627931490081,-58.470442339004137 -34.675853629764553,-58.4698274119012 -34.675284849697,-58.469698937300883 -34.675166332932896,-58.469566986678721 -34.675273878444457,-58.468582544689014 -34.676059795369717,-58.46933080477173 -34.676754000230801)));;3256;8_7_1;COMUNA 8;7;1;1339;652;687;94,91%;311;311;100,00%;0;0,00%;359;89;24,79%;270;75,21%
MULTIPOLYGON (((-58.467061171552459 -34.674690527950169,-58.466604357277845 -34.674944000748084,-58.46622630688811 -34.675200216120999,-58.466137147379783 -34.67536867374988,-58.466018661400511 -34.675495863434215,-58.466769369432185 -34.676236564091084,-58.466797840559515 -34.676213816070771,-58.467229508663841 -34.675868651022967,-58.467558798095936 -34.675605321659724,-58.467847681155263 -34.675374317892036,-58.467379662833885 -34.674996439605714,-58.467061171552459 -34.674690527950169)));;3257;8_7_10;COMUNA 8;7;10;1035;518;517;100,19%;161;161;100,00%;0;0,00%;285;60;21,05%;225;78,95%
MULTIPOLYGON (((-58.468582544689014 -34.676059795369717,-58.467847679823294 -34.675374317892086,-58.467229508663841 -34.675868651022967,-58.466797840559515 -34.676213816070771,-58.466769369432178 -34.676236564091077,-58.465822908716881 -34.676993372079004,-58.465449110382927 -34.677292261998304,-58.465167715612225 -34.677517273789242,-58.465948098204827 -34.678193399541279,-58.466225827546118 -34.677969794566614,-58.466689815094107 -34.677605686442924,-58.467592119879107 -34.676897748077202,-58.468336029425856 -34.677559775200685,-58.469330804771701 -34.676754000230801,-58.468582544689014 -34.676059795369717)));;3258;8_7_11;COMUNA 8;7;11;1570;759;811;93,59%;324;324;100,00%;0;0,00%;411;92;22,38%;319;77,62%
MULTIPOLYGON (((-58.466689815094107 -34.677605686442945,-58.466225827546118 -34.677969794566621,-58.465948098204855 -34.678193399541279,-58.465167715612225 -34.677517273789256,-58.464738076307853 -34.677860741224947,-58.465270041360938 -34.678445393977405,-58.465445487846893 -34.678598210944088,-58.465920594712962 -34.679012083074326,-58.46622281373854 -34.679271447488759,-58.46651512293775 -34.679034672123997,-58.466703077138327 -34.678882432943567,-58.466998124227572 -34.678643448928,-58.467352657583447 -34.678356315924901,-58.467474812894082 -34.67825736501679,-58.467941267903974 -34.677879519304859,-58.46833602942587 -34.677559775200685,-58.467592119879107 -34.676897748077202,-58.466689815094107 -34.677605686442945)));;3259;8_7_12;COMUNA 8;7;12;1705;819;886;92,44%;322;322;100,00%;0;0,00%;395;46;11,65%;349;88,35%
MULTIPOLYGON (((-58.46833602942587 -34.677559775200685,-58.467941267903974 -34.677879519304859,-58.467474812894082 -34.67825736501679,-58.467352657583447 -34.678356315924901,-58.466998124227572 -34.678643448928,-58.466703077138327 -34.678882432943567,-58.46651512293775 -34.679034672123997,-58.46622281373854 -34.679271447488759,-58.466128187009069 -34.679272929097465,-58.466056322203002 -34.679283001775062,-58.465992982836347 -34.679306173103633,-58.465958884062751 -34.679331315501862,-58.465917539844519 -34.679376599436971,-58.465904157110231 -34.679413783829403,-58.465885831087881 -34.679482236746246,-58.465885833631262 -34.679548646876739,-58.465884300849496 -34.679593366357423,-58.466160265391231 -34.679864844566907,-58.466293943019998 -34.679996252464676,-58.466471952076354 -34.680147095958631,-58.466667865083842 -34.68031300940919,-58.466723704488963 -34.680320754252534,-58.466780736204981 -34.680303920947118,-58.466881074089493 -34.68026694478521,-58.466931284851498 -34.680233280233331,-58.46697603898091 -34.680188488811353,-58.467014056893177 -34.680116725100667,-58.467044828701184 -34.680049257518718,-58.467003135774632 -34.679941016831663,-58.46717960761535 -34.680019815278328,-58.467384208226861 -34.680025230259481,-58.467565788616945 -34.679984306621762,-58.467691187905011 -34.679924370462494,-58.468083401679287 -34.679590401675874,-58.468225675155509 -34.679466166815345,-58.46842813197852 -34.67930812529999,-58.469044874664398 -34.67882681494337,-58.469437250567815 -34.678520518493457,-58.46833602942587 -34.677559775200685)));;3260;8_7_13;COMUNA 8;7;13;1513;742;771;96,24%;254;254;100,00%;0;0,00%;391;78;19,95%;313;80,05%
MULTIPOLYGON (((-58.467324054237089 -34.674476991561114,-58.467061171552459 -34.674690527950155,-58.467379662833885 -34.674996439605707,-58.467847681155263 -34.675374317892036,-58.468582544689014 -34.676059795369717,-58.469566986678721 -34.675273878444443,-58.469698937300883 -34.675166332932896,-58.46894702294864 -34.674472552883408,-58.469054935641303 -34.67438388301705,-58.469531248955278 -34.673992579411241,-58.470003125513834 -34.673605710921592,-58.469235198038923 -34.672924187273708,-58.468775851534424 -34.673297389878897,-58.468189579959216 -34.673773697809814,-58.467708226423163 -34.674165696604362,-58.467324054237089 -34.674476991561114)));;3261;8_7_2;COMUNA 8;7;2;1629;815;814;100,12%;383;383;100,00%;0;0,00%;478;170;35,56%;308;64,44%
MULTIPOLYGON (((-58.464511581524746 -34.671868410131637,-58.464471294708488 -34.671936929084261,-58.464533777634834 -34.671966576834507,-58.46462754529248 -34.672035380030223,-58.464690029131617 -34.672097775047099,-58.464765556759176 -34.672226932143445,-58.464854125795974 -34.672321581004695,-58.464994778103943 -34.672416299255211,-58.465041661934229 -34.672435665073273,-58.465062461741091 -34.672459327269813,-58.465184958962851 -34.672590595911252,-58.465364654939442 -34.672739046742308,-58.46540113880112 -34.672739045939373,-58.465494823473158 -34.672827778564589,-58.465722589654717 -34.672759813589479,-58.465959563752698 -34.672745088785021,-58.466219210391579 -34.672753655746,-58.466872402620652 -34.673384606518731,-58.467020335753247 -34.67353939990943,-58.467142380110275 -34.673650402371052,-58.46743085039828 -34.673921798160208,-58.467708226423149 -34.674165696604362,-58.46818957995923 -34.673773697809821,-58.468775851534424 -34.673297389878904,-58.469235198038923 -34.672924187273708,-58.469456927131219 -34.672852375187666,-58.4693188927709 -34.672751290871673,-58.469078334409389 -34.672705386989925,-58.469028118220365 -34.672695802615394,-58.467847958012584 -34.672470547994102,-58.467846649065294 -34.672470298151126,-58.466851605154183 -34.672280542343238,-58.46680534554929 -34.672271702453457,-58.4663113356522 -34.672177951193163,-58.465796053459862 -34.672095049790116,-58.465784816223433 -34.672093241856253,-58.464715256299698 -34.671913333119953,-58.464587563515764 -34.671889742988398,-58.464511581524746 -34.671868410131637)));;3262;8_7_3;COMUNA 8;7;3;1663;798;865;92,25%;363;363;100,00%;0;0,00%;493;95;19,27%;398;80,73%
MULTIPOLYGON (((-58.467708226423149 -34.674165696604362,-58.46743085039828 -34.673921798160208,-58.467142380110275 -34.673650402371052,-58.467020335753247 -34.67353939990943,-58.466872402620652 -34.673384606518731,-58.466219210391579 -34.672753655746,-58.465959563752698 -34.672745088785021,-58.465722589654717 -34.672759813589479,-58.465494823473158 -34.672827778564589,-58.46540113880112 -34.672739045939373,-58.465364654939442 -34.672739046742308,-58.465184958962851 -34.672590595911252,-58.465062461741091 -34.672459327269813,-58.465041661934229 -34.672435665073273,-58.464994778103943 -34.672416299255211,-58.464854125795974 -34.672321581004695,-58.464765556759176 -34.672226932143445,-58.464690029131617 -34.672097775047099,-58.46462754529248 -34.672035380030223,-58.464533777634834 -34.671966576834507,-58.464471294708488 -34.671936929084261,-58.464034951532994 -34.672549838202997,-58.464101100217917 -34.672581035468546,-58.464294176307966 -34.672675753909608,-58.46449543637231 -34.672781387704269,-58.464718604688727 -34.672900894409494,-58.464782708385258 -34.672944274757157,-58.464858320067322 -34.672992443726294,-58.464926174503752 -34.67303230271186,-58.465016278087219 -34.67309575340964,-58.465070663822431 -34.673119626232605,-58.465116098952798 -34.673139625867449,-58.465279513452515 -34.673253146635346,-58.465384620403633 -34.673318005227948,-58.465510185538939 -34.673371665781694,-58.465615889908278 -34.673447510364198,-58.465722958652421 -34.673531242351473,-58.465803771924207 -34.673597016696718,-58.465851424504379 -34.67363497421757,-58.465934624338054 -34.673688846692315,-58.466026945949075 -34.673757578406082,-58.466120710649299 -34.673675320130918,-58.466259055575684 -34.673547214214281,-58.466345062668211 -34.673465167263139,-58.466530261534757 -34.673650810800879,-58.466603022174006 -34.673741082017287,-58.466680940112809 -34.673849814744649,-58.466715891419035 -34.673877701653502,-58.466833106381891 -34.673972136830962,-58.466917925374545 -34.673997416278333,-58.466924575311403 -34.674015303840648,-58.466863972026275 -34.674118829763792,-58.466825613597145 -34.67414721209267,-58.466874119746315 -34.674192070770459,-58.467016395472299 -34.674254320965716,-58.467062001528603 -34.674261925175117,-58.467119799041484 -34.674298191647495,-58.467152110062116 -34.674362558351888,-58.467239915134982 -34.674425091959193,-58.4672658296126 -34.674428400936968,-58.467324054237103 -34.674476991561129,-58.467708226423149 -34.674165696604362)));;3263;8_7_4;COMUNA 8;7;4;1521;732;789;92,78%;308;308;100,00%;0;0,00%;446;146;32,74%;300;67,26%
MULTIPOLYGON (((-58.463066312799107 -34.671564800310669,-58.463071107364009 -34.671560053245486,-58.462927337025633 -34.671532642950361,-58.462675739162748 -34.671480106084203,-58.462471143428729 -34.671402442367778,-58.462377140097075 -34.671370463064875,-58.462302490442681 -34.671345336416209,-58.462214016849465 -34.671313357005118,-58.46212830815913 -34.67127680910113,-58.462070247098659 -34.671301935243413,-58.462031539344665 -34.671363608997488,-58.462000990414651 -34.671413404904413,-58.461870058554382 -34.671534604492344,-58.462331126646212 -34.672171384231774,-58.463282181789467 -34.673484798347602,-58.463805908735281 -34.672830411287968,-58.463884586794165 -34.672759493183698,-58.464034951532994 -34.672549838202997,-58.464471294708488 -34.671936929084261,-58.464511581524746 -34.671868410131637,-58.464450755178376 -34.671856989917622,-58.464389928709501 -34.671838717011575,-58.464334632134545 -34.67183186510389,-58.464232333349742 -34.671811308447595,-58.464022206292277 -34.671770194937359,-58.463848022081336 -34.671729080731467,-58.463770607049263 -34.671719944553516,-58.463613012068308 -34.67168796674715,-58.463306116931044 -34.671626294702399,-58.463248055711574 -34.671610305432772,-58.463159581523684 -34.671587463591933,-58.463066312799107 -34.671564800310669)));;3264;8_7_5;COMUNA 8;7;5;1707;874;833;104,92%;464;464;100,00%;0;0,00%;543;187;34,44%;356;65,56%
MULTIPOLYGON (((-58.465070663822431 -34.673119626232605,-58.465016278087219 -34.67309575340964,-58.464926174503752 -34.67303230271186,-58.464858320067322 -34.672992443726294,-58.464782708385258 -34.672944274757157,-58.464718604688727 -34.672900894409494,-58.46449543637231 -34.672781387704269,-58.464294176307966 -34.672675753909608,-58.464101100217917 -34.672581035468546,-58.464034951532994 -34.672549838202997,-58.463884586794165 -34.672759493183698,-58.463805908735281 -34.672830411287968,-58.463282181789467 -34.673484798347602,-58.463767566490134 -34.674155164760386,-58.464081772890573 -34.673949240717214,-58.464282945631325 -34.673797825849888,-58.464358981732765 -34.673731344221146,-58.464457351461256 -34.673661129731983,-58.464591436808753 -34.67353556104672,-58.464721089274981 -34.673417316421244,-58.464922259171196 -34.673251111364081,-58.465070663822431 -34.673119626232605)));;3265;8_7_6;COMUNA 8;7;6;1392;717;675;106,22%;238;238;100,00%;0;0,00%;395;133;33,67%;262;66,33%
MULTIPOLYGON (((-58.466026945949075 -34.673757578406082,-58.465934624338054 -34.673688846692315,-58.465851424504379 -34.67363497421757,-58.465803771924207 -34.673597016696718,-58.465722958652421 -34.673531242351473,-58.465615889908278 -34.673447510364198,-58.465510185538939 -34.673371665781694,-58.465384620403633 -34.673318005227948,-58.465279513452515 -34.673253146635346,-58.465116098952798 -34.673139625867449,-58.465070663822431 -34.673119626232605,-58.464922259171196 -34.673251111364081,-58.464721089274981 -34.673417316421244,-58.464591436808753 -34.67353556104672,-58.464457351461256 -34.673661129731983,-58.464358981732765 -34.673731344221146,-58.464282945631325 -34.673797825849888,-58.464081772890573 -34.673949240717214,-58.463767566490134 -34.674155164760386,-58.464141370891873 -34.674671371587209,-58.464346645613809 -34.674954897504954,-58.464579106195366 -34.67485024352947,-58.464950256076875 -34.674624315858246,-58.465068147314682 -34.674552551188349,-58.465156203649563 -34.674509872275117,-58.465222096649796 -34.674477405292905,-58.465349960565788 -34.674390851023091,-58.4654867748241 -34.674303099199228,-58.465583180919609 -34.674153797276375,-58.465713430050634 -34.674046678645404,-58.465870445075836 -34.673930263161907,-58.465890050035988 -34.673900684410278,-58.466026945949075 -34.673757578406082)));;3266;8_7_7;COMUNA 8;7;7;2159;1086;1073;101,21%;494;494;100,00%;0;0,00%;661;252;38,12%;409;61,88%
MULTIPOLYGON (((-58.464950256076875 -34.674624315858246,-58.464579106195366 -34.67485024352947,-58.464346645613809 -34.674954897504954,-58.464609208341443 -34.675317438318281,-58.464847381332241 -34.675224333343913,-58.464961779346545 -34.675185245751656,-58.465068846109695 -34.675143975039084,-58.465246665117078 -34.675067631439454,-58.465268315454018 -34.675005868814132,-58.465419877887356 -34.674909243291992,-58.465435476526153 -34.674873467362957,-58.465507334839593 -34.674781632349699,-58.465680548622295 -34.674681977751369,-58.465791789480555 -34.674589930325183,-58.466141825689512 -34.675122470034417,-58.46622630688811 -34.675200216120999,-58.466604357277845 -34.674944000748084,-58.467061171552459 -34.674690527950169,-58.467324054237103 -34.674476991561129,-58.4672658296126 -34.674428400936968,-58.467239915134982 -34.674425091959193,-58.467152110062116 -34.674362558351888,-58.467119799041484 -34.674298191647495,-58.467062001528603 -34.674261925175117,-58.467016395472299 -34.674254320965716,-58.466874119746315 -34.674192070770459,-58.466825613597145 -34.67414721209267,-58.466863972026275 -34.674118829763792,-58.466924575311403 -34.674015303840648,-58.466917925374545 -34.673997416278333,-58.466833106381891 -34.673972136830962,-58.466715891419035 -34.673877701653502,-58.466680940112809 -34.673849814744649,-58.466603022174006 -34.673741082017287,-58.466530261534757 -34.673650810800879,-58.466345062668211 -34.673465167263139,-58.466259055575684 -34.673547214214281,-58.466120710649299 -34.673675320130918,-58.466026945949075 -34.673757578406082,-58.465890050035988 -34.673900684410278,-58.465870445075836 -34.673930263161907,-58.465713430050634 -34.674046678645404,-58.465583180919609 -34.674153797276375,-58.4654867748241 -34.674303099199228,-58.465349960565788 -34.674390851023091,-58.465222096649796 -34.674477405292905,-58.465156203649563 -34.674509872275117,-58.465068147314682 -34.674552551188349,-58.464950256076875 -34.674624315858246)));;3267;8_7_8;COMUNA 8;7;8;1885;916;969;94,53%;381;381;100,00%;0;0,00%;457;160;35,01%;297;64,99%
MULTIPOLYGON (((-58.481912313741113 -34.683861859419871,-58.480842380228047 -34.684666409272452,-58.48067888802845 -34.684789816792936,-58.479621291767096 -34.685589565138834,-58.480385757059707 -34.686279543750842,-58.481147847350471 -34.686967334696256,-58.481909182795746 -34.687654557522016,-58.482444631291578 -34.688133920034623,-58.482445952117693 -34.688131117736738,-58.482926161333516 -34.688577014792507,-58.483342932739816 -34.688964001392549,-58.48560767405089 -34.687253424796403,-58.485228026633827 -34.686829037042124,-58.485229074100289 -34.686828265035516,-58.484115696782624 -34.685485334679385,-58.482998792912049 -34.684216832881212,-58.482349739489891 -34.683540314538725,-58.482316339169238 -34.683505500478518,-58.48190080022286 -34.683851415189636,-58.481912313741113 -34.683861859419871)));;3268;8_8_1;COMUNA 8;8;1;864;407;457;89,06%;307;307;100,00%;0;0,00%;281;3;1,07%;278;98,93%
MULTIPOLYGON (((-58.471443674901813 -34.680270998775626,-58.472349206791208 -34.679555912420099,-58.472223365123909 -34.679440778559282,-58.471410943574895 -34.678688848418595,-58.471303093569695 -34.67858906480739,-58.470518312832134 -34.677878184044715,-58.470410208102074 -34.677766497933519,-58.469437250567815 -34.678520518493457,-58.469044874664398 -34.67882681494337,-58.46842813197852 -34.67930812529999,-58.468225675155509 -34.679466166815345,-58.468083401679287 -34.679590401675874,-58.467691187905011 -34.679924370462494,-58.467565788616945 -34.679984306621762,-58.467384208226861 -34.680025230259481,-58.46717960761535 -34.680019815278328,-58.467003135774632 -34.679941016831663,-58.467044828701184 -34.680049257518718,-58.467080041833299 -34.680140737437021,-58.467465057283562 -34.680582635519151,-58.468188622873555 -34.681232198833207,-58.469115284344234 -34.682066258896974,-58.469964935459679 -34.681404363732838,-58.470071663149341 -34.681322594718424,-58.471443674901813 -34.680270998775626)));;3269;8_8_10;COMUNA 8;8;10;899;431;468;92,09%;293;293;100,00%;0;0,00%;289;13;4,50%;276;95,50%
MULTIPOLYGON (((-58.471514336276172 -34.682578868233882,-58.471364618883079 -34.682448664471707,-58.471090337119982 -34.682209804489723,-58.470860647608433 -34.682009815110604,-58.470071663149341 -34.681322594718424,-58.469964935459679 -34.681404363732838,-58.469115284344234 -34.682066258896974,-58.470228328089867 -34.682905370979469,-58.470595113104025 -34.683181833479736,-58.470627682662794 -34.683210916590866,-58.471241051847045 -34.683758564705407,-58.472376411496839 -34.684772166677817,-58.47250922680572 -34.6846706042842,-58.473258203221448 -34.68409489380624,-58.472747391042773 -34.683650841563029,-58.472169739035394 -34.683148621907137,-58.472099398127263 -34.683087499081338,-58.471514336276172 -34.682578868233882)));;3270;8_8_11;COMUNA 8;8;11;927;433;494;87,65%;382;382;100,00%;0;0,00%;338;21;6,21%;317;93,79%
MULTIPOLYGON (((-58.478559969707653 -34.682605972699236,-58.478383521600456 -34.682739308690905,-58.477339483070061 -34.683529951030735,-58.478100585016527 -34.684216916374794,-58.478863746029035 -34.684905778068853,-58.479621291767096 -34.685589565138834,-58.48067888802845 -34.684789816792936,-58.480842380228047 -34.684666409272452,-58.481912313741113 -34.683861859419871,-58.48190080022286 -34.683851415189636,-58.482316339169238 -34.683505500478518,-58.4818704352395 -34.683040719028675,-58.481841641377038 -34.683003187540578,-58.481828053352828 -34.682985476155764,-58.480938777492085 -34.681826324835619,-58.480878666937102 -34.681695807965042,-58.480700045032513 -34.681307967112616,-58.480360882476063 -34.681155829822671,-58.480034331605964 -34.680971435463469,-58.48017390288652 -34.681449737352786,-58.480438007044739 -34.681824778979241,-58.480038275417321 -34.681487222444105,-58.478559969707653 -34.682605972699236)));;3271;8_8_2;COMUNA 8;8;2;924;437;487;89,73%;319;319;100,00%;0;0,00%;309;6;1,94%;303;98,06%
MULTIPOLYGON (((-58.478425479223915 -34.680103462821904,-58.478305379539776 -34.680198691921603,-58.477814235902287 -34.680576509786093,-58.47700309754898 -34.681200426113975,-58.476836112001628 -34.681328829084947,-58.476673644297087 -34.681457372155307,-58.476509556517975 -34.681587182827272,-58.47579727974037 -34.682137838532704,-58.476578223166975 -34.682842840024463,-58.477339483070061 -34.683529951030735,-58.478383521600456 -34.682739308690905,-58.478559969707653 -34.682605972699236,-58.480038275417321 -34.681487222444105,-58.480438007044739 -34.681824778979241,-58.48017390288652 -34.681449737352786,-58.480034331605964 -34.680971435463469,-58.480360882476063 -34.681155829822671,-58.480700045032513 -34.681307967112616,-58.480701389634802 -34.681308570029884,-58.480543055756748 -34.680960958533504,-58.480517824150162 -34.68090560749426,-58.480062318776746 -34.679864995223468,-58.479745460626617 -34.679136034029405,-58.479309935020233 -34.679414505331948,-58.479314247627208 -34.679424736245068,-58.479053676799772 -34.679612663556192,-58.479056576581421 -34.679616645155349,-58.478895237474077 -34.679749969479268,-58.478901363855655 -34.679757898830452,-58.478625445881235 -34.679944982163313,-58.478533389703394 -34.6800178833168,-58.478425479223915 -34.680103462821904)));;3272;8_8_3;COMUNA 8;8;3;682;313;369;84,82%;264;264;100,00%;0;0,00%;235;6;2,55%;229;97,45%
MULTIPOLYGON (((-58.476171100410177 -34.681019248760826,-58.476673644297087 -34.681457372155307,-58.476836112001628 -34.681328829084947,-58.47700309754898 -34.681200426113975,-58.477814235902287 -34.680576509786093,-58.478305379539776 -34.680198691921603,-58.478425479223915 -34.680103462821904,-58.478533389703394 -34.6800178833168,-58.478625445881235 -34.679944982163313,-58.478901363855655 -34.679757898830452,-58.478895237474077 -34.679749969479268,-58.478542288192081 -34.67929314554452,-58.478493425857273 -34.67921709362097,-58.478444905021902 -34.679143224786671,-58.478262600042392 -34.678918031218522,-58.478090865398478 -34.678684737237667,-58.478038595639703 -34.6786181928383,-58.477985814330516 -34.678550873812348,-58.477970460452262 -34.678501156161737,-58.477849636669895 -34.678355322453911,-58.477838381059151 -34.678339830499816,-58.477723866138923 -34.678194136728401,-58.477676968708153 -34.678133647998791,-58.477584026128717 -34.67801041680093,-58.477527664228369 -34.677937886606195,-58.477223540139846 -34.678171309459245,-58.476564560765709 -34.677596582772068,-58.476134796210154 -34.677931357765438,-58.476021856715334 -34.678019330153496,-58.47589434134364 -34.678118642331746,-58.475414024833377 -34.678491449354397,-58.474280852933056 -34.679371162071803,-58.474936846439199 -34.679943154689184,-58.475590887929627 -34.680513383320374,-58.476171100410177 -34.681019248760826)));;3273;8_8_4;COMUNA 8;8;4;809;378;431;87,70%;372;372;100,00%;0;0,00%;300;2;0,67%;298;99,33%
MULTIPOLYGON (((-58.476553025852667 -34.676413666361405,-58.476371728661846 -34.676547352247923,-58.476581046361588 -34.676771348446088,-58.476751826859733 -34.676955840667183,-58.476951768355491 -34.677173639951789,-58.477058689492424 -34.6772960953354,-58.477227678670211 -34.677461924634699,-58.4775250021383 -34.677829010908567,-58.477473689780709 -34.677867680098252,-58.477527664228369 -34.677937886606195,-58.477584026128717 -34.67801041680093,-58.477676968708153 -34.678133647998791,-58.477723866138923 -34.678194136728401,-58.477838381059151 -34.678339830499816,-58.477849636669895 -34.678355322453911,-58.477970460452262 -34.678501156161737,-58.477985814330516 -34.678550873812348,-58.478038595639703 -34.6786181928383,-58.478090865398478 -34.678684737237667,-58.478262600042392 -34.678918031218522,-58.478444905021902 -34.679143224786671,-58.478493425857273 -34.67921709362097,-58.478542288192081 -34.67929314554452,-58.478895237474077 -34.679749969479268,-58.479056576581421 -34.679616645155349,-58.479053676799772 -34.679612663556192,-58.479314247627208 -34.679424736245068,-58.479309935020233 -34.679414505331948,-58.479745460626617 -34.679136034029405,-58.479739808206006 -34.679123029993796,-58.479094463305429 -34.677638312100363,-58.478426515781123 -34.676116670831746,-58.47840425725844 -34.676065930423469,-58.478344900251074 -34.675930620184907,-58.478289609997034 -34.675803109960256,-58.477510937849765 -34.674007294014444,-58.477103124940825 -34.673073590599358,-58.476778035435558 -34.673211859664548,-58.476777619392074 -34.673208768387688,-58.476697921138616 -34.67314761314487,-58.476689892874639 -34.673141452770693,-58.476558441691949 -34.673103297765884,-58.476360259998842 -34.6731543073927,-58.476326151279629 -34.673180777367946,-58.475692802228309 -34.673672281297222,-58.475124974940229 -34.674112422452261,-58.474548873838273 -34.674558970353701,-58.47537637601647 -34.675338414451367,-58.475544077246248 -34.675491710736225,-58.476473393643204 -34.676340927029159,-58.476553025852667 -34.676413666361405)));;3274;8_8_5;COMUNA 8;8;5;613;287;326;88,04%;299;298;99,67%;1;0,34%;240;16;6,67%;224;93,33%
MULTIPOLYGON (((-58.472550700132075 -34.677805006711999,-58.473476518664292 -34.678669950437289,-58.474280852933056 -34.679371162071803,-58.475414024833377 -34.678491449354397,-58.47589434134364 -34.678118642331746,-58.476021856715334 -34.678019330153496,-58.476134796210154 -34.677931357765438,-58.476564560765709 -34.677596582772068,-58.477223540139846 -34.678171309459245,-58.477527664228369 -34.677937886606195,-58.477473689780709 -34.677867680098252,-58.4775250021383 -34.677829010908567,-58.477227678670211 -34.677461924634699,-58.477058689492424 -34.6772960953354,-58.476951768355491 -34.677173639951789,-58.476751826859733 -34.676955840667183,-58.476581046361588 -34.676771348446088,-58.476371728661846 -34.676547352247923,-58.476553025852667 -34.676413666361405,-58.476473393643204 -34.676340927029159,-58.475544077246248 -34.675491710736225,-58.47537637601647 -34.675338414451367,-58.474548873838273 -34.674558970353701,-58.474404144397525 -34.674671099936873,-58.47416522918023 -34.674856338737463,-58.474128236858888 -34.674885004929621,-58.473425718864476 -34.675429449119584,-58.47329547671108 -34.675530378621588,-58.472693358365312 -34.675997061276739,-58.472156696791352 -34.676412959904518,-58.471552860866595 -34.676880904631219,-58.4724292086593 -34.67769149243852,-58.472550700132075 -34.677805006711999)));;3275;8_8_6;COMUNA 8;8;6;945;393;552;71,20%;417;414;99,28%;3;0,72%;321;3;0,93%;318;99,07%
MULTIPOLYGON (((-58.471552860866595 -34.676880904631219,-58.470410208102074 -34.677766497933519,-58.470518312832134 -34.677878184044715,-58.471303093569695 -34.67858906480739,-58.471410943574895 -34.678688848418595,-58.472223365123909 -34.679440778559282,-58.472349206791208 -34.679555912420099,-58.471443674901813 -34.680270998775626,-58.472230529351727 -34.680957435904915,-58.472884645574048 -34.681528101502948,-58.472987790315898 -34.681449006359578,-58.473662403180718 -34.680931258548959,-58.473797085922939 -34.680826807124397,-58.474936846439199 -34.679943154689184,-58.474280852933056 -34.679371162071803,-58.473476518664292 -34.678669950437289,-58.472550700132075 -34.677805006711999,-58.4724292086593 -34.67769149243852,-58.471552860866595 -34.676880904631219)));;3276;8_8_7;COMUNA 8;8;7;856;394;462;85,28%;333;333;100,00%;0;0,00%;308;10;3,25%;298;96,75%
MULTIPOLYGON (((-58.473797085922939 -34.680826807124397,-58.473662403180718 -34.680931258548959,-58.472987790315898 -34.681449006359578,-58.472884645574048 -34.681528101502948,-58.473537406579773 -34.682097566444092,-58.474117276616923 -34.68260344155987,-58.474472654057664 -34.68291341542858,-58.474621184111363 -34.683047136692586,-58.475536183115416 -34.682339772731801,-58.47579727974037 -34.682137838532704,-58.476509556517975 -34.681587182827272,-58.476673644297087 -34.681457372155307,-58.476171100410177 -34.681019248760826,-58.475590887929627 -34.680513383320374,-58.474936846439199 -34.679943154689184,-58.473797085922939 -34.680826807124397)));;3277;8_8_8;COMUNA 8;8;8;640;299;341;87,68%;222;222;100,00%;0;0,00%;206;2;0,97%;204;99,03%
MULTIPOLYGON (((-58.474117276616923 -34.68260344155987,-58.473537406579773 -34.682097566444092,-58.472884645574048 -34.681528101502948,-58.472230529351727 -34.680957435904915,-58.471443674901813 -34.680270998775626,-58.470071663149341 -34.681322594718424,-58.470860647608433 -34.682009815110604,-58.471090337119982 -34.682209804489723,-58.471364618883079 -34.682448664471707,-58.471514336276172 -34.682578868233882,-58.472099398127263 -34.683087499081338,-58.472169739035394 -34.683148621907137,-58.472747391042773 -34.683650841563029,-58.473258203221448 -34.68409489380624,-58.47344634078739 -34.683950296350005,-58.474621184111363 -34.683047136692586,-58.474472654057664 -34.68291341542858,-58.474117276616923 -34.68260344155987)));;3278;8_8_9;COMUNA 8;8;9;735;358;377;94,96%;243;243;100,00%;0;0,00%;232;2;0,86%;230;99,14%
MULTIPOLYGON (((-58.481909182795746 -34.687654557522016,-58.481147847350471 -34.686967334696256,-58.479962190580288 -34.687864783425979,-58.478775314767937 -34.688763136168923,-58.479535197344696 -34.689448894905077,-58.479398886613048 -34.689546873719834,-58.478577696637998 -34.69016784317855,-58.478381369918949 -34.690317801700893,-58.479106809770968 -34.690972727091022,-58.479122592839161 -34.690986400103355,-58.479415035275188 -34.691239647903238,-58.479841050106913 -34.691608778118237,-58.482120294245568 -34.689887422757288,-58.483342932739816 -34.688964001392549,-58.482926161333516 -34.688577014792507,-58.482445952117693 -34.688131117736738,-58.482444631291578 -34.688133920034623,-58.481909182795746 -34.687654557522016)));;3279;8_9_1;COMUNA 8;9;1;801;354;447;79,19%;301;301;100,00%;0;0,00%;271;16;5,90%;255;94,10%
MULTIPOLYGON (((-58.478100585016527 -34.684216916374794,-58.477339483070061 -34.683529951030735,-58.476154516228384 -34.684427433567684,-58.476915104832827 -34.685112997784813,-58.477555390333343 -34.685690188987756,-58.477676302946826 -34.685799543041469,-58.478438452026175 -34.686489111584493,-58.479084301809685 -34.687073336326577,-58.479199419819174 -34.687177055684572,-58.479962190580288 -34.687864783425979,-58.481147847350471 -34.686967334696256,-58.480385757059707 -34.686279543750842,-58.479621291767096 -34.685589565138834,-58.478863746029035 -34.684905778068853,-58.478100585016527 -34.684216916374794)));;3280;8_9_2;COMUNA 8;9;2;883;418;465;89,89%;319;319;100,00%;0;0,00%;298;6;2,01%;292;97,99%
MULTIPOLYGON (((-58.473055303584729 -34.685509382376495,-58.473817411490515 -34.686197430522938,-58.474968586104872 -34.685325608794841,-58.476154516228384 -34.684427433567684,-58.477339483070061 -34.683529951030735,-58.476578223166975 -34.682842840024463,-58.47579727974037 -34.682137838532704,-58.475536183115416 -34.682339772731801,-58.474621184111363 -34.683047136692586,-58.47344634078739 -34.683950296350005,-58.473258203221448 -34.68409489380624,-58.47250922680572 -34.6846706042842,-58.472376411496839 -34.684772166677817,-58.472301905206528 -34.684829145792435,-58.473055303584729 -34.685509382376495)));;3281;8_9_3;COMUNA 8;9;3;1028;490;538;91,08%;429;429;100,00%;0;0,00%;352;14;3,98%;338;96,02%
MULTIPOLYGON (((-58.477676302946826 -34.685799543041469,-58.477555390333343 -34.685690188987756,-58.476915104832827 -34.685112997784813,-58.476154516228384 -34.684427433567684,-58.474968586104872 -34.685325608794841,-58.473817411490515 -34.686197430522938,-58.474578423523027 -34.686884487992707,-58.475340471374551 -34.687572526463718,-58.475519662502791 -34.687436870693325,-58.476490029071648 -34.686700127336202,-58.477142261984376 -34.687289291323829,-58.477251323651778 -34.68738773141903,-58.478307174953557 -34.686586806878395,-58.478438452026175 -34.686489111584493,-58.477676302946826 -34.685799543041469)));;3282;8_9_4;COMUNA 8;9;4;513;240;273;87,91%;193;193;100,00%;0;0,00%;186;0;0,00%;186;100,00%
MULTIPOLYGON (((-58.479962190580288 -34.687864783425979,-58.479199419819174 -34.687177055684572,-58.479084301809685 -34.687073336326577,-58.478438452026175 -34.686489111584493,-58.478307174953557 -34.686586806878395,-58.477251323651778 -34.68738773141903,-58.477142261984376 -34.687289291323829,-58.476490029071648 -34.686700127336202,-58.475519662502791 -34.687436870693325,-58.475340471374551 -34.687572526463718,-58.476101593855759 -34.688259715102113,-58.476862728904635 -34.688946828482749,-58.477624132362834 -34.689634218694891,-58.477811593297076 -34.689492431682368,-58.478775314767937 -34.688763136168923,-58.479962190580288 -34.687864783425979)));;3283;8_9_5;COMUNA 8;9;5;940;428;512;83,59%;436;436;100,00%;0;0,00%;385;15;3,90%;370;96,10%
MULTIPOLYGON (((-58.479535197344696 -34.689448894905077,-58.478775314767937 -34.688763136168923,-58.477811593297076 -34.689492431682368,-58.477624132362834 -34.689634218694891,-58.478381369918949 -34.690317801700893,-58.478577696637998 -34.69016784317855,-58.479398886613048 -34.689546873719834,-58.479535197344696 -34.689448894905077)));;3284;8_9_6;COMUNA 8;9;6;1020;469;551;85,12%;305;305;100,00%;0;0,00%;294;6;2,04%;288;97,96%
MULTIPOLYGON (((-58.4770061425492 -34.693068375512922,-58.477426779865738 -34.693431984633811,-58.479841050106913 -34.691608778118237,-58.479415035275188 -34.691239647903238,-58.479122592839161 -34.690986400103355,-58.479106809770968 -34.690972727091022,-58.478381369918949 -34.690317801700893,-58.477624132362834 -34.689634218694891,-58.476862728904635 -34.688946828482749,-58.475642471432131 -34.689870929695289,-58.474453474342141 -34.690771353016345,-58.475212060927582 -34.691458547090797,-58.475974071060563 -34.692148905079442,-58.476707013105965 -34.692803838214722,-58.476703336657046 -34.692806619857869,-58.4770061425492 -34.693068375512922)));;3285;8_9_7;COMUNA 8;9;7;772;330;442;74,66%;298;297;99,66%;1;0,34%;260;16;6,15%;244;93,85%
MULTIPOLYGON (((-58.475340471374551 -34.687572526463718,-58.474578423523027 -34.686884487992707,-58.473516735527987 -34.687689606168824,-58.473359961289972 -34.687808214369426,-58.472173611683225 -34.688705868978083,-58.472934036505755 -34.689394767506066,-58.473694388667731 -34.690083661217081,-58.474453474342141 -34.690771353016345,-58.475642471432131 -34.689870929695289,-58.476862728904635 -34.688946828482749,-58.476101593855759 -34.688259715102113,-58.475340471374551 -34.687572526463718)));;3286;8_9_8;COMUNA 8;9;8;756;364;392;92,86%;286;285;99,65%;1;0,35%;258;5;1,94%;253;98,06%
MULTIPOLYGON (((-58.471096152697484 -34.685770314060157,-58.470515601821255 -34.686223955208362,-58.470038368914963 -34.686596881208956,-58.469929247530509 -34.686682101053272,-58.470649901709692 -34.687334677515913,-58.471270720417657 -34.68789683201107,-58.471411153540636 -34.688019641892332,-58.471558237860371 -34.688148296336053,-58.472173611683225 -34.688705868978083,-58.473359961289972 -34.687808214369426,-58.473516735527987 -34.687689606168824,-58.474578423523027 -34.686884487992707,-58.473817411490515 -34.686197430522938,-58.473055303584729 -34.685509382376495,-58.472301905206528 -34.684829145792435,-58.472129108178358 -34.684961204758821,-58.471741144844152 -34.685265185223983,-58.471213370347513 -34.685678683987007,-58.471096152697484 -34.685770314060157)));;3287;8_9_9;COMUNA 8;9;9;922;418;504;82,94%;328;328;100,00%;0;0,00%;315;14;4,44%;301;95,56%
MULTIPOLYGON (((-58.517763049753732 -34.634571012305464,-58.517802443840985 -34.634358734088984,-58.51784200734226 -34.634145258553794,-58.51788123122904 -34.633933895897002,-58.517921133925569 -34.633718589122303,-58.517969186799967 -34.633459474385361,-58.518012909679861 -34.633223883479033,-58.51817209130828 -34.633003803981836,-58.517092929432366 -34.633013726943865,-58.517062294768067 -34.632985862780039,-58.516833308619269 -34.633095070192162,-58.516820846202855 -34.633093709749154,-58.515932788653195 -34.633099523283249,-58.515369383832834 -34.633157375398255,-58.514911877741802 -34.633204334198318,-58.514073609696794 -34.633401457164908,-58.513913123010155 -34.63345779410362,-58.513322966228195 -34.633664878225353,-58.51262303327718 -34.63396088060901,-58.512532996506287 -34.633998946839199,-58.511864668566595 -34.634295284064116,-58.511446681743628 -34.634476161949465,-58.511327512167128 -34.634527760494066,-58.510670759602945 -34.63481746660581,-58.509977873843475 -34.635103521090329,-58.509542244384846 -34.635289399428373,-58.508830508400195 -34.635553411646498,-58.508545633808119 -34.635643521976391,-58.509011906287256 -34.635548554014498,-58.509758502265903 -34.635305866012963,-58.51041405509411 -34.635140676387813,-58.511130384291071 -34.635024545218982,-58.511722173648693 -34.634959940507422,-58.512547552197034 -34.634972493710407,-58.513824729953541 -34.635062108811702,-58.515117449938366 -34.6352031139754,-58.516238853164502 -34.635382843978981,-58.516370083628189 -34.635407153288718,-58.516416643985977 -34.635202900822605,-58.517646989198973 -34.635196930032258,-58.517683327267086 -34.635000921385874,-58.517722891376224 -34.634787445911236,-58.517763049753732 -34.634571012305464)));;3288;9_1_1;COMUNA 9;1;1;530;234;296;79,05%;238;238;100,00%;0;0,00%;206;1;0,49%;205;99,51%
MULTIPOLYGON (((-58.51784200734226 -34.634145258553794,-58.517802443840985 -34.634358734088984,-58.517763049753732 -34.634571012305464,-58.517722891376224 -34.634787445911236,-58.517683327267086 -34.635000921385874,-58.517646989198973 -34.635196930032258,-58.516416643985977 -34.635202900822605,-58.516370083628189 -34.635407153288718,-58.516238853164502 -34.635382843978981,-58.515117449938366 -34.6352031139754,-58.513824729953541 -34.635062108811702,-58.512547552197034 -34.634972493710407,-58.511722173648693 -34.634959940507422,-58.511130384291071 -34.635024545218982,-58.51041405509411 -34.635140676387813,-58.509758502265903 -34.635305866012963,-58.509011906287256 -34.635548554014498,-58.508545633808119 -34.635643521976391,-58.508275922389274 -34.635728766662339,-58.507651629372411 -34.635891116273221,-58.507092429253106 -34.635890968967615,-58.506961724858407 -34.635890946046281,-58.506819391014595 -34.635812403524604,-58.506443367382978 -34.636109238704123,-58.505869574828864 -34.636562133820036,-58.505735515827936 -34.636667959255178,-58.505671514295521 -34.636718460367433,-58.50578127894665 -34.636732785204472,-58.505977634735736 -34.636759762614552,-58.506230779124301 -34.636793083435542,-58.506354276905654 -34.636805005990411,-58.506370342941807 -34.636806557006381,-58.506594612130158 -34.636836705416137,-58.50685353302903 -34.63687240935834,-58.507103790723683 -34.636905729411446,-58.50734538560851 -34.636937461126493,-58.507580243441303 -34.636969194842059,-58.50777020793975 -34.63699438897514,-58.507831464178224 -34.63700251304688,-58.508073060485664 -34.637035834314865,-58.508306956843448 -34.637068362485763,-58.508555290777096 -34.637101680278334,-58.508798812588189 -34.637134999383932,-58.50905580953912 -34.637169108379901,-58.509135331527546 -34.637180447655822,-58.509283931863273 -34.637201636870635,-58.509517828709598 -34.637233367220126,-58.509762314652619 -34.637268275026301,-58.509997175236322 -34.63730159507967,-58.510244548070659 -34.637334909803485,-58.51049356496263 -34.637369858269018,-58.510514009447057 -34.637283892604628,-58.51130566215199 -34.63738398827352,-58.51191672597038 -34.63746564725065,-58.51255412197564 -34.637550884068062,-58.51341664533701 -34.637652362694773,-58.513826775010884 -34.637700643712478,-58.514660328357998 -34.637797688919036,-58.516153946261724 -34.637971556056684,-58.517347026730747 -34.638118426384764,-58.518592019951875 -34.638291036726486,-58.519895841656655 -34.638383392953472,-58.521263243143714 -34.638492888371516,-58.521326156509815 -34.637930304994249,-58.521471769797259 -34.636593783634488,-58.521505547942212 -34.636283616527088,-58.521536421025189 -34.636203669485347,-58.521577807126882 -34.636170197731289,-58.521641867581806 -34.636150588693781,-58.522702293160499 -34.635979009757911,-58.522873447362912 -34.635947586397037,-58.522925124016318 -34.6358884040527,-58.522324526819638 -34.635191282235731,-58.52154488848408 -34.634318815649841,-58.521082668192967 -34.633823701682523,-58.521016366161433 -34.633822072754676,-58.520686870937055 -34.633822229850772,-58.520706920492437 -34.633762437032729,-58.520732975387858 -34.633671089064123,-58.520769053795391 -34.633548184026722,-58.520788327072147 -34.633486221976597,-58.520788366993173 -34.633486139345884,-58.52081439416169 -34.633401697784429,-58.520748121107943 -34.633219865957948,-58.520528584209821 -34.633004348491433,-58.520388930652224 -34.63296879863055,-58.520340672128114 -34.632910698800508,-58.52024099011696 -34.632797216443294,-58.52023767993218 -34.632803313334065,-58.520173616165458 -34.632912449445008,-58.520067738126244 -34.632946245312418,-58.519896298827582 -34.632967302223278,-58.519746695441043 -34.63298371084997,-58.519425325958423 -34.633001819070302,-58.519254075570935 -34.633010067876739,-58.519082565111781 -34.633011767052643,-58.518888294702812 -34.632997137911055,-58.518803434080155 -34.632997951648036,-58.518380238472105 -34.633001878092131,-58.51817209130828 -34.633003803981836,-58.518012909679861 -34.633223883479033,-58.517969186799967 -34.633459474385361,-58.517921133925569 -34.633718589122303,-58.51788123122904 -34.633933895897002,-58.51784200734226 -34.634145258553794)));;3289;9_1_2;COMUNA 9;1;2;444;204;240;85,00%;211;211;100,00%;0;0,00%;184;0;0,00%;184;100,00%
MULTIPOLYGON (((-58.510315556649914 -34.638118346012206,-58.510052663372029 -34.639116719636547,-58.511410846558498 -34.639346332897446,-58.512992966047797 -34.639294210223724,-58.513220277009566 -34.638409721924226,-58.51341664533701 -34.637652362694773,-58.51255412197564 -34.637550884068062,-58.51191672597038 -34.63746564725065,-58.51130566215199 -34.63738398827352,-58.510514009447057 -34.637283892604628,-58.51049356496263 -34.637369858269018,-58.510315556649914 -34.638118346012206)));;3290;9_1_3;COMUNA 9;1;3;613;268;345;77,68%;333;333;100,00%;0;0,00%;261;3;1,15%;258;98,85%
MULTIPOLYGON (((-58.521263243143714 -34.638492888371516,-58.519895841656655 -34.638383392953472,-58.518592019951875 -34.638291036726486,-58.517347026730747 -34.638118426384764,-58.516153946261724 -34.637971556056684,-58.514660328357998 -34.637797688919036,-58.513826775010884 -34.637700643712478,-58.51341664533701 -34.637652362694773,-58.513220277009566 -34.638409721924226,-58.512992966047797 -34.639294210223724,-58.514298669668065 -34.639245423825471,-58.514490298864352 -34.639238300123012,-58.515912312543328 -34.639193390789778,-58.516301706645322 -34.639181107210078,-58.517052802368781 -34.639157393762872,-58.517412027185848 -34.639137162080573,-58.518770280512499 -34.639060627289105,-58.518967103924929 -34.639049550377223,-58.519756956135154 -34.639009393417979,-58.520541780496806 -34.638969515427263,-58.520960648577173 -34.638948259044518,-58.521217113680088 -34.638932361111365,-58.522563514081227 -34.638852831921959,-58.522590598264749 -34.638599148586863,-58.521263243143714 -34.638492888371516)));;3291;9_1_4;COMUNA 9;1;4;749;350;399;87,72%;326;326;100,00%;0;0,00%;269;0;0,00%;269;100,00%
MULTIPOLYGON (((-58.523929781494751 -34.637056180830015,-58.522764185925915 -34.636971616855881,-58.52265999993287 -34.637947966972789,-58.522651959642964 -34.638023536717625,-58.521326156509815 -34.637930304994249,-58.521263243143714 -34.638492888371516,-58.522590598264749 -34.638599148586863,-58.522563514081227 -34.638852831921959,-58.522670956723971 -34.638846440907265,-58.523729898619465 -34.638931904246519,-58.525100643793436 -34.639050158045528,-58.526423405991252 -34.639149336402106,-58.5277135403717 -34.639253447539737,-58.528797718370171 -34.639344064841971,-58.528896091799012 -34.639290770365108,-58.528961442923432 -34.639286086842318,-58.529229956195664 -34.639313124620365,-58.529238148008218 -34.639221215832933,-58.529294644545203 -34.639225480907356,-58.529843418317633 -34.639265251711507,-58.530072895964544 -34.639281884878173,-58.530072898000014 -34.639281885002923,-58.530085541966002 -34.639006870554908,-58.53000501515335 -34.639000506367424,-58.529208524236132 -34.638936997630722,-58.52908903381703 -34.638900934827525,-58.52909497199655 -34.638867831953235,-58.527785159976617 -34.638765154418017,-58.527827728893882 -34.638393359312715,-58.527171082411257 -34.638344833403515,-58.526509835274723 -34.638296024666069,-58.526628324522498 -34.637251985622335,-58.525969643309743 -34.637204158544208,-58.525318291056728 -34.637156957968429,-58.523929781494751 -34.637056180830015)));;3292;9_1_5;COMUNA 9;1;5;737;352;385;91,43%;366;365;99,73%;1;0,27%;294;2;0,68%;292;99,32%
MULTIPOLYGON (((-58.526747657352153 -34.636200762513567,-58.52609000679179 -34.636152865106432,-58.525444974605286 -34.636114605859497,-58.525166549186039 -34.636100554214089,-58.524448657011952 -34.636041587292375,-58.524044020865112 -34.635984680526612,-58.52406932235575 -34.635747336198875,-58.523322673384179 -34.635865248611019,-58.522873447362912 -34.635947586397037,-58.522702293160499 -34.635979009757911,-58.521641867581806 -34.636150588693781,-58.521577807126882 -34.636170197731289,-58.521536421025189 -34.636203669485347,-58.521505547942212 -34.636283616527088,-58.521471769797259 -34.636593783634488,-58.521326156509815 -34.637930304994249,-58.522651959642964 -34.638023536717625,-58.52265999993287 -34.637947966972789,-58.522764185925915 -34.636971616855881,-58.523929781494751 -34.637056180830015,-58.525318291056728 -34.637156957968429,-58.525969643309743 -34.637204158544208,-58.526628324522498 -34.637251985622335,-58.527287688136461 -34.637299808780938,-58.527405052992407 -34.636248586084136,-58.526747657352153 -34.636200762513567)));;3293;9_1_6;COMUNA 9;1;6;809;409;400;102,25%;295;293;99,32%;2;0,68%;291;51;17,53%;240;82,47%
MULTIPOLYGON (((-58.526848900376386 -34.635315173525299,-58.527383668184036 -34.635263002259258,-58.52751572984937 -34.635256593916594,-58.528182114126558 -34.635150178194245,-58.528206666526906 -34.634842338143663,-58.527077047812149 -34.634750260557432,-58.526920732223601 -34.634682946413093,-58.525604858131331 -34.634585741679913,-58.524300391179821 -34.634470699505783,-58.524231619514111 -34.634453832262565,-58.523274528954659 -34.634219374138191,-58.523037962864215 -34.634161461341087,-58.522344883962155 -34.63399165585664,-58.522168580232645 -34.633965403059392,-58.521082668192967 -34.633823701682523,-58.52154488848408 -34.634318815649841,-58.522324526819638 -34.635191282235731,-58.522925124016318 -34.6358884040527,-58.522873447362912 -34.635947586397037,-58.523322673384179 -34.635865248611019,-58.52406932235575 -34.635747336198875,-58.524044020865112 -34.635984680526612,-58.524448657011952 -34.636041587292375,-58.525166549186039 -34.636100554214089,-58.525444974605286 -34.636114605859497,-58.52609000679179 -34.636152865106432,-58.526747657352153 -34.636200762513567,-58.526848900376386 -34.635315173525299)));;3294;9_1_7;COMUNA 9;1;7;683;304;379;80,21%;317;316;99,68%;1;0,32%;257;4;1,56%;253;98,44%
MULTIPOLYGON (((-58.52806585787026 -34.636296756407383,-58.529230341006205 -34.636380495659459,-58.529229826123398 -34.636389051117959,-58.530157167699585 -34.636430169878295,-58.530157709068362 -34.636430193880763,-58.530157742485514 -34.636429628626651,-58.53015835461477 -34.636430222502121,-58.530266416054154 -34.636535061353214,-58.530370036987492 -34.634794536218763,-58.530257200971192 -34.63479787127347,-58.529970467148708 -34.634806345694024,-58.529336451179546 -34.634826469443169,-58.52875328885289 -34.634861394145751,-58.528564441596401 -34.634855506140816,-58.528296767786067 -34.634849730915001,-58.528206666526906 -34.634842338143663,-58.528182114126558 -34.635150178194245,-58.52751572984937 -34.635256593916594,-58.527383668184036 -34.635263002259258,-58.526848900376386 -34.635315173525299,-58.526747657352153 -34.636200762513567,-58.527405052992407 -34.636248586084136,-58.527287688136461 -34.637299808780938,-58.526628324522498 -34.637251985622335,-58.526509835274723 -34.638296024666069,-58.527171082411257 -34.638344833403515,-58.527827728893882 -34.638393359312715,-58.527843215857409 -34.638257783346518,-58.527947478533484 -34.637347628145655,-58.527959665400203 -34.637241843592967,-58.528048725792502 -34.636506631488409,-58.52806585787026 -34.636296756407383)));;3295;9_1_8;COMUNA 9;1;8;683;338;345;97,97%;348;346;99,43%;2;0,58%;278;34;12,23%;244;87,77%
MULTIPOLYGON (((-58.53015835461477 -34.636430222502121,-58.530157742485514 -34.636429628626651,-58.530157709068362 -34.636430193880763,-58.529229826123398 -34.636389051117959,-58.529230341006205 -34.636380495659459,-58.52806585787026 -34.636296756407383,-58.528048725792502 -34.636506631488409,-58.527959665400203 -34.637241843592967,-58.527947478533484 -34.637347628145655,-58.527843215857409 -34.638257783346518,-58.527827728893882 -34.638393359312715,-58.527785159976617 -34.638765154418017,-58.52909497199655 -34.638867831953235,-58.52908903381703 -34.638900934827525,-58.529208524236132 -34.638936997630722,-58.53000501515335 -34.639000506367424,-58.530085541966002 -34.639006870554908,-58.530072898000014 -34.639281885002923,-58.530072898054321 -34.639281885006241,-58.530073584794998 -34.639281927088739,-58.530102759932355 -34.639283852871813,-58.530266416054154 -34.636535061353214,-58.53015835461477 -34.636430222502121)));;3296;9_1_9;COMUNA 9;1;9;751;359;392;91,58%;489;487;99,59%;2;0,41%;344;5;1,45%;339;98,55%
MULTIPOLYGON (((-58.489588628205055 -34.648100833554714,-58.490337055395656 -34.648758010131019,-58.491415454401292 -34.647911608498802,-58.492629883689318 -34.646958470503556,-58.492765679970674 -34.646851954967289,-58.493859704194008 -34.645992076497208,-58.494897822174558 -34.645176147889927,-58.49523354586676 -34.644903656005205,-58.494800516073177 -34.644977857556412,-58.493152457619537 -34.645402941234423,-58.491859953231341 -34.645737281521235,-58.491663209448802 -34.645788175043236,-58.491427269969634 -34.645849218644223,-58.489596150668937 -34.64632591849935,-58.490175101634442 -34.646830523221283,-58.489099345108492 -34.647674941571431,-58.489588628205055 -34.648100833554714)));;3297;9_10_1;COMUNA 9;10;1;825;385;440;87,50%;334;334;100,00%;0;0,00%;298;13;4,36%;285;95,64%
MULTIPOLYGON (((-58.482979198283438 -34.642293199867559,-58.482945512785541 -34.642196314321637,-58.48297303873094 -34.642128020355855,-58.483018259222206 -34.642083538895207,-58.482939031862713 -34.641811571686681,-58.482915416434885 -34.641762207852793,-58.482888734910411 -34.641718901050247,-58.4828576229771 -34.641677778141222,-58.482796084932353 -34.641612293276843,-58.482739835098286 -34.641567794088552,-58.482668929420321 -34.641524705769669,-58.482196039108537 -34.641285126839364,-58.482102038910519 -34.641229083723104,-58.481992525254739 -34.641150154942352,-58.481688946548793 -34.640889067576772,-58.481113408171026 -34.640369561915428,-58.480157770584022 -34.641122191056333,-58.479928847944514 -34.64130321524032,-58.481995354906964 -34.643065989332662,-58.482979198283438 -34.642293199867559)));;3298;9_10_10;COMUNA 9;10;10;760;343;417;82,25%;358;358;100,00%;0;0,00%;304;2;0,66%;302;99,34%
MULTIPOLYGON (((-58.483018259222206 -34.642083538895207,-58.48297303873094 -34.642128020355855,-58.482945512785541 -34.642196314321637,-58.482979198283438 -34.642293199867559,-58.481995354906964 -34.643065989332662,-58.483655566351274 -34.644502027684652,-58.484255629858708 -34.642480803728937,-58.483237127157764 -34.642267522097704,-58.483248612256681 -34.642192729082645,-58.483205134823159 -34.642113015586922,-58.483110372063955 -34.642081269922031,-58.483018259222206 -34.642083538895207)));;3299;9_10_11;COMUNA 9;10;11;586;262;324;80,86%;285;285;100,00%;0;0,00%;245;2;0,82%;243;99,18%
MULTIPOLYGON (((-58.48458158250132 -34.642549057680959,-58.484255629858708 -34.642480803728937,-58.483655566351274 -34.644502027684652,-58.484569606259498 -34.645292595895413,-58.484725868531264 -34.644890020113706,-58.484978307104768 -34.644062272525552,-58.485190131230631 -34.643371226207705,-58.485397012030724 -34.642689265155923,-58.48458158250132 -34.642549057680959)));;3300;9_10_12;COMUNA 9;10;12;520;233;287;81,18%;261;261;100,00%;0;0,00%;224;1;0,45%;223;99,55%
MULTIPOLYGON (((-58.487136497614181 -34.647524078479854,-58.487646482821873 -34.647967439438908,-58.488159030659439 -34.648412980861551,-58.488769270612018 -34.64894336097548,-58.488912476537251 -34.649067841087621,-58.489403724303706 -34.64948563445531,-58.489547283328868 -34.649377853200974,-58.490337055395656 -34.648758010131019,-58.489588628205055 -34.648100833554714,-58.489099345108492 -34.647674941571431,-58.490175101634442 -34.646830523221283,-58.489596150668937 -34.64632591849935,-58.48915606057043 -34.645942341003611,-58.488636447486336 -34.645489410497106,-58.488084705742409 -34.645008525822533,-58.487008356074469 -34.645856517762496,-58.48679604831905 -34.646023748141651,-58.486068810964461 -34.646596019920302,-58.486623108351338 -34.647077828610136,-58.487136497614181 -34.647524078479854)));;3301;9_10_2;COMUNA 9;10;2;1068;488;580;84,14%;380;377;99,21%;3;0,80%;336;20;5,95%;316;94,05%
MULTIPOLYGON (((-58.490439152595464 -34.644937799561852,-58.489930355610987 -34.64446853349849,-58.48939556662625 -34.643975256136152,-58.488862147755256 -34.643483173313648,-58.488428725343148 -34.643108394671074,-58.487305378852909 -34.643999781027574,-58.487102447836342 -34.644159967625399,-58.486144265566679 -34.644916446650292,-58.48602788848472 -34.645007457698249,-58.485390280698581 -34.645506114527535,-58.485104663377889 -34.645755293411888,-58.485336317902423 -34.645960323550369,-58.486068810964461 -34.646596019920302,-58.48679604831905 -34.646023748141651,-58.487008356074469 -34.645856517762496,-58.488084705742409 -34.645008525822533,-58.488636447486336 -34.645489410497106,-58.48915606057043 -34.645942341003611,-58.489596150668937 -34.64632591849935,-58.491427269969634 -34.645849218644223,-58.490439152595464 -34.644937799561852)));;3302;9_10_3;COMUNA 9;10;3;1131;486;645;75,35%;363;361;99,45%;2;0,55%;328;18;5,49%;310;94,51%
MULTIPOLYGON (((-58.491009042493644 -34.643617416356165,-58.490443754009995 -34.643146475238538,-58.490204667546841 -34.642947297818701,-58.490300583652981 -34.642848329392926,-58.490499761028332 -34.642703209191019,-58.490586052660902 -34.642619454474399,-58.490176289401873 -34.642423062453886,-58.490063159989909 -34.642519358511962,-58.489664734260103 -34.642857697281698,-58.489173522582654 -34.643238873147112,-58.488862147755256 -34.643483173313648,-58.48939556662625 -34.643975256136152,-58.489930355610987 -34.64446853349849,-58.490439152595464 -34.644937799561852,-58.491427269969634 -34.645849218644223,-58.491663209448802 -34.645788175043236,-58.491859953231341 -34.645737281521235,-58.493152457619537 -34.645402941234423,-58.492592344531928 -34.64493637526045,-58.491550044546578 -34.644068078243009,-58.491009042493644 -34.643617416356165)));;3303;9_10_4;COMUNA 9;10;4;626;287;339;84,66%;289;288;99,65%;1;0,35%;237;6;2,53%;231;97,47%
MULTIPOLYGON (((-58.490878887966666 -34.642759743668599,-58.490586052660902 -34.642619454474399,-58.490499761028332 -34.642703209191019,-58.490300583652981 -34.642848329392926,-58.490204667546841 -34.642947297818701,-58.490443754009995 -34.643146475238538,-58.491009042493644 -34.643617416356165,-58.491550044546578 -34.644068078243009,-58.492592344531928 -34.64493637526045,-58.493152457619537 -34.645402941234423,-58.494800516073177 -34.644977857556412,-58.49523354586676 -34.644903656005205,-58.49530220667296 -34.644847931720662,-58.495082056954722 -34.644740733537191,-58.49496401506417 -34.644687805438508,-58.494840784298859 -34.644658259598401,-58.493665134119027 -34.644094884327671,-58.492331744145083 -34.643455970360968,-58.491636122425383 -34.643122676290005,-58.490878887966666 -34.642759743668599)));;3304;9_10_5;COMUNA 9;10;5;883;408;475;85,89%;406;406;100,00%;0;0,00%;342;7;2,05%;335;97,95%
MULTIPOLYGON (((-58.48640676527652 -34.64356008617483,-58.485351632840541 -34.644398552229937,-58.48524479789593 -34.644483433814983,-58.484725868531264 -34.644890020113706,-58.484569606259498 -34.645292595895413,-58.485101145238332 -34.64575225108009,-58.485104663377889 -34.645755293411888,-58.485390280698581 -34.645506114527535,-58.48602788848472 -34.645007457698249,-58.486144265566679 -34.644916446650292,-58.487102447836342 -34.644159967625399,-58.487305378852909 -34.643999781027574,-58.488428725343148 -34.643108394671074,-58.488862147755256 -34.643483173313648,-58.489173522582654 -34.643238873147112,-58.489664734260103 -34.642857697281698,-58.490063159989909 -34.642519358511962,-58.490176289401873 -34.642423062453886,-58.489993566976871 -34.642335495103836,-58.489623521843043 -34.642160290169308,-58.489544007507575 -34.642122630458374,-58.488711540242242 -34.641728502687357,-58.487732615351597 -34.642506478453136,-58.48640676527652 -34.64356008617483)));;3305;9_10_6;COMUNA 9;10;6;810;403;407;99,02%;273;273;100,00%;0;0,00%;282;9;3,19%;273;96,81%
MULTIPOLYGON (((-58.487805619012541 -34.641299946644139,-58.486967799666182 -34.640904822068336,-58.486065646452005 -34.640479350978083,-58.486003760569297 -34.640699299359056,-58.485928418726431 -34.640946363797241,-58.487039242874864 -34.641906952095241,-58.485710240381856 -34.642959355756581,-58.485190131230631 -34.643371226207705,-58.484978307104768 -34.644062272525552,-58.484725868531264 -34.644890020113706,-58.48524479789593 -34.644483433814983,-58.485351632840541 -34.644398552229937,-58.48640676527652 -34.64356008617483,-58.487732615351597 -34.642506478453136,-58.488711540242242 -34.641728502687357,-58.488044498279223 -34.641412647268389,-58.487805619012541 -34.641299946644139)));;3306;9_10_7;COMUNA 9;10;7;669;313;356;87,92%;284;284;100,00%;0;0,00%;249;11;4,42%;238;95,58%
MULTIPOLYGON (((-58.485397012030724 -34.642689265155923,-58.485190131230631 -34.643371226207705,-58.485710240381856 -34.642959355756581,-58.487039242874864 -34.641906952095241,-58.485928418726431 -34.640946363797241,-58.486003760569297 -34.640699299359056,-58.486065646452005 -34.640479350978083,-58.485516484584508 -34.640220362235198,-58.485319540444507 -34.640127297376125,-58.484879975675689 -34.63991962503448,-58.48460633536515 -34.639790374609248,-58.483900805722172 -34.639456967556697,-58.483478430252461 -34.640837717868848,-58.484241867756552 -34.640996393244798,-58.484177582885501 -34.64118570633552,-58.484152887350753 -34.641245783000471,-58.48412367616811 -34.641307973195865,-58.48408875409914 -34.641363403608807,-58.484035260059102 -34.641434401132585,-58.483966513807957 -34.641507725309616,-58.483928433405026 -34.641542169648886,-58.483558096174669 -34.641836961138637,-58.48340866514657 -34.641954102963645,-58.483318273480116 -34.642024261329112,-58.483205134823159 -34.642113015586922,-58.483248612256681 -34.642192729082645,-58.483237127157764 -34.642267522097704,-58.484255629858708 -34.642480803728937,-58.48458158250132 -34.642549057680959,-58.485397012030724 -34.642689265155923)));;3307;9_10_8;COMUNA 9;10;8;931;434;497;87,32%;367;366;99,73%;1;0,27%;322;1;0,31%;321;99,69%
MULTIPOLYGON (((-58.483900805722172 -34.639456967556697,-58.482881936125786 -34.638979730825959,-58.482702350663963 -34.639118145110238,-58.481930674616663 -34.639725894221677,-58.481113408171026 -34.640369561915428,-58.481688946548793 -34.640889067576772,-58.481992525254739 -34.641150154942352,-58.482102038910519 -34.641229083723104,-58.482196039108537 -34.641285126839364,-58.482668929420321 -34.641524705769669,-58.482739835098286 -34.641567794088552,-58.482796084932353 -34.641612293276843,-58.4828576229771 -34.641677778141222,-58.482888734910411 -34.641718901050247,-58.482915416434885 -34.641762207852793,-58.482939031862713 -34.641811571686681,-58.483018259222206 -34.642083538895207,-58.483110372063955 -34.642081269922031,-58.483205134823159 -34.642113015586922,-58.483318273480116 -34.642024261329112,-58.48340866514657 -34.641954102963645,-58.483558096174669 -34.641836961138637,-58.483928433405026 -34.641542169648886,-58.483966513807957 -34.641507725309616,-58.484035260059102 -34.641434401132585,-58.48408875409914 -34.641363403608807,-58.48412367616811 -34.641307973195865,-58.484152887350753 -34.641245783000471,-58.484177582885501 -34.64118570633552,-58.484241867756552 -34.640996393244798,-58.483478430252461 -34.640837717868848,-58.483900805722172 -34.639456967556697)));;3308;9_10_9;COMUNA 9;10;9;459;214;245;87,35%;221;221;100,00%;0;0,00%;170;0;0,00%;170;100,00%
MULTIPOLYGON (((-58.480403331910566 -34.637844868173588,-58.480048751990644 -34.637682519542459,-58.479099098763626 -34.638428238235605,-58.480517517392059 -34.639078341744479,-58.479703654584966 -34.639721295315304,-58.478675594925889 -34.640533502351502,-58.479928847944514 -34.64130321524032,-58.480157770584022 -34.641122191056333,-58.481113408171026 -34.640369561915428,-58.481930674616663 -34.639725894221677,-58.482702350663963 -34.639118145110238,-58.482881936125786 -34.638979730825959,-58.481745396626103 -34.638459404004777,-58.48146401219033 -34.638330570254162,-58.480403331910566 -34.637844868173588)));;3309;9_11_1;COMUNA 9;11;1;1151;534;617;86,55%;499;499;100,00%;0;0,00%;430;16;3,72%;414;96,28%
MULTIPOLYGON (((-58.471287627623994 -34.642715089723168,-58.47002683428471 -34.643711118606653,-58.471285946436609 -34.644592120197764,-58.472327258702038 -34.645320726973843,-58.472481424733616 -34.645429943432646,-58.4736585199161 -34.646263178878606,-58.473808142631817 -34.646144640569027,-58.474962251373569 -34.645231825775731,-58.473780129225617 -34.644391842456066,-58.473715693599559 -34.644285154838229,-58.473471790182096 -34.64411291774951,-58.472821556166167 -34.643651480205747,-58.47263125988367 -34.643518111409207,-58.471392770481785 -34.642632051502758,-58.471287627623994 -34.642715089723168)));;3310;9_11_10;COMUNA 9;11;10;923;432;491;87,98%;327;327;100,00%;0;0,00%;306;41;13,40%;265;86,60%
MULTIPOLYGON (((-58.47002683428471 -34.643711118606653,-58.471287627623994 -34.642715089723168,-58.471392770481785 -34.642632051502758,-58.471206144249557 -34.6425117087758,-58.470256403739178 -34.641895977325582,-58.469292958400409 -34.641280450431871,-58.469242352527552 -34.641396865281941,-58.467989821746961 -34.642417169415779,-58.466850246143551 -34.64331421343902,-58.466708202247389 -34.643426756916035,-58.467686224708309 -34.644040965347429,-58.468760302051408 -34.644715303847384,-58.469894848434272 -34.643815425489784,-58.47002683428471 -34.643711118606653)));;3311;9_11_11;COMUNA 9;11;11;969;449;520;86,35%;371;369;99,46%;2;0,54%;329;15;4,56%;314;95,44%
MULTIPOLYGON (((-58.471285946436609 -34.644592120197764,-58.47002683428471 -34.643711118606653,-58.469894848434272 -34.643815425489784,-58.468760302051408 -34.644715303847384,-58.470012939969742 -34.645599839993665,-58.471205778681124 -34.646441971659975,-58.472383386496716 -34.64727338819786,-58.472753702406095 -34.646980039392886,-58.47301537596514 -34.646772687240826,-58.4736585199161 -34.646263178878606,-58.472481424733616 -34.645429943432646,-58.472327258702038 -34.645320726973843,-58.471285946436609 -34.644592120197764)));;3312;9_11_12;COMUNA 9;11;12;1260;609;651;93,55%;407;406;99,75%;1;0,25%;414;45;10,87%;369;89,13%
MULTIPOLYGON (((-58.477408730170971 -34.639755468002356,-58.478675594925889 -34.640533502351502,-58.479703654584966 -34.639721295315304,-58.480517517392059 -34.639078341744479,-58.479099098763626 -34.638428238235605,-58.480048751990644 -34.637682519542459,-58.47854557344094 -34.636994251224777,-58.47835678173336 -34.637127096791957,-58.477591226950111 -34.637732845966966,-58.47677837721762 -34.638375991310888,-58.476290542079212 -34.63876197449369,-58.476072352400536 -34.638934680188051,-58.477408730170971 -34.639755468002356)));;3313;9_11_2;COMUNA 9;11;2;1082;526;556;94,60%;411;410;99,76%;1;0,24%;355;12;3,38%;343;96,62%
MULTIPOLYGON (((-58.476072352400536 -34.638934680188051,-58.475323133371226 -34.638474463621471,-58.475068021274744 -34.639044648837221,-58.475707792106277 -34.639222968254657,-58.476955735286708 -34.640111096475849,-58.478143367889736 -34.640954006749709,-58.477108802649404 -34.641771271824133,-58.478285040101618 -34.642603547694961,-58.479317133181453 -34.641787118188049,-58.479928847944514 -34.64130321524032,-58.478675594925889 -34.640533502351502,-58.477408730170971 -34.639755468002356,-58.476072352400536 -34.638934680188051)));;3314;9_11_3;COMUNA 9;11;3;846;398;448;88,84%;338;338;100,00%;0;0,00%;292;5;1,71%;287;98,29%
MULTIPOLYGON (((-58.473492297167716 -34.637308334303214,-58.472416954968679 -34.636987498876536,-58.471302936456219 -34.636655177440893,-58.471223627995407 -34.636831878859894,-58.470808853385698 -34.637787290038368,-58.471917261639078 -34.638121869941784,-58.472807880252461 -34.638390681241937,-58.472992276162167 -34.638446230980591,-58.473884009373762 -34.638714752614135,-58.474048978013101 -34.638760724760935,-58.47361684880596 -34.63975586637207,-58.474670072091143 -34.640042818926808,-58.475707792106277 -34.639222968254657,-58.475068021274744 -34.639044648837221,-58.475323133371226 -34.638474463621471,-58.474415423686423 -34.637916930675196,-58.473492297167716 -34.637308334303214)));;3315;9_11_4;COMUNA 9;11;4;1055;484;571;84,76%;412;411;99,76%;1;0,24%;370;14;3,78%;356;96,22%
MULTIPOLYGON (((-58.472992276162167 -34.638446230980591,-58.472807880252461 -34.638390681241937,-58.471917261639078 -34.638121869941784,-58.470808853385698 -34.637787290038368,-58.470442031026394 -34.638632200129415,-58.470375071984904 -34.638786927621346,-58.469971097526034 -34.639720362435128,-58.46990549975115 -34.639871286622729,-58.471003876552395 -34.640197353906018,-58.471901416125185 -34.640463776819004,-58.472083429609157 -34.64051453920807,-58.47315727960418 -34.640814109235073,-58.473553861292203 -34.640924711887834,-58.474670072091143 -34.640042818926808,-58.47361684880596 -34.63975586637207,-58.474048978013101 -34.638760724760935,-58.473884009373762 -34.638714752614135,-58.472992276162167 -34.638446230980591)));;3316;9_11_5;COMUNA 9;11;5;1224;584;640;91,25%;435;434;99,77%;1;0,23%;397;13;3,27%;384;96,73%
MULTIPOLYGON (((-58.472440523770466 -34.64180434068583,-58.473553861292203 -34.640924711887834,-58.47315727960418 -34.640814109235073,-58.472083429609157 -34.64051453920807,-58.471901416125185 -34.640463776819004,-58.471003876552395 -34.640197353906018,-58.46990549975115 -34.639871286622729,-58.469292958400409 -34.641280450431871,-58.470256403739178 -34.641895977325582,-58.471206144249557 -34.6425117087758,-58.471392770481785 -34.642632051502758,-58.472440523770466 -34.64180434068583)));;3317;9_11_6;COMUNA 9;11;6;959;449;510;88,04%;358;357;99,72%;1;0,28%;327;10;3,06%;317;96,94%
MULTIPOLYGON (((-58.472440523770466 -34.64180434068583,-58.471392770481785 -34.642632051502758,-58.47263125988367 -34.643518111409207,-58.472744070145531 -34.643423380904323,-58.473550780427793 -34.642785122826531,-58.473686680603763 -34.642686797720067,-58.473808010649677 -34.642599037500027,-58.474804107261598 -34.641809762983407,-58.475916993494671 -34.640927929492854,-58.476104346631331 -34.640779524069011,-58.476955735286708 -34.640111096475849,-58.475707792106277 -34.639222968254657,-58.474670072091143 -34.640042818926808,-58.473553861292203 -34.640924711887834,-58.472440523770466 -34.64180434068583)));;3318;9_11_7;COMUNA 9;11;7;1124;537;587;91,48%;401;400;99,75%;1;0,25%;385;20;5,19%;365;94,81%
MULTIPOLYGON (((-58.474804107261598 -34.641809762983407,-58.473808010649677 -34.642599037500027,-58.473686680603763 -34.642686797720067,-58.474700637307876 -34.643419049006141,-58.474871079020424 -34.643531359563724,-58.475032709867797 -34.643411339580794,-58.475993872519311 -34.642652059919833,-58.477108802649404 -34.641771271824133,-58.478143367889736 -34.640954006749709,-58.476955735286708 -34.640111096475849,-58.476104346631331 -34.640779524069011,-58.475916993494671 -34.640927929492854,-58.474804107261598 -34.641809762983407)));;3319;9_11_8;COMUNA 9;11;8;908;415;493;84,18%;325;322;99,08%;3;0,93%;311;14;4,50%;297;95,50%
MULTIPOLYGON (((-58.473686680603763 -34.642686797720067,-58.473550780427793 -34.642785122826531,-58.472744070145531 -34.643423380904323,-58.47263125988367 -34.643518111409207,-58.472821556166167 -34.643651480205747,-58.473471790182096 -34.64411291774951,-58.473715693599559 -34.644285154838229,-58.473780129225617 -34.644391842456066,-58.474962251373569 -34.645231825775731,-58.476058482146215 -34.644364782349584,-58.477170707887566 -34.643485050599949,-58.478285040101618 -34.642603547694961,-58.477108802649404 -34.641771271824133,-58.475993872519311 -34.642652059919833,-58.475032709867797 -34.643411339580794,-58.474871079020424 -34.643531359563724,-58.474700637307876 -34.643419049006141,-58.473686680603763 -34.642686797720067)));;3320;9_11_9;COMUNA 9;11;9;1082;457;625;73,12%;332;328;98,80%;4;1,22%;314;12;3,82%;302;96,18%
MULTIPOLYGON (((-58.484569606259498 -34.645292595895413,-58.483473791652727 -34.646155208434209,-58.483619456652498 -34.646281807143886,-58.48368747357005 -34.646340881779409,-58.483889563755348 -34.646513457765515,-58.484072477006215 -34.646669768669682,-58.484194438854644 -34.646738693009375,-58.485014316114416 -34.647425890713912,-58.485095460748695 -34.64749390608474,-58.48610236416031 -34.648337827223372,-58.486242324732409 -34.648455057366107,-58.486623425650258 -34.648775767576083,-58.487141253694517 -34.649211593577832,-58.487768280362069 -34.649739228704163,-58.488406652145152 -34.650276435920418,-58.489240484062904 -34.649608279427198,-58.489403724303706 -34.64948563445531,-58.488912476537251 -34.649067841087621,-58.488769270612018 -34.64894336097548,-58.488159030659439 -34.648412980861551,-58.487646482821873 -34.647967439438908,-58.487136497614181 -34.647524078479854,-58.486623108351338 -34.647077828610136,-58.486068810964461 -34.646596019920302,-58.485336317902423 -34.645960323550369,-58.485104663377889 -34.645755293411888,-58.485101145238332 -34.64575225108009,-58.484569606259498 -34.645292595895413)));;3321;9_12_1;COMUNA 9;12;1;1042;481;561;85,74%;380;380;100,00%;0;0,00%;338;20;5,92%;318;94,08%
MULTIPOLYGON (((-58.476869628934473 -34.651367369038937,-58.475889970784486 -34.652157784216911,-58.475725087726346 -34.652290270672651,-58.476338185994166 -34.652890925712853,-58.476288507770562 -34.652930157774378,-58.47569100198006 -34.653401645306459,-58.474712328784527 -34.654173951533892,-58.47516833760011 -34.654589692635959,-58.476199961582118 -34.654506270476844,-58.477288853146241 -34.654418184726552,-58.477705927120631 -34.654344220127825,-58.47805780197087 -34.654274635377512,-58.479415616251593 -34.653996350019085,-58.479251099044689 -34.653386988274164,-58.479123278252459 -34.653023262395386,-58.479074849713761 -34.652910519087605,-58.479018323178032 -34.652787494847274,-58.478950715543824 -34.652652218170559,-58.478834518964042 -34.652451664261804,-58.478796754353461 -34.652393146386203,-58.478719607013922 -34.652280970110297,-58.478868562047857 -34.652216441488498,-58.478922076291255 -34.65219101108903,-58.479007629588644 -34.652143956023345,-58.479302366438247 -34.65192031803911,-58.478473879515576 -34.651205477091203,-58.4778022359639 -34.650626037707674,-58.477599015037967 -34.650787194303689,-58.476991051736825 -34.651269394192035,-58.476869628934473 -34.651367369038937)));;3322;9_12_10;COMUNA 9;12;10;1063;526;537;97,95%;367;367;100,00%;0;0,00%;343;3;0,87%;340;99,13%
MULTIPOLYGON (((-58.476338185994166 -34.652890925712853,-58.475725087726346 -34.652290270672651,-58.47562527790064 -34.652192461480176,-58.474924317140342 -34.65152427439606,-58.474373716247619 -34.65099931263773,-58.474251920695473 -34.650886926500867,-58.473731075873744 -34.650406678617159,-58.47317660575375 -34.650844839264508,-58.472633804009384 -34.651274404603278,-58.472044981523617 -34.651742000335943,-58.472567955118102 -34.652218874761779,-58.472707307783097 -34.652345839014977,-58.473257563242321 -34.652847568085718,-58.473675032236542 -34.653228246734415,-58.474088499062525 -34.653605262223529,-58.474712328784527 -34.654173951533892,-58.47569100198006 -34.653401645306459,-58.476288507770562 -34.652930157774378,-58.476338185994166 -34.652890925712853)));;3323;9_12_11;COMUNA 9;12;11;859;427;432;98,84%;334;333;99,70%;1;0,30%;310;35;11,29%;275;88,71%
MULTIPOLYGON (((-58.470107155483966 -34.649071067205654,-58.469971160562991 -34.649227981549842,-58.469944661023149 -34.6492675617896,-58.469893025197052 -34.649344750280036,-58.469814805097144 -34.649469758648564,-58.469778178449332 -34.649675119096493,-58.47002669713703 -34.649901660549773,-58.470816664889519 -34.650621984319748,-58.472044981523617 -34.651742000335943,-58.472633804009384 -34.651274404603278,-58.47317660575375 -34.650844839264508,-58.473731075873744 -34.650406678617159,-58.472736279787689 -34.649489201679444,-58.472735101712182 -34.64948929898253,-58.472235891216421 -34.649040590015268,-58.472238294561009 -34.649040284401948,-58.472191504593766 -34.648995850086692,-58.471768609475681 -34.648613546728178,-58.471263305597525 -34.648160752590393,-58.470250823942862 -34.648962745253186,-58.470107155483966 -34.649071067205654)));;3324;9_12_12;COMUNA 9;12;12;726;353;373;94,64%;237;237;100,00%;0;0,00%;232;5;2,16%;227;97,84%
MULTIPOLYGON (((-58.479928847944514 -34.64130321524032,-58.479317133181453 -34.641787118188049,-58.478285040101618 -34.642603547694961,-58.477170707887566 -34.643485050599949,-58.476058482146215 -34.644364782349584,-58.474962251373569 -34.645231825775731,-58.473808142631817 -34.646144640569027,-58.4736585199161 -34.646263178878606,-58.47301537596514 -34.646772687240826,-58.472753702406095 -34.646980039392886,-58.472383386496716 -34.64727338819786,-58.471263305597525 -34.648160752590393,-58.471768609475681 -34.648613546728178,-58.472191504593766 -34.648995850086692,-58.472238294561009 -34.649040284401948,-58.472235891216421 -34.649040590015268,-58.472735101712182 -34.64948929898253,-58.472736279787689 -34.649489201679444,-58.472738390344453 -34.649488991790307,-58.473583940789588 -34.649404901070191,-58.473961369875703 -34.649368879795354,-58.474151490390518 -34.649350762950789,-58.474524478494452 -34.649250513054632,-58.475488185241886 -34.649051254840209,-58.475657252829983 -34.649014334466663,-58.476062367387492 -34.648929569870909,-58.476374681806703 -34.648864955825793,-58.476745627209425 -34.648808503502941,-58.477043371126889 -34.648760016671247,-58.477731483368871 -34.648626831161891,-58.478417887151046 -34.64848357125878,-58.478828106241401 -34.648382599134763,-58.479326091247898 -34.648245344986108,-58.479891391320592 -34.648083501116822,-58.48042686398059 -34.647925532320031,-58.480566186704415 -34.647890581345749,-58.481145535034955 -34.647693798952162,-58.481593396937768 -34.647522880102173,-58.481765604190251 -34.647452992011999,-58.48199668178092 -34.647322177022119,-58.482132587467589 -34.647258491523004,-58.482385825476761 -34.647149926460315,-58.482684479271718 -34.647025226181533,-58.482344825761373 -34.646743723449887,-58.482586137297027 -34.646658611306556,-58.4832091585725 -34.646342442078939,-58.483473791652727 -34.646155208434209,-58.484569606259498 -34.645292595895413,-58.483655566351274 -34.644502027684652,-58.481995354906964 -34.643065989332662,-58.479928847944514 -34.64130321524032)));;3325;9_12_2;COMUNA 9;12;2;546;276;270;102,22%;211;211;100,00%;0;0,00%;191;10;5,24%;181;94,76%
MULTIPOLYGON (((-58.483889563755348 -34.646513457765515,-58.48368747357005 -34.646340881779409,-58.483619456652498 -34.646281807143886,-58.483473791652727 -34.646155208434209,-58.4832091585725 -34.646342442078939,-58.482586137297027 -34.646658611306556,-58.482344825761373 -34.646743723449887,-58.482684479271718 -34.647025226181533,-58.482385825476761 -34.647149926460315,-58.482132587467589 -34.647258491523004,-58.48199668178092 -34.647322177022119,-58.481431454802383 -34.647767842135082,-58.481554532316196 -34.647873953163106,-58.482101481006431 -34.648345571866038,-58.481026049378109 -34.649191115975171,-58.480896113473321 -34.64929360332134,-58.481728948937295 -34.650011033070086,-58.482490540132034 -34.650667058333887,-58.482680620225551 -34.650831046341146,-58.483297346094652 -34.649744995578736,-58.483436361829902 -34.649496513815386,-58.484080869970853 -34.648160376104052,-58.485014316114416 -34.647425890713912,-58.484194438854644 -34.646738693009375,-58.484072477006215 -34.646669768669682,-58.483889563755348 -34.646513457765515)));;3326;9_12_3;COMUNA 9;12;3;858;401;457;87,75%;297;297;100,00%;0;0,00%;283;4;1,41%;279;98,59%
MULTIPOLYGON (((-58.485095460748695 -34.64749390608474,-58.485014316114416 -34.647425890713912,-58.484080869970853 -34.648160376104052,-58.483436361829902 -34.649496513815386,-58.48400574947668 -34.649987486810424,-58.485026913573293 -34.650867893954114,-58.486182415641316 -34.649962720145261,-58.487141253694517 -34.649211593577832,-58.486623425650258 -34.648775767576083,-58.486242324732409 -34.648455057366107,-58.48610236416031 -34.648337827223372,-58.485095460748695 -34.64749390608474)));;3327;9_12_4;COMUNA 9;12;4;810;384;426;90,14%;317;317;100,00%;0;0,00%;296;13;4,39%;283;95,61%
MULTIPOLYGON (((-58.485084950616731 -34.652903817496075,-58.485172804158957 -34.652835779162373,-58.485561106083551 -34.652536013759303,-58.485686014980274 -34.652439931085802,-58.485916064740266 -34.652263051260512,-58.486298114035399 -34.651963814088923,-58.486394307560353 -34.651888511502008,-58.486470052358584 -34.65182912879358,-58.487298888264284 -34.651164085398271,-58.487459064782549 -34.651035739281475,-58.488406652145152 -34.650276435920418,-58.487768280362069 -34.649739228704163,-58.487141253694517 -34.649211593577832,-58.486182415641316 -34.649962720145261,-58.485026913573293 -34.650867893954114,-58.484416775834937 -34.651345764922169,-58.483819837779016 -34.651813348519035,-58.485037589991769 -34.652863092318036,-58.485084950616731 -34.652903817496075)));;3328;9_12_5;COMUNA 9;12;5;803;386;417;92,57%;288;288;100,00%;0;0,00%;290;7;2,41%;283;97,59%
MULTIPOLYGON (((-58.48400574947668 -34.649987486810424,-58.483436361829902 -34.649496513815386,-58.483297346094652 -34.649744995578736,-58.482680620225551 -34.650831046341146,-58.482476432730209 -34.65119066786351,-58.48216950925341 -34.651731085514207,-58.481935245552556 -34.652140078543539,-58.481150573079447 -34.653509536185936,-58.481061549316458 -34.653664835900372,-58.481595160627535 -34.653557288064803,-58.48306487608243 -34.653261407272694,-58.48320659441989 -34.653232791126506,-58.485037589991769 -34.652863092318036,-58.483819837779016 -34.651813348519035,-58.484416775834937 -34.651345764922169,-58.485026913573293 -34.650867893954114,-58.48400574947668 -34.649987486810424)));;3329;9_12_6;COMUNA 9;12;6;1016;478;538;88,85%;360;360;100,00%;0;0,00%;338;11;3,25%;327;96,75%
MULTIPOLYGON (((-58.481618500340801 -34.651867866464428,-58.481935245552556 -34.652140078543539,-58.48216950925341 -34.651731085514207,-58.482476432730209 -34.65119066786351,-58.482680620225551 -34.650831046341146,-58.482490540132034 -34.650667058333887,-58.481728948937295 -34.650011033070086,-58.480896113473321 -34.64929360332134,-58.481026049378109 -34.649191115975171,-58.482101481006431 -34.648345571866038,-58.481554532316196 -34.647873953163106,-58.481431454802383 -34.647767842135082,-58.480227196143822 -34.64871734581596,-58.479146032387689 -34.64956984616262,-58.47903926875054 -34.649649862930161,-58.479201127458744 -34.649790056633414,-58.479711424233464 -34.650228732124305,-58.480543406149245 -34.650943845965784,-58.481081078117136 -34.65140596303609,-58.481618500340801 -34.651867866464428)));;3330;9_12_7;COMUNA 9;12;7;719;355;364;97,53%;288;288;100,00%;0;0,00%;250;8;3,20%;242;96,80%
MULTIPOLYGON (((-58.477599015037967 -34.650787194303689,-58.4778022359639 -34.650626037707674,-58.478925347559937 -34.649735303254566,-58.47903926875054 -34.649649862930161,-58.479146032387689 -34.64956984616262,-58.480227196143822 -34.64871734581596,-58.481431454802383 -34.647767842135082,-58.48199668178092 -34.647322177022119,-58.481765604190251 -34.647452992011999,-58.481593396937768 -34.647522880102173,-58.481145535034955 -34.647693798952162,-58.480566186704415 -34.647890581345749,-58.48042686398059 -34.647925532320031,-58.479891391320592 -34.648083501116822,-58.479326091247898 -34.648245344986108,-58.478828106241401 -34.648382599134763,-58.478417887151046 -34.64848357125878,-58.477731483368871 -34.648626831161891,-58.477043371126889 -34.648760016671247,-58.476745627209425 -34.648808503502941,-58.476374681806703 -34.648864955825793,-58.476062367387492 -34.648929569870909,-58.475657252829983 -34.649014334466663,-58.475488185241886 -34.649051254840209,-58.474524478494452 -34.649250513054632,-58.474151490390518 -34.649350762950789,-58.473961369875703 -34.649368879795354,-58.473583940789588 -34.649404901070191,-58.472738390344453 -34.649488991790307,-58.472736279787689 -34.649489201679444,-58.473731075873744 -34.650406678617159,-58.474251920695473 -34.650886926500867,-58.474373716247619 -34.65099931263773,-58.474924317140342 -34.65152427439606,-58.47562527790064 -34.652192461480176,-58.475725087726346 -34.652290270672651,-58.475889970784486 -34.652157784216911,-58.476869628934473 -34.651367369038937,-58.476991051736825 -34.651269394192035,-58.477599015037967 -34.650787194303689)));;3331;9_12_8;COMUNA 9;12;8;1017;491;526;93,35%;356;355;99,72%;1;0,28%;320;2;0,63%;318;99,38%
MULTIPOLYGON (((-58.479302366438247 -34.65192031803911,-58.479007629588644 -34.652143956023345,-58.478922076291255 -34.65219101108903,-58.478868562047857 -34.652216441488498,-58.478719607013922 -34.652280970110297,-58.478796754353461 -34.652393146386203,-58.478834518964042 -34.652451664261804,-58.478950715543824 -34.652652218170559,-58.479018323178032 -34.652787494847274,-58.479074849713761 -34.652910519087605,-58.479123278252459 -34.653023262395386,-58.479251099044689 -34.653386988274164,-58.479415616251593 -34.653996350019085,-58.481061549316458 -34.653664835900372,-58.481150573079447 -34.653509536185936,-58.481935245552556 -34.652140078543539,-58.481618500340801 -34.651867866464428,-58.481081078117136 -34.65140596303609,-58.480543406149245 -34.650943845965784,-58.479711424233464 -34.650228732124305,-58.479201127458744 -34.649790056633414,-58.47903926875054 -34.649649862930161,-58.478925347559937 -34.649735303254566,-58.4778022359639 -34.650626037707674,-58.478473879515576 -34.651205477091203,-58.479302366438247 -34.65192031803911)));;3332;9_12_9;COMUNA 9;12;9;871;401;470;85,32%;325;324;99,69%;1;0,31%;292;4;1,37%;288;98,63%
MULTIPOLYGON (((-58.464866197098608 -34.64484621389262,-58.464695941797565 -34.644950304529594,-58.464118878563859 -34.645387790931011,-58.463416543867403 -34.645920137449373,-58.46333207728398 -34.645970034878282,-58.463330490956452 -34.645970929925284,-58.462998941310879 -34.646169179033066,-58.463000257237212 -34.646171596712712,-58.463357411675382 -34.646827771314349,-58.463883205530927 -34.647551169766452,-58.464409517329756 -34.648152942438315,-58.464866444184096 -34.647793346753723,-58.465425091099689 -34.648315480074707,-58.465427786584222 -34.648317999358113,-58.466009720011968 -34.647865083835448,-58.466524754200208 -34.647460690228584,-58.467019843562944 -34.647071858984837,-58.467545775086151 -34.646658868813979,-58.46709989159416 -34.646023654921137,-58.467218591383187 -34.645928788503895,-58.466002633231412 -34.645369232765418,-58.464866197098608 -34.64484621389262)));;3333;9_13_1;COMUNA 9;13;1;972;481;491;97,96%;310;309;99,68%;1;0,32%;315;20;6,35%;295;93,65%
MULTIPOLYGON (((-58.469874256461125 -34.660974387816928,-58.469140716092191 -34.661485710845945,-58.468838587223836 -34.661696295757899,-58.469130612039834 -34.661983471901578,-58.469595502673705 -34.662432614062432,-58.469641105558651 -34.662477049342947,-58.470674050236717 -34.661756120798941,-58.470000579070067 -34.661097904944327,-58.469874256461125 -34.660974387816928)));;3334;8_17_3;COMUNA 8;17;3;666;290;376;77,13%;419;419;100,00%;0;0,00%;327;5;1,53%;322;98,47%
MULTIPOLYGON (((-58.470460703500976 -34.664113909741353,-58.470443214008718 -34.664283107399818,-58.470411949799512 -34.664366703698036,-58.470360305931905 -34.664453540351332,-58.470162162598868 -34.664666881220086,-58.470584290510395 -34.66433901584962,-58.470939603815417 -34.664061167727588,-58.471002330980063 -34.664012077598933,-58.471400849041302 -34.663678660238361,-58.472026681961275 -34.663156770848992,-58.472026681861344 -34.663155879035052,-58.471838752163961 -34.662665360418302,-58.471646846405456 -34.662221207243341,-58.471570224951435 -34.662240157036727,-58.470992245856515 -34.662024487419565,-58.470863282093475 -34.661940761369202,-58.470769688947534 -34.661849567846133,-58.470674050236717 -34.661756120798941,-58.469641105558651 -34.662477049342947,-58.46968261700988 -34.662517470643223,-58.469823517868662 -34.662658100243142,-58.469915330059486 -34.662853734133783,-58.469980045543849 -34.663127963319127,-58.47004228079269 -34.663301274293786,-58.470091042536083 -34.663396626125127,-58.470152503759017 -34.66348775168975,-58.470184251880518 -34.663609540951782,-58.470393862486958 -34.66376863682045,-58.470425113649632 -34.663855632307616,-58.47045794323077 -34.66401288812397,-58.470460703500976 -34.664113909741353)));;3335;8_17_2;COMUNA 8;17;2;620;295;325;90,77%;265;265;100,00%;0;0,00%;221;0;0,00%;221;100,00%
MULTIPOLYGON (((-58.468900525232073 -34.646480421697085,-58.470012939969742 -34.645599839993665,-58.468760302051408 -34.644715303847384,-58.467686224708309 -34.644040965347429,-58.466708202247389 -34.643426756916035,-58.46559646329667 -34.644307308772376,-58.465085619591839 -34.644711980284598,-58.464866197098608 -34.64484621389262,-58.466002633231412 -34.645369232765418,-58.467218591383187 -34.645928788503895,-58.46709989159416 -34.646023654921137,-58.467545775086151 -34.646658868813979,-58.467945388703484 -34.647229714842787,-58.468168304059496 -34.647060051970371,-58.468900525232073 -34.646480421697085)));;3336;9_13_2;COMUNA 9;13;2;1112;530;582;91,07%;452;452;100,00%;0;0,00%;404;16;3,96%;388;96,04%
MULTIPOLYGON (((-58.469391249453395 -34.649245761765471,-58.469565711380291 -34.649481392997139,-58.469778178449332 -34.649675119096493,-58.469814805097144 -34.649469758648564,-58.469893025197052 -34.649344750280036,-58.469944661023149 -34.6492675617896,-58.469971160562991 -34.649227981549842,-58.470107155483966 -34.649071067205654,-58.470250823942862 -34.648962745253186,-58.471263305597525 -34.648160752590393,-58.472383386496716 -34.64727338819786,-58.471205778681124 -34.646441971659975,-58.470012939969742 -34.645599839993665,-58.468900525232073 -34.646480421697085,-58.468168304059496 -34.647060051970371,-58.467945388703484 -34.647229714842787,-58.468185040187763 -34.64757203870677,-58.468429466278195 -34.647921193050365,-58.468755030010179 -34.648386191475986,-58.469306959211046 -34.649131889674699,-58.469391249453395 -34.649245761765471)));;3337;9_13_3;COMUNA 9;13;3;1193;606;587;103,24%;418;418;100,00%;0;0,00%;402;43;10,70%;359;89,30%
MULTIPOLYGON (((-58.467019843562944 -34.647071858984837,-58.466524754200208 -34.647460690228584,-58.466009720011968 -34.647865083835448,-58.465427786584222 -34.648317999358113,-58.465425091099689 -34.648315480074707,-58.464866444184096 -34.647793346753723,-58.464409517329756 -34.648152942438315,-58.464914120202543 -34.648730318676741,-58.46504031751067 -34.648874714458991,-58.465747406527754 -34.649785641888982,-58.465892741789823 -34.649962755124356,-58.466338347685692 -34.650505788223633,-58.467008823476917 -34.651487908493522,-58.46739843604221 -34.651179082046774,-58.467981741666073 -34.650716720369751,-58.468154644309138 -34.650579666388509,-58.469039429760144 -34.649875799596956,-58.469327283144644 -34.649658805913653,-58.46931559106801 -34.649443940901804,-58.469391249453395 -34.649245761765471,-58.469306959211046 -34.649131889674699,-58.468755030010179 -34.648386191475986,-58.468429466278195 -34.647921193050365,-58.468185040187763 -34.64757203870677,-58.467945388703484 -34.647229714842787,-58.467545775086151 -34.646658868813979,-58.467019843562944 -34.647071858984837)));;3338;9_13_4;COMUNA 9;13;4;822;401;421;95,25%;266;266;100,00%;0;0,00%;250;5;2,00%;245;98,00%
MULTIPOLYGON (((-58.474088499062525 -34.653605262223529,-58.473675032236542 -34.653228246734415,-58.473257563242321 -34.652847568085718,-58.472707307783097 -34.652345839014977,-58.472567955118102 -34.652218874761779,-58.472044981523617 -34.651742000335943,-58.470816664889519 -34.650621984319748,-58.47002669713703 -34.649901660549773,-58.469778178449332 -34.649675119096493,-58.469565711380291 -34.649481392997139,-58.469734062485841 -34.650000765275365,-58.470115097765735 -34.651175778001424,-58.470655385075212 -34.652842413349553,-58.470847022607899 -34.653433333694572,-58.470948809863884 -34.653747420639462,-58.471069987576293 -34.653650860234706,-58.471609333541451 -34.654156048190146,-58.472025609452409 -34.654545887690084,-58.472437627570272 -34.65493171188146,-58.472608436371516 -34.655091702811454,-58.47423379565786 -34.654772606885622,-58.47516833760011 -34.654589692635959,-58.474712328784527 -34.654173951533892,-58.474088499062525 -34.653605262223529)));;3339;9_13_5;COMUNA 9;13;5;976;452;524;86,26%;340;340;100,00%;0;0,00%;303;15;4,95%;288;95,05%
MULTIPOLYGON (((-58.469565711380291 -34.649481392997139,-58.469391249453395 -34.649245761765471,-58.46931559106801 -34.649443940901804,-58.469327283144644 -34.649658805913653,-58.469039429760144 -34.649875799596956,-58.468154644309138 -34.650579666388509,-58.467981741666073 -34.650716720369751,-58.46739843604221 -34.651179082046774,-58.46834558641843 -34.652564717015629,-58.469892971115208 -34.655624655302383,-58.470765914120385 -34.65543762338536,-58.471425884201082 -34.655323771795985,-58.472118917156394 -34.655187730334795,-58.472608436371516 -34.655091702811454,-58.472437627570272 -34.65493171188146,-58.472025609452409 -34.654545887690084,-58.471609333541451 -34.654156048190146,-58.471069987576293 -34.653650860234706,-58.470948809863884 -34.653747420639462,-58.470847022607899 -34.653433333694572,-58.470655385075212 -34.652842413349553,-58.470115097765735 -34.651175778001424,-58.469734062485841 -34.650000765275365,-58.469565711380291 -34.649481392997139)));;3340;9_13_6;COMUNA 9;13;6;977;489;488;100,20%;206;206;100,00%;0;0,00%;300;17;5,67%;283;94,33%
MULTIPOLYGON (((-58.468299110444434 -34.663524049086469,-58.468470666878424 -34.66366948110398,-58.468482031725863 -34.663679115298962,-58.468655658238575 -34.663764391009636,-58.468890224794187 -34.663818606189409,-58.469268329813659 -34.663856442275325,-58.469382602650214 -34.663818116713109,-58.46964132229823 -34.663651660309696,-58.469655321811324 -34.663642653194771,-58.469978977455817 -34.663584666286887,-58.470184251880511 -34.663609540951775,-58.470152503759017 -34.663487751689743,-58.470091042536069 -34.663396626125127,-58.47004228079269 -34.663301274293786,-58.469980045543849 -34.663127963319141,-58.469915330059486 -34.662853734133783,-58.469823517868662 -34.662658100243135,-58.469821979093091 -34.662656564433462,-58.46968261700988 -34.662517470643223,-58.469641105558651 -34.662477049342925,-58.469595502673691 -34.662432614062418,-58.469130612039848 -34.661983471901564,-58.468838587223829 -34.661696295757885,-58.467600274373133 -34.660478500424375,-58.46788723160423 -34.660277074375387,-58.468473584790686 -34.659865346150703,-58.468629291270403 -34.659756039785236,-58.46909325494417 -34.6594302323861,-58.46952387348913 -34.659127931729465,-58.467620690422002 -34.65757132862386,-58.464425103267999 -34.660065405921621,-58.464541016778782 -34.660116743717118,-58.465615376209954 -34.661217599086058,-58.466830564621922 -34.662264213221491,-58.467164888831611 -34.662552796852552,-58.467356044898075 -34.662717798577667,-58.468299110444434 -34.663524049086469)));;3341;8_17_5;COMUNA 8;17;5;448;206;242;85,12%;246;246;100,00%;0;0,00%;173;0;0,00%;173;100,00%
MULTIPOLYGON (((-58.46952387348913 -34.659127931729465,-58.46909325494417 -34.6594302323861,-58.468629291270403 -34.659756039785236,-58.469020267442467 -34.660138636686156,-58.469389000389711 -34.66049947234972,-58.46952895950843 -34.660636510737277,-58.469874256461097 -34.660974387816935,-58.470000579070046 -34.661097904944313,-58.470674050236717 -34.661756120798934,-58.470769688947534 -34.661849567846133,-58.470863282093461 -34.661940761369202,-58.470992245856515 -34.662024487419565,-58.471570224951407 -34.662240157036727,-58.471646846405442 -34.662221207243327,-58.471838752163947 -34.662665360418295,-58.47202668186133 -34.663155879035052,-58.47202668196126 -34.663156770848992,-58.472527187821058 -34.662783690474534,-58.471970941837718 -34.661586118501944,-58.471247155659839 -34.659889794734667,-58.470567648415397 -34.658407994434597,-58.46952387348913 -34.659127931729465)));;3342;8_17_1;COMUNA 8;17;1;576;267;309;86,41%;250;250;100,00%;0;0,00%;223;1;0,45%;222;99,55%
MULTIPOLYGON (((-58.467600274373133 -34.660478500424375,-58.468838587223829 -34.661696295757885,-58.469140716092163 -34.661485710845945,-58.469874256461097 -34.660974387816935,-58.46952895950843 -34.660636510737277,-58.469389000389711 -34.66049947234972,-58.469020267442467 -34.660138636686156,-58.468629291270403 -34.659756039785236,-58.468473584790686 -34.659865346150703,-58.46788723160423 -34.660277074375387,-58.467600274373133 -34.660478500424375)));;3343;8_17_4;COMUNA 8;17;4;780;362;418;86,60%;324;324;100,00%;0;0,00%;290;0;0,00%;290;100,00%
MULTIPOLYGON (((-58.478530861763609 -34.655080161910512,-58.478997220505534 -34.655565748480498,-58.479406471611597 -34.655991832288983,-58.479611738064435 -34.656205542611367,-58.480160370671165 -34.656776679065388,-58.480398111914873 -34.656587625218087,-58.481400021740534 -34.655790832770599,-58.481554592602514 -34.655667847632394,-58.482096269493937 -34.655240285387137,-58.482656090189508 -34.654798491969018,-58.483752367179619 -34.653933211764169,-58.483894151050372 -34.653823676931871,-58.484653932436935 -34.653236764609787,-58.484984811952366 -34.652981217970094,-58.485084950616731 -34.652903817496075,-58.485037589991769 -34.652863092318036,-58.48320659441989 -34.653232791126506,-58.48306487608243 -34.653261407272694,-58.481595160627535 -34.653557288064803,-58.481061549316458 -34.653664835900372,-58.479415616251593 -34.653996350019085,-58.47805780197087 -34.654274635377512,-58.477705927120631 -34.654344220127825,-58.477900249317159 -34.654417476222164,-58.478101758564478 -34.654633372773887,-58.478530861763609 -34.655080161910512)));;3344;9_14_1;COMUNA 9;14;1;1109;537;572;93,88%;427;427;100,00%;0;0,00%;388;6;1,55%;382;98,45%
MULTIPOLYGON (((-58.473628794170608 -34.661956812905927,-58.473196240097536 -34.660576530177096,-58.473203270067025 -34.660493698591729,-58.473208720498981 -34.660272362820685,-58.473208730514315 -34.660272154252262,-58.472825147816266 -34.659876259939772,-58.472199830600907 -34.659230869289956,-58.471719264761397 -34.659595916222017,-58.471047381091196 -34.658074190213654,-58.470567648415397 -34.658407994434597,-58.471247155659839 -34.659889794734667,-58.471970941837718 -34.661586118501944,-58.472527187821058 -34.662783690474534,-58.472975554974894 -34.662452587881376,-58.473211454905758 -34.662273548655556,-58.473628794170608 -34.661956812905927)));;3345;9_14_10;COMUNA 9;14;10;1804;897;907;98,90%;406;406;100,00%;0;0,00%;489;77;15,75%;412;84,25%
MULTIPOLYGON (((-58.476199961582118 -34.654506270476844,-58.47516833760011 -34.654589692635959,-58.475510645539899 -34.654901849415751,-58.476549944264441 -34.655849298722508,-58.477005119040903 -34.65626425826315,-58.477508970417148 -34.65672357765871,-58.477957335482756 -34.657132337048175,-58.478178365728304 -34.657333793894601,-58.478495038397746 -34.657622494022789,-58.478721772563048 -34.657777609763585,-58.478817836716694 -34.65784443001651,-58.479114296391089 -34.657608609014936,-58.480160370671165 -34.656776679065388,-58.479611738064435 -34.656205542611367,-58.479406471611597 -34.655991832288983,-58.478997220505534 -34.655565748480498,-58.478530861763609 -34.655080161910512,-58.478101758564478 -34.654633372773887,-58.477900249317159 -34.654417476222164,-58.477705927120631 -34.654344220127825,-58.477288853146241 -34.654418184726552,-58.476199961582118 -34.654506270476844)));;3346;9_14_2;COMUNA 9;14;2;917;452;465;97,20%;296;296;100,00%;0;0,00%;307;5;1,63%;302;98,37%
MULTIPOLYGON (((-58.477901179178062 -34.658576892765076,-58.478277405029488 -34.658275005617014,-58.478398069421537 -34.658178226793424,-58.478817836716694 -34.65784443001651,-58.478721772563048 -34.657777609763585,-58.478495038397746 -34.657622494022789,-58.478178365728304 -34.657333793894601,-58.477957335482756 -34.657132337048175,-58.477508970417148 -34.65672357765871,-58.477005119040903 -34.65626425826315,-58.476549944264441 -34.655849298722508,-58.475510645539899 -34.654901849415751,-58.474589890683617 -34.655565694501249,-58.473747093836813 -34.656162622168445,-58.473948507824268 -34.656352679709165,-58.474835403762981 -34.657180013045981,-58.475719248695768 -34.658004523160621,-58.475830402126476 -34.658110218512086,-58.476446354036263 -34.658695589993094,-58.476878787114778 -34.659106538171898,-58.477043047736551 -34.659251100562898,-58.477700155004641 -34.65873818989715,-58.477901179178062 -34.658576892765076)));;3347;9_14_3;COMUNA 9;14;3;773;363;410;88,54%;258;258;100,00%;0;0,00%;263;26;9,89%;237;90,11%
MULTIPOLYGON (((-58.475510645539899 -34.654901849415744,-58.475168337600095 -34.654589692635945,-58.474233795657845 -34.654772606885601,-58.472608436371516 -34.655091702811454,-58.472118917156394 -34.655187730334788,-58.471425884201075 -34.655323771795977,-58.470765914120385 -34.655437623385353,-58.469892971115179 -34.655624655302383,-58.469394038928293 -34.655747747242401,-58.469530436077747 -34.656080707232988,-58.470567648415397 -34.658407994434597,-58.471046994572241 -34.658073314783081,-58.471538226108073 -34.657726231200982,-58.47201331449336 -34.657390549037615,-58.472496170150755 -34.657048599892661,-58.473747093836806 -34.656162622168431,-58.474589890683603 -34.655565694501249,-58.475510645539899 -34.654901849415744)));;3348;9_14_4;COMUNA 9;14;4;846;408;438;93,15%;197;197;100,00%;0;0,00%;249;27;10,84%;222;89,16%
MULTIPOLYGON (((-58.473747093836813 -34.656162622168445,-58.47249617015077 -34.657048599892661,-58.472953472824805 -34.657471291124487,-58.47331289220741 -34.657803503229225,-58.473641840040237 -34.658107547146663,-58.47472146775376 -34.657264040849107,-58.474835403762981 -34.657180013045981,-58.473948507824268 -34.656352679709165,-58.473747093836813 -34.656162622168445)));;3349;9_14_5;COMUNA 9;14;5;1880;907;973;93,22%;333;333;100,00%;0;0,00%;457;71;15,54%;386;84,46%
MULTIPOLYGON (((-58.472496170150755 -34.657048599892661,-58.47201331449336 -34.657390549037615,-58.471538226108073 -34.657726231200982,-58.471046994572241 -34.658073314783081,-58.471047381091196 -34.658074190213654,-58.471719264761397 -34.659595916222017,-58.472199830600907 -34.659230869289956,-58.472532533568305 -34.658973511599633,-58.472634968852802 -34.658894275672424,-58.472767316191856 -34.658790881569438,-58.472767942131732 -34.658790392479546,-58.473641840040251 -34.65810754714667,-58.47331289220741 -34.657803503229218,-58.472953472824791 -34.657471291124487,-58.472496170150755 -34.657048599892661)));;3350;9_14_6;COMUNA 9;14;6;2558;1261;1297;97,22%;555;555;100,00%;0;0,00%;659;152;23,07%;507;76,93%
MULTIPOLYGON (((-58.472532533568291 -34.658973511599655,-58.472199830600907 -34.659230869289949,-58.472825147816266 -34.659876259939772,-58.473208730514315 -34.660272154252269,-58.47333622095362 -34.660166576812763,-58.473863308915732 -34.65973186941698,-58.47467493690413 -34.659062407069051,-58.474175774269916 -34.658601033385182,-58.473641840040237 -34.658107547146663,-58.472767942131718 -34.65879039247956,-58.472767316191856 -34.658790881569438,-58.472634968852802 -34.658894275672438,-58.472532533568291 -34.658973511599655)));;3351;9_14_7;COMUNA 9;14;7;1374;676;698;96,85%;262;262;100,00%;0;0,00%;351;62;17,66%;289;82,34%
MULTIPOLYGON (((-58.474835403762981 -34.657180013045981,-58.47472146775376 -34.657264040849107,-58.473641840040237 -34.658107547146663,-58.474175774269916 -34.658601033385182,-58.47467493690413 -34.659062407069051,-58.474801827164491 -34.658957743654604,-58.475830402126476 -34.658110218512086,-58.475719248695768 -34.658004523160621,-58.474835403762981 -34.657180013045981)));;3352;9_14_8;COMUNA 9;14;8;1684;829;855;96,96%;341;341;100,00%;0;0,00%;426;83;19,48%;343;80,52%
MULTIPOLYGON (((-58.473208720498967 -34.660272362820685,-58.473203270067025 -34.660493698591743,-58.473196240097522 -34.660576530177096,-58.473628794170629 -34.661956812905927,-58.474011188001271 -34.661659023155217,-58.474216062021455 -34.661499492430494,-58.474319348575477 -34.661402015088377,-58.474442235404439 -34.661286084545118,-58.475089147918801 -34.660778611789013,-58.475132013790699 -34.660744944499022,-58.475707930124287 -34.660293181444025,-58.475869846970937 -34.660166752014526,-58.477043047736551 -34.659251100562898,-58.476878787114778 -34.659106538171898,-58.476446354036263 -34.658695589993094,-58.475830402126476 -34.658110218512086,-58.474801827164491 -34.658957743654604,-58.47467493690413 -34.659062407069051,-58.473863308915732 -34.65973186941698,-58.47333622095362 -34.660166576812763,-58.473208730514315 -34.660272154252269,-58.473208720498967 -34.660272362820685)));;3353;9_14_9;COMUNA 9;14;9;905;435;470;92,55%;202;201;99,50%;1;0,50%;252;31;12,30%;221;87,70%
MULTIPOLYGON (((-58.493335180041349 -34.657972073022904,-58.492343407067978 -34.658746072793818,-58.492195491415309 -34.65886104153585,-58.493026893023277 -34.659557618055132,-58.493171315576866 -34.659678782686186,-58.492120856002693 -34.660619067410565,-58.493447956208023 -34.661718559765596,-58.494426891994365 -34.662529599357505,-58.49551615204679 -34.661645694663598,-58.496489769466628 -34.660855758541587,-58.496598061561933 -34.66076769782115,-58.497825204584586 -34.659771011286558,-58.497923450528518 -34.659692009903509,-58.498005924136116 -34.65962515315988,-58.498815656003366 -34.658964192913878,-58.497839956969585 -34.658150511018682,-58.497272655245879 -34.657677420139407,-58.4968618045908 -34.657334779575869,-58.496355982938979 -34.656912936214127,-58.496250778114998 -34.656825145763804,-58.495954348072949 -34.656579867746025,-58.495541719018803 -34.656238490796852,-58.495411703916488 -34.656338810349922,-58.494634509987428 -34.656955231427688,-58.494521516459898 -34.657042026772416,-58.494406768318456 -34.657135789041696,-58.493436486378904 -34.657892960743425,-58.493335180041349 -34.657972073022904)));;3354;9_15_1;COMUNA 9;15;1;579;279;300;93,00%;238;238;100,00%;0;0,00%;217;5;2,30%;212;97,70%
MULTIPOLYGON (((-58.492120856002693 -34.660619067410565,-58.491978310638103 -34.660746570125184,-58.490951510682677 -34.661664021388958,-58.490801121134119 -34.661541094930449,-58.489806120285053 -34.660719395551148,-58.488560695020055 -34.661690186461293,-58.48731694495563 -34.662659626097799,-58.487132288714527 -34.662803540512222,-58.488952429882161 -34.663348388692974,-58.490077084975702 -34.664400283291393,-58.491000037831782 -34.665263406289831,-58.491964801115152 -34.664502734964941,-58.493041426155784 -34.663653927083885,-58.493204769913717 -34.663521347420406,-58.494426891994365 -34.662529599357505,-58.493447956208023 -34.661718559765596,-58.492120856002693 -34.660619067410565)));;3355;9_15_10;COMUNA 9;15;10;682;345;337;102,37%;251;251;100,00%;0;0,00%;229;15;6,55%;214;93,45%
MULTIPOLYGON (((-58.484914656135103 -34.660686158569149,-58.484131631876068 -34.661296597690438,-58.485037364994611 -34.661871662614459,-58.48522686725844 -34.661991983250111,-58.485360874597184 -34.662077101657744,-58.48594532705458 -34.662448128818518,-58.487132288714527 -34.662803540512222,-58.48731694495563 -34.662659626097799,-58.488560695020055 -34.661690186461293,-58.489806120285053 -34.660719395551148,-58.489006877125178 -34.66005934060032,-58.488210118884801 -34.659401251703216,-58.486962564101752 -34.660372519916116,-58.486164795429509 -34.659711460054446,-58.484914656135103 -34.660686158569149)));;3356;9_15_11;COMUNA 9;15;11;928;452;476;94,96%;334;334;100,00%;0;0,00%;311;7;2,25%;304;97,75%
MULTIPOLYGON (((-58.495541719018803 -34.656238490796852,-58.495404716662613 -34.656125073618462,-58.494746819124508 -34.655576359078765,-58.49395542681394 -34.654916193092639,-58.493052308527375 -34.655630737895933,-58.492944412344031 -34.655714864938354,-58.492818907710294 -34.655811624485573,-58.491865445522514 -34.656553519189707,-58.49176269062275 -34.656633053073982,-58.490605619481727 -34.657528842246336,-58.491401103238559 -34.658195437363482,-58.492195491415309 -34.65886104153585,-58.492343407067978 -34.658746072793818,-58.493335180041349 -34.657972073022904,-58.493436486378904 -34.657892960743425,-58.494406768318456 -34.657135789041696,-58.494521516459898 -34.657042026772416,-58.494634509987428 -34.656955231427688,-58.495411703916488 -34.656338810349922,-58.495541719018803 -34.656238490796852)));;3357;9_15_2;COMUNA 9;15;2;875;433;442;97,96%;272;272;100,00%;0;0,00%;290;31;10,69%;259;89,31%
MULTIPOLYGON (((-58.490192212490612 -34.655295631850016,-58.489747642146988 -34.654916987798295,-58.489406822054832 -34.654627406543206,-58.488620080541033 -34.653958824265459,-58.487441713449591 -34.654877546751173,-58.486270307293076 -34.655790833677727,-58.485645313948879 -34.656278150177741,-58.48515511294103 -34.656660294792047,-58.485019461157272 -34.656765956566097,-58.485816680434176 -34.657424489068781,-58.486613571311239 -34.658082664226761,-58.48773746066972 -34.65720677955423,-58.487865355904738 -34.657107102454425,-58.489025005256337 -34.656204366627755,-58.489816542209596 -34.656867663130946,-58.490605619481727 -34.657528842246336,-58.49176269062275 -34.656633053073982,-58.490976933753366 -34.65596392260133,-58.490192212490612 -34.655295631850016)));;3358;9_15_3;COMUNA 9;15;3;863;407;456;89,25%;312;312;100,00%;0;0,00%;290;10;3,45%;280;96,55%
MULTIPOLYGON (((-58.486298114035399 -34.651963814088923,-58.485916064740266 -34.652263051260512,-58.485686014980274 -34.652439931085802,-58.485561106083551 -34.652536013759303,-58.485172804158957 -34.652835779162373,-58.485084950616731 -34.652903817496075,-58.484984811952366 -34.652981217970094,-58.484653932436935 -34.653236764609787,-58.483894151050372 -34.653823676931871,-58.484035141431484 -34.653944853100349,-58.484670961633071 -34.654470530312302,-58.485470031685146 -34.655131177739058,-58.48484665791905 -34.65561863074484,-58.485645313948879 -34.656278150177741,-58.486270307293076 -34.655790833677727,-58.487441713449591 -34.654877546751173,-58.488620080541033 -34.653958824265459,-58.487832072980517 -34.65328911030231,-58.487286680979054 -34.652825616216496,-58.486988091107229 -34.652574962012551,-58.486988074201015 -34.65257482354756,-58.487158593291113 -34.65254021097229,-58.487059625894638 -34.652455862080309,-58.486394307560353 -34.651888511502008,-58.486298114035399 -34.651963814088923)));;3359;9_15_4;COMUNA 9;15;4;865;413;452;91,37%;304;304;100,00%;0;0,00%;272;12;4,41%;260;95,59%
MULTIPOLYGON (((-58.483246033364885 -34.657299523176277,-58.483776254536899 -34.657734586091856,-58.484363862869628 -34.657276793828188,-58.485019461157272 -34.656765956566097,-58.48515511294103 -34.656660294792047,-58.485645313948879 -34.656278150177741,-58.48484665791905 -34.65561863074484,-58.485470031685146 -34.655131177739058,-58.484670961633071 -34.654470530312302,-58.484035141431484 -34.653944853100349,-58.483894151050372 -34.653823676931871,-58.483752367179619 -34.653933211764169,-58.482656090189508 -34.654798491969018,-58.482096269493937 -34.655240285387137,-58.481554592602514 -34.655667847632394,-58.481400021740534 -34.655790832770599,-58.482178021052 -34.656423053328815,-58.482767816111703 -34.656907056243952,-58.483246033364885 -34.657299523176277)));;3360;9_15_5;COMUNA 9;15;5;949;468;481;97,30%;375;375;100,00%;0;0,00%;319;9;2,82%;310;97,18%
MULTIPOLYGON (((-58.479356548064771 -34.658214790821269,-58.479462586096965 -34.658287595286026,-58.479632808572696 -34.658397856626877,-58.479822466067461 -34.65852058014714,-58.480169221114245 -34.658745114871316,-58.48030014965412 -34.658829394234822,-58.480533537272422 -34.658979716744582,-58.480841596564012 -34.659178057259943,-58.48143376669578 -34.659559387066444,-58.482703102786765 -34.658570565573285,-58.483776254536899 -34.657734586091856,-58.483246033364885 -34.657299523176277,-58.482767816111703 -34.656907056243952,-58.482178021052 -34.656423053328815,-58.481400021740534 -34.655790832770599,-58.480398111914873 -34.656587625218087,-58.480160370671165 -34.656776679065388,-58.479114296391089 -34.657608609014936,-58.478817836716694 -34.65784443001651,-58.479356548064771 -34.658214790821269)));;3361;9_15_6;COMUNA 9;15;6;1049;526;523;100,57%;359;359;100,00%;0;0,00%;336;4;1,19%;332;98,81%
MULTIPOLYGON (((-58.484363862869628 -34.657276793828188,-58.483776254536899 -34.657734586091856,-58.482703102786765 -34.658570565573285,-58.48143376669578 -34.659559387066444,-58.482333326733801 -34.660138698669364,-58.483232387804406 -34.660717581114916,-58.484131631876068 -34.661296597690438,-58.484914656135103 -34.660686158569149,-58.486164795429509 -34.659711460054446,-58.486286049992245 -34.659616997345069,-58.487410815785381 -34.658741115729207,-58.486613571311239 -34.658082664226761,-58.485816680434176 -34.657424489068781,-58.485019461157272 -34.656765956566097,-58.484363862869628 -34.657276793828188)));;3362;9_15_7;COMUNA 9;15;7;1059;520;539;96,47%;378;378;100,00%;0;0,00%;348;9;2,59%;339;97,41%
MULTIPOLYGON (((-58.487410815785381 -34.658741115729207,-58.486286049992245 -34.659616997345069,-58.486164795429509 -34.659711460054446,-58.486962564101752 -34.660372519916116,-58.488210118884801 -34.659401251703216,-58.489310577600847 -34.658544442674511,-58.48945943176372 -34.658421941791765,-58.489579826974406 -34.658322968804917,-58.490605619481727 -34.657528842246336,-58.489816542209596 -34.656867663130946,-58.489025005256337 -34.656204366627755,-58.487865355904738 -34.657107102454425,-58.48773746066972 -34.65720677955423,-58.486613571311239 -34.658082664226761,-58.487410815785381 -34.658741115729207)));;3363;9_15_8;COMUNA 9;15;8;843;413;430;96,05%;290;290;100,00%;0;0,00%;283;25;8,83%;258;91,17%
MULTIPOLYGON (((-58.489806120285053 -34.660719395551148,-58.490801121134119 -34.661541094930449,-58.490951510682677 -34.661664021388958,-58.491978310638103 -34.660746570125184,-58.492120856002693 -34.660619067410565,-58.493171315576866 -34.659678782686186,-58.493026893023277 -34.659557618055132,-58.492195491415309 -34.65886104153585,-58.491401103238559 -34.658195437363482,-58.490605619481727 -34.657528842246336,-58.489579826974406 -34.658322968804917,-58.48945943176372 -34.658421941791765,-58.489310577600847 -34.658544442674511,-58.488210118884801 -34.659401251703216,-58.489006877125178 -34.66005934060032,-58.489806120285053 -34.660719395551148)));;3364;9_15_9;COMUNA 9;15;9;801;366;435;84,14%;318;318;100,00%;0;0,00%;293;12;4,10%;281;95,90%
MULTIPOLYGON (((-58.509667590005485 -34.667943632766459,-58.508880996310445 -34.667293563507158,-58.507941176572487 -34.666517486273996,-58.507230759147504 -34.665930759932472,-58.506533995358332 -34.66535543324715,-58.506425188261225 -34.665265751539458,-58.505626963885334 -34.664607495909785,-58.504138792393391 -34.665845861807384,-58.504929858123511 -34.66650624226029,-58.505731339792682 -34.66717527603555,-58.506536074787704 -34.667846979422386,-58.507305091950975 -34.668488900955047,-58.508074374659856 -34.669127084970782,-58.508072153626408 -34.669128768978965,-58.508369435249023 -34.669382140879684,-58.508787774744292 -34.669738686044539,-58.510384596907599 -34.668531700242575,-58.509964840334462 -34.668177434880064,-58.509678194489531 -34.667935509482248,-58.509667590005485 -34.667943632766459)));;3365;9_16_1;COMUNA 9;16;1;925;442;483;91,51%;359;359;100,00%;0;0,00%;309;9;2,91%;300;97,09%
MULTIPOLYGON (((-58.496691874489926 -34.667800613234512,-58.496584913324114 -34.667830150853952,-58.496478554662865 -34.667874266072999,-58.496424610376721 -34.667901816966065,-58.496307526627803 -34.667983189533729,-58.496876889449943 -34.668543468961573,-58.497034473909345 -34.668698499295381,-58.497136968545625 -34.668790163003024,-58.498194124385869 -34.669651713986191,-58.498268283172742 -34.669713441558912,-58.49888029370328 -34.670219978216039,-58.499631790767282 -34.670842375127322,-58.500474995424447 -34.669535602943498,-58.501301882631815 -34.668206153153768,-58.500497702242399 -34.66754420406869,-58.49971714789465 -34.66689679950224,-58.499684835061792 -34.666869998382687,-58.498895004129267 -34.666217330247378,-58.49857048038217 -34.665949108941874,-58.497302595960463 -34.666966263785604,-58.497226898534656 -34.667770743768692,-58.497123586996373 -34.667762040351974,-58.497045336538569 -34.667756287616911,-58.496943223288817 -34.667759555865928,-58.496820570725319 -34.667770013073259,-58.496745143520528 -34.667789682581066,-58.496691874489926 -34.667800613234512)));;3366;9_16_10;COMUNA 9;16;10;862;385;477;80,71%;323;322;99,69%;1;0,31%;297;7;2,36%;290;97,64%
MULTIPOLYGON (((-58.498093589510368 -34.665555082556217,-58.497314270996085 -34.664911063190168,-58.49506641562175 -34.666761942786707,-58.496307526627803 -34.667983189533729,-58.496424610376721 -34.667901816966065,-58.496478554662865 -34.667874266072999,-58.496584913324114 -34.667830150853952,-58.496691874489926 -34.667800613234512,-58.496745143520528 -34.667789682581066,-58.496820570725319 -34.667770013073259,-58.496943223288817 -34.667759555865928,-58.497045336538569 -34.667756287616911,-58.497123586996373 -34.667762040351974,-58.497226898534656 -34.667770743768692,-58.497302595960463 -34.666966263785604,-58.49857048038217 -34.665949108941874,-58.498093589510368 -34.665555082556217)));;3367;9_16_11;COMUNA 9;16;11;748;369;379;97,36%;255;255;100,00%;0;0,00%;247;2;0,81%;245;99,19%
MULTIPOLYGON (((-58.49506641562175 -34.666761942786707,-58.493608634684527 -34.667962283350541,-58.493959006476594 -34.668307837191335,-58.494353039668297 -34.668696478432587,-58.49474076644816 -34.669078852257485,-58.495093449980615 -34.669426655746015,-58.495844172673337 -34.668835945090471,-58.496160342601904 -34.669096992526207,-58.496876889449943 -34.668543468961573,-58.496307526627803 -34.667983189533729,-58.49506641562175 -34.666761942786707)));;3368;9_16_12;COMUNA 9;16;12;793;376;417;90,17%;284;284;100,00%;0;0,00%;259;4;1,54%;255;98,46%
MULTIPOLYGON (((-58.498268283172742 -34.669713441558912,-58.498194124385869 -34.669651713986191,-58.497136968545625 -34.668790163003024,-58.497034473909345 -34.668698499295381,-58.496876889449943 -34.668543468961573,-58.496160342601904 -34.669096992526207,-58.495844172673337 -34.668835945090471,-58.495093449980615 -34.669426655746015,-58.495738025996424 -34.670062344907087,-58.495873184400615 -34.670195621632757,-58.497039930458619 -34.67118032484565,-58.497233249024134 -34.671319073576342,-58.497407941066079 -34.671444453001357,-58.49888029370328 -34.670219978216039,-58.498268283172742 -34.669713441558912)));;3369;9_16_13;COMUNA 9;16;13;784;392;392;100,00%;329;329;100,00%;0;0,00%;296;2;0,68%;294;99,32%
MULTIPOLYGON (((-58.505465943437677 -34.662094243063429,-58.505160598995168 -34.661840328567131,-58.50457308757921 -34.662835630062929,-58.504214646823421 -34.663442952674082,-58.503337556163984 -34.66492878231508,-58.503236380271424 -34.665098961535875,-58.503020400672753 -34.665462141748769,-58.502586477017793 -34.666191881980801,-58.503154122809555 -34.666665158603038,-58.504138792393391 -34.665845861807384,-58.505626963885334 -34.664607495909785,-58.506425188261225 -34.665265751539458,-58.507852999056603 -34.664081184310938,-58.5071485690505 -34.663493821209101,-58.507056817474457 -34.663417514472009,-58.506264486480291 -34.662758485997735,-58.505465943437677 -34.662094243063429)));;3370;9_16_2;COMUNA 9;16;2;863;404;459;88,02%;360;360;100,00%;0;0,00%;314;10;3,18%;304;96,82%
MULTIPOLYGON (((-58.503217530709321 -34.662621645466999,-58.501868915798042 -34.663741835729418,-58.50173233990877 -34.663855544661267,-58.500757468557026 -34.664667072537675,-58.50155855748833 -34.665334936872163,-58.502362387927661 -34.666005118980706,-58.502586477017793 -34.666191881980801,-58.503020400672753 -34.665462141748769,-58.503236380271424 -34.665098961535875,-58.503337556163984 -34.66492878231508,-58.504214646823421 -34.663442952674082,-58.50457308757921 -34.662835630062929,-58.505160598995168 -34.661840328567131,-58.504659653882605 -34.66142358885655,-58.503217530709321 -34.662621645466999)));;3371;9_16_3;COMUNA 9;16;3;613;268;345;77,68%;217;217;100,00%;0;0,00%;228;9;3,95%;219;96,05%
MULTIPOLYGON (((-58.503217530709321 -34.662621645466999,-58.504659653882605 -34.66142358885655,-58.503863609177806 -34.660761447148282,-58.503112170219396 -34.660136258270335,-58.502937810623592 -34.66000229804613,-58.50285392360005 -34.659958592064392,-58.502743613618506 -34.659910950931319,-58.502603812378233 -34.659859164305708,-58.502522234279709 -34.659830950737366,-58.502387292997213 -34.659782542653154,-58.502305033178736 -34.659754258736456,-58.502144519419275 -34.659697548591126,-58.50200190684339 -34.659646818550854,-58.50185494669266 -34.659593836154208,-58.501679942222793 -34.659532059481144,-58.501558384751959 -34.659487660396238,-58.501488483225778 -34.659458315619673,-58.501426764979371 -34.659431644336586,-58.50124629141672 -34.659337262212276,-58.501100169345946 -34.6592512495262,-58.501053448305647 -34.659217319600764,-58.500958045366474 -34.659147910970802,-58.499788867895639 -34.658169863917109,-58.498815656003366 -34.658964192913878,-58.498005924136116 -34.65962515315988,-58.497923450528518 -34.659692009903509,-58.497825204584586 -34.659771011286558,-58.496598061561933 -34.66076769782115,-58.496489769466628 -34.660855758541587,-58.49551615204679 -34.661645694663598,-58.494426891994365 -34.662529599357505,-58.493204769913717 -34.663521347420406,-58.493041426155784 -34.663653927083885,-58.491964801115152 -34.664502734964941,-58.491000037831782 -34.665263406289831,-58.491135093259786 -34.66538978680282,-58.491761701957238 -34.666007472950767,-58.491935390087406 -34.666186450423467,-58.492188377483409 -34.666447030443436,-58.492566113553224 -34.666836104071145,-58.492598089121984 -34.666869054880898,-58.492896108191594 -34.667191455022561,-58.493458726728079 -34.667800063337211,-58.493608634684527 -34.667962283350541,-58.49506641562175 -34.666761942786707,-58.497314270996085 -34.664911063190168,-58.498252630043794 -34.664138306988249,-58.499193783370238 -34.663363289051453,-58.499959547295198 -34.664001807599995,-58.500757468557026 -34.664667072537675,-58.50173233990877 -34.663855544661267,-58.501868915798042 -34.663741835729418,-58.503217530709321 -34.662621645466999)));;3372;9_16_4;COMUNA 9;16;4;729;373;356;104,78%;279;276;98,92%;3;1,09%;247;13;5,26%;234;94,74%
MULTIPOLYGON (((-58.498252630043794 -34.664138306988249,-58.497314270996085 -34.664911063190168,-58.498093589510368 -34.665555082556217,-58.49857048038217 -34.665949108941874,-58.498895004129267 -34.666217330247378,-58.499684835061792 -34.666869998382687,-58.49971714789465 -34.66689679950224,-58.500497702242399 -34.66754420406869,-58.501415867096846 -34.666786007976341,-58.502362387927661 -34.666005118980706,-58.50155855748833 -34.665334936872163,-58.500757468557026 -34.664667072537675,-58.499959547295198 -34.664001807599995,-58.499193783370238 -34.663363289051453,-58.498252630043794 -34.664138306988249)));;3373;9_16_5;COMUNA 9;16;5;887;425;462;91,99%;253;252;99,60%;1;0,40%;283;11;3,89%;272;96,11%
MULTIPOLYGON (((-58.504743261776547 -34.667996769848102,-58.505596978593857 -34.667286805292989,-58.505731339792682 -34.66717527603555,-58.504929858123511 -34.66650624226029,-58.504138792393391 -34.665845861807384,-58.503154122809555 -34.666665158603038,-58.502586477017793 -34.666191881980801,-58.502362387927661 -34.666005118980706,-58.501415867096846 -34.666786007976341,-58.500497702242399 -34.66754420406869,-58.501301882631815 -34.668206153153768,-58.502098061411168 -34.668863944402318,-58.502901842141384 -34.669528066067414,-58.503799811069811 -34.668781338108786,-58.504743261776547 -34.667996769848102)));;3374;9_16_6;COMUNA 9;16;6;986;459;527;87,10%;362;362;100,00%;0;0,00%;326;11;3,37%;315;96,63%
MULTIPOLYGON (((-58.50606296003388 -34.670655409703386,-58.506360292165205 -34.670899421449533,-58.50678783919124 -34.671250292935817,-58.508787774744292 -34.669738686044539,-58.508369435249023 -34.669382140879684,-58.508072153626408 -34.669128768978965,-58.508074374659856 -34.669127084970782,-58.507305091950975 -34.668488900955047,-58.506536074787704 -34.667846979422386,-58.505731339792682 -34.66717527603555,-58.505596978593857 -34.667286805292989,-58.504743261776547 -34.667996769848102,-58.503799811069811 -34.668781338108786,-58.502901842141384 -34.669528066067414,-58.503636392659949 -34.670135020994827,-58.504350061275865 -34.670724654162683,-58.505281125201101 -34.670021003873394,-58.50605160247737 -34.670664059360426,-58.50606296003388 -34.670655409703386)));;3375;9_16_7;COMUNA 9;16;7;968;478;490;97,55%;370;370;100,00%;0;0,00%;336;7;2,08%;329;97,92%
MULTIPOLYGON (((-58.50605160247737 -34.670664059360426,-58.505281125201101 -34.670021003873394,-58.504350061275865 -34.670724654162683,-58.503636392659949 -34.670135020994827,-58.502901842141384 -34.669528066067414,-58.502805560224168 -34.66960809992711,-58.501684670725631 -34.6705377137407,-58.500651777249175 -34.671394400493696,-58.50047360360751 -34.671539530104404,-58.500634514943201 -34.671672793533396,-58.501271597489016 -34.67219655115084,-58.500118111461227 -34.6731668657876,-58.500681450386878 -34.673468671325828,-58.50164187158515 -34.673983768279541,-58.501641882017026 -34.673983773002675,-58.502004305240682 -34.674185404644213,-58.502522626279266 -34.674473765367807,-58.502573464871304 -34.674435345944318,-58.50678783919124 -34.671250292935817,-58.506360292165205 -34.670899421449533,-58.50606296003388 -34.670655409703386,-58.50605160247737 -34.670664059360426)));;3376;9_16_8;COMUNA 9;16;8;930;417;513;81,29%;309;308;99,68%;1;0,32%;301;9;2,99%;292;97,01%
MULTIPOLYGON (((-58.499631790767282 -34.670842375127322,-58.49888029370328 -34.670219978216039,-58.497407941066079 -34.671444453001357,-58.497916389569376 -34.671809316864142,-58.498252856492357 -34.672050704467885,-58.498723794167319 -34.672388744164287,-58.498928260007403 -34.6725146023877,-58.49912752472801 -34.672636025083044,-58.499741929165396 -34.672965285232706,-58.500118111461227 -34.6731668657876,-58.501271597489016 -34.67219655115084,-58.500634514943201 -34.671672793533396,-58.50047360360751 -34.671539530104404,-58.500651777249175 -34.671394400493696,-58.501684670725631 -34.6705377137407,-58.502805560224168 -34.66960809992711,-58.502901842141384 -34.669528066067414,-58.502098061411168 -34.668863944402318,-58.501301882631815 -34.668206153153768,-58.500474995424447 -34.669535602943498,-58.499631790767282 -34.670842375127322)));;3377;9_16_9;COMUNA 9;16;9;1023;462;561;82,35%;382;382;100,00%;0;0,00%;340;11;3,24%;329;96,76%
MULTIPOLYGON (((-58.518637050949103 -34.640383335975407,-58.518526248735228 -34.641483210079436,-58.518723256139836 -34.641483753561204,-58.51942963202842 -34.641453707782752,-58.520997375738794 -34.641387121309471,-58.52115977680846 -34.640279684788155,-58.521206927451651 -34.639958173152429,-58.52122940266495 -34.639808439324767,-58.521225613660462 -34.63963047776528,-58.521215649650145 -34.639152932198165,-58.521217113680088 -34.638932361111365,-58.520960648577173 -34.638948259044518,-58.520541780496806 -34.638969515427263,-58.519756956135154 -34.639009393417979,-58.518967103924929 -34.639049550377223,-58.518770280512499 -34.639060627289105,-58.518637050949103 -34.640383335975407)));;3378;9_2_1;COMUNA 9;2;1;824;377;447;84,34%;474;474;100,00%;0;0,00%;349;2;0,57%;347;99,43%
MULTIPOLYGON (((-58.520997375738794 -34.641387121309471,-58.51942963202842 -34.641453707782752,-58.518723256139836 -34.641483753561204,-58.518526248735228 -34.641483210079436,-58.518341852553121 -34.641482730951012,-58.517554512717659 -34.641492806245374,-58.51706821948693 -34.6414990101093,-58.516819662035587 -34.641502219352496,-58.516647130447879 -34.642191049761571,-58.515510543191446 -34.642265774912524,-58.516430144532904 -34.64305729933416,-58.516507811327685 -34.643116773985099,-58.51684229122322 -34.64341205766776,-58.518330707791691 -34.643423359987459,-58.518986422387762 -34.643428270538863,-58.519176193804682 -34.643432478711453,-58.51928907352805 -34.64251465134339,-58.520650654154053 -34.642612254442106,-58.520816227624529 -34.642622175963382,-58.520997375738794 -34.641387121309471)));;3379;9_2_10;COMUNA 9;2;10;754;356;398;89,45%;389;389;100,00%;0;0,00%;305;6;1,97%;299;98,03%
MULTIPOLYGON (((-58.519324709392073 -34.64554860193541,-58.519879871058897 -34.64602638571715,-58.520012718696783 -34.646145834054416,-58.520267407938448 -34.646363960200539,-58.520379957612214 -34.645596489152403,-58.520542629483707 -34.644487363888302,-58.52068765691029 -34.64349902499508,-58.520816227624529 -34.642622175963382,-58.520650654154053 -34.642612254442106,-58.51928907352805 -34.64251465134339,-58.519176193804682 -34.643432478711453,-58.518986422387762 -34.643428270538863,-58.518330707791691 -34.643423359987459,-58.51684229122322 -34.64341205766776,-58.517082299655335 -34.643618647434899,-58.517851357713667 -34.644280505670061,-58.517949579760021 -34.644365041289447,-58.518637480713068 -34.644957069914213,-58.519324709392073 -34.64554860193541)));;3380;9_2_11;COMUNA 9;2;11;1058;449;609;73,73%;431;425;98,61%;6;1,41%;341;7;2,05%;334;97,95%
MULTIPOLYGON (((-58.520012718696783 -34.646145834054416,-58.519879871058897 -34.64602638571715,-58.519324709392073 -34.64554860193541,-58.518637480713068 -34.644957069914213,-58.517949579760021 -34.644365041289447,-58.517851357713667 -34.644280505670061,-58.517082299655335 -34.643618647434899,-58.515883266954162 -34.644548500772366,-58.515981573301325 -34.644634235157213,-58.516540713828533 -34.645110553567179,-58.516650019651451 -34.645204733512152,-58.517437847142752 -34.645883135675312,-58.51816114204027 -34.646505926530999,-58.518292449818098 -34.646618968787728,-58.5188154677301 -34.647069447204146,-58.519476794095169 -34.647638876723043,-58.51959557719271 -34.647749951493722,-58.519733305002433 -34.647650377095296,-58.520121013528332 -34.647361594835338,-58.520267407938448 -34.646363960200539,-58.520012718696783 -34.646145834054416)));;3381;9_2_12;COMUNA 9;2;12;625;292;333;87,69%;288;288;100,00%;0;0,00%;223;0;0,00%;223;100,00%
MULTIPOLYGON (((-58.515510543191446 -34.642265774912524,-58.516647130447879 -34.642191049761571,-58.516819662035587 -34.641502219352496,-58.51706821948693 -34.6414990101093,-58.517554512717659 -34.641492806245374,-58.518341852553121 -34.641482730951012,-58.518526248735228 -34.641483210079436,-58.518637050949103 -34.640383335975407,-58.518770280512499 -34.639060627289105,-58.517412027185848 -34.639137162080573,-58.517245029563405 -34.63980401858889,-58.517083383319211 -34.640449181585559,-58.516856306209746 -34.640459142098692,-58.515995369000485 -34.640491494207005,-58.514658056108964 -34.641531963162109,-58.515510543191446 -34.642265774912524)));;3382;9_2_2;COMUNA 9;2;2;767;353;414;85,27%;375;375;100,00%;0;0,00%;301;5;1,66%;296;98,34%
MULTIPOLYGON (((-58.516301706645322 -34.639181107210078,-58.515912312543328 -34.639193390789778,-58.514490298864352 -34.639238300123012,-58.514298669668065 -34.639245423825471,-58.51397863772403 -34.640508697388448,-58.513430378394496 -34.640475263645122,-58.51402554244342 -34.64098756599045,-58.514658056108964 -34.641531963162109,-58.515995369000485 -34.640491494207005,-58.516856306209746 -34.640459142098692,-58.517083383319211 -34.640449181585559,-58.517245029563405 -34.63980401858889,-58.517412027185848 -34.639137162080573,-58.517052802368781 -34.639157393762872,-58.516301706645322 -34.639181107210078)));;3383;9_2_3;COMUNA 9;2;3;819;388;431;90,02%;434;434;100,00%;0;0,00%;330;6;1,82%;324;98,18%
MULTIPOLYGON (((-58.512992966047797 -34.639294210223724,-58.511410846558498 -34.639346332897446,-58.510052663372029 -34.639116719636547,-58.509822253348069 -34.640008316043975,-58.509788549740229 -34.640077697454849,-58.511154339090204 -34.640320339173378,-58.512642501356559 -34.640427207022853,-58.512700446012289 -34.640430774943006,-58.513430378394496 -34.640475263645122,-58.51397863772403 -34.640508697388448,-58.514298669668065 -34.639245423825471,-58.512992966047797 -34.639294210223724)));;3384;9_2_4;COMUNA 9;2;4;982;436;546;79,85%;545;545;100,00%;0;0,00%;414;4;0,97%;410;99,03%
MULTIPOLYGON (((-58.509788549740229 -34.640077697454849,-58.509725181322359 -34.64012596286851,-58.509210650901068 -34.64051786270236,-58.509331454361472 -34.640627467921021,-58.509587042778811 -34.640857518030934,-58.509970257591121 -34.641202521814336,-58.510730984512037 -34.641887175671606,-58.511490274596433 -34.642570557630876,-58.511751841394904 -34.642803347297956,-58.512897218541042 -34.641884049687526,-58.513015349010715 -34.64178920930371,-58.51402554244342 -34.64098756599045,-58.513430378394496 -34.640475263645122,-58.512700446012289 -34.640430774943006,-58.512642501356559 -34.640427207022853,-58.511154339090204 -34.640320339173378,-58.509788549740229 -34.640077697454849)));;3385;9_2_5;COMUNA 9;2;5;1143;526;617;85,25%;527;527;100,00%;0;0,00%;428;3;0,70%;425;99,30%
MULTIPOLYGON (((-58.511751841394904 -34.642803347297956,-58.511490274596433 -34.642570557630876,-58.510730984512037 -34.641887175671606,-58.509970257591121 -34.641202521814336,-58.509587042778811 -34.640857518030934,-58.509331454361472 -34.640627467921021,-58.509210650901068 -34.64051786270236,-58.508031752343584 -34.641415658821209,-58.508409166203862 -34.641755669479174,-58.508792550934736 -34.642101099397415,-58.509553362047299 -34.642786535140338,-58.510317936971902 -34.643475344971698,-58.511123192656754 -34.644200825057098,-58.512332360056064 -34.643323762440971,-58.511751841394904 -34.642803347297956)));;3386;9_2_6;COMUNA 9;2;6;716;327;389;84,06%;301;301;100,00%;0;0,00%;255;0;0,00%;255;100,00%
MULTIPOLYGON (((-58.512021821711329 -34.645010419529036,-58.512959773719473 -34.645855344261157,-58.514004442265602 -34.645051645105077,-58.514133732366233 -34.644946024010352,-58.513196889772971 -34.644106530425901,-58.514368269944391 -34.643205448429477,-58.513498968118149 -34.642424944212927,-58.512332360056064 -34.643323762440971,-58.511123192656754 -34.644200825057098,-58.512021821711329 -34.645010419529036)));;3387;9_2_7;COMUNA 9;2;7;800;382;418;91,39%;379;379;100,00%;0;0,00%;300;2;0,67%;298;99,33%
MULTIPOLYGON (((-58.51684229122322 -34.64341205766776,-58.516507811327685 -34.643116773985099,-58.515306734126511 -34.644046340933478,-58.51517031803062 -34.643927522781354,-58.514501872401098 -34.643325395484737,-58.514368269944391 -34.643205448429477,-58.513196889772971 -34.644106530425901,-58.514133732366233 -34.644946024010352,-58.514004442265602 -34.645051645105077,-58.512959773719473 -34.645855344261157,-58.513080333658664 -34.645964030244052,-58.513534693329973 -34.646369769615831,-58.514707630227903 -34.645460233068448,-58.515883266954162 -34.644548500772366,-58.517082299655335 -34.643618647434899,-58.51684229122322 -34.64341205766776)));;3388;9_2_8;COMUNA 9;2;8;686;329;357;92,16%;303;303;100,00%;0;0,00%;245;1;0,41%;244;99,59%
MULTIPOLYGON (((-58.513498968118149 -34.642424944212927,-58.514368269944391 -34.643205448429477,-58.514501872401098 -34.643325395484737,-58.51517031803062 -34.643927522781354,-58.515306734126511 -34.644046340933478,-58.516507811327685 -34.643116773985099,-58.516430144532904 -34.64305729933416,-58.515510543191446 -34.642265774912524,-58.514658056108964 -34.641531963162109,-58.51402554244342 -34.64098756599045,-58.513015349010715 -34.64178920930371,-58.512897218541042 -34.641884049687526,-58.511751841394904 -34.642803347297956,-58.512332360056064 -34.643323762440971,-58.513498968118149 -34.642424944212927)));;3389;9_2_9;COMUNA 9;2;9;861;388;473;82,03%;442;442;100,00%;0;0,00%;358;3;0,84%;355;99,16%
MULTIPOLYGON (((-58.529294644545203 -34.639225480907356,-58.529238148008218 -34.639221215832933,-58.529229956195664 -34.639313124620365,-58.528961442923432 -34.639286086842318,-58.528896091799012 -34.639290770365108,-58.528797718370171 -34.639344064841971,-58.5277135403717 -34.639253447539737,-58.527604486639397 -34.640363822385353,-58.527515187039583 -34.641677995631206,-58.527430940579713 -34.642919064984973,-58.528880446864918 -34.642979626928899,-58.528879732903391 -34.642990700973463,-58.529544066788752 -34.6430101832714,-58.52988029942118 -34.643020042268176,-58.530102759932355 -34.639283852871813,-58.530073584794998 -34.639281927088739,-58.530072898054321 -34.639281885006241,-58.530072898000014 -34.639281885002923,-58.530072895964544 -34.639281884878173,-58.529843418317633 -34.639265251711507,-58.529294644545203 -34.639225480907356)));;3390;9_3_1;COMUNA 9;3;1;646;318;328;96,95%;380;380;100,00%;0;0,00%;263;27;10,27%;236;89,73%
MULTIPOLYGON (((-58.524542495305703 -34.642790841575341,-58.524245095732269 -34.642777681750275,-58.523947099716374 -34.642764451074697,-58.523649189005965 -34.642751219628238,-58.523310971824635 -34.642736176450022,-58.523211744140269 -34.643618154529577,-58.523100406993422 -34.644607958626437,-58.522975943164148 -34.645714180970771,-58.522886276398367 -34.646511151038638,-58.522776786119081 -34.647472924442802,-58.524352916685288 -34.647535308706978,-58.524435478858578 -34.646598125757059,-58.524507307935203 -34.645783627863274,-58.524604654556164 -34.644678826242171,-58.524691943153996 -34.643688047074292,-58.52477010411004 -34.642801007952897,-58.524542495305703 -34.642790841575341)));;3391;9_3_10;COMUNA 9;3;10;809;390;419;93,08%;332;332;100,00%;0;0,00%;283;0;0,00%;283;100,00%
MULTIPOLYGON (((-58.526622419073966 -34.645879441893101,-58.526697837156917 -34.645882923571996,-58.526774022128009 -34.645886334376627,-58.526867250781507 -34.645890581263046,-58.527231132302248 -34.645907079903402,-58.527257335521071 -34.645521702122565,-58.527305865479555 -34.644807781259779,-58.527363746517139 -34.64395631587594,-58.527372839413239 -34.643814475682937,-58.526125190520524 -34.643755622063047,-58.525723737847159 -34.643736674668538,-58.525392418120347 -34.643721070305311,-58.525062547188178 -34.643705534725697,-58.524691943153996 -34.643688047074292,-58.524604654556164 -34.644678826242171,-58.524507307935203 -34.645783627863274,-58.524893941683537 -34.645801107890414,-58.525236091852641 -34.645816637619838,-58.525579435211924 -34.645832236198643,-58.525989504356971 -34.645850757036257,-58.52632475229089 -34.645866005594073,-58.526622419073966 -34.645879441893101)));;3392;9_3_11;COMUNA 9;3;11;833;394;439;89,75%;327;327;100,00%;0;0,00%;294;7;2,38%;287;97,62%
MULTIPOLYGON (((-58.525319474419689 -34.647572915955628,-58.525876722626514 -34.647592699565514,-58.526435249401231 -34.64761255038519,-58.526582593669929 -34.647618036835325,-58.527109846170127 -34.647637900944325,-58.527168471092232 -34.64675157543715,-58.527204775014702 -34.646203863481617,-58.526867250781507 -34.645890581263046,-58.526774022128009 -34.645886334376627,-58.526697837156917 -34.645882923571996,-58.526622419073966 -34.645879441893101,-58.52632475229089 -34.645866005594073,-58.525989504356971 -34.645850757036257,-58.525579435211924 -34.645832236198643,-58.525236091852641 -34.645816637619838,-58.524893941683537 -34.645801107890414,-58.524507307935203 -34.645783627863274,-58.524435478858578 -34.646598125757059,-58.524352916685288 -34.647535308706978,-58.525158069373752 -34.647567223907572,-58.525319474419689 -34.647572915955628)));;3393;9_3_12;COMUNA 9;3;12;585;288;297;96,97%;224;224;100,00%;0;0,00%;213;0;0,00%;213;100,00%
MULTIPOLYGON (((-58.529265692907863 -34.647708692513802,-58.529600599456408 -34.647717086711637,-58.52988029942118 -34.643020042268176,-58.529544066788752 -34.6430101832714,-58.528879732903391 -34.642990700973463,-58.528880446864918 -34.642979626928899,-58.527430940579713 -34.642919064984973,-58.527419060989075 -34.643093231629308,-58.527372839413239 -34.643814475682937,-58.527363746517139 -34.64395631587594,-58.527305865479555 -34.644807781259779,-58.527257335521071 -34.645521702122565,-58.527231132302248 -34.645907079903402,-58.526867250781507 -34.645890581263046,-58.527204775014702 -34.646203863481617,-58.527168471092232 -34.64675157543715,-58.527109846170127 -34.647637900944325,-58.527857817331778 -34.647666025574857,-58.528575365641792 -34.647693035260779,-58.528575360459996 -34.647691386907582,-58.529265692907863 -34.647708692513802)));;3394;9_3_13;COMUNA 9;3;13;946;435;511;85,13%;335;333;99,40%;2;0,60%;313;18;5,75%;295;94,25%
MULTIPOLYGON (((-58.5277135403717 -34.639253447539737,-58.526423405991252 -34.639149336402106,-58.526351992247527 -34.640252507158777,-58.526263396604065 -34.641621610452965,-58.526182966841212 -34.642863662923709,-58.525140788633578 -34.642817438959419,-58.525062547188178 -34.643705534725697,-58.525392418120347 -34.643721070305311,-58.525723737847159 -34.643736674668538,-58.526125190520524 -34.643755622063047,-58.527372839413239 -34.643814475682937,-58.527419060989075 -34.643093231629308,-58.527430940579713 -34.642919064984973,-58.527515187039583 -34.641677995631206,-58.527604486639397 -34.640363822385353,-58.5277135403717 -34.639253447539737)));;3395;9_3_2;COMUNA 9;3;2;676;306;370;82,70%;335;334;99,70%;1;0,30%;255;23;9,02%;232;90,98%
MULTIPOLYGON (((-58.524879526834418 -34.641559364158937,-58.524859839587798 -34.64178297274271,-58.524838039765974 -34.642030456376872,-58.524816493349483 -34.6422751228788,-58.524794862225818 -34.642520634507058,-58.52477010411004 -34.642801007952897,-58.524691943153996 -34.643688047074292,-58.525062547188178 -34.643705534725697,-58.525140788633578 -34.642817438959419,-58.526182966841212 -34.642863662923709,-58.526263396604065 -34.641621610452965,-58.526351992247527 -34.640252507158777,-58.526423405991252 -34.639149336402106,-58.525100643793436 -34.639050158045528,-58.525006523144803 -34.640121507668098,-58.524969090821045 -34.640543441492412,-58.524947544798884 -34.640787615103314,-58.524925914546067 -34.641033267663353,-58.524904199114175 -34.641279131527412,-58.524879526834418 -34.641559364158937)));;3396;9_3_3;COMUNA 9;3;3;601;276;325;84,92%;313;313;100,00%;0;0,00%;239;7;2,93%;232;97,07%
MULTIPOLYGON (((-58.523342467371272 -34.642456926740344,-58.523310971824635 -34.642736176450022,-58.523649189005965 -34.642751219628238,-58.523947099716374 -34.642764451074697,-58.524245095732269 -34.642777681750275,-58.524542495305703 -34.642790841575341,-58.52477010411004 -34.642801007952897,-58.524794862225818 -34.642520634507058,-58.524816493349483 -34.6422751228788,-58.524838039765974 -34.642030456376872,-58.524859839587798 -34.64178297274271,-58.524879526834418 -34.641559364158937,-58.524904199114175 -34.641279131527412,-58.524925914546067 -34.641033267663353,-58.524947544798884 -34.640787615103314,-58.524969090821045 -34.640543441492412,-58.525006523144803 -34.640121507668098,-58.525100643793436 -34.639050158045528,-58.523729898619465 -34.638931904246519,-58.523597630385389 -34.640179474641357,-58.523581890207126 -34.640328290010288,-58.523565043123014 -34.640478303146807,-58.523537444028435 -34.64072374717977,-58.523509759613646 -34.640969261663976,-58.523482160349893 -34.641214916939141,-58.52345058180812 -34.641495927401202,-58.523425352187964 -34.641719749792813,-58.523397667732041 -34.641966109308662,-58.523370067299027 -34.64221106027189,-58.523342467371272 -34.642456926740344)));;3397;9_3_4;COMUNA 9;3;4;641;306;335;91,34%;323;323;100,00%;0;0,00%;242;7;2,89%;235;97,11%
MULTIPOLYGON (((-58.523729898619465 -34.638931904246519,-58.522670956723971 -34.638846440907265,-58.522563514081227 -34.638852831921959,-58.522459731752797 -34.639566919551982,-58.522359660605829 -34.64023036979529,-58.523597630385389 -34.640179474641357,-58.523729898619465 -34.638931904246519)));;3398;9_3_5;COMUNA 9;3;5;546;223;323;69,04%;404;404;100,00%;0;0,00%;271;2;0,74%;269;99,26%
MULTIPOLYGON (((-58.522563514081227 -34.638852831921959,-58.521217113680088 -34.638932361111365,-58.521215649650145 -34.639152932198165,-58.521225613660462 -34.63963047776528,-58.52122940266495 -34.639808439324767,-58.521206927451651 -34.639958173152429,-58.52115977680846 -34.640279684788155,-58.520997375738794 -34.641387121309471,-58.521560209093252 -34.64141206302326,-58.521858114690069 -34.641425299580838,-58.522196496663327 -34.641440276289416,-58.52345058180812 -34.641495927401202,-58.523482160349893 -34.641214916939141,-58.523509759613646 -34.640969261663976,-58.523537444028435 -34.64072374717977,-58.523565043123014 -34.640478303146807,-58.523581890207126 -34.640328290010288,-58.523597630385389 -34.640179474641357,-58.522359660605829 -34.64023036979529,-58.522459731752797 -34.639566919551982,-58.522563514081227 -34.638852831921959)));;3399;9_3_6;COMUNA 9;3;6;749;334;415;80,48%;412;412;100,00%;0;0,00%;298;0;0,00%;298;100,00%
MULTIPOLYGON (((-58.521560209093252 -34.64141206302326,-58.520997375738794 -34.641387121309471,-58.520816227624529 -34.642622175963382,-58.52068765691029 -34.64349902499508,-58.521274110297917 -34.643526703343689,-58.5215722796489 -34.643540785560852,-58.521911096980759 -34.643556819212144,-58.522248721362267 -34.643572711655096,-58.52254731710304 -34.643586791279844,-58.522845657305275 -34.64360087029943,-58.523211744140269 -34.643618154529577,-58.523310971824635 -34.642736176450022,-58.523342467371272 -34.642456926740344,-58.523370067299027 -34.64221106027189,-58.523397667732041 -34.641966109308662,-58.523425352187964 -34.641719749792813,-58.52345058180812 -34.641495927401202,-58.522196496663327 -34.641440276289416,-58.521858114690069 -34.641425299580838,-58.521560209093252 -34.64141206302326)));;3400;9_3_7;COMUNA 9;3;7;819;361;458;78,82%;390;390;100,00%;0;0,00%;316;6;1,90%;310;98,10%
MULTIPOLYGON (((-58.52254731710304 -34.643586791279844,-58.522248721362267 -34.643572711655096,-58.521911096980759 -34.643556819212144,-58.5215722796489 -34.643540785560852,-58.521274110297917 -34.643526703343689,-58.52068765691029 -34.64349902499508,-58.520542629483707 -34.644487363888302,-58.520379957612214 -34.645596489152403,-58.520804000144828 -34.645615654641233,-58.521190802832976 -34.645633216754575,-58.521627969326509 -34.64565307732952,-58.522009233188605 -34.645670357824194,-58.522308262131943 -34.645683944841849,-58.5226063537568 -34.64569746116193,-58.522975943164148 -34.645714180970771,-58.523100406993422 -34.644607958626437,-58.523211744140269 -34.643618154529577,-58.522845657305275 -34.64360087029943,-58.52254731710304 -34.643586791279844)));;3401;9_3_8;COMUNA 9;3;8;778;346;432;80,09%;314;314;100,00%;0;0,00%;279;3;1,08%;276;98,92%
MULTIPOLYGON (((-58.520267407938448 -34.646363960200539,-58.520121013528332 -34.647361594835338,-58.52139009781277 -34.647415006381962,-58.5219631974226 -34.647439096151992,-58.522611205207042 -34.647466385984565,-58.522776786119081 -34.647472924442802,-58.522886276398367 -34.646511151038638,-58.522975943164148 -34.645714180970771,-58.5226063537568 -34.64569746116193,-58.522308262131943 -34.645683944841849,-58.522009233188605 -34.645670357824194,-58.521627969326509 -34.64565307732952,-58.521190802832976 -34.645633216754575,-58.520804000144828 -34.645615654641233,-58.520379957612214 -34.645596489152403,-58.520267407938448 -34.646363960200539)));;3402;9_3_9;COMUNA 9;3;9;697;306;391;78,26%;289;289;100,00%;0;0,00%;257;0;0,00%;257;100,00%
MULTIPOLYGON (((-58.526906416677122 -34.650711269599363,-58.526858315372728 -34.651437302425464,-58.526789826926915 -34.652471664829967,-58.527001517150822 -34.652691137324439,-58.527528576125043 -34.653187281312135,-58.527806510160751 -34.653434746135751,-58.527818830610613 -34.653418651050508,-58.528205095651202 -34.65366977002622,-58.529192148492655 -34.654311461211819,-58.529208605540063 -34.654299014760227,-58.529600599456408 -34.647717086711637,-58.529265692907863 -34.647708692513802,-58.528575360459996 -34.647691386907582,-58.528575365641792 -34.647693035260779,-58.527857817331778 -34.647666025574857,-58.527109846170127 -34.647637900944325,-58.527035299036058 -34.648763960231477,-58.526946682544043 -34.650102920372902,-58.526906416677122 -34.650711269599363)));;3403;9_4_1;COMUNA 9;4;1;926;410;516;79,46%;398;398;100,00%;0;0,00%;361;1;0,28%;360;99,72%
MULTIPOLYGON (((-58.522956169349115 -34.650891178194719,-58.522210078788888 -34.650193847698056,-58.521792396295368 -34.649803405316703,-58.521462806817226 -34.649495315900182,-58.520242344271544 -34.650419235449682,-58.519059843682754 -34.651314462293556,-58.519823552301361 -34.652002366793788,-58.51993389717758 -34.652101825042109,-58.520584460671749 -34.652689493085269,-58.521771137042968 -34.651789812882818,-58.522956169349115 -34.650891178194719)));;3404;9_4_10;COMUNA 9;4;10;771;352;419;84,01%;308;308;100,00%;0;0,00%;290;2;0,69%;288;99,31%
MULTIPOLYGON (((-58.520202714575113 -34.648317500811615,-58.51959557719271 -34.647749951493722,-58.518304394638044 -34.648683040090901,-58.517702700470167 -34.649116002073882,-58.51710083236749 -34.649553186617041,-58.517660369218056 -34.65005372539072,-58.51777352284833 -34.650155719649653,-58.518268946106694 -34.650601987120204,-58.519059843682754 -34.651314462293556,-58.520242344271544 -34.650419235449682,-58.521462806817226 -34.649495315900182,-58.520686810197937 -34.648769961303621,-58.520202714575113 -34.648317500811615)));;3405;9_4_11;COMUNA 9;4;11;933;452;481;93,97%;403;403;100,00%;0;0,00%;341;20;5,87%;321;94,13%
MULTIPOLYGON (((-58.525630675473579 -34.651392659130728,-58.52584490937155 -34.65160269546292,-58.52603952301444 -34.651785839398386,-58.526789826926915 -34.652471664829967,-58.526858315372728 -34.651437302425464,-58.526906416677122 -34.650711269599363,-58.526946682544043 -34.650102920372902,-58.527035299036058 -34.648763960231477,-58.527109846170127 -34.647637900944325,-58.526582593669929 -34.647618036835325,-58.526435249401231 -34.64761255038519,-58.525876722626514 -34.647592699565514,-58.525803947208821 -34.648717137432847,-58.525248394796819 -34.648695944135348,-58.525163499718175 -34.65003546450054,-58.525108166135311 -34.650910237255466,-58.525630675473579 -34.651392659130728)));;3406;9_4_2;COMUNA 9;4;2;923;431;492;87,60%;372;372;100,00%;0;0,00%;325;6;1,85%;319;98,15%
MULTIPOLYGON (((-58.525876722626514 -34.647592699565514,-58.525319474419689 -34.647572915955628,-58.525158069373752 -34.647567223907572,-58.524352916685288 -34.647535308706978,-58.522776786119081 -34.647472924442802,-58.522611205207042 -34.647466385984565,-58.5219631974226 -34.647439096151992,-58.52139009781277 -34.647415006381962,-58.521874111410646 -34.647870279253254,-58.521973626147556 -34.647963402759622,-58.522648832456802 -34.64859668339745,-58.522874557356587 -34.648808480019525,-58.522983369898903 -34.648910964577176,-58.523392187004248 -34.649296266348884,-58.523919032748914 -34.649792708043634,-58.52413598071098 -34.649996619131549,-58.524881491541635 -34.650697248112834,-58.525108166135311 -34.650910237255466,-58.525163499718175 -34.65003546450054,-58.525248394796819 -34.648695944135348,-58.525803947208821 -34.648717137432847,-58.525876722626514 -34.647592699565514)));;3407;9_4_3;COMUNA 9;4;3;910;411;499;82,36%;406;405;99,75%;1;0,25%;342;5;1,46%;337;98,54%
MULTIPOLYGON (((-58.52139009781277 -34.647415006381962,-58.520121013528332 -34.647361594835338,-58.519733305002433 -34.647650377095296,-58.51959557719271 -34.647749951493722,-58.520202714575113 -34.648317500811615,-58.520686810197937 -34.648769961303621,-58.521462806817226 -34.649495315900182,-58.521792396295368 -34.649803405316703,-58.522210078788888 -34.650193847698056,-58.522956169349115 -34.650891178194719,-58.523609446645224 -34.650395909288072,-58.52413598071098 -34.649996619131549,-58.523919032748914 -34.649792708043634,-58.523392187004248 -34.649296266348884,-58.522983369898903 -34.648910964577176,-58.522874557356587 -34.648808480019525,-58.522648832456802 -34.64859668339745,-58.521973626147556 -34.647963402759622,-58.521874111410646 -34.647870279253254,-58.52139009781277 -34.647415006381962)));;3408;9_4_4;COMUNA 9;4;4;931;429;502;85,46%;378;378;100,00%;0;0,00%;329;3;0,91%;326;99,09%
MULTIPOLYGON (((-58.527818830610613 -34.653418651050508,-58.527806510160751 -34.653434746135751,-58.527528576125043 -34.653187281312135,-58.527001517150822 -34.652691137324439,-58.526789826926915 -34.652471664829967,-58.52603952301444 -34.651785839398386,-58.52584490937155 -34.65160269546292,-58.525630675473579 -34.651392659130728,-58.525108166135311 -34.650910237255466,-58.524881491541635 -34.650697248112834,-58.52413598071098 -34.649996619131549,-58.523609446645224 -34.650395909288072,-58.522956169349115 -34.650891178194719,-58.523143184329932 -34.651066020426612,-58.523586025814751 -34.651464896488974,-58.52371479421204 -34.651580751059896,-58.52447709355976 -34.652266796028044,-58.524900589103801 -34.652647859603363,-58.525020918525883 -34.652756181641507,-58.525547269513538 -34.65323268609135,-58.525662056936412 -34.653335446797996,-58.525800041055405 -34.653459041075457,-58.526423111121382 -34.654022888519656,-58.526952287326154 -34.654495230269013,-58.526960817949892 -34.654484639998181,-58.52739636222352 -34.654836753939811,-58.52792861978606 -34.655267049145415,-58.529192148492655 -34.654311461211819,-58.528205095651202 -34.65366977002622,-58.527818830610613 -34.653418651050508)));;3409;9_4_5;COMUNA 9;4;5;992;469;523;89,67%;370;370;100,00%;0;0,00%;355;3;0,85%;352;99,15%
MULTIPOLYGON (((-58.523289141582815 -34.655130363398278,-58.52315243118111 -34.655233814542648,-58.522889827575924 -34.655433316446647,-58.523403225972835 -34.655671801262706,-58.523882440336756 -34.655894525958672,-58.524589629345847 -34.656223192666246,-58.524922466337308 -34.6563780277517,-58.524923921079498 -34.656376924944738,-58.525353259320198 -34.656580052764625,-58.52586946993933 -34.656824278180132,-58.52792861978606 -34.655267049145415,-58.52739636222352 -34.654836753939811,-58.526960817949892 -34.654484639998181,-58.526952287326154 -34.654495230269013,-58.526423111121382 -34.654022888519656,-58.525800041055405 -34.653459041075457,-58.525662056936412 -34.653335446797996,-58.525069838508983 -34.653783440346345,-58.524476506427519 -34.654232276648401,-58.523882401293683 -34.654681603393868,-58.523289141582815 -34.655130363398278)));;3410;9_4_6;COMUNA 9;4;6;626;292;334;87,43%;275;275;100,00%;0;0,00%;251;2;0,80%;249;99,20%
MULTIPOLYGON (((-58.522105376778214 -34.654062534391947,-58.521973351496648 -34.654162531144507,-58.521286563221842 -34.654688160105295,-58.521855622322839 -34.654952470538845,-58.522343353701615 -34.655179140958865,-58.522889827575924 -34.655433316446647,-58.52315243118111 -34.655233814542648,-58.523289141582815 -34.655130363398278,-58.523882401293683 -34.654681603393868,-58.524476506427519 -34.654232276648401,-58.525069838508983 -34.653783440346345,-58.525662056936412 -34.653335446797996,-58.525547269513538 -34.65323268609135,-58.525020918525883 -34.652756181641507,-58.524900589103801 -34.652647859603363,-58.52447709355976 -34.652266796028044,-58.523292568241196 -34.653163754853189,-58.52315705362404 -34.653266430769499,-58.522105376778214 -34.654062534391947)));;3411;9_4_7;COMUNA 9;4;7;680;308;372;82,80%;321;321;100,00%;0;0,00%;271;1;0,37%;270;99,63%
MULTIPOLYGON (((-58.521771137042968 -34.651789812882818,-58.520584460671749 -34.652689493085269,-58.521344273109875 -34.653375769976293,-58.521441659644381 -34.653463753856826,-58.522105376778214 -34.654062534391947,-58.52315705362404 -34.653266430769499,-58.523292568241196 -34.653163754853189,-58.52447709355976 -34.652266796028044,-58.52371479421204 -34.651580751059896,-58.523586025814751 -34.651464896488974,-58.523143184329932 -34.651066020426612,-58.522956169349115 -34.650891178194719,-58.521771137042968 -34.651789812882818)));;3412;9_4_8;COMUNA 9;4;8;735;319;416;76,68%;298;297;99,66%;1;0,34%;270;1;0,37%;269;99,63%
MULTIPOLYGON (((-58.522105376778214 -34.654062534391947,-58.521441659644381 -34.653463753856826,-58.521344273109875 -34.653375769976293,-58.520584460671749 -34.652689493085269,-58.51993389717758 -34.652101825042109,-58.519823552301361 -34.652002366793788,-58.519059843682754 -34.651314462293556,-58.517875017802844 -34.652211368794738,-58.517145881514594 -34.652763332567588,-58.518180543847564 -34.653244359263674,-58.519194200974397 -34.653715461771611,-58.519195099010915 -34.653715879132704,-58.519718194900385 -34.653959023073028,-58.519908985824337 -34.654047668703242,-58.520245385940299 -34.654204134714156,-58.520762946540472 -34.654444600627492,-58.521286563221842 -34.654688160105295,-58.521973351496648 -34.654162531144507,-58.522105376778214 -34.654062534391947)));;3413;9_4_9;COMUNA 9;4;9;707;342;365;93,70%;285;285;100,00%;0;0,00%;256;5;1,95%;251;98,05%
MULTIPOLYGON (((-58.514707630227903 -34.645460233068448,-58.513534693329973 -34.646369769615831,-58.514262752374592 -34.647019976771233,-58.514754563514373 -34.646655320086673,-58.514869039639436 -34.64656893050168,-58.515531548696835 -34.647170846749624,-58.515636339430664 -34.647264747827876,-58.516228054824907 -34.646822645081976,-58.516932180363355 -34.647453550381897,-58.517047081176408 -34.647366806451927,-58.51816114204027 -34.646505926530999,-58.517437847142752 -34.645883135675312,-58.516650019651451 -34.645204733512152,-58.516540713828533 -34.645110553567179,-58.515981573301325 -34.644634235157213,-58.515883266954162 -34.644548500772366,-58.514707630227903 -34.645460233068448)));;3414;9_5_1;COMUNA 9;5;1;879;414;465;89,03%;331;331;100,00%;0;0,00%;310;4;1,29%;306;98,71%
MULTIPOLYGON (((-58.505659821047033 -34.643215306119195,-58.504470706533866 -34.644114831663799,-58.505234142842191 -34.644801631303153,-58.505999808313256 -34.645490326756459,-58.506149299943765 -34.64537477707195,-58.507185174665786 -34.644587337060216,-58.508367875877845 -34.643688280501188,-58.507608941391027 -34.643003681869125,-58.506847461877847 -34.642316896186486,-58.505659821047033 -34.643215306119195)));;3415;9_5_10;COMUNA 9;5;10;847;408;439;92,94%;369;369;100,00%;0;0,00%;319;4;1,25%;315;98,75%
MULTIPOLYGON (((-58.505234142842191 -34.644801631303153,-58.504470706533866 -34.644114831663799,-58.504349323406451 -34.644206636588024,-58.503843599922462 -34.644588791917059,-58.503327309116138 -34.64497890663975,-58.502835730906774 -34.645379786002522,-58.502299513093412 -34.645818143803389,-58.503338870324214 -34.646318873591262,-58.504358117772753 -34.646797065446066,-58.505383428703453 -34.647277993180388,-58.505704222292792 -34.647022168448018,-58.506092817709671 -34.646712232593806,-58.506205342462515 -34.646624936311994,-58.506772306925278 -34.646185141798803,-58.505999808313256 -34.645490326756459,-58.505234142842191 -34.644801631303153)));;3416;9_5_11;COMUNA 9;5;11;900;435;465;93,55%;380;380;100,00%;0;0,00%;317;5;1,58%;312;98,42%
MULTIPOLYGON (((-58.516982439500559 -34.648470741957055,-58.516390122841671 -34.64891742611519,-58.51710083236749 -34.649553186617041,-58.517702700470167 -34.649116002073882,-58.518304394638044 -34.648683040090901,-58.51959557719271 -34.647749951493722,-58.519476794095169 -34.647638876723043,-58.5188154677301 -34.647069447204146,-58.518292449818098 -34.646618968787728,-58.51816114204027 -34.646505926530999,-58.517047081176408 -34.647366806451927,-58.516932180363355 -34.647453550381897,-58.516228054824907 -34.646822645081976,-58.515636339430664 -34.647264747827876,-58.516343277988639 -34.647898120125049,-58.516982439500559 -34.648470741957055)));;3417;9_5_2;COMUNA 9;5;2;832;386;446;86,55%;385;382;99,22%;3;0,79%;322;2;0,62%;320;99,38%
MULTIPOLYGON (((-58.51710083236749 -34.649553186617041,-58.516390122841671 -34.64891742611519,-58.516982439500559 -34.648470741957055,-58.516343277988639 -34.647898120125049,-58.515636339430664 -34.647264747827876,-58.515531548696835 -34.647170846749624,-58.514869039639436 -34.64656893050168,-58.514754563514373 -34.646655320086673,-58.514262752374592 -34.647019976771233,-58.513534693329973 -34.646369769615831,-58.513080333658664 -34.645964030244052,-58.512959773719473 -34.645855344261157,-58.512021821711329 -34.645010419529036,-58.51084664301036 -34.645914438079949,-58.511789022583173 -34.646756059983758,-58.513072473171256 -34.647902402485194,-58.513851530296414 -34.648598155608703,-58.51399366676835 -34.648725071572443,-58.514571426164473 -34.649241673754773,-58.515206918608492 -34.649809869575414,-58.51589494508746 -34.6504250123579,-58.51710083236749 -34.649553186617041)));;3418;9_5_3;COMUNA 9;5;3;1061;468;593;78,92%;316;312;98,73%;4;1,28%;261;0;0,00%;261;100,00%
MULTIPOLYGON (((-58.519059843682754 -34.651314462293556,-58.518268946106694 -34.650601987120204,-58.51777352284833 -34.650155719649653,-58.517660369218056 -34.65005372539072,-58.51710083236749 -34.649553186617041,-58.51589494508746 -34.6504250123579,-58.514689458481882 -34.651296544191673,-58.514415937612888 -34.651494272017516,-58.515416288527874 -34.651942307682305,-58.51607781434106 -34.652266888683727,-58.516556137004052 -34.652489149735338,-58.517145881514594 -34.652763332567588,-58.517875017802844 -34.652211368794738,-58.519059843682754 -34.651314462293556)));;3419;9_5_4;COMUNA 9;5;4;848;377;471;80,04%;377;377;100,00%;0;0,00%;303;2;0,66%;301;99,34%
MULTIPOLYGON (((-58.511872202589082 -34.648792215083695,-58.510675484053579 -34.649679408640033,-58.510612619193658 -34.649725984051919,-58.510652696124751 -34.649767589268031,-58.511678063987667 -34.650221350301408,-58.512646087731419 -34.650671464093911,-58.513517539645591 -34.651076609105516,-58.514415937612888 -34.651494272017516,-58.514689458481882 -34.651296544191673,-58.51589494508746 -34.6504250123579,-58.515206918608492 -34.649809869575414,-58.514571426164473 -34.649241673754773,-58.51399366676835 -34.648725071572443,-58.513851530296414 -34.648598155608703,-58.513072473171256 -34.647902402485194,-58.511872202589082 -34.648792215083695)));;3420;9_5_5;COMUNA 9;5;5;1006;445;561;79,32%;464;464;100,00%;0;0,00%;384;3;0,78%;381;99,22%
MULTIPOLYGON (((-58.510607172779274 -34.647665219666493,-58.509428022997348 -34.648572324420833,-58.508941125372324 -34.648946887538102,-58.509126523655304 -34.649033861975532,-58.510099038022574 -34.649486811363715,-58.510612619193658 -34.649725984051919,-58.510675484053579 -34.649679408640033,-58.511872202589082 -34.648792215083695,-58.513072473171256 -34.647902402485194,-58.511789022583173 -34.646756059983758,-58.51084664301036 -34.645914438079949,-58.509668287151513 -34.646820840846082,-58.510607172779274 -34.647665219666493)));;3421;9_5_6;COMUNA 9;5;6;841;391;450;86,89%;362;362;100,00%;0;0,00%;315;1;0,32%;314;99,68%
MULTIPOLYGON (((-58.507675824408757 -34.648353328720155,-58.508941125372324 -34.648946887538102,-58.509428022997348 -34.648572324420833,-58.510607172779274 -34.647665219666493,-58.509668287151513 -34.646820840846082,-58.508769406376473 -34.646012356160611,-58.507739155638539 -34.64680431454925,-58.507592562673565 -34.64692296377487,-58.507031122778905 -34.647336773333123,-58.506205342462515 -34.646624936311994,-58.506092817709671 -34.646712232593806,-58.505704222292792 -34.647022168448018,-58.505383428703453 -34.647277993180388,-58.506504559121367 -34.647803879237571,-58.506699754751914 -34.647895501891732,-58.507675824408757 -34.648353328720155)));;3422;9_5_7;COMUNA 9;5;7;798;393;405;97,04%;382;382;100,00%;0;0,00%;314;3;0,96%;311;99,04%
MULTIPOLYGON (((-58.509944182915625 -34.645108287362554,-58.509761305818124 -34.644944972753045,-58.509131767624247 -34.644377168348434,-58.508367875877845 -34.643688280501188,-58.507185174665786 -34.644587337060216,-58.506149299943765 -34.64537477707195,-58.505999808313256 -34.645490326756459,-58.506772306925278 -34.646185141798803,-58.506205342462515 -34.646624936311994,-58.507031122778905 -34.647336773333123,-58.507592562673565 -34.64692296377487,-58.507739155638539 -34.64680431454925,-58.508769406376473 -34.646012356160611,-58.509668287151513 -34.646820840846082,-58.51084664301036 -34.645914438079949,-58.509944182915625 -34.645108287362554)));;3423;9_5_8;COMUNA 9;5;8;834;398;436;91,28%;324;324;100,00%;0;0,00%;292;1;0,34%;291;99,66%
MULTIPOLYGON (((-58.508409166203862 -34.641755669479174,-58.508031752343584 -34.641415658821209,-58.506965602736848 -34.642227484367481,-58.506847461877847 -34.642316896186486,-58.507608941391027 -34.643003681869125,-58.508367875877845 -34.643688280501188,-58.509131767624247 -34.644377168348434,-58.509761305818124 -34.644944972753045,-58.509944182915625 -34.645108287362554,-58.51084664301036 -34.645914438079949,-58.512021821711329 -34.645010419529036,-58.511123192656754 -34.644200825057098,-58.510317936971902 -34.643475344971698,-58.509553362047299 -34.642786535140338,-58.508792550934736 -34.642101099397415,-58.508409166203862 -34.641755669479174)));;3424;9_5_9;COMUNA 9;5;9;792;361;431;83,76%;408;408;100,00%;0;0,00%;330;55;16,67%;275;83,33%
MULTIPOLYGON (((-58.506699754751914 -34.647895501891732,-58.506504559121367 -34.647803879237571,-58.505452841826155 -34.64869723732437,-58.506335782259647 -34.649503357368552,-58.507285584704242 -34.650370504646261,-58.508230461670692 -34.651233139057055,-58.508339260190056 -34.651337115570989,-58.509462278530435 -34.650541595909132,-58.510612619193658 -34.649725984051919,-58.510099038022574 -34.649486811363715,-58.509126523655304 -34.649033861975532,-58.508941125372324 -34.648946887538102,-58.507675824408757 -34.648353328720155,-58.506699754751914 -34.647895501891732)));;3425;9_6_1;COMUNA 9;6;1;1111;506;605;83,64%;483;482;99,79%;1;0,21%;408;17;4,17%;391;95,83%
MULTIPOLYGON (((-58.493859704194008 -34.645992076497208,-58.492765679970674 -34.646851954967289,-58.492629883689318 -34.646958470503556,-58.493323589114738 -34.64754437250987,-58.493447873880854 -34.647648851463899,-58.494236381998846 -34.648311980134608,-58.495357678233006 -34.647448700990019,-58.495487423657792 -34.647347818027292,-58.496787842011607 -34.646336162904575,-58.49603681524502 -34.645643954873862,-58.49523354586676 -34.644903656005205,-58.494897822174558 -34.645176147889927,-58.493859704194008 -34.645992076497208)));;3426;9_6_10;COMUNA 9;6;10;899;404;495;81,62%;380;380;100,00%;0;0,00%;345;42;12,17%;303;87,83%
MULTIPOLYGON (((-58.497547235645214 -34.647035969703161,-58.496787842011607 -34.646336162904575,-58.495487423657792 -34.647347818027292,-58.495357678233006 -34.647448700990019,-58.494236381998846 -34.648311980134608,-58.494653401331462 -34.648662727288965,-58.495028736568891 -34.648972708172685,-58.49582365860099 -34.649629204810068,-58.497072913374353 -34.648668196240521,-58.498296753010521 -34.64772676021277,-58.497547235645214 -34.647035969703161)));;3427;9_6_11;COMUNA 9;6;11;823;383;440;87,05%;302;302;100,00%;0;0,00%;309;53;17,15%;256;82,85%
MULTIPOLYGON (((-58.499795910295276 -34.649108397551949,-58.499422927948132 -34.648764697229936,-58.499044236754685 -34.648415645173287,-58.498296753010521 -34.64772676021277,-58.497072913374353 -34.648668196240521,-58.49582365860099 -34.649629204810068,-58.496607766627278 -34.650276755267875,-58.497405953042808 -34.650935916671088,-58.497545328116544 -34.650827422973009,-58.498142527751682 -34.650371251272929,-58.498653422200711 -34.649981089993211,-58.499795910295276 -34.649108397551949)));;3428;9_6_12;COMUNA 9;6;12;830;404;426;94,84%;324;324;100,00%;0;0,00%;286;10;3,50%;276;96,50%
MULTIPOLYGON (((-58.507181337354687 -34.652081297980502,-58.507316455809089 -34.652001316665228,-58.508339260190056 -34.651337115570989,-58.508230461670692 -34.651233139057055,-58.507285584704242 -34.650370504646261,-58.506335782259647 -34.649503357368552,-58.505452841826155 -34.64869723732437,-58.504953752920244 -34.649098550165739,-58.504867887678827 -34.649167596055968,-58.504464199971721 -34.649492392660576,-58.50535150564756 -34.650337885609446,-58.506272081911284 -34.651214980755647,-58.506140302653954 -34.651324326807448,-58.50521008552257 -34.652094677561294,-58.505955291836422 -34.652807394369376,-58.506019529543089 -34.652769201421982,-58.506171007655261 -34.652679215275093,-58.507181337354687 -34.652081297980502)));;3429;9_6_2;COMUNA 9;6;2;834;366;468;78,21%;312;311;99,68%;1;0,32%;259;1;0,39%;258;99,61%
MULTIPOLYGON (((-58.505955291836422 -34.652807394369376,-58.50521008552257 -34.652094677561294,-58.506140302653954 -34.651324326807448,-58.506272081911284 -34.651214980755647,-58.50535150564756 -34.650337885609446,-58.504464199971721 -34.649492392660576,-58.503928301670861 -34.649923714759552,-58.503479457996733 -34.650284792019391,-58.503362327978316 -34.650381101627005,-58.502204131307714 -34.651332426278238,-58.503120423993558 -34.652208771799543,-58.504026248565125 -34.653074972705909,-58.504634348492651 -34.653656542818219,-58.504789460665975 -34.653500005892901,-58.505955291836422 -34.652807394369376)));;3430;9_6_3;COMUNA 9;6;3;929;419;510;82,16%;444;442;99,55%;2;0,45%;373;19;5,09%;354;94,91%
MULTIPOLYGON (((-58.501303131390252 -34.650497337741356,-58.502067545941578 -34.651201832748107,-58.502204131307714 -34.651332426278238,-58.503362327978316 -34.650381101627005,-58.503479457996733 -34.650284792019391,-58.503928301670861 -34.649923714759552,-58.503064217506051 -34.64912616290087,-58.502308935348708 -34.648428924673141,-58.502877375357059 -34.647976682739653,-58.50276764828574 -34.647867771868604,-58.502143663157455 -34.647275562886293,-58.501562958571668 -34.647740411378045,-58.501117182236648 -34.648097183189122,-58.500993405689158 -34.648193703923525,-58.499795910295276 -34.649108397551949,-58.500546999552178 -34.649800581998335,-58.501303131390252 -34.650497337741356)));;3431;9_6_4;COMUNA 9;6;4;905;438;467;93,79%;424;424;100,00%;0;0,00%;341;35;10,26%;306;89,74%
MULTIPOLYGON (((-58.502582786362204 -34.646924071305548,-58.502143663157455 -34.647275562886293,-58.50276764828574 -34.647867771868604,-58.502877375357059 -34.647976682739653,-58.502308935348708 -34.648428924673141,-58.503064217506051 -34.64912616290087,-58.503928301670861 -34.649923714759552,-58.504464199971721 -34.649492392660576,-58.504867887678827 -34.649167596055968,-58.504953752920244 -34.649098550165739,-58.505452841826155 -34.64869723732437,-58.506504559121367 -34.647803879237571,-58.505383428703453 -34.647277993180388,-58.504358117772753 -34.646797065446066,-58.503338870324214 -34.646318873591262,-58.503077274692529 -34.646528262674558,-58.502582786362204 -34.646924071305548)));;3432;9_6_5;COMUNA 9;6;5;1109;523;586;89,25%;444;444;100,00%;0;0,00%;412;7;1,70%;405;98,30%
MULTIPOLYGON (((-58.49990347801392 -34.645151483383593,-58.499294668076168 -34.645646542003917,-58.500054418022692 -34.646347882500578,-58.500804632474896 -34.647040347648257,-58.501562958571668 -34.647740411378045,-58.502143663157455 -34.647275562886293,-58.502582786362204 -34.646924071305548,-58.503077274692529 -34.646528262674558,-58.503338870324214 -34.646318873591262,-58.502299513093412 -34.645818143803389,-58.501275181546241 -34.64535071124557,-58.500248980461656 -34.644869256101849,-58.500026227252846 -34.645051654061469,-58.49990347801392 -34.645151483383593)));;3433;9_6_6;COMUNA 9;6;6;709;325;384;84,64%;288;288;100,00%;0;0,00%;259;2;0,77%;257;99,23%
MULTIPOLYGON (((-58.499044236754685 -34.648415645173287,-58.499422927948132 -34.648764697229936,-58.499795910295276 -34.649108397551949,-58.500993405689158 -34.648193703923525,-58.501117182236648 -34.648097183189122,-58.501562958571668 -34.647740411378045,-58.500804632474896 -34.647040347648257,-58.500054418022692 -34.646347882500578,-58.499294668076168 -34.645646542003917,-58.498730999170697 -34.646104822525686,-58.497547235645214 -34.647035969703161,-58.498296753010521 -34.64772676021277,-58.499044236754685 -34.648415645173287)));;3434;9_6_7;COMUNA 9;6;7;999;456;543;83,98%;450;450;100,00%;0;0,00%;374;41;10,96%;333;89,04%
MULTIPOLYGON (((-58.497205912387507 -34.644696628612685,-58.496251232984257 -34.645474595079925,-58.49603681524502 -34.645643954873862,-58.496787842011607 -34.646336162904575,-58.497547235645214 -34.647035969703161,-58.498730999170697 -34.646104822525686,-58.499294668076168 -34.645646542003917,-58.49990347801392 -34.645151483383593,-58.500026227252846 -34.645051654061469,-58.500248980461656 -34.644869256101849,-58.499663267006007 -34.64459442653208,-58.499221768455293 -34.644387299610379,-58.498186130520487 -34.64390132266734,-58.497137635111649 -34.643409424840989,-58.496676952160541 -34.643769776542833,-58.496419860704663 -34.643970840063474,-58.497205912387507 -34.644696628612685)));;3435;9_6_8;COMUNA 9;6;8;785;382;403;94,79%;351;350;99,72%;1;0,29%;281;17;6,05%;264;93,95%
MULTIPOLYGON (((-58.497205912387507 -34.644696628612685,-58.496419860704663 -34.643970840063474,-58.495398467973146 -34.644769875365199,-58.49530220667296 -34.644847931720662,-58.49523354586676 -34.644903656005205,-58.49603681524502 -34.645643954873862,-58.496251232984257 -34.645474595079925,-58.497205912387507 -34.644696628612685)));;3436;9_6_9;COMUNA 9;6;9;890;445;445;100,00%;452;452;100,00%;0;0,00%;373;2;0,54%;371;99,46%
MULTIPOLYGON (((-58.524922466337308 -34.6563780277517,-58.524589629345847 -34.656223192666246,-58.523882440336756 -34.655894525958672,-58.523403225972835 -34.655671801262706,-58.522889827575924 -34.655433316446647,-58.522343353701615 -34.655179140958865,-58.521855622322839 -34.654952470538845,-58.520116904486308 -34.656233479698145,-58.520509611571953 -34.656582740864735,-58.519928992303882 -34.656992815317807,-58.52029842073734 -34.65732110152436,-58.520103013512319 -34.657470775440864,-58.519514402406038 -34.657921486594176,-58.519883673035451 -34.658264563235036,-58.520401457399863 -34.658547003434769,-58.520571550885407 -34.658638193032381,-58.520750852196308 -34.658733392206628,-58.521245903085692 -34.659160773319819,-58.521259223420927 -34.659150522923035,-58.52154524949659 -34.659383866915348,-58.521997106814268 -34.659752494253084,-58.52586946993933 -34.656824278180132,-58.525353259320198 -34.656580052764625,-58.524923921079498 -34.656376924944738,-58.524922466337308 -34.6563780277517)));;3437;9_7_1;COMUNA 9;7;1;765;352;413;85,23%;312;312;100,00%;0;0,00%;269;2;0,74%;267;99,26%
MULTIPOLYGON (((-58.512832461836403 -34.653782043194063,-58.512142355742476 -34.653117868786374,-58.511507686078474 -34.652506909231789,-58.51038618962518 -34.653293362107526,-58.509410858120312 -34.653977351298252,-58.509274299760783 -34.654075364157158,-58.509377134250734 -34.654173285456608,-58.509910841229541 -34.654688588043307,-58.510602052359026 -34.655356014008248,-58.511715649316358 -34.654570618946813,-58.512715159713053 -34.653865755794669,-58.512832461836403 -34.653782043194063)));;3438;9_7_10;COMUNA 9;7;10;669;307;362;84,81%;270;270;100,00%;0;0,00%;245;35;14,29%;210;85,71%
MULTIPOLYGON (((-58.513863975591136 -34.656648318002006,-58.514788820105935 -34.655919313766034,-58.5149303095289 -34.655807700706305,-58.514305149517249 -34.655205555000549,-58.513524373114166 -34.654453537024267,-58.513407888245524 -34.654340272344278,-58.512936750428054 -34.653882425757821,-58.512832461836403 -34.653782043194063,-58.512715159713053 -34.653865755794669,-58.511715649316358 -34.654570618946813,-58.512333368697114 -34.655168414707035,-58.512198434617076 -34.655272345825132,-58.511270677032314 -34.656001542931968,-58.511395688209319 -34.65612220079889,-58.512062535230328 -34.656767373880875,-58.512803497986205 -34.657484275438769,-58.513863975591136 -34.656648318002006)));;3439;9_7_11;COMUNA 9;7;11;767;362;405;89,38%;324;324;100,00%;0;0,00%;278;9;3,24%;269;96,76%
MULTIPOLYGON (((-58.512333368697114 -34.655168414707035,-58.511715649316358 -34.654570618946813,-58.510602052359026 -34.655356014008248,-58.509502831782392 -34.656131181725897,-58.508731073520934 -34.656675434940887,-58.508777199402978 -34.656708869190808,-58.509237692946122 -34.657042718039619,-58.509456388153417 -34.657201230498941,-58.509617526992017 -34.657308213940794,-58.510497233147618 -34.657892536974124,-58.510713197009899 -34.658035977370766,-58.511404985120357 -34.658465644895649,-58.511700348713411 -34.65825833752119,-58.512803497986205 -34.657484275438769,-58.512062535230328 -34.656767373880875,-58.511395688209319 -34.65612220079889,-58.511270677032314 -34.656001542931968,-58.512198434617076 -34.655272345825132,-58.512333368697114 -34.655168414707035)));;3440;9_7_12;COMUNA 9;7;12;1014;487;527;92,41%;372;371;99,73%;1;0,27%;315;2;0,63%;313;99,37%
MULTIPOLYGON (((-58.509910841229541 -34.654688588043307,-58.509377134250734 -34.654173285456608,-58.509274299760783 -34.654075364157158,-58.508660111579232 -34.653490227878336,-58.507570528061088 -34.654265867750638,-58.507425958630741 -34.654368740781074,-58.506500102387491 -34.655046491061974,-58.507201521096199 -34.655563646542625,-58.507434874582657 -34.655735749263442,-58.507925539111433 -34.656091494096955,-58.50797413684716 -34.656126688351804,-58.508731073520934 -34.656675434940887,-58.509502831782392 -34.656131181725897,-58.510602052359026 -34.655356014008248,-58.509910841229541 -34.654688588043307)));;3441;9_7_13;COMUNA 9;7;13;829;379;450;84,22%;374;374;100,00%;0;0,00%;324;12;3,70%;312;96,30%
MULTIPOLYGON (((-58.506019529543089 -34.652769201421982,-58.505955291836422 -34.652807394369376,-58.504789460665975 -34.653500005892901,-58.504634348492651 -34.653656542818219,-58.50571215707447 -34.654465557365199,-58.506500102387491 -34.655046491061974,-58.507425958630741 -34.654368740781074,-58.507570528061088 -34.654265867750638,-58.508660111579232 -34.653490227878336,-58.507972688064925 -34.652835254438763,-58.507181337354687 -34.652081297980502,-58.506171007655261 -34.652679215275093,-58.506019529543089 -34.652769201421982)));;3442;9_7_14;COMUNA 9;7;14;861;375;486;77,16%;337;335;99,41%;2;0,60%;297;4;1,35%;293;98,65%
MULTIPOLYGON (((-58.520056982184016 -34.660532201161075,-58.520470004970456 -34.660907172303084,-58.521997106814268 -34.659752494253084,-58.52154524949659 -34.659383866915348,-58.521259223420927 -34.659150522923035,-58.521245903085692 -34.659160773319819,-58.520750852196308 -34.658733392206628,-58.520571550885407 -34.658638193032381,-58.520401457399863 -34.658547003434769,-58.519883673035451 -34.658264563235036,-58.519514402406038 -34.657921486594176,-58.520103013512319 -34.657470775440864,-58.52029842073734 -34.65732110152436,-58.519928992303882 -34.656992815317807,-58.520509611571953 -34.656582740864735,-58.520116904486308 -34.656233479698145,-58.518776824802181 -34.657260611869347,-58.518385144917161 -34.656911978510671,-58.517998243778763 -34.65656756717928,-58.517607423183009 -34.656219705560019,-58.517470789939246 -34.656324347503286,-58.516335804008435 -34.65719860967144,-58.516725088896187 -34.65754506750028,-58.517112245095873 -34.657889623551945,-58.51750273028437 -34.658237064263595,-58.51761538237492 -34.65833736856306,-58.517876682887845 -34.658582116751354,-58.518056285247205 -34.65875035000802,-58.518230083730096 -34.658904993701725,-58.51860923605696 -34.659242224409802,-58.518738690938527 -34.659357379524998,-58.519015084329759 -34.659603315508669,-58.519772549244223 -34.660273052709364,-58.519771995276152 -34.660273467195857,-58.520056982184016 -34.660532201161075)));;3443;9_7_2;COMUNA 9;7;2;842;402;440;91,36%;359;359;100,00%;0;0,00%;300;1;0,33%;299;99,67%
MULTIPOLYGON (((-58.517998243778763 -34.65656756717928,-58.518385144917161 -34.656911978510671,-58.518776824802181 -34.657260611869347,-58.520116904486308 -34.656233479698145,-58.521855622322839 -34.654952470538845,-58.521286563221842 -34.654688160105295,-58.520762946540472 -34.654444600627492,-58.520245385940299 -34.654204134714156,-58.520088057568998 -34.654319846047947,-58.518947415922518 -34.655193431201809,-58.517607423183009 -34.656219705560019,-58.517998243778763 -34.65656756717928)));;3444;9_7_3;COMUNA 9;7;3;568;259;309;83,82%;256;256;100,00%;0;0,00%;220;2;0,91%;218;99,09%
MULTIPOLYGON (((-58.518172264233264 -34.654504047875633,-58.51805893459381 -34.654403321785345,-58.516827043084746 -34.655351226434995,-58.516722865719466 -34.655432331332158,-58.515515227339826 -34.656371056640772,-58.515541277592504 -34.656459850740909,-58.515578818388953 -34.656524977195446,-58.515948739552492 -34.656854191921255,-58.516335804008435 -34.65719860967144,-58.517470789939246 -34.656324347503286,-58.517607423183009 -34.656219705560019,-58.518947415922518 -34.655193431201809,-58.520088057568998 -34.654319846047947,-58.520245385940299 -34.654204134714156,-58.519908985824337 -34.654047668703242,-58.519718194900385 -34.653959023073028,-58.519195099010915 -34.653715879132704,-58.518172264233264 -34.654504047875633)));;3445;9_7_4;COMUNA 9;7;4;669;298;371;80,32%;285;285;100,00%;0;0,00%;242;0;0,00%;242;100,00%
MULTIPOLYGON (((-58.516788318412196 -34.653070754284023,-58.516211428045786 -34.653571375657776,-58.515910158818805 -34.653828979850203,-58.515325501888221 -34.654328543995305,-58.515186236433017 -34.65444825541055,-58.514305149517249 -34.655205555000549,-58.5149303095289 -34.655807700706305,-58.515515227339826 -34.656371056640772,-58.516722865719466 -34.655432331332158,-58.516827043084746 -34.655351226434995,-58.51805893459381 -34.654403321785345,-58.518172264233264 -34.654504047875633,-58.519195099010915 -34.653715879132704,-58.519194200974397 -34.653715461771611,-58.518180543847564 -34.653244359263674,-58.517145881514594 -34.652763332567588,-58.516788318412196 -34.653070754284023)));;3446;9_7_5;COMUNA 9;7;5;709;332;377;88,06%;298;298;100,00%;0;0,00%;257;2;0,78%;255;99,22%
MULTIPOLYGON (((-58.51607781434106 -34.652266888683727,-58.515416288527874 -34.651942307682305,-58.513943540740378 -34.652989304477366,-58.512832461836403 -34.653782043194063,-58.512936750428054 -34.653882425757821,-58.513407888245524 -34.654340272344278,-58.513524373114166 -34.654453537024267,-58.514305149517249 -34.655205555000549,-58.515186236433017 -34.65444825541055,-58.515325501888221 -34.654328543995305,-58.515910158818805 -34.653828979850203,-58.516211428045786 -34.653571375657776,-58.516788318412196 -34.653070754284023,-58.517145881514594 -34.652763332567588,-58.516556137004052 -34.652489149735338,-58.51607781434106 -34.652266888683727)));;3447;9_7_6;COMUNA 9;7;6;853;402;451;89,14%;338;338;100,00%;0;0,00%;308;2;0,65%;306;99,35%
MULTIPOLYGON (((-58.514415937612888 -34.651494272017516,-58.513517539645591 -34.651076609105516,-58.512754290878711 -34.651620109986432,-58.512619443477284 -34.65171601318491,-58.511507686078474 -34.652506909231789,-58.512142355742476 -34.653117868786374,-58.512832461836403 -34.653782043194063,-58.513943540740378 -34.652989304477366,-58.515416288527874 -34.651942307682305,-58.514415937612888 -34.651494272017516)));;3448;9_7_7;COMUNA 9;7;7;600;264;336;78,57%;271;271;100,00%;0;0,00%;232;1;0,43%;231;99,57%
MULTIPOLYGON (((-58.509462278530435 -34.650541595909132,-58.508339260190056 -34.651337115570989,-58.509085083067255 -34.65204988352636,-58.510208446167674 -34.6512568218157,-58.51033046385372 -34.651373819957797,-58.510888288940137 -34.651910799870279,-58.511507686078474 -34.652506909231789,-58.512619443477284 -34.65171601318491,-58.512754290878711 -34.651620109986432,-58.513517539645591 -34.651076609105516,-58.512646087731419 -34.650671464093911,-58.511678063987667 -34.650221350301408,-58.510652696124751 -34.649767589268031,-58.510612619193658 -34.649725984051919,-58.509462278530435 -34.650541595909132)));;3449;9_7_8;COMUNA 9;7;8;737;348;389;89,46%;313;313;100,00%;0;0,00%;275;3;1,09%;272;98,91%
MULTIPOLYGON (((-58.507316455809089 -34.652001316665228,-58.507181337354687 -34.652081297980502,-58.507972688064925 -34.652835254438763,-58.508660111579232 -34.653490227878336,-58.509274299760783 -34.654075364157158,-58.509410858120312 -34.653977351298252,-58.51038618962518 -34.653293362107526,-58.511507686078474 -34.652506909231789,-58.510888288940137 -34.651910799870279,-58.51033046385372 -34.651373819957797,-58.510208446167674 -34.6512568218157,-58.509085083067255 -34.65204988352636,-58.508339260190056 -34.651337115570989,-58.507316455809089 -34.652001316665228)));;3450;9_7_9;COMUNA 9;7;9;838;389;449;86,64%;339;339;100,00%;0;0,00%;313;1;0,32%;312;99,68%
MULTIPOLYGON (((-58.514204702142784 -34.65884006850451,-58.515277547001261 -34.658013741897136,-58.516335804008435 -34.65719860967144,-58.515948739552492 -34.656854191921255,-58.515578818388953 -34.656524977195446,-58.515541277592504 -34.656459850740909,-58.515515227339826 -34.656371056640772,-58.5149303095289 -34.655807700706305,-58.514788820105935 -34.655919313766034,-58.513863975591136 -34.656648318002006,-58.512803497986205 -34.657484275438769,-58.511700348713411 -34.65825833752119,-58.511404985120357 -34.658465644895649,-58.512324509959782 -34.659036769321389,-58.512588731817097 -34.659200891531199,-58.51325400528485 -34.659584924220496,-58.513479345389975 -34.659715045548459,-58.514386347766546 -34.659015771301753,-58.514204702142784 -34.65884006850451)));;3451;9_8_1;COMUNA 9;8;1;770;369;401;92,02%;336;335;99,70%;1;0,30%;287;6;2,09%;281;97,91%
MULTIPOLYGON (((-58.506354120975196 -34.660425923521522,-58.505160598995168 -34.661840328567131,-58.505465943437677 -34.662094243063429,-58.506264486480291 -34.662758485997735,-58.507056817474457 -34.663417514472009,-58.50850170901429 -34.662214411442271,-58.509707684376146 -34.661210191839373,-58.508913305340926 -34.660546533110725,-58.508116551394131 -34.659880757277413,-58.507319639696398 -34.659214905792744,-58.506354120975196 -34.660425923521522)));;3452;9_8_10;COMUNA 9;8;10;905;448;457;98,03%;361;360;99,72%;1;0,28%;326;30;9,20%;296;90,80%
MULTIPOLYGON (((-58.50850170901429 -34.662214411442271,-58.507056817474457 -34.663417514472009,-58.5071485690505 -34.663493821209101,-58.507852999056603 -34.664081184310938,-58.508654139266966 -34.664749072472837,-58.508759196637136 -34.664836711304972,-58.50943474311341 -34.6654035120917,-58.510956813336023 -34.664272747119483,-58.51168865322726 -34.663728989488519,-58.512136868545312 -34.663396052843886,-58.512235780295704 -34.663322348675813,-58.511302534934408 -34.662542632096766,-58.510504719589591 -34.661876168282163,-58.509707684376146 -34.661210191839373,-58.50850170901429 -34.662214411442271)));;3453;9_8_11;COMUNA 9;8;11;905;437;468;93,38%;367;367;100,00%;0;0,00%;323;21;6,50%;302;93,50%
MULTIPOLYGON (((-58.510355042889884 -34.666175641814391,-58.511090869793613 -34.666792933050722,-58.511128510380878 -34.666824509681184,-58.511129516626326 -34.666823662769005,-58.511432302371823 -34.66706441920433,-58.511867702642569 -34.667410618701744,-58.514595938737024 -34.665348215047068,-58.514160561585108 -34.664972523918145,-58.513892638228796 -34.664741327807,-58.513914540281021 -34.664724792501971,-58.513133312091654 -34.664072212800399,-58.512235780295704 -34.663322348675813,-58.512136868545312 -34.663396052843886,-58.51168865322726 -34.663728989488519,-58.510956813336023 -34.664272747119483,-58.50943474311341 -34.6654035120917,-58.510355042889884 -34.666175641814391)));;3454;9_8_12;COMUNA 9;8;12;954;463;491;94,30%;401;401;100,00%;0;0,00%;331;2;0,60%;329;99,40%
MULTIPOLYGON (((-58.509964840334462 -34.668177434880064,-58.510384596907599 -34.668531700242575,-58.511867702642569 -34.667410618701744,-58.511432302371823 -34.66706441920433,-58.511129516626326 -34.666823662769005,-58.511128510380878 -34.666824509681184,-58.511090869793613 -34.666792933050722,-58.510355042889884 -34.666175641814391,-58.50943474311341 -34.6654035120917,-58.508759196637136 -34.664836711304972,-58.508654139266966 -34.664749072472837,-58.507852999056603 -34.664081184310938,-58.506425188261225 -34.665265751539458,-58.506533995358332 -34.66535543324715,-58.507230759147504 -34.665930759932472,-58.507941176572487 -34.666517486273996,-58.508880996310445 -34.667293563507158,-58.509667590005485 -34.667943632766459,-58.509678194489531 -34.667935509482248,-58.509964840334462 -34.668177434880064)));;3455;9_8_13;COMUNA 9;8;13;650;315;335;94,03%;232;232;100,00%;0;0,00%;207;1;0,48%;206;99,52%
MULTIPOLYGON (((-58.515341974131445 -34.659892922626121,-58.516417975837705 -34.659068345376369,-58.51750273028437 -34.658237064263595,-58.517112245095873 -34.657889623551945,-58.516725088896187 -34.65754506750028,-58.516335804008435 -34.65719860967144,-58.515277547001261 -34.658013741897136,-58.514204702142784 -34.65884006850451,-58.514386347766546 -34.659015771301753,-58.513479345389975 -34.659715045548459,-58.514201495577076 -34.660131867162001,-58.514392137628555 -34.660241930450645,-58.514534947897886 -34.660322646755127,-58.514914014609623 -34.660536927695588,-58.515516722741033 -34.66087759321681,-58.51562364022741 -34.660938041517866,-58.516004859674183 -34.660645472829906,-58.516080739127048 -34.660550789071351,-58.515723677875052 -34.660232837286649,-58.515533081458948 -34.660063126483479,-58.515341974131445 -34.659892922626121)));;3456;9_8_2;COMUNA 9;8;2;733;353;380;92,89%;375;375;100,00%;0;0,00%;294;4;1,36%;290;98,64%
MULTIPOLYGON (((-58.516080739127048 -34.660550789071351,-58.516004859674183 -34.660645472829906,-58.51562364022741 -34.660938041517866,-58.516576355150754 -34.661476583082901,-58.516695722446656 -34.661543996961946,-58.517475536995832 -34.661984858673677,-58.5174736342599 -34.661986351643037,-58.517864182225438 -34.662221520018171,-58.5183470710747 -34.662512287855357,-58.520470004970456 -34.660907172303084,-58.520056982184016 -34.660532201161075,-58.519771995276152 -34.660273467195857,-58.519772549244223 -34.660273052709364,-58.519015084329759 -34.659603315508669,-58.518738690938527 -34.659357379524998,-58.51860923605696 -34.659242224409802,-58.518230083730096 -34.658904993701725,-58.518056285247205 -34.65875035000802,-58.517876682887845 -34.658582116751354,-58.51761538237492 -34.65833736856306,-58.51750273028437 -34.658237064263595,-58.516417975837705 -34.659068345376369,-58.515341974131445 -34.659892922626121,-58.515533081458948 -34.660063126483479,-58.515723677875052 -34.660232837286649,-58.516080739127048 -34.660550789071351)));;3457;9_8_3;COMUNA 9;8;3;832;369;463;79,70%;354;354;100,00%;0;0,00%;293;3;1,02%;290;98,98%
MULTIPOLYGON (((-58.513229730800518 -34.662138386623681,-58.512508651306334 -34.661537750978525,-58.511302534934408 -34.662542632096766,-58.512235780295704 -34.663322348675813,-58.513133312091654 -34.664072212800399,-58.513914540281021 -34.664724792501971,-58.513892638228796 -34.664741327807,-58.514160561585108 -34.664972523918145,-58.514595938737024 -34.665348215047068,-58.5183470710747 -34.662512287855357,-58.517864182225438 -34.662221520018171,-58.5174736342599 -34.661986351643037,-58.517475536995832 -34.661984858673677,-58.516695722446656 -34.661543996961946,-58.516576355150754 -34.661476583082901,-58.515234603412587 -34.662488112425351,-58.514845787491531 -34.66278124526697,-58.514403212129871 -34.663114893750873,-58.513510797587628 -34.662372290448943,-58.513229730800518 -34.662138386623681)));;3458;9_8_4;COMUNA 9;8;4;703;324;379;85,49%;347;347;100,00%;0;0,00%;286;1;0,35%;285;99,65%
MULTIPOLYGON (((-58.51562364022741 -34.660938041517866,-58.515516722741033 -34.66087759321681,-58.514914014609623 -34.660536927695588,-58.514534947897886 -34.660322646755127,-58.514392137628555 -34.660241930450645,-58.514201495577076 -34.660131867162001,-58.513479345389975 -34.659715045548459,-58.51325400528485 -34.659584924220496,-58.512588731817097 -34.659200891531199,-58.512324509959782 -34.659036769321389,-58.512180371099404 -34.659151126934646,-58.510914908476259 -34.660204903292971,-58.511711176587333 -34.660870801837703,-58.512508651306334 -34.661537750978525,-58.513229730800518 -34.662138386623681,-58.513510797587628 -34.662372290448943,-58.514403212129871 -34.663114893750873,-58.514845787491531 -34.66278124526697,-58.515234603412587 -34.662488112425351,-58.516576355150754 -34.661476583082901,-58.51562364022741 -34.660938041517866)));;3459;9_8_5;COMUNA 9;8;5;909;433;476;90,97%;395;395;100,00%;0;0,00%;329;4;1,22%;325;98,78%
MULTIPOLYGON (((-58.511711176587333 -34.660870801837703,-58.510914908476259 -34.660204903292971,-58.512180371099404 -34.659151126934646,-58.512324509959782 -34.659036769321389,-58.511404985120357 -34.658465644895649,-58.510713197009899 -34.658035977370766,-58.510497233147618 -34.657892536974124,-58.509322751582133 -34.658873442345552,-58.508116551394131 -34.659880757277413,-58.508913305340926 -34.660546533110725,-58.509707684376146 -34.661210191839373,-58.510504719589591 -34.661876168282163,-58.511302534934408 -34.662542632096766,-58.512508651306334 -34.661537750978525,-58.511711176587333 -34.660870801837703)));;3460;9_8_6;COMUNA 9;8;6;994;502;492;102,03%;404;404;100,00%;0;0,00%;353;49;13,88%;304;86,12%
MULTIPOLYGON (((-58.508369289683138 -34.658076315575173,-58.508529780437023 -34.658210815870156,-58.507836536908549 -34.658758177825824,-58.507772496133917 -34.658808741720165,-58.507319639696398 -34.659214905792744,-58.508116551394131 -34.659880757277413,-58.509322751582133 -34.658873442345552,-58.510497233147618 -34.657892536974124,-58.509617526992017 -34.657308213940794,-58.509456388153417 -34.657201230498941,-58.509237692946122 -34.657042718039619,-58.508777199402978 -34.656708869190808,-58.508731073520934 -34.656675434940887,-58.50797413684716 -34.656126688351804,-58.506999071984744 -34.656930872598601,-58.507209334429682 -34.657106646175706,-58.507741730433018 -34.657551745196095,-58.508354036070855 -34.658063565353473,-58.508369289683138 -34.658076315575173)));;3461;9_8_7;COMUNA 9;8;7;1066;510;556;91,73%;359;359;100,00%;0;0,00%;330;7;2,12%;323;97,88%
MULTIPOLYGON (((-58.507925539111433 -34.656091494096955,-58.507434874582657 -34.655735749263442,-58.507201521096199 -34.655563646542625,-58.506500102387491 -34.655046491061974,-58.50571215707447 -34.654465557365199,-58.504634348492651 -34.653656542818219,-58.503930501628794 -34.654366944559925,-58.502837270727881 -34.655470440173254,-58.501758066517937 -34.656559765963365,-58.501953809711651 -34.65669569295946,-58.502487031384007 -34.657149406497261,-58.503213634091225 -34.65776756534477,-58.504405981235927 -34.656780374297533,-58.50453268070504 -34.656886179026891,-58.505064719805731 -34.657330726484382,-58.505784686946789 -34.657932392942911,-58.506999071984744 -34.656930872598601,-58.50797413684716 -34.656126688351804,-58.507925539111433 -34.656091494096955)));;3462;9_8_8;COMUNA 9;8;8;1082;506;576;87,85%;388;387;99,74%;1;0,26%;335;18;5,37%;317;94,63%
MULTIPOLYGON (((-58.501100169345946 -34.6592512495262,-58.50124629141672 -34.659337262212276,-58.501426764979371 -34.659431644336586,-58.501488483225778 -34.659458315619673,-58.501558384751959 -34.659487660396238,-58.501679942222793 -34.659532059481144,-58.50185494669266 -34.659593836154208,-58.50200190684339 -34.659646818550854,-58.502144519419275 -34.659697548591126,-58.502305033178736 -34.659754258736456,-58.502387292997213 -34.659782542653154,-58.502522234279709 -34.659830950737366,-58.502603812378233 -34.659859164305708,-58.502743613618506 -34.659910950931319,-58.50285392360005 -34.659958592064392,-58.502937810623592 -34.66000229804613,-58.503112170219396 -34.660136258270335,-58.503863609177806 -34.660761447148282,-58.504659653882605 -34.66142358885655,-58.505160598995168 -34.661840328567131,-58.506354120975196 -34.660425923521522,-58.507319639696398 -34.659214905792744,-58.507772496133917 -34.658808741720165,-58.507836536908549 -34.658758177825824,-58.508529780437023 -34.658210815870156,-58.508369289683138 -34.658076315575173,-58.508354036070855 -34.658063565353473,-58.507741730433018 -34.657551745196095,-58.507209334429682 -34.657106646175706,-58.506999071984744 -34.656930872598601,-58.505784686946789 -34.657932392942911,-58.505064719805731 -34.657330726484382,-58.50453268070504 -34.656886179026891,-58.504405981235927 -34.656780374297533,-58.503213634091225 -34.65776756534477,-58.502487031384007 -34.657149406497261,-58.501953809711651 -34.65669569295946,-58.501758066517937 -34.656559765963365,-58.500766321016577 -34.657372145351758,-58.499788867895639 -34.658169863917109,-58.500958045366474 -34.659147910970802,-58.501053448305647 -34.659217319600764,-58.501100169345946 -34.6592512495262)));;3463;9_8_9;COMUNA 9;8;9;764;368;396;92,93%;276;276;100,00%;0;0,00%;250;17;6,80%;233;93,20%
MULTIPOLYGON (((-58.498653422200711 -34.649981089993211,-58.498142527751682 -34.650371251272929,-58.497545328116544 -34.650827422973009,-58.497405953042808 -34.650935916671088,-58.497556077948978 -34.651059891645232,-58.498202620158231 -34.651599862091821,-58.498997851301191 -34.652264013932587,-58.500248218052327 -34.651305789902175,-58.501303131390252 -34.650497337741356,-58.500546999552178 -34.649800581998335,-58.499795910295276 -34.649108397551949,-58.498653422200711 -34.649981089993211)));;3464;9_9_1;COMUNA 9;9;1;792;350;442;79,19%;317;317;100,00%;0;0,00%;282;38;13,48%;244;86,52%
MULTIPOLYGON (((-58.491575612323764 -34.652927143821891,-58.492369439658773 -34.653591057391651,-58.493358591347246 -34.652808888173716,-58.494222912410841 -34.652125478502384,-58.494347384423122 -34.652028964517797,-58.49534647257984 -34.651253889293585,-58.49489286498838 -34.650869913896322,-58.494566879139512 -34.650599357609309,-58.494065797548821 -34.650178629820893,-58.493777663756291 -34.649932991977629,-58.493436371864689 -34.650194917342247,-58.492752503720048 -34.650719821860079,-58.49260579510554 -34.650832396511944,-58.491940745728385 -34.651344333674849,-58.491769243830973 -34.651480364656493,-58.490781712425814 -34.652263225025266,-58.491575612323764 -34.652927143821891)));;3465;9_9_10;COMUNA 9;9;10;839;408;431;94,66%;313;313;100,00%;0;0,00%;285;4;1,40%;281;98,60%
MULTIPOLYGON (((-58.493358591347246 -34.652808888173716,-58.492369439658773 -34.653591057391651,-58.493161745136298 -34.654253628030396,-58.49341007844987 -34.654461247896265,-58.49395542681394 -34.654916193092639,-58.494946623901654 -34.654131968324506,-58.495814012523418 -34.653445659302854,-58.495941211060916 -34.653347311931761,-58.496157013368517 -34.653180416995738,-58.496936893470441 -34.652577506619203,-58.496144234349117 -34.651918199961884,-58.495453971364363 -34.651344215277646,-58.49534647257984 -34.651253889293585,-58.494347384423122 -34.652028964517797,-58.494222912410841 -34.652125478502384,-58.493358591347246 -34.652808888173716)));;3466;9_9_11;COMUNA 9;9;11;753;341;412;82,77%;293;293;100,00%;0;0,00%;275;48;17,45%;227;82,55%
MULTIPOLYGON (((-58.491865445522514 -34.656553519189707,-58.492818907710294 -34.655811624485573,-58.492944412344031 -34.655714864938354,-58.493052308527375 -34.655630737895933,-58.49395542681394 -34.654916193092639,-58.49341007844987 -34.654461247896265,-58.493161745136298 -34.654253628030396,-58.492369439658773 -34.653591057391651,-58.491575612323764 -34.652927143821891,-58.491441764176059 -34.653032037704264,-58.490667551324123 -34.653638996230505,-58.490572060845572 -34.653712636358918,-58.490034932595051 -34.654134999368182,-58.489510769233981 -34.654545902467106,-58.489406822054832 -34.654627406543206,-58.489747642146988 -34.654916987798295,-58.490192212490612 -34.655295631850016,-58.490976933753366 -34.65596392260133,-58.49176269062275 -34.656633053073982,-58.491865445522514 -34.656553519189707)));;3467;9_9_12;COMUNA 9;9;12;689;318;371;85,71%;278;278;100,00%;0;0,00%;227;4;1,76%;223;98,24%
MULTIPOLYGON (((-58.490667551324123 -34.653638996230505,-58.491441764176059 -34.653032037704264,-58.491575612323764 -34.652927143821891,-58.490781712425814 -34.652263225025266,-58.490638407630691 -34.652376782443852,-58.489869392335777 -34.652979931847099,-58.489023704177981 -34.652358620035294,-58.488962103993927 -34.652406733338559,-58.488690924826116 -34.652396298171929,-58.487582602101185 -34.652353570348829,-58.487307948144327 -34.652407289651713,-58.487059625894638 -34.652455862080309,-58.487158593291113 -34.65254021097229,-58.486988074201015 -34.65257482354756,-58.486988091107229 -34.652574962012551,-58.487286680979054 -34.652825616216496,-58.487832072980517 -34.65328911030231,-58.488620080541033 -34.653958824265459,-58.489406822054832 -34.654627406543206,-58.489510769233981 -34.654545902467106,-58.490034932595051 -34.654134999368182,-58.490572060845572 -34.653712636358918,-58.490667551324123 -34.653638996230505)));;3468;9_9_13;COMUNA 9;9;13;640;299;341;87,68%;214;214;100,00%;0;0,00%;209;2;0,96%;207;99,04%
MULTIPOLYGON (((-58.489023704177981 -34.652358620035294,-58.489869392335777 -34.652979931847099,-58.490638407630691 -34.652376782443852,-58.490781712425814 -34.652263225025266,-58.489991234974305 -34.65160218762842,-58.489196848884092 -34.650937835923543,-58.488507152334705 -34.65036099469917,-58.488406652145152 -34.650276435920418,-58.487459064782549 -34.651035739281475,-58.487298888264284 -34.651164085398271,-58.486470052358584 -34.65182912879358,-58.486394307560353 -34.651888511502008,-58.487059625894638 -34.652455862080309,-58.487307948144327 -34.652407289651713,-58.487582602101185 -34.652353570348829,-58.488690924826116 -34.652396298171929,-58.488962103993927 -34.652406733338559,-58.489023704177981 -34.652358620035294)));;3469;9_9_14;COMUNA 9;9;14;971;452;519;87,09%;345;344;99,71%;1;0,29%;310;4;1,29%;306;98,71%
MULTIPOLYGON (((-58.498997851301191 -34.652264013932587,-58.498594885788322 -34.652572804350527,-58.497886238558777 -34.653115843869308,-58.497730673364821 -34.653237582397395,-58.49854057884864 -34.653911099294135,-58.499019367043694 -34.654309279192105,-58.499788199968677 -34.654948643975025,-58.500914701008206 -34.654029677639997,-58.50101394868647 -34.653947742678291,-58.50013326013859 -34.653212290309455,-58.501176534170931 -34.652242852366996,-58.501271430716315 -34.652155636698353,-58.502204131307714 -34.651332426278238,-58.502067545941578 -34.651201832748107,-58.501303131390252 -34.650497337741356,-58.500248218052327 -34.651305789902175,-58.498997851301191 -34.652264013932587)));;3470;9_9_2;COMUNA 9;9;2;720;334;386;86,53%;279;279;100,00%;0;0,00%;268;10;3,73%;258;96,27%
MULTIPOLYGON (((-58.502204131307714 -34.651332426278238,-58.501271430716315 -34.652155636698353,-58.501176534170931 -34.652242852366996,-58.50013326013859 -34.653212290309455,-58.50101394868647 -34.653947742678291,-58.501988862672363 -34.654761963392467,-58.502837270727881 -34.655470440173254,-58.503930501628794 -34.654366944559925,-58.504634348492651 -34.653656542818219,-58.504026248565125 -34.653074972705909,-58.503120423993558 -34.652208771799543,-58.502204131307714 -34.651332426278238)));;3471;9_9_3;COMUNA 9;9;3;1033;487;546;89,19%;477;477;100,00%;0;0,00%;396;13;3,28%;383;96,72%
MULTIPOLYGON (((-58.498815656003366 -34.658964192913878,-58.499788867895639 -34.658169863917109,-58.500766321016577 -34.657372145351758,-58.501758066517937 -34.656559765963365,-58.502837270727881 -34.655470440173254,-58.501988862672363 -34.654761963392467,-58.50101394868647 -34.653947742678291,-58.500914701008206 -34.654029677639997,-58.499788199968677 -34.654948643975025,-58.499019367043694 -34.654309279192105,-58.498139461574404 -34.655181042507827,-58.497358954989757 -34.655954458422542,-58.49724768977962 -34.656049070214863,-58.497105413061412 -34.656170029452426,-58.496355982938979 -34.656912936214127,-58.4968618045908 -34.657334779575869,-58.497272655245879 -34.657677420139407,-58.497839956969585 -34.658150511018682,-58.498815656003366 -34.658964192913878)));;3472;9_9_4;COMUNA 9;9;4;628;302;326;92,64%;231;231;100,00%;0;0,00%;211;2;0,95%;209;99,05%
MULTIPOLYGON (((-58.497730673364821 -34.653237582397395,-58.496927281685302 -34.65386599809591,-58.496745558438853 -34.654008165828941,-58.496618875507153 -34.653907916492656,-58.495941211060916 -34.653347311931761,-58.495814012523418 -34.653445659302854,-58.494946623901654 -34.654131968324506,-58.49395542681394 -34.654916193092639,-58.494746819124508 -34.655576359078765,-58.495404716662613 -34.656125073618462,-58.495541719018803 -34.656238490796852,-58.495954348072949 -34.656579867746025,-58.496250778114998 -34.656825145763804,-58.496355982938979 -34.656912936214127,-58.497105413061412 -34.656170029452426,-58.49724768977962 -34.656049070214863,-58.497358954989757 -34.655954458422542,-58.498139461574404 -34.655181042507827,-58.499019367043694 -34.654309279192105,-58.49854057884864 -34.653911099294135,-58.497730673364821 -34.653237582397395)));;3473;9_9_5;COMUNA 9;9;5;713;332;381;87,14%;281;281;100,00%;0;0,00%;261;4;1,53%;257;98,47%
MULTIPOLYGON (((-58.498997851301191 -34.652264013932587,-58.498202620158231 -34.651599862091821,-58.497556077948978 -34.651059891645232,-58.497405953042808 -34.650935916671088,-58.496607766627278 -34.650276755267875,-58.49582365860099 -34.649629204810068,-58.495285577314803 -34.650043024211577,-58.494566879139512 -34.650599357609309,-58.49489286498838 -34.650869913896322,-58.49534647257984 -34.651253889293585,-58.495453971364363 -34.651344215277646,-58.496144234349117 -34.651918199961884,-58.496936893470441 -34.652577506619203,-58.496157013368517 -34.653180416995738,-58.495941211060916 -34.653347311931761,-58.496618875507153 -34.653907916492656,-58.496745558438853 -34.654008165828941,-58.496927281685302 -34.65386599809591,-58.497730673364821 -34.653237582397395,-58.497886238558777 -34.653115843869308,-58.498594885788322 -34.652572804350527,-58.498997851301191 -34.652264013932587)));;3474;9_9_6;COMUNA 9;9;6;881;412;469;87,85%;332;332;100,00%;0;0,00%;304;2;0,66%;302;99,34%
MULTIPOLYGON (((-58.493777663756291 -34.649932991977629,-58.494065797548821 -34.650178629820893,-58.494566879139512 -34.650599357609309,-58.495285577314803 -34.650043024211577,-58.49582365860099 -34.649629204810068,-58.495028736568891 -34.648972708172685,-58.494653401331462 -34.648662727288965,-58.494236381998846 -34.648311980134608,-58.493447873880854 -34.647648851463899,-58.493323589114738 -34.64754437250987,-58.492629883689318 -34.646958470503556,-58.491415454401292 -34.647911608498802,-58.491546302376342 -34.648025665595554,-58.492220148751855 -34.648598761181994,-58.492342899784184 -34.648703241615337,-58.493001753571072 -34.649262392376393,-58.493777663756291 -34.649932991977629)));;3475;9_9_7;COMUNA 9;9;7;964;445;519;85,74%;388;388;100,00%;0;0,00%;359;0;0,00%;359;100,00%
MULTIPOLYGON (((-58.493001753571072 -34.649262392376393,-58.492342899784184 -34.648703241615337,-58.492220148751855 -34.648598761181994,-58.491546302376342 -34.648025665595554,-58.491415454401292 -34.647911608498802,-58.490337055395656 -34.648758010131019,-58.491030156172435 -34.649323361146692,-58.491152222841606 -34.649421434281066,-58.49181234249609 -34.64995164657455,-58.491954955370538 -34.65006816524722,-58.492752503720048 -34.650719821860079,-58.493436371864689 -34.650194917342247,-58.493777663756291 -34.649932991977629,-58.493001753571072 -34.649262392376393)));;3476;9_9_8;COMUNA 9;9;8;589;292;297;98,32%;218;218;100,00%;0;0,00%;205;2;0,98%;203;99,02%
MULTIPOLYGON (((-58.489403724303706 -34.64948563445531,-58.489240484062904 -34.649608279427198,-58.488406652145152 -34.650276435920418,-58.488507152334705 -34.65036099469917,-58.489196848884092 -34.650937835923543,-58.489991234974305 -34.65160218762842,-58.490781712425814 -34.652263225025266,-58.491769243830973 -34.651480364656493,-58.491940745728385 -34.651344333674849,-58.49260579510554 -34.650832396511944,-58.492752503720048 -34.650719821860079,-58.491954955370538 -34.65006816524722,-58.49181234249609 -34.64995164657455,-58.491152222841606 -34.649421434281066,-58.491030156172435 -34.649323361146692,-58.490337055395656 -34.648758010131019,-58.489547283328868 -34.649377853200974,-58.489403724303706 -34.64948563445531)));;3477;9_9_9;COMUNA 9;9;9;809;376;433;86,84%;274;274;100,00%;0;0,00%;256;6;2,34%;250;97,66%
MULTIPOLYGON (((-58.469892971115179 -34.655624655302383,-58.46834558641843 -34.652564717015622,-58.46739843604221 -34.65117908204676,-58.467008823476917 -34.651487908493515,-58.466629263750619 -34.651788775372331,-58.466459597703036 -34.651996815096254,-58.465684362785296 -34.652678124413015,-58.464593198139198 -34.653533734969429,-58.463766456962013 -34.654092846012141,-58.462958666705433 -34.654723270462242,-58.46191385638901 -34.655576041759915,-58.461279266792978 -34.656158676267296,-58.460355391246132 -34.65684135921687,-58.461580336160893 -34.657878519302649,-58.464061252743249 -34.659760401829594,-58.464425103267999 -34.660065405921621,-58.467620690422002 -34.65757132862386,-58.46952387348913 -34.659127931729465,-58.470567648415397 -34.658407994434597,-58.469530436077747 -34.656080707232988,-58.469394038928293 -34.655747747242401,-58.469892971115179 -34.655624655302383)));;3478;9_13_7;COMUNA 9;1;7;1146;575;571;100,70%;397;397;100,00%;0;0,00%;358;24;6,70%;334;93,30%
MULTIPOLYGON (((-58.389092855434832 -34.578551891306859,-58.388896762850273 -34.578378822780998,-58.38810071781365 -34.578358414010282,-58.388198345940083 -34.578459503692038,-58.388050530001024 -34.578554602155187,-58.387906801701718 -34.578654633142314,-58.387585009416995 -34.578841115318951,-58.387376123684241 -34.578964661944823,-58.387043052346414 -34.579141801731694,-58.386441598921365 -34.57944159713302,-58.386207498378624 -34.579601792192065,-58.386107215768071 -34.579672957086601,-58.386207500722392 -34.579749600284799,-58.386297768364081 -34.579714633861009,-58.386364267209828 -34.579781075546684,-58.386084161541042 -34.580043870088168,-58.386201986718731 -34.580200111100552,-58.386725758408041 -34.579959867357367,-58.388006164522608 -34.579274228629224,-58.388422283900788 -34.579014294850722,-58.389092855434832 -34.578551891306859)));;3479;1_2_2;COMUNA 1;2;2;401;188;213;88,26%;124;124;100,00%;0;0,00%;128;25;19,53%;103;80,47%
MULTIPOLYGON (((-58.389092855434832 -34.578551891306859,-58.389484181712866 -34.578225680180864,-58.389200167144878 -34.57818503509781,-58.38892529989554 -34.578186951468737,-58.386835156554824 -34.578040368271729,-58.386734424943889 -34.578059666016202,-58.386628552308444 -34.578099531317299,-58.386519874897282 -34.578133760738424,-58.386408259646899 -34.578231955632567,-58.386181042953893 -34.578210669003631,-58.386065548951798 -34.578212564129743,-58.385949405437209 -34.57821728008448,-58.385729905848045 -34.57820981761526,-58.385616139384958 -34.57822214070211,-58.38572419667959 -34.578711356639026,-58.38586449279633 -34.57928961076653,-58.385954045142221 -34.579361673092578,-58.386031208372358 -34.579462798000833,-58.386112685434945 -34.579484606475916,-58.38623550385924 -34.579579985515736,-58.386441598921365 -34.57944159713302,-58.387043052346414 -34.579141801731694,-58.387376123684241 -34.578964661944823,-58.387585009416995 -34.578841115318951,-58.387906801701718 -34.578654633142314,-58.388050530001024 -34.578554602155187,-58.388198345940083 -34.578459503692038,-58.38810071781365 -34.578358414010282,-58.388896762850273 -34.578378822780998,-58.389092855434832 -34.578551891306859)));;3480;1_2_1;COMUNA 1;2;1;478;232;246;94,31%;149;148;99,33%;1;0,68%;161;43;26,71%;118;73,29%
MULTIPOLYGON (((-58.384929179107488 -34.58002801965857,-58.385077150511208 -34.579944767375466,-58.385792289370407 -34.579588312470712,-58.386031208372358 -34.579462798000833,-58.385954045142221 -34.579361673092578,-58.38586449279633 -34.57928961076653,-58.38572419667959 -34.578711356639026,-58.385616139384958 -34.57822214070211,-58.384712573054102 -34.57816392671235,-58.38445695250757 -34.578142618722381,-58.384266644718601 -34.578140147202539,-58.383917246390155 -34.578164590641876,-58.383735437696437 -34.578185617551988,-58.383553644499599 -34.578190198560364,-58.383371831195703 -34.578215923680041,-58.383215568421086 -34.578255761433304,-58.38301665274534 -34.578343733380677,-58.38285750642455 -34.578428206957817,-58.379838201737435 -34.580162578897813,-58.379847364100179 -34.580328307612284,-58.380104629171868 -34.580639832826456,-58.380591269417778 -34.581229058620522,-58.380584815914816 -34.581297507793209,-58.379100850557762 -34.582133576921166,-58.37917712474453 -34.582238915136678,-58.379253830857593 -34.582338267438175,-58.379496939275327 -34.582590063406165,-58.379588253905624 -34.58255660312696,-58.381097098279973 -34.581904793844004,-58.38227767116841 -34.581356015944785,-58.383360625849967 -34.580683352676715,-58.383487473638681 -34.580804491043999,-58.383522610892854 -34.580782315776453,-58.383850239531746 -34.580613743761901,-58.383867369223928 -34.580593991641194,-58.38412248285907 -34.580448797974853,-58.38414595788521 -34.580427168696708,-58.384929179107488 -34.58002801965857)));;3481;1_2_4;COMUNA 1;2;4;602;297;305;97,38%;120;120;100,00%;0;0,00%;163;23;14,11%;140;85,89%
MULTIPOLYGON (((-58.384824250338127 -34.580863996855697,-58.385135871345099 -34.580718700498004,-58.385453170752037 -34.58055568438413,-58.386201986718731 -34.580200111100552,-58.386084161541042 -34.580043870088168,-58.386364267209828 -34.579781075546684,-58.386297768364081 -34.579714633861009,-58.386207500722392 -34.579749600284799,-58.386107215768071 -34.579672957086601,-58.38623550385924 -34.579579985515736,-58.386112685434945 -34.579484606475916,-58.386031208372358 -34.579462798000833,-58.385792289370407 -34.579588312470712,-58.385077150511208 -34.579944767375466,-58.384929179107488 -34.58002801965857,-58.385039114712477 -34.580091948125258,-58.385138442335659 -34.580189985918764,-58.384579738828336 -34.580518373573888,-58.384663090568047 -34.580594591742724,-58.384824250338127 -34.580863996855697)));;3482;1_2_3;COMUNA 1;2;3;337;170;167;101,80%;104;104;100,00%;0;0,00%;104;25;24,04%;79;75,96%
MULTIPOLYGON (((-58.383564306229673 -34.581528266159296,-58.384824250338134 -34.580863996855619,-58.384663090568047 -34.580594591742724,-58.384579738828336 -34.580518373573888,-58.385138442335659 -34.580189985918764,-58.385039114712477 -34.580091948125258,-58.384929179107488 -34.58002801965857,-58.38414595788521 -34.580427168696708,-58.38412248285907 -34.580448797974853,-58.383867369223928 -34.580593991641194,-58.383850239531746 -34.580613743761901,-58.383522610892854 -34.580782315776453,-58.383487473638681 -34.580804491043999,-58.383622180029207 -34.580891714025924,-58.383718143262882 -34.580990444449945,-58.383476591475549 -34.58110616128522,-58.383680050333695 -34.581268124977264,-58.383564306229673 -34.581528266159296)));;3483;1_2_5;COMUNA 1;2;5;307;174;133;130,83%;82;82;100,00%;0;0,00%;95;16;16,84%;79;83,16%
MULTIPOLYGON (((-58.382669683253198 -34.58179372506121,-58.382797931669664 -34.58187871846205,-58.383564306229673 -34.581528266159296,-58.383680050333695 -34.581268124977264,-58.383476591475549 -34.58110616128522,-58.383718143262882 -34.580990444449945,-58.383622180029207 -34.580891714025924,-58.383487473638681 -34.580804491043999,-58.383360625849967 -34.580683352676772,-58.38227767116841 -34.581356015944785,-58.382464047966828 -34.581590377388949,-58.381463690567166 -34.58208729222239,-58.381638162616184 -34.582234565551914,-58.381706156652172 -34.582305856861439,-58.382087930777743 -34.582105984401309,-58.382669683253198 -34.58179372506121)));;3484;1_2_6;COMUNA 1;2;6;732;366;366;100,00%;180;180;100,00%;0;0,00%;215;57;26,51%;158;73,49%
MULTIPOLYGON (((-58.381706156652172 -34.582305856861439,-58.381638162616184 -34.582234565551914,-58.381463690567166 -34.58208729222239,-58.381350343494958 -34.58214623859196,-58.38061585605719 -34.582474643514772,-58.380486440724255 -34.58252928005188,-58.379943571309994 -34.582730725952771,-58.37964889645248 -34.582831795658727,-58.379977246296711 -34.583156790432099,-58.380090290633483 -34.583286552310717,-58.380110016890129 -34.583447743735022,-58.380219432357229 -34.583403411523477,-58.380303054704072 -34.583299853530278,-58.380404577202043 -34.58319301820039,-58.38048815861891 -34.58313057690637,-58.380516236270708 -34.583087617356078,-58.380617603866824 -34.582982888870248,-58.380873883362511 -34.582799088716406,-58.381185241969142 -34.58258781627034,-58.381671232915352 -34.582313809366589,-58.381706156652172 -34.582305856861439)));;3485;1_2_8;COMUNA 1;2;8;486;266;220;120,91%;135;135;100,00%;0;0,00%;145;55;37,93%;90;62,07%
MULTIPOLYGON (((-58.379496939275327 -34.582590063406165,-58.379253830857593 -34.582338267438175,-58.37917712474453 -34.582238915136713,-58.379051053532521 -34.5822878448853,-58.37887068211694 -34.582395894565984,-58.378884718207537 -34.582447607736626,-58.378495620088181 -34.582648656794397,-58.378681853261355 -34.58285930025572,-58.378351309610053 -34.583047307165998,-58.378471229673622 -34.583174148756441,-58.378554621883083 -34.583300846194973,-58.377882129026467 -34.583650696295003,-58.37775120362393 -34.583736238221384,-58.377978655806331 -34.58391201667532,-58.378111679566494 -34.5839981459538,-58.378274846804686 -34.584076710263304,-58.378499654078027 -34.583749958518865,-58.378711702338784 -34.583487367932456,-58.378772290512501 -34.583430682272045,-58.378926159636578 -34.583284376644947,-58.379041104648934 -34.583179607505507,-58.379298302685541 -34.583003986124659,-58.37960870156887 -34.582820405481819,-58.379382952339768 -34.582618999783257,-58.379496939275327 -34.582590063406165)));;3486;1_2_11;COMUNA 1;2;11;611;308;303;101,65%;172;172;100,00%;0;0,00%;200;53;26,50%;147;73,50%
MULTIPOLYGON (((-58.380584815914816 -34.581297507793209,-58.380591269417778 -34.581229058620522,-58.379847364100179 -34.580328307612284,-58.379838201737435 -34.580162578897813,-58.376161962059733 -34.579948318648306,-58.375126962143703 -34.580535192916891,-58.375832963030412 -34.58144213548961,-58.375927946975359 -34.581573323438718,-58.376380331741061 -34.582124349805063,-58.376502452244758 -34.582296765741411,-58.376624569389953 -34.582472927844861,-58.376710511988811 -34.582589123603846,-58.377290103311786 -34.583291056293547,-58.378495620088181 -34.582648656794397,-58.378884718207537 -34.582447607736626,-58.37887068211694 -34.582395894565984,-58.379051053532521 -34.5822878448853,-58.37917712474453 -34.582238915136678,-58.379100850557762 -34.58213357692113,-58.380584815914816 -34.581297507793209)));;3487;1_2_12;COMUNA 1;2;12;1225;636;589;107,98%;342;341;99,71%;1;0,29%;366;111;30,33%;255;69,67%
MULTIPOLYGON (((-58.37775120362393 -34.583736238221384,-58.377882129026467 -34.583650696295003,-58.378554621883083 -34.583300846194973,-58.378471229673622 -34.583174148756441,-58.378351309610039 -34.58304730716597,-58.378681853261355 -34.58285930025572,-58.378495620088181 -34.582648656794404,-58.377290103311786 -34.583291056293547,-58.377485298857309 -34.583503339371568,-58.37759354892723 -34.583621347647998,-58.37775120362393 -34.583736238221384)));;3488;1_2_13;COMUNA 1;2;13;476;234;242;96,69%;122;122;100,00%;0;0,00%;162;37;22,84%;125;77,16%
MULTIPOLYGON (((-58.37759354892723 -34.583621347647998,-58.377485298857309 -34.583503339371568,-58.377290103311786 -34.583291056293547,-58.37643628980414 -34.583793198745461,-58.375779490532565 -34.584191622656306,-58.376002394483358 -34.584473703790252,-58.376659440264277 -34.584125231649253,-58.37759354892723 -34.583621347647998)));;3489;1_2_14;COMUNA 1;2;14;688;331;357;92,72%;168;168;100,00%;0;0,00%;261;96;36,78%;165;63,22%
MULTIPOLYGON (((-58.377105980113278 -34.5847063772867,-58.377463121547606 -34.584523514503132,-58.377342217871643 -34.584374432829449,-58.377537320107102 -34.584159116838329,-58.377666781240784 -34.583960201551385,-58.377709224182254 -34.583768434328213,-58.377751203623951 -34.583736238221391,-58.37759354892723 -34.583621347647998,-58.376659440264277 -34.584125231649253,-58.376873206626435 -34.584407111318718,-58.377105980113278 -34.5847063772867)));;3490;1_2_15;COMUNA 1;2;15;757;377;380;99,21%;154;154;100,00%;0;0,00%;278;97;34,89%;181;65,11%
MULTIPOLYGON (((-58.377324902054589 -34.585021074485518,-58.377395424503632 -34.585018496888409,-58.377878892781958 -34.584786934850364,-58.37806542466172 -34.584688383916259,-58.378031196307596 -34.584614349852245,-58.377990982186709 -34.584560047709942,-58.377914056580671 -34.584504143910181,-58.378092650857049 -34.584313417146959,-58.378274846804686 -34.584076710263304,-58.378111679566494 -34.5839981459538,-58.377978655806331 -34.58391201667532,-58.37775120362393 -34.583736238221384,-58.377709224182254 -34.583768434328213,-58.377666781240784 -34.583960201551363,-58.377537320107095 -34.584159116838336,-58.377342217871643 -34.584374432829449,-58.377463121547606 -34.584523514503132,-58.377105980113278 -34.5847063772867,-58.377324902054589 -34.585021074485518)));;3491;1_2_17;COMUNA 1;2;17;712;347;365;95,07%;162;162;100,00%;0;0,00%;227;52;22,91%;175;77,09%
MULTIPOLYGON (((-58.378772290512501 -34.583430682272045,-58.378711702338784 -34.583487367932456,-58.378499654078027 -34.583749958518865,-58.378274846804686 -34.584076710263304,-58.378092650857049 -34.584313417146959,-58.377914056580671 -34.584504143910181,-58.377990982186709 -34.584560047709985,-58.378031196307596 -34.584614349852188,-58.37806542466172 -34.584688383916259,-58.378102693484948 -34.584705678830332,-58.378147437082085 -34.584705709836413,-58.378194630044028 -34.584680301473654,-58.378363964091044 -34.584569142925432,-58.378423777518108 -34.584530675745611,-58.378477303562789 -34.584487520731777,-58.378520769620401 -34.584437073364313,-58.378620638977132 -34.584297746453622,-58.378587860721716 -34.584264419220389,-58.37868018321381 -34.584163678482383,-58.37880563057881 -34.583998475040062,-58.378881809227074 -34.583883811365617,-58.378980411167319 -34.583717355790455,-58.379040090221388 -34.58366868216163,-58.378955853763593 -34.583592648155609,-58.378904304409822 -34.583547859648277,-58.378772290512501 -34.583430682272045)));;3492;1_2_18;COMUNA 1;2;18;480;239;241;99,17%;126;126;100,00%;0;0,00%;148;33;22,30%;115;77,70%
MULTIPOLYGON (((-58.379040090221388 -34.58366868216163,-58.379325171782199 -34.583478291705013,-58.379701987394675 -34.58329883586233,-58.379923519506086 -34.58319252567064,-58.379977246296711 -34.583156790432099,-58.37964889645248 -34.582831795658727,-58.37960870156887 -34.582820405481819,-58.379298302685541 -34.583003986124659,-58.379041104648934 -34.583179607505507,-58.378926159636578 -34.583284376644947,-58.378772290512501 -34.583430682272045,-58.378904304409822 -34.583547859648242,-58.378955853763593 -34.583592648155609,-58.379040090221388 -34.58366868216163)));;3493;1_2_10;COMUNA 1;2;10;327;145;182;79,67%;59;59;100,00%;0;0,00%;88;16;18,18%;72;81,82%
MULTIPOLYGON (((-58.38227767116841 -34.581356015944785,-58.381097098279973 -34.581904793844004,-58.379588253905624 -34.58255660312696,-58.379496939275327 -34.582590063406165,-58.379382952339768 -34.582618999783257,-58.37960870156887 -34.582820405481819,-58.37964889645248 -34.582831795658727,-58.379943571309994 -34.582730725952771,-58.380486440724255 -34.58252928005188,-58.38061585605719 -34.582474643514772,-58.381350343494958 -34.58214623859196,-58.381463690567166 -34.58208729222239,-58.382464047966828 -34.581590377388949,-58.38227767116841 -34.581356015944785)));;3494;1_2_7;COMUNA 1;2;7;438;217;221;98,19%;77;77;100,00%;0;0,00%;151;51;33,77%;100;66,23%
MULTIPOLYGON (((-58.379977246296711 -34.583156790432099,-58.379923519506086 -34.58319252567064,-58.379701987394647 -34.58329883586233,-58.379325171782199 -34.583478291705013,-58.379040090221388 -34.58366868216163,-58.378980411167319 -34.583717355790455,-58.378881809227074 -34.583883811365617,-58.37880563057881 -34.583998475040062,-58.37868018321381 -34.584163678482383,-58.378587860721716 -34.584264419220389,-58.378620638977132 -34.584297746453622,-58.378699322264744 -34.584354109777308,-58.378761995594232 -34.584321773378782,-58.378933049340112 -34.584211993305779,-58.378960563471814 -34.584174972728967,-58.37903053819219 -34.584111869213707,-58.379183337083809 -34.583999570678692,-58.379306827332883 -34.583926041701744,-58.379522341580902 -34.583800179871574,-58.379651954270294 -34.583943354780956,-58.379735406245267 -34.584012487848028,-58.379794412284596 -34.584105020733375,-58.379961287240299 -34.584055287944985,-58.380004156511049 -34.583918048856972,-58.380105746857446 -34.583743782194723,-58.380139697499096 -34.583597429166879,-58.380110016890129 -34.583447743735022,-58.380090290633483 -34.583286552310717,-58.379977246296711 -34.583156790432099)));;3495;1_2_9;COMUNA 1;2;9;511;259;252;102,78%;99;99;100,00%;0;0,00%;156;54;34,62%;102;65,38%
MULTIPOLYGON (((-58.379735406245267 -34.584012487848028,-58.379651954270294 -34.583943354780956,-58.379522341580902 -34.583800179871574,-58.379306827332883 -34.583926041701744,-58.379183337083809 -34.583999570678692,-58.37903053819219 -34.584111869213707,-58.378960563471814 -34.584174972728967,-58.378933049340112 -34.584211993305779,-58.378761995594232 -34.584321773378782,-58.378699322264744 -34.584354109777308,-58.378620638977132 -34.584297746453622,-58.378520769620401 -34.584437073364313,-58.378477303562789 -34.584487520731777,-58.378423777518108 -34.584530675745597,-58.378194630044028 -34.584680301473654,-58.378147437082085 -34.584705709836349,-58.378102693484948 -34.584705678830332,-58.37806542466172 -34.584688383916259,-58.377878892781958 -34.584786934850364,-58.377395424503632 -34.585018496888409,-58.377324902054589 -34.585021074485518,-58.377036879687616 -34.585174527699763,-58.377068659241438 -34.585243443300122,-58.377088510154309 -34.585406867782467,-58.377103080469574 -34.585399597119057,-58.37906791208686 -34.584368434580554,-58.379735406245267 -34.584012487848028)));;3496;1_2_19;COMUNA 1;2;19;547;277;270;102,59%;99;99;100,00%;0;0,00%;200;57;28,50%;143;71,50%
MULTIPOLYGON (((-58.376659440264277 -34.584125231649253,-58.376002394483358 -34.584473703790252,-58.375779490532565 -34.584191622656306,-58.375648181119558 -34.58422221290656,-58.375536787014418 -34.584311824619405,-58.376632769274693 -34.585638679410351,-58.376927562809364 -34.585686321586984,-58.37705321764016 -34.585811871026067,-58.37705375669249 -34.585859005335308,-58.377111421365861 -34.585738598184918,-58.377081173857391 -34.585475368858425,-58.377088510154309 -34.585406867782467,-58.377068659241438 -34.585243443300122,-58.377036879687616 -34.585174527699763,-58.377324902054589 -34.585021074485518,-58.377105980113278 -34.5847063772867,-58.376873206626435 -34.584407111318711,-58.376659440264277 -34.584125231649253)));;3497;1_2_16;COMUNA 1;2;16;1128;570;558;102,15%;376;376;100,00%;0;0,00%;444;172;38,74%;272;61,26%
MULTIPOLYGON (((-58.390251708407689 -34.579980820677029,-58.390906770492734 -34.579733450114247,-58.390155464679097 -34.578607258363469,-58.389914910713699 -34.578240132599468,-58.389484181712866 -34.578225680180928,-58.389092855434832 -34.578551891306859,-58.388422283900788 -34.579014294850722,-58.388811713638702 -34.579423885129813,-58.388578917382191 -34.57953098987938,-58.388472066079927 -34.579721400494492,-58.388681301231038 -34.579972314637395,-58.388782759621826 -34.580090433471319,-58.389112147291506 -34.580097443508414,-58.389686915375172 -34.57985848099792,-58.39009763113129 -34.579798489325434,-58.390251708407689 -34.579980820677029)));;3498;1_3_1;COMUNA 1;3;1;594;322;272;118,38%;168;168;100,00%;0;0,00%;191;58;30,37%;133;69,63%
MULTIPOLYGON (((-58.388411422741655 -34.5797435180313,-58.388472066079927 -34.579721400494492,-58.388578917382191 -34.57953098987938,-58.388811713638702 -34.579423885129813,-58.388422283900788 -34.579014294850722,-58.388006164522608 -34.579274228629224,-58.386725758408041 -34.579959867357367,-58.386201986718731 -34.580200111100552,-58.385453170752037 -34.580555684384116,-58.385135871345099 -34.580718700498004,-58.385384559212206 -34.580962389284529,-58.385521371992084 -34.580909117533295,-58.385464576489589 -34.580786703576557,-58.385732148994215 -34.58067626169035,-58.385846989661232 -34.580791336258834,-58.386147973187811 -34.580657428249161,-58.38625034084545 -34.580609645206039,-58.386313466753812 -34.580594670643315,-58.386517003667549 -34.580504054063709,-58.386548250744568 -34.580466026108326,-58.386585545012892 -34.580457169299073,-58.386677813607882 -34.580421849480025,-58.386816896137503 -34.580393399062039,-58.386935078806573 -34.580352828921086,-58.387056408156489 -34.5803010187796,-58.38710241647329 -34.580295858745131,-58.387678210561447 -34.580025200747215,-58.388004508201725 -34.579901615815714,-58.388411422741655 -34.5797435180313)));;3499;1_3_2;COMUNA 1;3;2;564;283;281;100,71%;156;154;98,72%;2;1,30%;161;58;36,02%;103;63,98%
MULTIPOLYGON (((-58.387678210561461 -34.580025200747336,-58.38710241647329 -34.580295858745188,-58.387056408156489 -34.5803010187796,-58.386935078806573 -34.580352828921086,-58.386816896137503 -34.580393399062039,-58.386677813607882 -34.580421849480025,-58.386585545012892 -34.580457169299073,-58.386548250744568 -34.580466026108326,-58.386517004234626 -34.580503432550529,-58.386313466753812 -34.580594670643315,-58.38625034084545 -34.580609645206039,-58.386147973757645 -34.580656806736023,-58.385846989661232 -34.580791336258834,-58.385732148994215 -34.58067626169035,-58.385464576489589 -34.580786703576557,-58.385521371992084 -34.580909117533295,-58.385384559212206 -34.580962389284529,-58.385473632372722 -34.581079492636867,-58.385629071713304 -34.581121485661484,-58.385661961095245 -34.581197903094889,-58.38589482695523 -34.5810044488586,-58.386237851236416 -34.580913939767392,-58.386226425897192 -34.580890664427919,-58.386690743534167 -34.580729584058517,-58.386935965697823 -34.580665997533742,-58.388197094903134 -34.580482571730833,-58.388514262401557 -34.580340828098372,-58.388566694666316 -34.580254254435104,-58.388569705817353 -34.580138782234044,-58.388411422741655 -34.5797435180313,-58.388004508201725 -34.579901615815714,-58.387678210561461 -34.580025200747336)));;3500;1_3_3;COMUNA 1;3;3;659;314;345;91,01%;174;174;100,00%;0;0,00%;200;60;30,00%;140;70,00%
MULTIPOLYGON (((-58.39009763113129 -34.579798489325434,-58.389686915375172 -34.57985848099792,-58.389112147291506 -34.580097443508414,-58.388782759621826 -34.580090433471319,-58.388681301231038 -34.579972314637395,-58.388472066079927 -34.579721400494556,-58.388411422741655 -34.5797435180313,-58.388569705817353 -34.580138782234044,-58.388566694666316 -34.580254254435104,-58.388514262401557 -34.580340828098372,-58.388197094903134 -34.580482571730805,-58.386935965697823 -34.580665997533742,-58.386690743534167 -34.580729584058517,-58.386226425897192 -34.580890664427919,-58.386237851236416 -34.580913939767392,-58.38589482695523 -34.5810044488586,-58.386004723757921 -34.581142585480933,-58.386155220646494 -34.581152779366171,-58.386257783505286 -34.581179342638819,-58.386362224933301 -34.581159952831804,-58.386419244048206 -34.581137890225506,-58.386486919495987 -34.581149718239203,-58.386561696990057 -34.581186595335673,-58.386708609076749 -34.581281680517066,-58.387199047272404 -34.58108152115512,-58.387485603752161 -34.58095413024877,-58.387819490592861 -34.580835458302047,-58.388140236364173 -34.580692261524149,-58.389019209333469 -34.580415830468652,-58.389715173738828 -34.580177929011292,-58.390251708407689 -34.579980820677029,-58.39009763113129 -34.579798489325434)));;3501;1_3_23;COMUNA 1;3;23;837;424;413;102,66%;280;280;100,00%;0;0,00%;267;105;39,33%;162;60,67%
MULTIPOLYGON (((-58.387402245543186 -34.582190179964265,-58.387873479309938 -34.582840496369052,-58.388090662752937 -34.58269034149491,-58.388341671008895 -34.582516755178645,-58.388391938310846 -34.582484671803371,-58.388442713657277 -34.582455757860032,-58.388628005867453 -34.58235410572518,-58.388790380652928 -34.582265538559234,-58.388932649607575 -34.58218836794353,-58.389024485542045 -34.582139921787011,-58.389166412464654 -34.582062306650542,-58.38935783438815 -34.581959882413223,-58.389501634437565 -34.581883345878651,-58.389633296913857 -34.58181229592018,-58.389684478923911 -34.581785126073918,-58.389771768917861 -34.581740755251438,-58.389934308528815 -34.581655707923019,-58.390026226397453 -34.581608014248729,-58.390187401205253 -34.581525148956729,-58.390429418021355 -34.581401132469495,-58.390550128533512 -34.581338666103385,-58.390610271031449 -34.581307221473267,-58.390670328456515 -34.581275635912363,-58.390717267170785 -34.581250662575997,-58.390799133467574 -34.581206554084531,-58.390921635122837 -34.58113993330317,-58.391023949078239 -34.58108477270811,-58.39109448241588 -34.581046721130711,-58.391170213856988 -34.581006975166261,-58.391290751743583 -34.580945916470476,-58.391392967023123 -34.58090294628893,-58.391532307685623 -34.580859222994683,-58.391653517558012 -34.58082890054996,-58.391611097134088 -34.580765739184173,-58.391223489901542 -34.580188611055718,-58.391004015846079 -34.579881157348645,-58.390906770492734 -34.579733450114247,-58.390251708407689 -34.579980820677029,-58.389715173738814 -34.580177929011292,-58.389019209333469 -34.580415830468652,-58.388140236364187 -34.580692261524149,-58.387819490592861 -34.580835458302047,-58.387485603752161 -34.58095413024877,-58.387199047272397 -34.58108152115512,-58.386708609076734 -34.58128168051708,-58.386699747383886 -34.581418139464475,-58.386836863792638 -34.581574176575351,-58.387402245543186 -34.582190179964265)));;3502;1_3_22;COMUNA 1;3;22;670;359;311;115,43%;197;197;100,00%;0;0,00%;205;76;37,07%;129;62,93%
MULTIPOLYGON (((-58.385135871345099 -34.580718700498004,-58.384824250338127 -34.580863996855697,-58.383564306229673 -34.581528266159296,-58.384016416938564 -34.582176346724339,-58.38485730805904 -34.581725815704743,-58.385122497659246 -34.581601749411526,-58.385264708565707 -34.581525115835369,-58.38530690264826 -34.581532347529787,-58.385333478494871 -34.581509524837458,-58.385535625201527 -34.581351135398052,-58.385661961095245 -34.581197903094889,-58.385629071713304 -34.581121485661484,-58.385473632372722 -34.581079492636867,-58.385384559212206 -34.580962389284529,-58.385135871345099 -34.580718700498004)));;3503;1_3_4;COMUNA 1;3;4;428;226;202;111,88%;133;133;100,00%;0;0,00%;132;45;34,09%;87;65,91%
MULTIPOLYGON (((-58.386708609076734 -34.581281680517051,-58.386561696990057 -34.581186595335673,-58.386486919495987 -34.581149718239203,-58.386419244048206 -34.581137890225506,-58.386362224933301 -34.581159952831804,-58.386257783505286 -34.581179342638791,-58.386155220646494 -34.581152779366171,-58.386004723757921 -34.581142585480933,-58.38589482695523 -34.5810044488586,-58.385661961095245 -34.581197903094889,-58.385535625201527 -34.581351135398052,-58.385333478494871 -34.581509524837458,-58.38530690264826 -34.581532347529787,-58.385264708565707 -34.581525115835369,-58.385122497659246 -34.581601749411526,-58.38485730805904 -34.581725815704743,-58.384016416938564 -34.582176346724339,-58.383879590598575 -34.582251917338553,-58.383664357066436 -34.58235467432997,-58.383687011806785 -34.582470006725529,-58.383800680109772 -34.582630113020201,-58.383937086200717 -34.582818474955033,-58.384213973957038 -34.582675376192583,-58.384237851702515 -34.582659355969078,-58.384461909844234 -34.5825559538387,-58.384785540830435 -34.582385114716232,-58.385509725588832 -34.582004010361366,-58.386468143965601 -34.581491384113995,-58.386684512142942 -34.581400929409519,-58.386699747383858 -34.581418139464475,-58.386708609076734 -34.581281680517051)));;3504;1_3_19;COMUNA 1;3;19;1017;536;481;111,43%;311;311;100,00%;0;0,00%;343;88;25,66%;255;74,34%
MULTIPOLYGON (((-58.386684512142942 -34.581400929409533,-58.386468143965601 -34.581491384113995,-58.385509725588832 -34.582004010361366,-58.384785540830435 -34.582385114716232,-58.384461909844234 -34.5825559538387,-58.384237851702515 -34.582659355969078,-58.384275483127418 -34.582662229655938,-58.384376180818791 -34.582755166948395,-58.384610755231947 -34.58295138017062,-58.38580172420653 -34.582251412421165,-58.386714240864755 -34.581627221982281,-58.386836863792638 -34.581574176575351,-58.386699747383858 -34.581418139464475,-58.386684512142942 -34.581400929409533)));;3505;1_3_20;COMUNA 1;3;20;397;203;194;104,64%;109;109;100,00%;0;0,00%;115;33;28,70%;82;71,30%
MULTIPOLYGON (((-58.384275483127418 -34.582662229655938,-58.384237851702515 -34.582659355969092,-58.384213973957046 -34.582675376192583,-58.383937086200717 -34.582818474955019,-58.383631101957121 -34.582970233818529,-58.382962584979147 -34.58327313118231,-58.382951413627687 -34.583283885103725,-58.383193810058678 -34.583553082516652,-58.38356506092623 -34.583391073550807,-58.383748828331541 -34.583344907571281,-58.384432584554986 -34.583011376613641,-58.384610755231961 -34.582951380170641,-58.384376180818805 -34.582755166948417,-58.384275483127418 -34.582662229655938)));;3506;1_3_18;COMUNA 1;3;18;783;411;372;110,48%;175;175;100,00%;0;0,00%;231;79;34,20%;152;65,80%
MULTIPOLYGON (((-58.383687011806785 -34.582470006725529,-58.383549145318447 -34.582553695686414,-58.383341946919678 -34.582648012696573,-58.383072793618894 -34.582758297686489,-58.382873351888144 -34.582836610219864,-58.382553850151581 -34.582969273352489,-58.382428688811906 -34.58304503249115,-58.382457339257826 -34.583083578531841,-58.382438131433922 -34.58310238054402,-58.382095097378709 -34.58324479732704,-58.382147047320544 -34.5833175397267,-58.382249495014257 -34.583308193609298,-58.382480870092593 -34.583371103841316,-58.382541475076287 -34.583474694254221,-58.382951413627687 -34.583283885103725,-58.382962584979147 -34.58327313118231,-58.383631101957121 -34.582970233818529,-58.383937086200717 -34.582818474955019,-58.383800680109772 -34.582630113020201,-58.383687011806785 -34.582470006725529)));;3507;1_3_17;COMUNA 1;3;17;571;277;294;94,22%;187;187;100,00%;0;0,00%;182;53;29,12%;129;70,88%
MULTIPOLYGON (((-58.382347674640037 -34.582941272580641,-58.382486180911719 -34.582889185210234,-58.382553850151581 -34.582969273352489,-58.382873351888144 -34.582836610219864,-58.383072793618894 -34.582758297686489,-58.383341946919678 -34.582648012696573,-58.383549145318447 -34.582553695686414,-58.383687011806785 -34.582470006725529,-58.383664357066436 -34.582354674329949,-58.383879590598575 -34.582251917338596,-58.384016416938579 -34.58217634672436,-58.383564306229687 -34.581528266159296,-58.382797931669678 -34.581878718462058,-58.383001043247383 -34.582096221285148,-58.382412705975767 -34.582414725721499,-58.382014389938469 -34.582629920986982,-58.381973086621095 -34.582733775949841,-58.382109452404848 -34.582959794658848,-58.382347674640037 -34.582941272580641)));;3508;1_3_5;COMUNA 1;3;5;1283;688;595;115,63%;232;232;100,00%;0;0,00%;412;161;39,08%;251;60,92%
MULTIPOLYGON (((-58.382457340123331 -34.583082678040952,-58.382428688811906 -34.583045032491093,-58.382553850151581 -34.582969273352496,-58.382486180911698 -34.582889185210185,-58.382347674640052 -34.582941272580612,-58.382109452404848 -34.582959794658848,-58.381973086621066 -34.582733775949841,-58.382014389938455 -34.582629920986967,-58.381860601746908 -34.582707511926415,-58.381764391514473 -34.582750987741314,-58.381503172607239 -34.582897840748956,-58.381181519604617 -34.583086306107575,-58.381170432673095 -34.583077121670925,-58.381159952858624 -34.58308349489149,-58.381106221742144 -34.583119955980671,-58.381068982539539 -34.583151125609895,-58.380916639308047 -34.583258882839559,-58.380778200147844 -34.583369599836658,-58.38075817030424 -34.583372143595724,-58.380687474891815 -34.5834318394636,-58.380593971586748 -34.583523170493045,-58.380508182728867 -34.583619590892638,-58.380430389325483 -34.583720819376609,-58.380360855571595 -34.58382656173444,-58.380321822072951 -34.583860349430452,-58.380197460766013 -34.584123083911351,-58.380524058322081 -34.583979716018483,-58.381031223933036 -34.583705897366627,-58.381208302617161 -34.583615027339256,-58.381889089935498 -34.583239423944718,-58.38203840965874 -34.583165420729095,-58.382095097378709 -34.58324479732704,-58.382438132299626 -34.583101480053109,-58.382457340123331 -34.583082678040952)));;3509;1_3_7;COMUNA 1;3;7;403;201;202;99,50%;108;108;100,00%;0;0,00%;148;52;35,14%;96;64,86%
MULTIPOLYGON (((-58.382014389938455 -34.582629920986967,-58.382412705975753 -34.582414725721485,-58.383001043247383 -34.582096221285134,-58.382797931669664 -34.58187871846205,-58.382669683253198 -34.58179372506121,-58.382087930777743 -34.582105984401309,-58.381706156652172 -34.582305856861439,-58.381671232915352 -34.582313809366589,-58.381185241969142 -34.582587816270284,-58.380873883362511 -34.582799088716364,-58.380617603866824 -34.582982888870248,-58.380516236270708 -34.583087617356078,-58.38048815861891 -34.58313057690637,-58.380404577202043 -34.58319301820039,-58.380303054704072 -34.583299853530278,-58.380219432357229 -34.583403411523477,-58.380110016890129 -34.583447743735022,-58.380139697499096 -34.583597429166879,-58.380105746857446 -34.583743782194723,-58.380004156511049 -34.583918048856972,-58.379961287240299 -34.584055287944985,-58.380003589529558 -34.584061667274227,-58.380100853692603 -34.583980791303354,-58.380321822072951 -34.583860349430452,-58.380360855571595 -34.58382656173444,-58.380430389325483 -34.583720819376545,-58.380508182728867 -34.583619590892638,-58.380585285348772 -34.58353241752949,-58.380687474891815 -34.5834318394636,-58.38075817030424 -34.583372143595724,-58.380778200147844 -34.583369599836658,-58.380916639308047 -34.583258882839559,-58.381068982539539 -34.583151125609895,-58.381106221742144 -34.583119955980671,-58.381159952858624 -34.58308349489149,-58.381170432673095 -34.583077121670925,-58.381181519604617 -34.583086306107575,-58.381503172607239 -34.582897840748956,-58.381764391514473 -34.582750987741314,-58.381860601746908 -34.582707511926415,-58.382014389938455 -34.582629920986967)));;3510;1_3_6;COMUNA 1;3;6;1027;506;521;97,12%;252;252;100,00%;0;0,00%;341;104;30,50%;237;69,50%
MULTIPOLYGON (((-58.381031223933036 -34.583705897366627,-58.380524058322081 -34.583979716018504,-58.380197460766013 -34.584123083911351,-58.380369323000849 -34.584306373865758,-58.381171428764297 -34.58388485120831,-58.382147047320558 -34.583317539726707,-58.382095097378709 -34.58324479732704,-58.38203840965874 -34.583165420729159,-58.381889089935513 -34.583239423944718,-58.381208302617161 -34.583615027339256,-58.381031223933036 -34.583705897366627)));;3511;1_3_16;COMUNA 1;3;16;726;385;341;112,90%;202;202;100,00%;0;0,00%;254;114;44,88%;140;55,12%
MULTIPOLYGON (((-58.382541475076287 -34.583474694254221,-58.382480870092593 -34.583371103841316,-58.382249495014257 -34.583308193609298,-58.382147047320544 -34.5833175397267,-58.381171428764283 -34.58388485120831,-58.380369323000863 -34.584306373865758,-58.38028628923081 -34.584350086739605,-58.380468481708327 -34.584542159108842,-58.380861378188769 -34.584311328896256,-58.382541475076287 -34.583474694254221)));;3512;1_3_15;COMUNA 1;3;15;843;440;403;109,18%;263;263;100,00%;0;0,00%;310;105;33,87%;205;66,13%
MULTIPOLYGON (((-58.382951413627687 -34.583283885103725,-58.382541475076287 -34.583474694254221,-58.380861378188769 -34.584311328896256,-58.380997769054822 -34.584435428358567,-58.381522085007063 -34.584205854724402,-58.383193810058678 -34.583553082516652,-58.382951413627687 -34.583283885103725)));;3513;1_3_14;COMUNA 1;3;14;471;249;222;112,16%;133;133;100,00%;0;0,00%;147;62;42,18%;85;57,82%
MULTIPOLYGON (((-58.383565060926216 -34.583391073550807,-58.383193810058678 -34.583553082516637,-58.381522085007049 -34.584205854724374,-58.380997769054822 -34.58443542835856,-58.380846432001491 -34.584508510585081,-58.381249553742478 -34.584764229048623,-58.382117549373731 -34.584299184591927,-58.38366907549036 -34.583479639320096,-58.383565060926216 -34.583391073550807)));;3514;1_3_13;COMUNA 1;3;13;381;205;176;116,48%;91;91;100,00%;0;0,00%;118;56;47,46%;62;52,54%
MULTIPOLYGON (((-58.379067912086654 -34.584368434573477,-58.377088510154309 -34.585406867782467,-58.377081173857391 -34.585475368858425,-58.377111421365861 -34.585738598184918,-58.377205325858128 -34.585731491829534,-58.377351122042036 -34.585547513049839,-58.377872553855177 -34.585190177678626,-58.377908204617718 -34.585152369100115,-58.378073191122084 -34.585048183934703,-58.378751442525314 -34.584667830974027,-58.378848342758857 -34.584629768602511,-58.379144689606349 -34.584471999243299,-58.379794412284596 -34.584105020733375,-58.379735406245267 -34.584012487848028,-58.379067912086654 -34.584368434573477)));;3515;1_3_8;COMUNA 1;3;8;797;374;423;88,42%;286;286;100,00%;0;0,00%;257;89;34,63%;168;65,37%
MULTIPOLYGON (((-58.377908204617718 -34.585152369100115,-58.377872553855177 -34.585190177678626,-58.37827130027032 -34.585595802591143,-58.378507696053013 -34.585381279104737,-58.378847204266215 -34.585186592809883,-58.378913155392432 -34.585211693605132,-58.378977825436642 -34.585171649184119,-58.379018187810942 -34.585202857044337,-58.379167734554876 -34.585112759687611,-58.379217296428905 -34.585162234479888,-58.37962291784666 -34.584978102410567,-58.379460502841049 -34.584771328389465,-58.379522416590397 -34.584732662225292,-58.379749019270477 -34.584608271703033,-58.379804883025763 -34.584670527359926,-58.380114624927202 -34.584523787192225,-58.380138131040802 -34.5844381641665,-58.38010859251893 -34.584391246671395,-58.380182590045742 -34.584355613836529,-58.380286289230817 -34.584350086739612,-58.380369323000849 -34.584306373865758,-58.380197460766013 -34.584123083911351,-58.380321822072951 -34.583860349430431,-58.380100853692603 -34.583980791303375,-58.380003589529558 -34.584061667274405,-58.379961287240299 -34.58405528794497,-58.37979441228461 -34.584105020733375,-58.379144689606349 -34.584471999243299,-58.378848342758829 -34.584629768602518,-58.378751442525314 -34.584667830974027,-58.378073191122084 -34.585048183934703,-58.377908204617718 -34.585152369100115)));;3516;1_3_9;COMUNA 1;3;9;1092;528;564;93,62%;372;372;100,00%;0;0,00%;380;136;35,79%;244;64,21%
MULTIPOLYGON (((-58.383682673085254 -34.587496184605435,-58.383837304309303 -34.587416396573175,-58.384317385724039 -34.587081176023503,-58.384507476795299 -34.586956140004965,-58.384711397732815 -34.586452829513647,-58.385058294057323 -34.585879565591512,-58.385325200285919 -34.585383447454454,-58.385599309138534 -34.585014380639109,-58.385975650779066 -34.584588614630285,-58.3864214464393 -34.584098381193009,-58.386642805820586 -34.583857382774831,-58.386733656457622 -34.58377074568871,-58.386963594745779 -34.583551372612952,-58.387413436251755 -34.583188889663433,-58.387822611686609 -34.582876875110472,-58.387873479309938 -34.582840496369059,-58.387402245543186 -34.582190179964307,-58.386836863792638 -34.581574176575351,-58.386714240864755 -34.581627221982281,-58.38580172420653 -34.582251412421165,-58.384610755231947 -34.58295138017062,-58.384432584554986 -34.583011376613641,-58.383748828331527 -34.583344907571266,-58.38356506092623 -34.583391073550743,-58.38366907549036 -34.583479639320096,-58.382117549373731 -34.584299184591927,-58.382217353182121 -34.584439045386716,-58.38190040824319 -34.584756360311765,-58.38144875288824 -34.58498739255176,-58.381562054773198 -34.585152776980749,-58.378103668731953 -34.586856985289366,-58.377882388527546 -34.586490205797354,-58.378643050845859 -34.586109784812514,-58.378560058019325 -34.585984518315911,-58.37886143433915 -34.585782159753713,-58.378747412822413 -34.585643519457726,-58.378554984517869 -34.585774559578134,-58.378360143327484 -34.585876617123674,-58.378291095983151 -34.585840443952939,-58.37830156142109 -34.585778863743428,-58.378354848398459 -34.585725130498645,-58.378474652100948 -34.585659622918655,-58.378559989633899 -34.5856339503,-58.378651893352931 -34.585569918466419,-58.378774246588932 -34.585483731598934,-58.37888007479421 -34.585411141461321,-58.379008089363907 -34.585321314157099,-58.378985234157639 -34.585282594031177,-58.379217296428905 -34.585162234479888,-58.379167734554876 -34.585112759687597,-58.379018187810935 -34.585202857044337,-58.378977825436628 -34.585171649184097,-58.378913155392446 -34.585211693605082,-58.378847204266229 -34.585186592809897,-58.378507696053013 -34.585381279104737,-58.37827130027032 -34.585595802591143,-58.377872553855177 -34.585190177678626,-58.377351122042036 -34.585547513049839,-58.377205325858128 -34.585731491829534,-58.377111421365861 -34.585738598184918,-58.377056040554322 -34.585855283665296,-58.37705375669249 -34.585859005335308,-58.377141384871457 -34.586032236380042,-58.37721474540507 -34.586239760920762,-58.377251348888542 -34.586418666982766,-58.372689323596518 -34.588991405959604,-58.373497681143306 -34.58998309511086,-58.373790906972935 -34.590357690084311,-58.373638208081054 -34.590446741553045,-58.373551693744893 -34.590495846031075,-58.374001304695014 -34.590945612852963,-58.374153045168192 -34.591112180170157,-58.374431443699883 -34.591427915534652,-58.375439895610661 -34.592656224159747,-58.376670017405388 -34.591854601299623,-58.377129421524536 -34.591555264630628,-58.377855380585146 -34.591078992171241,-58.378749204665752 -34.590492615319022,-58.379452358835586 -34.590071092806518,-58.379449709789505 -34.590074839209997,-58.379539349400396 -34.590021377079928,-58.380905417348629 -34.589277834157301,-58.381968399585567 -34.588699223142562,-58.382835661570354 -34.588227098856692,-58.383843385900349 -34.587679172576642,-58.383682673085254 -34.587496184605435)));;3517;1_3_21;COMUNA 1;3;21;300;150;150;100,00%;108;108;100,00%;0;0,00%;109;32;29,36%;77;70,64%
MULTIPOLYGON (((-58.363889167870418 -34.60000183424183,-58.364696003996009 -34.600062508603308,-58.36480828006178 -34.599025587595335,-58.364001635356118 -34.598975358461566,-58.363889167870418 -34.60000183424183)));;3518;1_13_2;COMUNA 1;13;2;128;60;68;88,24%;183;183;100,00%;0;0,00%;60;0;0,00%;60;100,00%
MULTIPOLYGON (((-58.361536078525234 -34.604637143196435,-58.362279818720253 -34.604699731700947,-58.363379292511006 -34.604792184321084,-58.363801017317634 -34.600453797464979,-58.363742151905669 -34.60044980278019,-58.363077158480159 -34.600404673447329,-58.361536078525234 -34.604637143196435)));;3519;1_13_3;COMUNA 1;13;3;45;27;18;150,00%;473;472;99,79%;1;0,21%;20;0;0,00%;20;100,00%
MULTIPOLYGON (((-58.359234923509234 -34.611190100491491,-58.359434273566158 -34.610622916148245,-58.360023134496252 -34.610626857511214,-58.360360774154167 -34.610548271663596,-58.360757405389222 -34.610233125581594,-58.361308002600268 -34.610021243330998,-58.361594369412728 -34.609863741896625,-58.361851501286907 -34.609609145414836,-58.361959116377633 -34.609375695007003,-58.362172042266238 -34.609391152877954,-58.361880782238252 -34.611606133295446,-58.362418137140239 -34.611644605697009,-58.362540956357094 -34.611653368870442,-58.362549556308693 -34.611653980288942,-58.36269265901074 -34.610518093031189,-58.362970821999888 -34.608099369363259,-58.363139016222178 -34.606523443101359,-58.362940129142793 -34.606510410551536,-58.362787247970012 -34.606503947195009,-58.362638296182098 -34.60648804990312,-58.362489274505954 -34.606459475849917,-58.362367094319353 -34.606421486723505,-58.362271574000218 -34.606383448996262,-58.36217607269468 -34.606329706407138,-58.362103583930782 -34.606263306196091,-58.362015783002789 -34.606181047653465,-58.361947142569711 -34.606102044426045,-58.361893779105216 -34.605997700735969,-58.361874714148961 -34.60591556928388,-58.361844328737533 -34.605827090209111,-58.361798519313034 -34.605744866207885,-58.361733719942791 -34.605659527769802,-58.361657317953977 -34.605589954917946,-58.361577153078684 -34.60553305542286,-58.361493140199777 -34.605488758781767,-58.361278960603542 -34.605391887228905,-58.361396052022585 -34.60505971871077,-58.361536078525234 -34.604637143196435,-58.360933544972291 -34.604575313576746,-58.360816207035946 -34.604907540159267,-58.35877725601825 -34.61070934212195,-58.35875219804479 -34.61078995748047,-58.358765619976054 -34.610887507635937,-58.358781455567701 -34.610962101272243,-58.358801756476623 -34.611076207170711,-58.358809777727224 -34.611133047029654,-58.359234923509234 -34.611190100491491)));;3520;1_13_6;COMUNA 1;13;6;192;103;89;115,73%;260;260;100,00%;0;0,00%;100;0;0,00%;100;100,00%
MULTIPOLYGON (((-58.362970821999888 -34.608099369363259,-58.36269265901074 -34.610518093031189,-58.363866623920444 -34.610599941510173,-58.364134582558492 -34.608168206014952,-58.362970821999888 -34.608099369363259)));;3521;1_13_5;COMUNA 1;13;5;295;140;155;90,32%;302;302;100,00%;0;0,00%;154;0;0,00%;154;100,00%
MULTIPOLYGON (((-58.362549556308693 -34.611653980288942,-58.362588056951829 -34.611656717506705,-58.363421984746495 -34.611716344713756,-58.363537758489407 -34.611776300185561,-58.363624585379654 -34.611824259768255,-58.363728293706039 -34.611697335046692,-58.363735545653967 -34.611633920456171,-58.363866623920444 -34.610599941510173,-58.36269265901074 -34.610518093031189,-58.362549556308693 -34.611653980288942)));;3522;1_13_8;COMUNA 1;13;8;308;153;155;98,71%;347;347;100,00%;0;0,00%;156;2;1,28%;154;98,72%
MULTIPOLYGON (((-58.359234923509234 -34.611190100491491,-58.35913106458262 -34.611484529986285,-58.359527549896576 -34.611437821977084,-58.361802423368694 -34.611600504937371,-58.361880782238252 -34.611606133295446,-58.362172042266238 -34.609391152877954,-58.361959116377633 -34.609375695007003,-58.361851501286907 -34.609609145414836,-58.361594369412728 -34.609863741896625,-58.361308002600268 -34.610021243330998,-58.360757405389222 -34.610233125581594,-58.360360774154167 -34.610548271663596,-58.360023134496252 -34.610626857511214,-58.359434273566158 -34.610622916148245,-58.359234923509234 -34.611190100491491)));;3523;1_13_7;COMUNA 1;13;7;505;262;243;107,82%;561;561;100,00%;0;0,00%;241;0;0,00%;241;100,00%
MULTIPOLYGON (((-58.361056500467136 -34.6160739179046,-58.361891409149777 -34.616132852152006,-58.362073774049364 -34.616145749635507,-58.362101670043394 -34.616147717200924,-58.362888071260485 -34.616203181134672,-58.363038473987274 -34.61487713057835,-58.362238669587704 -34.614820697967851,-58.362056137192802 -34.614807800592473,-58.361200203203204 -34.61474737105538,-58.361056500467136 -34.6160739179046)));;3524;1_13_12;COMUNA 1;13;12;292;150;142;105,63%;250;250;100,00%;0;0,00%;138;0;0,00%;138;100,00%
MULTIPOLYGON (((-58.361907446277485 -34.617946520426663,-58.359749520579726 -34.617792107480746,-58.359658859759172 -34.617964957953234,-58.359334472586731 -34.620663020429369,-58.359285873815715 -34.6210702793935,-58.359805144984492 -34.621601772343972,-58.361309785736829 -34.621145511853058,-58.361499775612899 -34.621148908063084,-58.361907446277485 -34.617946520426663)));;3525;1_13_15;COMUNA 1;13;15;0;0;0;;6;6;100,00%;0;0,00%;0;0;;0;
MULTIPOLYGON (((-58.357323174419989 -34.595093242042012,-58.357225380044341 -34.595145388255318,-58.357126593158441 -34.595143401348672,-58.356984257648918 -34.595165250802417,-58.356860693653438 -34.59522613195989,-58.356805839038479 -34.595233549447109,-58.356484434120752 -34.595366092132245,-58.356303651287142 -34.595417767623829,-58.355984638847453 -34.595476364567098,-58.355814983741105 -34.595483540309978,-58.355654355850142 -34.595490794161378,-58.355512692443469 -34.595519051183224,-58.355341937781631 -34.595586438885086,-58.355181233521705 -34.595652778824174,-58.355154302398191 -34.595733884970187,-58.355082878115311 -34.595778049052974,-58.354984521669451 -34.59596987104878,-58.354779086297874 -34.596050819409555,-58.354672025451649 -34.596058119328568,-58.354573916400689 -34.596058032436119,-58.354522421131968 -34.59610129831686,-58.354136310650823 -34.596279060838505,-58.353939787139318 -34.596382129231785,-58.35343076949593 -34.596699081006868,-58.35329678222039 -34.596846501805231,-58.353046571120579 -34.597038115534794,-58.352921408414879 -34.597274138769755,-58.352813998208511 -34.597480740112829,-58.352635257668233 -34.597657628020087,-58.352393962765596 -34.597930519120361,-58.352277908036029 -34.597974711614981,-58.352099321848868 -34.598033495781735,-58.351956407059802 -34.598166258535976,-58.351768727367805 -34.598402223786657,-58.351554173327223 -34.598608585677127,-58.351330914842066 -34.598763387990225,-58.351161150300143 -34.598910844153259,-58.350946777375597 -34.599043469938444,-58.350794995799873 -34.599117066019986,-58.350670005847235 -34.599153924559047,-58.350589584113763 -34.599234980523832,-58.35050025923119 -34.599286590516563,-58.350321450251734 -34.599507772356922,-58.350223152400375 -34.599581557815455,-58.35001762476427 -34.599846941585746,-58.349865685832853 -34.599972228441629,-58.349731696913878 -34.600112321013768,-58.349553034166192 -34.600222863866499,-58.349347648047669 -34.600318662770079,-58.349061736497738 -34.600569321756424,-58.34888308672727 -34.60073141486032,-58.348766945654852 -34.600834620207003,-58.348615083651048 -34.600900959681873,-58.348409700691583 -34.600930275631413,-58.348311494878686 -34.600996594547006,-58.348061446469877 -34.601114392471949,-58.347900654757282 -34.601232344314184,-58.347721987285539 -34.601342814030936,-58.347543516396527 -34.601372224300135,-58.347507769209223 -34.601416487989503,-58.347409538250467 -34.60143843829303,-58.347266525094298 -34.601571124948393,-58.347141478798719 -34.601644882586392,-58.347061010334656 -34.601755444285942,-58.347016282203775 -34.601888294171644,-58.346998178300048 -34.601984196077026,-58.346926819359759 -34.602035679609386,-58.346908800393315 -34.602131652004807,-58.346846121396126 -34.602249695500127,-58.346801440935607 -34.602286485426369,-58.346819285643051 -34.602316080941044,-58.346756701925372 -34.60242665941054,-58.346756445490605 -34.602611173073171,-58.346747358963469 -34.602714478138687,-58.346658051632616 -34.602810312294963,-58.346648951600748 -34.602861995701318,-58.346702472964239 -34.602898878947833,-58.346711303029565 -34.60298008754004,-58.34672005822101 -34.603053901418861,-58.346657517842964 -34.603194058426467,-58.346585720102468 -34.603437520276927,-58.346630144650398 -34.603585173645286,-58.346567474553424 -34.603695751911218,-58.346531479202284 -34.603917134286434,-58.346540288612623 -34.604013132136707,-58.346468657317708 -34.604197507354606,-58.346477497689605 -34.604271250891955,-58.346405791070673 -34.604448301779271,-58.346342934659781 -34.604691771956695,-58.346316172571413 -34.604765551967887,-58.346199968409721 -34.604846641243462,-58.346074813266462 -34.604994062320721,-58.346083601782908 -34.605104708592563,-58.346145920269485 -34.605186038731745,-58.346127840608176 -34.605385254131441,-58.346164265000958 -34.605406698163002,-58.346154340374568 -34.6056214148742,-58.346122956123708 -34.605772094644344,-58.346111916303734 -34.605992373857617,-58.346087103738533 -34.606072493925168,-58.346061764603839 -34.606285505669106,-58.345870308111671 -34.606699703832227,-58.34574630195776 -34.60687571821655,-58.345604285768452 -34.607017770286781,-58.34519786145303 -34.607236472045088,-58.345121344376572 -34.607317739320216,-58.344927207481959 -34.607453613367923,-58.344800637633654 -34.607512859483862,-58.344599688482269 -34.607646754519401,-58.343999888500413 -34.60793928169506,-58.343615784815611 -34.60826814468939,-58.343117119446973 -34.608593936369367,-58.342802735447634 -34.608887229986578,-58.342506813638593 -34.609134694242734,-58.342356066315709 -34.609241028355598,-58.342196182623049 -34.609362565072125,-58.342010250778088 -34.609472526100355,-58.341717776079669 -34.609748091425779,-58.341467262142395 -34.6098686921707,-58.341283745047228 -34.610073798740416,-58.341237315035166 -34.610196080858771,-58.340861167843521 -34.610661426716192,-58.340860815052835 -34.610902913874952,-58.340807667615117 -34.611191251372375,-58.34070145781395 -34.611534326469496,-58.340450501648832 -34.612242480753643,-58.3403672330655 -34.61244874264262,-58.340225820059189 -34.61321137426421,-58.33998021089802 -34.613868685881144,-58.339937271984155 -34.614336335206083,-58.339938658800868 -34.614551555435504,-58.339870074989186 -34.614848468662665,-58.339848339357509 -34.615031340515635,-58.33984301448745 -34.615349937864138,-58.339846924822147 -34.615933624178574,-58.339851774935248 -34.6161107479195,-58.339983472784787 -34.616282787868961,-58.34012254615088 -34.616421453638488,-58.34039942747718 -34.616633217763621,-58.340502030012182 -34.616722478611855,-58.340547526696582 -34.616775342914501,-58.340715757160865 -34.616899036668386,-58.340818564961978 -34.616906604472192,-58.341081433642152 -34.616974404372399,-58.342205886972138 -34.616912630665794,-58.342387580344422 -34.616917669312755,-58.342605371037791 -34.616937532476364,-58.342722279709996 -34.616973000850457,-58.342917325203935 -34.616993474910821,-58.342962648919872 -34.616989998155056,-58.34314887739481 -34.617040464234442,-58.34328942657028 -34.617104899897811,-58.343730672072638 -34.61723575806824,-58.344013587693745 -34.617286105803117,-58.344236584218258 -34.617360198355371,-58.344415123225033 -34.617367766219623,-58.34458605387622 -34.617454413710256,-58.345357634803115 -34.617478750679886,-58.345557604629597 -34.617390982059,-58.345798639155284 -34.617420791762157,-58.345870107727158 -34.617361773666012,-58.34595044832384 -34.617354455956026,-58.346003996672117 -34.617317604499263,-58.346307472453532 -34.617347402485954,-58.34639656192504 -34.617480308969611,-58.346548236911552 -34.617510031967747,-58.346691093814805 -34.617510167899816,-58.347030406912594 -34.61743661428784,-58.347110798542886 -34.617392463595792,-58.34749476484555 -34.61724521603103,-58.347627871356302 -34.617149986226032,-58.34772145557389 -34.617113523895817,-58.347819944674811 -34.617041219793457,-58.347915309728684 -34.617010463414722,-58.348012753105628 -34.617016963734223,-58.348119957000939 -34.616987556399117,-58.34822715076546 -34.616965473159119,-58.348325450431851 -34.616906619641682,-58.348429359798843 -34.616918970964541,-58.348558926874304 -34.6169190218342,-58.348675799593479 -34.616920328351846,-58.348843081778995 -34.616936541487632,-58.34891455777997 -34.616870197408453,-58.349057473973289 -34.61682603330393,-58.349164376182429 -34.616892614032245,-58.349226811861875 -34.616959082888968,-58.349369617676459 -34.616996118330903,-58.349601592787259 -34.617048025552876,-58.349851397301791 -34.617144175720789,-58.349967370324137 -34.617181115213334,-58.350047715749966 -34.617232881373965,-58.350212669120111 -34.61720796228829,-58.350261882612294 -34.617225684328702,-58.35027060822506 -34.617388021966363,-58.350341864731902 -34.617484006446169,-58.3505292200702 -34.617587492312154,-58.350582558117267 -34.617705644041422,-58.350555621057616 -34.617845835421605,-58.350589374752722 -34.617957771740024,-58.350672769032123 -34.618087078187337,-58.350830828904364 -34.618185325227472,-58.350351889148868 -34.618136643982936,-58.350144474993179 -34.618251315928063,-58.350037330037686 -34.618236427779571,-58.349930350128865 -34.618162523558958,-58.349792272008685 -34.618218313273516,-58.349867618574763 -34.618376557480744,-58.349985928091478 -34.618450824347299,-58.350099528215814 -34.618480014768728,-58.350117212761553 -34.618568555281769,-58.34997442451985 -34.618642299219083,-58.349965284982737 -34.618723420340217,-58.350249907692486 -34.618777839835126,-58.350341568446005 -34.618652074868677,-58.350402820769702 -34.618650088944385,-58.350527959278288 -34.618524636347324,-58.350724275674587 -34.61855439519146,-58.350687799370519 -34.618629857275607,-58.350547767263436 -34.618681490973209,-58.35040256238387 -34.618841926327114,-58.350366749607879 -34.618930417541272,-58.35044698200452 -34.619004296761823,-58.350562813550525 -34.619021868683795,-58.350661242006232 -34.619121328750524,-58.350670201396909 -34.619173803578647,-58.350830524083236 -34.619174373254353,-58.351125020491914 -34.619300069824753,-58.351239078147749 -34.619306794037136,-58.351341211593379 -34.619311957909353,-58.351467837560982 -34.619284466846977,-58.351501298532121 -34.619234002651822,-58.351518850209246 -34.619167889605883,-58.351613326823596 -34.619229315819972,-58.351552110970722 -34.619331446685813,-58.351463311578094 -34.619356577884361,-58.351919653977525 -34.619620312082709,-58.352215579357107 -34.619634383748092,-58.352563272618831 -34.619539694876707,-58.352690239742472 -34.619770099066997,-58.352930153871078 -34.619752215968546,-58.353081729594628 -34.61953840122915,-58.353517471852761 -34.619404702866461,-58.354071829635714 -34.619701546011548,-58.354249159634051 -34.619464301233776,-58.355142849674088 -34.619552830966796,-58.355247522056644 -34.619335210213237,-58.355392105670219 -34.619034609355765,-58.355394019676616 -34.619034932955635,-58.3555371757176 -34.618726894590488,-58.355797665725369 -34.61814305742233,-58.356002638823419 -34.617639336988944,-58.356233716732831 -34.617894613155713,-58.356235282808285 -34.617892615921761,-58.356339311263469 -34.618013837638223,-58.356386472094968 -34.618039372590914,-58.356454914883926 -34.618076475759224,-58.35669906931534 -34.61833711973653,-58.357256291650209 -34.618931919029777,-58.357680806831681 -34.619385047367686,-58.357789447201874 -34.619500074394658,-58.358764756868602 -34.620532634959993,-58.358885311022654 -34.620660277209339,-58.359285873815715 -34.6210702793935,-58.359334472586731 -34.620663020429369,-58.359658859759172 -34.617964957953234,-58.359749520579726 -34.617792107480746,-58.361907446277485 -34.617946520426663,-58.361499775612899 -34.621148908063084,-58.361309785736829 -34.621145511853058,-58.359805144984492 -34.621601772343972,-58.360343538486916 -34.622152828176183,-58.361446192673817 -34.62332139381023,-58.361770687397225 -34.623674702877018,-58.361897116709493 -34.62381248814232,-58.361947229277739 -34.623866968007469,-58.362206646785374 -34.624144656181755,-58.362999010546346 -34.625012237068148,-58.363090985265295 -34.625112456427765,-58.363455008161345 -34.625121344980698,-58.363521019255813 -34.624990056215317,-58.363737704916474 -34.62488635545953,-58.364152918278322 -34.624687529957832,-58.364697994859874 -34.624390142128803,-58.36506831061785 -34.624188037865217,-58.365478775868326 -34.623964062324106,-58.365785868549402 -34.623987335640955,-58.365839848927862 -34.623794766349114,-58.365856432186909 -34.623599984170369,-58.365936238644849 -34.622662057825124,-58.366067066362 -34.621508812211438,-58.36619031667081 -34.620422182258025,-58.366323891054606 -34.619244923194529,-58.366451437996659 -34.61812012561726,-58.365742664940477 -34.618063506066115,-58.364933509199183 -34.61796306807134,-58.364102081878897 -34.617896340282364,-58.3638980784838 -34.617880893008163,-58.363144416442552 -34.617823869873817,-58.362879529534283 -34.617574560218493,-58.361943784584312 -34.61750055218689,-58.361932945956958 -34.61749969491747,-58.361737973659778 -34.617484251490588,-58.360906804628698 -34.617418461088441,-58.360899056933853 -34.617417847799835,-58.36024225137146 -34.617365887697986,-58.359839538839964 -34.617328012289668,-58.358077164754057 -34.617162282511138,-58.357815040601821 -34.61713283924675,-58.357670111305957 -34.617119250453463,-58.356721164621227 -34.616902625241565,-58.356844868368398 -34.61635647300006,-58.358431956955648 -34.611853736496194,-58.358474709710812 -34.611791798976107,-58.358517798284097 -34.611733735105339,-58.358570086332065 -34.61167560864579,-58.358624517781237 -34.611606286407131,-58.358679027292503 -34.611542598214704,-58.358731246258358 -34.611471372563692,-58.358776674095971 -34.61138140803817,-58.358806265435106 -34.611285796004481,-58.358817545204396 -34.611188478170106,-58.358809777727224 -34.611133047029654,-58.358801756476623 -34.611076207170711,-58.358781455567701 -34.610962101272243,-58.358765619976054 -34.610887507635937,-58.35875219804479 -34.61078995748047,-58.35877725601825 -34.61070934212195,-58.360816207035946 -34.604907540159267,-58.360933544972291 -34.604575313576746,-58.362920118973406 -34.598957154286424,-58.362953882568355 -34.598860679664675,-58.363006432498921 -34.598710525320811,-58.363178630754426 -34.598218464054099,-58.363233665172878 -34.598061390262586,-58.363499349393017 -34.59730242261746,-58.363533560683656 -34.597180333075912,-58.363439820690566 -34.597157579936649,-58.363450930119512 -34.59712568634324,-58.363281413407599 -34.597085898945572,-58.359252361857024 -34.595240320045896,-58.358515789601732 -34.595181677815603,-58.357688512992546 -34.595143149208837,-58.3573908052525 -34.595101373578743,-58.357323174419989 -34.595093242042012)));;3526;1_13_14;COMUNA 1;13;14;1960;1008;952;105,88%;855;855;100,00%;0;0,00%;659;177;26,86%;482;73,14%
MULTIPOLYGON (((-58.487205536378667 -34.573646291956138,-58.488322013178241 -34.574258976131318,-58.48895522212176 -34.573471131964133,-58.488062197113969 -34.572980243471804,-58.487205536378667 -34.573646291956138)));;3527;12_16_14;COMUNA 12;16;14;353;152;201;75,62%;199;199;100,00%;0;0,00%;175;1;0,57%;174;99,43%
MULTIPOLYGON (((-58.475513244709198 -34.578692103732521,-58.475652632427852 -34.57869799623699,-58.476568899875268 -34.578730784263044,-58.476271282489627 -34.579069564270853,-58.475499303656186 -34.579940458625792,-58.477222709705174 -34.57953299524484,-58.478988076277027 -34.579124938508393,-58.478655284303947 -34.578928354532991,-58.478198679084123 -34.57866882504824,-58.477773158274999 -34.578426966805743,-58.477333248821083 -34.578176939439217,-58.477150337217324 -34.578073154062281,-58.475619763490506 -34.577204694763772,-58.475513244709198 -34.578692103732521)));;3528;15_3_1;COMUNA 15;3;1;722;335;387;86,56%;356;356;100,00%;0;0,00%;289;0;0,00%;289;100,00%
MULTIPOLYGON (((-58.46322476301517 -34.541532631889183,-58.464398616739118 -34.543900172076469,-58.46438765212865 -34.543911513412951,-58.464388148005739 -34.543911764987406,-58.464656076119681 -34.544753161159193,-58.464670395312318 -34.544712714280628,-58.464863161267168 -34.544227688002231,-58.464887926984417 -34.544162402769956,-58.465034222631189 -34.543776114093355,-58.465141198994623 -34.543497859323118,-58.465170985515847 -34.543422784726559,-58.465319406709021 -34.54304903142755,-58.465487995848179 -34.542622458042885,-58.465524164423186 -34.542531044394906,-58.465658540613113 -34.542191095386883,-58.465811723360041 -34.541812411485147,-58.465844481501684 -34.541733149813936,-58.465849678501264 -34.541720575127641,-58.465633498125598 -34.54161142035241,-58.464692439186798 -34.541136346124397,-58.463824073494038 -34.540697955864474,-58.463364436037374 -34.541368346926902,-58.463363769278338 -34.541369319400097,-58.46322476301517 -34.541532631889183)));;3529;13_2_5;COMUNA 13;2;5;786;394;392;100,51%;483;482;99,79%;1;0,21%;330;4;1,21%;326;98,79%
MULTIPOLYGON (((-58.46438765212865 -34.543911513412951,-58.464398616739118 -34.543900172076469,-58.46322476301517 -34.541532631889183,-58.463182070838769 -34.541582788933177,-58.463180970213941 -34.541584155067412,-58.462602008424611 -34.542112324599884,-58.46198317395762 -34.542686997887799,-58.463117606172425 -34.543265266296579,-58.463928033933769 -34.543678379098736,-58.464057914189837 -34.543744225926844,-58.46438765212865 -34.543911513412951)));;3530;13_2_11;COMUNA 13;2;11;613;305;308;99,03%;457;457;100,00%;0;0,00%;293;0;0,00%;293;100,00%
MULTIPOLYGON (((-58.393196370858931 -34.594835660960314,-58.394505626318612 -34.594716664581625,-58.394316860992461 -34.593620764248413,-58.393076657833014 -34.593816056555887,-58.39319597495323 -34.594832290977799,-58.393196370858931 -34.594835660960314)));;3531;2_16_4;COMUNA 2;16;4;534;227;307;73,94%;679;678;99,85%;1;0,15%;284;2;0,70%;282;99,30%
MULTIPOLYGON (((-58.376653446346211 -34.60340471379682,-58.376658703910358 -34.603405036074776,-58.378071018883702 -34.603491519965146,-58.378108309237327 -34.602498269173282,-58.378114647017391 -34.60237960713836,-58.377972504694199 -34.602372184300954,-58.376702766653501 -34.60230284273306,-58.376694981091212 -34.602302417282232,-58.376653446346211 -34.60340471379682)));;3532;1_9_18;COMUNA 1;9;18;395;209;186;112,37%;728;725;99,59%;3;0,41%;169;1;0,59%;168;99,41%
MULTIPOLYGON (((-58.37938327879349 -34.604838177477156,-58.379497914593401 -34.604845509492499,-58.38033159609278 -34.604407889813309,-58.380555987350483 -34.604274444558357,-58.380955935561197 -34.604036535260875,-58.380975118304825 -34.603669421722294,-58.379471157948714 -34.603577274952826,-58.378071018883702 -34.603491519965146,-58.378006464296227 -34.604744338782503,-58.37938327879349 -34.604838177477156)));;3533;1_12_12;COMUNA 1;12;12;499;255;244;104,51%;471;466;98,94%;5;1,07%;90;17;18,89%;73;81,11%
MULTIPOLYGON (((-58.442569755538443 -34.643783975373303,-58.442421403477184 -34.643768316505358,-58.442272373256621 -34.643738431548122,-58.44192259149898 -34.643668229425991,-58.44163722566033 -34.644666689271027,-58.44175513868732 -34.644697164296851,-58.442278161310739 -34.644807338956539,-58.442438781911925 -34.644839901967224,-58.442592074580354 -34.644870984639134,-58.442752269373244 -34.644903476741717,-58.442900364444199 -34.64493357222949,-58.443060474263667 -34.644966063913117,-58.443215130758929 -34.644997427719765,-58.443375326038421 -34.64502991900337,-58.443528278565509 -34.645060930018978,-58.443682168516268 -34.645092152262976,-58.443838529688193 -34.645123867667849,-58.444000344449421 -34.645156710503862,-58.44415099674616 -34.645187297836884,-58.444311874441262 -34.645219928842558,-58.444463719923938 -34.645250727242995,-58.444774398519243 -34.645313732997835,-58.444994583518323 -34.645358414431037,-58.445046232481417 -34.645316448791291,-58.445127455906444 -34.645250472567895,-58.445874739473339 -34.644643446488992,-58.446014256538085 -34.644534096068753,-58.445375946880986 -34.644404988974046,-58.445060925475154 -34.64434127986749,-58.444750079847374 -34.644278345233246,-58.444439149460777 -34.644215480218136,-58.444127452670372 -34.644152403018808,-58.443811921912143 -34.644088620181236,-58.443499373988175 -34.644025329969445,-58.443185803007708 -34.643966193851185,-58.443316282099907 -34.643524088212594,-58.443226622015935 -34.643593653562796,-58.443080801341281 -34.643685041490464,-58.442928937928826 -34.643743962462977,-58.442804604925783 -34.643774365725278,-58.442569755538443 -34.643783975373303)));;3534;7_19_2;COMUNA 7;19;2;1659;829;830;99,88%;267;267;100,00%;0;0,00%;507;86;16,96%;421;83,04%
MULTIPOLYGON (((-58.444463719923938 -34.645250727242995,-58.444311874441262 -34.645219928842558,-58.44415099674616 -34.645187297836884,-58.444000344449421 -34.645156710503862,-58.443838529688193 -34.645123867667849,-58.443682168516268 -34.645092152262976,-58.443528278565509 -34.645060930018978,-58.443375326038421 -34.64502991900337,-58.443215130758929 -34.644997427719765,-58.443060474263667 -34.644966063913117,-58.442900364444199 -34.64493357222949,-58.442752269373244 -34.644903476741717,-58.442592074580354 -34.644870984639134,-58.442438781911925 -34.644839901967224,-58.442278161310739 -34.644807338956539,-58.44175513868732 -34.644697164296851,-58.441467455379886 -34.645683847309023,-58.441837538487924 -34.64575158932157,-58.442150176908548 -34.645814602091946,-58.4424628158026 -34.645877614060332,-58.442775881229373 -34.645940695721031,-58.443084686565214 -34.646002930795852,-58.443398775470058 -34.646066222295069,-58.443707155676428 -34.646128385300543,-58.443975572102829 -34.6461824425554,-58.444038387221127 -34.646131957673454,-58.444408969268963 -34.645834258175469,-58.444994583518323 -34.645358414431037,-58.444774398519243 -34.645313732997835,-58.444463719923938 -34.645250727242995)));;3535;7_19_3;COMUNA 7;19;3;1339;659;680;96,91%;238;238;100,00%;0;0,00%;363;102;28,10%;261;71,90%
MULTIPOLYGON (((-58.443398775470058 -34.646066222295069,-58.443084686565214 -34.646002930795852,-58.442775881229373 -34.645940695721031,-58.4424628158026 -34.645877614060332,-58.442150176908548 -34.645814602091946,-58.441837538487924 -34.64575158932157,-58.441467455379886 -34.645683847309023,-58.44175513868732 -34.644697164296851,-58.44163722566033 -34.644666689271027,-58.44192259149898 -34.643668229425991,-58.441592578690589 -34.643602043932759,-58.441475246612889 -34.643578501708625,-58.440745474104062 -34.644262971279652,-58.440625293306475 -34.644375206591114,-58.440565543734536 -34.644430972139872,-58.440521988686747 -34.644471740139736,-58.440184371867254 -34.644787110585675,-58.439961565524214 -34.644995244703168,-58.439870448146117 -34.645080371158073,-58.439761601364062 -34.645182255291473,-58.439652583847618 -34.645284280143137,-58.439118061659968 -34.645784756772144,-58.438850755569604 -34.646034923758627,-58.43910055672464 -34.646212020053348,-58.439157818575943 -34.646222524401495,-58.439475228490949 -34.646286671740917,-58.439795536072296 -34.646351382195469,-58.439827916218803 -34.646357937769785,-58.440098205455136 -34.646412567305461,-58.440431125262258 -34.646479813715416,-58.440723314607368 -34.646538812193043,-58.44105793965133 -34.646606409321357,-58.441196829997075 -34.646651294422,-58.44139435016254 -34.646692034564595,-58.44155071333978 -34.646724245868135,-58.441711507642495 -34.646757373254815,-58.441859520310935 -34.646787892531961,-58.442014690875055 -34.646819891762263,-58.442175059483816 -34.64685294804034,-58.442324861946105 -34.646883819176956,-58.442485401233725 -34.646916875075149,-58.442796425140259 -34.646981012704991,-58.442943927339783 -34.647011389732278,-58.443180788111277 -34.646821069932159,-58.443393782882531 -34.646649971831664,-58.443655614420763 -34.646439513584831,-58.443975572102829 -34.6461824425554,-58.443707155676428 -34.646128385300543,-58.443398775470058 -34.646066222295069)));;3536;7_19_4;COMUNA 7;19;4;1553;769;784;98,09%;288;288;100,00%;0;0,00%;455;91;20,00%;364;80,00%
MULTIPOLYGON (((-58.439827916218803 -34.646357937769785,-58.439795536072296 -34.646351382195469,-58.439475228490949 -34.646286671740917,-58.439157818575943 -34.646222524401495,-58.43910055672464 -34.646212020053348,-58.438850755569604 -34.646034923758627,-58.437870250053777 -34.646952784399645,-58.438253939718372 -34.647086246282583,-58.438554565033272 -34.647148843300798,-58.438860644355685 -34.647212497013996,-58.439171666390337 -34.647277277707133,-58.439480899477211 -34.647341634717698,-58.43979507534128 -34.647406977817617,-58.440107973504198 -34.647472108596752,-58.440420020026004 -34.647537097567465,-58.440667220532319 -34.647588552500864,-58.440750728706632 -34.647605258210334,-58.441094305549647 -34.647673983633744,-58.441410955752374 -34.647737280690102,-58.441722493657444 -34.647799590098792,-58.44191490431816 -34.647838145346952,-58.442094663077818 -34.6476936644058,-58.442308258967707 -34.647522004930714,-58.442943927339783 -34.647011389732278,-58.442796425140259 -34.646981012704991,-58.442485401233725 -34.646916875075149,-58.442324861946105 -34.646883819176956,-58.442175059483816 -34.64685294804034,-58.442014690875055 -34.646819891762263,-58.441859520310935 -34.646787892531961,-58.441711507642495 -34.646757373254815,-58.44155071333978 -34.646724245868135,-58.44139435016254 -34.646692034564595,-58.441196829997075 -34.646651294422,-58.44105793965133 -34.646606409321357,-58.440723314607368 -34.646538812193043,-58.440431125262258 -34.646479813715416,-58.440098205455136 -34.646412567305461,-58.439827916218803 -34.646357937769785)));;3537;7_19_5;COMUNA 7;19;5;1407;674;733;91,95%;310;310;100,00%;0;0,00%;392;78;19,90%;314;80,10%
MULTIPOLYGON (((-58.39982073903662 -34.654635611885801,-58.399050925939846 -34.654516044297992,-58.398605829799365 -34.654549101837581,-58.398532936398439 -34.654541137145415,-58.398510679220841 -34.654379956221291,-58.398275408528846 -34.654310608644877,-58.39857469677488 -34.653872967396474,-58.398508551950634 -34.653821411283538,-58.398866271258846 -34.652649555208377,-58.398648885952007 -34.652583154817755,-58.398446108523203 -34.653290475833018,-58.398319742412745 -34.653707393246009,-58.398175892144636 -34.654139865083337,-58.398082877169941 -34.654403345203178,-58.398076372030033 -34.654441298959618,-58.39805468278972 -34.654495867620618,-58.398016206693576 -34.654547468990366,-58.397984973061554 -34.654601044429505,-58.397966944422741 -34.654661530131342,-58.397958639518706 -34.654710610559405,-58.397913352494591 -34.654859958154269,-58.397865832787502 -34.654926413705176,-58.397840557150218 -34.654987879825043,-58.397839345463986 -34.655011684340508,-58.397850154271424 -34.655030562227473,-58.397822460276828 -34.655135692498376,-58.397806226706876 -34.655187303978231,-58.39794187323804 -34.655229067446925,-58.397878074581307 -34.65540263178854,-58.397816144971856 -34.655585139357008,-58.397663524031053 -34.6556713974785,-58.397572720265053 -34.655938258149696,-58.397515744860009 -34.656106049459638,-58.397498635595404 -34.6561862538979,-58.397544051224109 -34.656197756829485,-58.397989213343841 -34.656272785888298,-58.398091814481482 -34.656285727442793,-58.398346770231164 -34.656337272755444,-58.398589281368466 -34.656391345726384,-58.399100368903028 -34.656408232478462,-58.399152195006202 -34.65639678084549,-58.399276536967925 -34.656399380320266,-58.399446649136586 -34.656398624691874,-58.399820405357168 -34.65463718402706,-58.39982073903662 -34.654635611885801)));;3538;4_10_9;COMUNA 4;10;9;2091;1034;1057;97,82%;588;588;100,00%;0;0,00%;624;117;18,75%;507;81,25%
MULTIPOLYGON (((-58.402014848644157 -34.657600904818494,-58.399234775330193 -34.657400386200663,-58.399018056895088 -34.658490761115708,-58.39914222670177 -34.658561889390612,-58.399295030785282 -34.65867646011683,-58.399438249557249 -34.658830505389105,-58.399552753683338 -34.659047703159274,-58.399553283913122 -34.65913603928648,-58.399571120150938 -34.659242643739674,-58.399518972509192 -34.659379120947072,-58.399492039886098 -34.659565349387407,-58.399391525881363 -34.659799214501277,-58.399330469863031 -34.659979802435871,-58.399276616590342 -34.660113018436718,-58.399143834296069 -34.66036759337873,-58.399140201091576 -34.660432732993158,-58.399150894991031 -34.660506763007959,-58.399140090312308 -34.660577820837958,-58.399125695351799 -34.660657759726782,-58.399122064381537 -34.660719938361247,-58.39916857281797 -34.660820635838434,-58.39924824032277 -34.660875268934468,-58.399328233771072 -34.660925171095947,-58.399403103562676 -34.660949632167707,-58.39954162022633 -34.660995019919113,-58.399667165023438 -34.661017742847818,-58.399828824255643 -34.66099636088024,-58.399912534025752 -34.660994018968587,-58.399950574951731 -34.660941479342071,-58.400055873454953 -34.660889982743015,-58.400237429017558 -34.66087056829867,-58.400413746474321 -34.66078931818123,-58.400419193305595 -34.660572061320565,-58.400531287107484 -34.660550498199889,-58.400618966499813 -34.660466315147424,-58.400714263326755 -34.66033896567059,-58.400755851103888 -34.660230392189739,-58.400835345112867 -34.660196768277963,-58.401134544666988 -34.659586347220205,-58.40121254001324 -34.659502909863853,-58.40200884656489 -34.657615102769014,-58.402014848644157 -34.657600904818494)));;3539;4_25_1;COMUNA 4;25;1;2357;1193;1164;102,49%;608;608;100,00%;0;0,00%;688;183;26,60%;505;73,40%
MULTIPOLYGON (((-58.399859945252359 -34.654450891851042,-58.399820405446619 -34.654637184764354,-58.399446649136586 -34.656398624691874,-58.399235807456691 -34.657395374819984,-58.399234775330193 -34.657400386200663,-58.402014848644157 -34.657600904818494,-58.402233721255357 -34.657083156950748,-58.402745441095234 -34.655872952144975,-58.401033899603014 -34.656164430970058,-58.401594948762323 -34.654410014526093,-58.399859945252359 -34.654450891851042)));;3540;4_25_2;COMUNA 4;25;2;2215;1099;1116;98,48%;485;485;100,00%;0;0,00%;624;131;20,99%;493;79,01%
MULTIPOLYGON (((-58.401594948762323 -34.654410014526093,-58.401731989374376 -34.654410998643677,-58.401883354528856 -34.654049725636511,-58.401896544565929 -34.653959870428046,-58.401955752545447 -34.653756795393633,-58.402062722306582 -34.653736707199549,-58.402105877770559 -34.653690177991301,-58.40211069832975 -34.653508837035801,-58.402201166964446 -34.653416645496229,-58.402391643751578 -34.652851633577718,-58.402510891363697 -34.652702883641695,-58.402688771142948 -34.652436063676099,-58.402469393744909 -34.652339894685859,-58.402418333942251 -34.652122821881427,-58.40228565401047 -34.652226491681105,-58.402004476381713 -34.65226959276302,-58.401726960520925 -34.652316075408763,-58.401477227264365 -34.652361726279274,-58.401195957403559 -34.652413135553722,-58.400995844445646 -34.652429443390524,-58.400928934187988 -34.652444409956708,-58.40066981657602 -34.652502308300839,-58.40049567909783 -34.652541234828483,-58.400450333973502 -34.652550648586356,-58.400398170081424 -34.652561396911231,-58.400268488770962 -34.652525977428098,-58.399859945252359 -34.654450891851042,-58.401594948762323 -34.654410014526093)));;3541;4_25_4;COMUNA 4;25;4;2028;1065;963;110,59%;469;469;100,00%;0;0,00%;573;159;27,75%;414;72,25%
MULTIPOLYGON (((-58.403427325820459 -34.650710491690077,-58.403516832209988 -34.650249933407345,-58.400858940448153 -34.649780990972715,-58.400857788049962 -34.649786055370164,-58.400759037197929 -34.650219961901023,-58.400565037732434 -34.651072635117401,-58.400631587489038 -34.651082598882759,-58.400947660503547 -34.651095717488403,-58.401199394140001 -34.651106126706253,-58.401365824682586 -34.651113041721132,-58.401476967145705 -34.65109274485522,-58.401522992399677 -34.651084316998862,-58.40172797711903 -34.65104406635286,-58.402038138601725 -34.650983233312367,-58.402315740888824 -34.6509287215803,-58.402560613565001 -34.650880672144559,-58.402869665870412 -34.650819977288954,-58.403132180943878 -34.650768484552067,-58.403230453578999 -34.650749165743619,-58.403427325820459 -34.650710491690077)));;3542;4_26_2;COMUNA 4;26;2;1228;604;624;96,79%;252;252;100,00%;0;0,00%;283;19;6,71%;264;93,29%
MULTIPOLYGON (((-58.465052243172785 -34.677609586589178,-58.464600606224863 -34.677226245597787,-58.464872906458169 -34.677007922146409,-58.464801479604141 -34.676907614711524,-58.464751479730197 -34.676789605340922,-58.464737192302842 -34.676683396378493,-58.464758616449203 -34.676559485280507,-58.464834673948232 -34.676440720827273,-58.464914584379692 -34.676344572432569,-58.464903718676418 -34.676217433325803,-58.465223854473642 -34.676068843581334,-58.464609208341443 -34.675317438318281,-58.464346645613809 -34.674954897504954,-58.464141370891873 -34.674671371587209,-58.463767566490134 -34.674155164760386,-58.463282181789467 -34.673484798347602,-58.462331126646212 -34.672171384231774,-58.461870058554382 -34.671534604492344,-58.462000990414651 -34.671413404904413,-58.461928961779591 -34.671384107915351,-58.461783796656029 -34.671313682499679,-58.461879523458897 -34.671219666591476,-58.461787548665356 -34.671186355190521,-58.460029748121805 -34.672566718122546,-58.459932142079893 -34.672668620047084,-58.459865138422387 -34.672756015181932,-58.45980955696993 -34.672848762803952,-58.459765994489921 -34.672945736152649,-58.459665226857481 -34.673234966659251,-58.459636920533576 -34.673386800932612,-58.45954655699493 -34.673534760264872,-58.459405303884381 -34.673652435676594,-58.459226971100598 -34.673728277787866,-58.45900363143037 -34.673755877578643,-58.459425157913195 -34.673848849816515,-58.45961149909202 -34.673896743259654,-58.459963377730254 -34.674139645354146,-58.460320542277813 -34.674427829400159,-58.460667309488372 -34.674714322028272,-58.460609763782223 -34.674934819760381,-58.460685289156999 -34.67500179460712,-58.460978362006777 -34.674973347653442,-58.4610855131858 -34.675062576794765,-58.461197267763474 -34.675155608813235,-58.461978704372164 -34.675803942630402,-58.462361456756241 -34.67612155814767,-58.463184341653822 -34.676804251323411,-58.463918240569875 -34.677414332294376,-58.464296404323882 -34.677728631753972,-58.464361279086773 -34.677788843695197,-58.464484464674072 -34.677903351924378,-58.464625468542138 -34.678065114474649,-58.465055134888686 -34.678623149322796,-58.465111827432032 -34.678697657151709,-58.465459998525866 -34.679152943016689,-58.465837838044024 -34.679547662181271,-58.465884300849496 -34.679593366357423,-58.465885833631262 -34.679548646876739,-58.465885831087881 -34.679482236746246,-58.465904157110231 -34.679413783829403,-58.465917539844519 -34.679376599436971,-58.465958884062751 -34.679331315501862,-58.465992982836347 -34.679306173103633,-58.466056322203002 -34.679283001775062,-58.466128187009069 -34.679272929097465,-58.46622281373854 -34.679271447488759,-58.465920594712962 -34.679012083074326,-58.465445487846893 -34.678598210944088,-58.465270041360938 -34.678445393977405,-58.464738076307853 -34.677860741224947,-58.465052243172785 -34.677609586589178)));;3543;8_7_14;COMUNA 8;7;14;2062;1037;1025;101,17%;259;259;100,00%;0;0,00%;574;188;32,75%;386;67,25%
MULTIPOLYGON (((-58.464609208341443 -34.675317438318281,-58.465223854473642 -34.676068843581334,-58.464903718676418 -34.676217433325803,-58.464914584379692 -34.676344572432569,-58.464834673948232 -34.676440720827273,-58.464758616449203 -34.676559485280507,-58.464737192302842 -34.676683396378493,-58.464751479730197 -34.676789605340922,-58.464801479604141 -34.676907614711524,-58.464872906458169 -34.677007922146409,-58.464600606224863 -34.677226245597787,-58.465052243172785 -34.677609586589178,-58.465167715612225 -34.677517273789256,-58.465449110382927 -34.677292261998304,-58.465822908716881 -34.676993372079004,-58.466769369432185 -34.676236564091084,-58.466018661400511 -34.675495863434215,-58.466137147379783 -34.67536867374988,-58.46622630688811 -34.675200216120999,-58.466141825689512 -34.675122470034417,-58.465791789480555 -34.674589930325183,-58.465680548622295 -34.674681977751369,-58.465507334839593 -34.674781632349699,-58.465435476526153 -34.674873467362957,-58.465419877887356 -34.674909243291992,-58.465268315454018 -34.675005868814132,-58.465246665117078 -34.675067631439454,-58.465068846109695 -34.675143975039084,-58.464961779346545 -34.675185245751656,-58.464847381332241 -34.675224333343913,-58.464609208341443 -34.675317438318281)));;3544;8_7_9;COMUNA 8;7;9;3088;1558;1530;101,83%;494;494;100,00%;0;0,00%;814;202;24,82%;612;75,18%
MULTIPOLYGON (((-58.44166733742702 -34.576562897465124,-58.441878201702785 -34.576771967516876,-58.442727919962287 -34.576163140159089,-58.442919182403926 -34.576040278788888,-58.44397171183153 -34.575364289450235,-58.443682802408865 -34.575072612698889,-58.443658202605967 -34.575047749784858,-58.443575085009371 -34.57508856585855,-58.443029528542141 -34.575504889160058,-58.443008221324561 -34.575520866539804,-58.442712169446651 -34.57567316734599,-58.44166733742702 -34.576562897465124)));;3545;14_5_1;COMUNA 14;5;1;788;352;436;80,73%;408;408;100,00%;0;0,00%;357;1;0,28%;356;99,72%
MULTIPOLYGON (((-58.441051490013223 -34.575952282064783,-58.44166733742702 -34.576562897465124,-58.442712169446651 -34.57567316734599,-58.443008221324561 -34.575520866539804,-58.443029528542141 -34.575504889160058,-58.443575085009371 -34.57508856585855,-58.443658202605967 -34.575047749784858,-58.443569826045447 -34.57495847611186,-58.443487274643985 -34.57499964069401,-58.442863652340684 -34.575257511147697,-58.442853686127997 -34.575269527807741,-58.441884621815916 -34.57560973643384,-58.441723772022662 -34.575665133778514,-58.441644411401683 -34.575692586065472,-58.441579101134856 -34.575713209457767,-58.441483562577915 -34.575742912455915,-58.441265878071981 -34.575804837425473,-58.441051357966288 -34.575952151025149,-58.441051490013223 -34.575952282064783)));;3546;14_5_2;COMUNA 14;5;2;955;446;509;87,62%;414;414;100,00%;0;0,00%;370;1;0,27%;369;99,73%
MULTIPOLYGON (((-58.442853686153491 -34.575269527831445,-58.442863652344236 -34.575257511167777,-58.443569826045447 -34.57495847611186,-58.443446500878551 -34.574834044422893,-58.443139123598641 -34.574523771106051,-58.442420443427608 -34.573798200407694,-58.441703052501055 -34.573074034126606,-58.44087014650421 -34.573623841069669,-58.440684589413713 -34.573752968180301,-58.441383673928343 -34.574468615681312,-58.440849315996367 -34.574814169680842,-58.440274164579243 -34.575180559786794,-58.440881842548755 -34.575783864474666,-58.440770980515055 -34.575803282049705,-58.440723719854461 -34.575825950565168,-58.440679101852268 -34.575836365499775,-58.440561768112744 -34.575858317035333,-58.440536308910012 -34.575863030924481,-58.440515277380349 -34.575866970932495,-58.440425276027995 -34.575883856664468,-58.44030513228099 -34.575906300418893,-58.440184222119058 -34.575928955190129,-58.440160721255197 -34.575933387660051,-58.440139604660558 -34.575936905034517,-58.44008502510961 -34.575945838974391,-58.440034447475021 -34.57595413980345,-58.439963178958948 -34.575965887609165,-58.439936357485522 -34.575970248991759,-58.439867132854609 -34.575980306910239,-58.439811872404796 -34.575988113792363,-58.439722382805378 -34.576000773570954,-58.439659374262199 -34.576008508499697,-58.439566138777863 -34.576019406818773,-58.439482780481192 -34.576028405456974,-58.43921525200502 -34.576051805972007,-58.439152263135895 -34.575989467259603,-58.439060289452719 -34.576054452227858,-58.438890851111232 -34.576061743547847,-58.438890792246738 -34.576061717251349,-58.438882003513669 -34.576067310266865,-58.438656264638965 -34.57621112804808,-58.438651010722097 -34.576214575591088,-58.438801745857837 -34.576218211615959,-58.438836490894083 -34.576196245655133,-58.439105123128996 -34.576185874903423,-58.439221092199844 -34.576175333439416,-58.439331952288661 -34.576165917695356,-58.439355537854567 -34.576163457315637,-58.439441365376148 -34.576154811362663,-58.43953434518582 -34.576145392026326,-58.439661809237421 -34.576132457857256,-58.439698933269341 -34.576127816774928,-58.439739633457812 -34.576122753800988,-58.439789103753981 -34.576116636077337,-58.439842661085216 -34.576110026120425,-58.439895196931268 -34.576102500417562,-58.439945263518347 -34.576095255933822,-58.439983324368932 -34.576089628982459,-58.44004880282256 -34.576079288601122,-58.440127308937058 -34.576066485701659,-58.440192276605551 -34.576055722595768,-58.440236212877089 -34.576048124734484,-58.440445166202423 -34.57600935855455,-58.440548621431326 -34.575988601847499,-58.440596645170018 -34.575978610130711,-58.440656760091834 -34.575965662707709,-58.44070188887995 -34.575955811277659,-58.440757916777351 -34.575943215195679,-58.440809091262715 -34.575931392898269,-58.44088061634983 -34.575914714858563,-58.440983988462349 -34.575885295429245,-58.441255446408675 -34.575807804932992,-58.441265878076081 -34.575804837436777,-58.441483562598691 -34.57574291247311,-58.441579101155646 -34.575713209474976,-58.441644411422473 -34.575692586082653,-58.441723772043453 -34.575665133795717,-58.441884621836692 -34.57560973645105,-58.442853686153491 -34.575269527831445)));;3547;14_5_3;COMUNA 14;5;3;972;442;530;83,40%;531;527;99,25%;4;0,76%;412;5;1,21%;407;98,79%
MULTIPOLYGON (((-58.366457802742175 -34.646248511352631,-58.366696974113694 -34.646273278082212,-58.366813711930703 -34.645465528532156,-58.366943073557671 -34.64457109588691,-58.365461346602423 -34.644450483151466,-58.364197084227527 -34.644333831192704,-58.362816709172947 -34.643695012857897,-58.362686257522078 -34.643926411098953,-58.363056313869443 -34.644986558648554,-58.363088967212448 -34.645018700931367,-58.363130242128022 -34.645062574990092,-58.363131656770022 -34.645063254946145,-58.363369692581017 -34.645729199804492,-58.363367440434182 -34.645940775115101,-58.363367144356879 -34.645941615012127,-58.365206303023797 -34.646124133224085,-58.366457802742175 -34.646248511352631)));;3548;4_21_11;COMUNA 4;21;11;912;462;450;102,67%;287;287;100,00%;0;0,00%;281;105;37,37%;176;62,63%
MULTIPOLYGON (((-58.366813711930703 -34.645465528532156,-58.366696974113694 -34.646273278082212,-58.366457802742175 -34.646248511352631,-58.365206303023797 -34.646124133224085,-58.363367144356879 -34.645941615012127,-58.363788072408319 -34.64706473410245,-58.364037696299093 -34.647506840029429,-58.364290846523943 -34.647841336183852,-58.364449328946293 -34.647964059052732,-58.364521194276165 -34.648052725255063,-58.36450406146934 -34.648052577433582,-58.364332139717668 -34.648130156447863,-58.364254562105963 -34.648287588503038,-58.364348147368823 -34.648320200339299,-58.364650039321084 -34.648566295865457,-58.365132752291963 -34.648896763307981,-58.367526970032735 -34.650079324327855,-58.367645644112748 -34.650144190593601,-58.367680599140975 -34.649955176407488,-58.367680677044454 -34.649955215160688,-58.368076772448973 -34.647933561440219,-58.368119827699893 -34.647690348103517,-58.36817298157461 -34.64733389972659,-58.368272161300823 -34.646668393118205,-58.368305314583878 -34.646439045655725,-58.368336834946625 -34.646221739530027,-58.368391537796114 -34.645850291713806,-58.368421598772649 -34.645642069199212,-58.368521916887985 -34.644945928342807,-58.368553945882276 -34.64472996056864,-58.366943073557671 -34.64457109588691,-58.366813711930703 -34.645465528532156)));;3549;4_21_12;COMUNA 4;21;12;557;261;296;88,18%;201;201;100,00%;0;0,00%;190;33;17,37%;157;82,63%
MULTIPOLYGON (((-58.382117549366896 -34.584299184567634,-58.381249553736332 -34.584764229038718,-58.380846431992012 -34.58450851057308,-58.380007787477297 -34.584984311381916,-58.379928730857664 -34.585049587684495,-58.379971750667345 -34.585116926461708,-58.379866365222533 -34.585180205190412,-58.379691728029421 -34.585323983572827,-58.379282162789053 -34.585541752329803,-58.378903907697698 -34.585790794492702,-58.378857724486849 -34.585784650725593,-58.378560058013647 -34.585984518300542,-58.378643050819321 -34.586109784816131,-58.37983700218237 -34.585506650491489,-58.380018099839624 -34.585488360172683,-58.381190321455435 -34.584825730174508,-58.38144875285748 -34.584987392546068,-58.381900408214833 -34.584756360307537,-58.382217353189333 -34.584439045375206,-58.382117549366896 -34.584299184567634)));;3550;1_3_12;COMUNA 1;3;12;561;269;292;92,12%;170;170;100,00%;0;0,00%;181;70;38,67%;111;61,33%
MULTIPOLYGON (((-58.381190321486109 -34.584825730194943,-58.380018099852279 -34.585488360173549,-58.379837002171996 -34.585506650486501,-58.378643050845859 -34.5861097848125,-58.377882388527546 -34.586490205797361,-58.378103668731953 -34.586856985289351,-58.381562054773198 -34.585152776980749,-58.38144875288824 -34.58498739255176,-58.381190321486109 -34.584825730194943)));;3551;1_3_11;COMUNA 1;3;11;745;377;368;102,45%;223;223;100,00%;0;0,00%;267;95;35,58%;172;64,42%
MULTIPOLYGON (((-58.380861378161157 -34.58431132888478,-58.380468481701357 -34.584542159109994,-58.380286289220614 -34.584350086730069,-58.380182590024049 -34.584355613829885,-58.380108592526078 -34.584391246650867,-58.380138131028083 -34.584438164168922,-58.38011462493192 -34.584523787188793,-58.379949366493648 -34.584600138584761,-58.379804883011872 -34.584670527338716,-58.379749019275316 -34.584608271682804,-58.379522416595286 -34.584732662209341,-58.379460502817118 -34.584771328375616,-58.379622917847321 -34.584978102397784,-58.379217296410232 -34.585162234477664,-58.378985234151493 -34.585282594011339,-58.379008089369457 -34.58532131414016,-58.378880074763281 -34.585411141442009,-58.378774246588542 -34.585483731575287,-58.37865189332436 -34.585569918461836,-58.378559989627789 -34.585633950274293,-58.378474652094283 -34.58565962291047,-58.378354848405046 -34.585725130473548,-58.378301561427051 -34.585778863751472,-58.378291095975975 -34.585840443948939,-58.378360143318453 -34.585876617114494,-58.378554984494016 -34.585774559575896,-58.378747412826392 -34.585643519438293,-58.37886143433645 -34.58578215974137,-58.378857724486849 -34.585784650725593,-58.378903907697698 -34.585790794492702,-58.379282162789053 -34.585541752329803,-58.379691728029421 -34.585323983572827,-58.379866365222533 -34.585180205190412,-58.379971750667345 -34.585116926461708,-58.379928730857664 -34.585049587684495,-58.380007787477297 -34.584984311381916,-58.380846431992012 -34.58450851057308,-58.38099776905721 -34.584435428339937,-58.380861378161157 -34.58431132888478)));;3552;1_3_10;COMUNA 1;3;10;745;367;378;97,09%;261;261;100,00%;0;0,00%;261;86;32,95%;175;67,05%
MULTIPOLYGON (((-58.435320400685285 -34.649051809494424,-58.434962898785358 -34.649339695153969,-58.434801419644785 -34.649472194066838,-58.434763202166977 -34.649437433594564,-58.434727532620528 -34.649404779859644,-58.434622314075256 -34.649490255560544,-58.434361024012539 -34.649767245727006,-58.434293510205777 -34.649826598004381,-58.434271681806507 -34.649862579917055,-58.434156344410106 -34.649966922313887,-58.434116942690906 -34.650055436875512,-58.434077910206639 -34.650061202541721,-58.434057011243048 -34.650119931795786,-58.434017968828151 -34.650154430698912,-58.434003981297828 -34.650187879118171,-58.433991448073421 -34.650205130208022,-58.433977550941563 -34.650223507769709,-58.433948318623912 -34.65022927570223,-58.433931261802833 -34.650513294294768,-58.435349634923618 -34.650595524538964,-58.435389212454133 -34.650227564611441,-58.435393824727491 -34.650195804126,-58.435403044254386 -34.650147565302788,-58.435387713909208 -34.650119603282612,-58.435366155456649 -34.650113260233276,-58.435432341516368 -34.649943058660625,-58.435450681643673 -34.649888131528563,-58.435660395497969 -34.649921277799514,-58.435747236968325 -34.649912000970303,-58.435546427048862 -34.649491309934461,-58.435356005168146 -34.649103016215399,-58.435320400685285 -34.649051809494424)));;3553;7_18_11;COMUNA 7;18;11;1325;685;640;107,03%;223;223;100,00%;0;0,00%;403;143;35,48%;260;64,52%
MULTIPOLYGON (((-58.430517283241144 -34.649810096012821,-58.430429908696411 -34.649874300207941,-58.430846751902024 -34.650226180950597,-58.430983059440102 -34.650341290359705,-58.431310893762436 -34.650357150310235,-58.431114183438559 -34.65019350305198,-58.432292110379812 -34.649199899276688,-58.432566396187525 -34.64929039263189,-58.433130534381633 -34.649316587857363,-58.433154987019364 -34.649331030840131,-58.433281155993996 -34.649444022501136,-58.433358183595601 -34.649472985595395,-58.43348080944638 -34.649484564684258,-58.433573182365663 -34.649496911098694,-58.433550796582459 -34.6499073406573,-58.433545905208661 -34.650490948582345,-58.433931261802833 -34.650513294294768,-58.433948318623912 -34.65022927570223,-58.433977550941563 -34.650223507769709,-58.433991448073421 -34.650205130208022,-58.434003981297828 -34.650187879118171,-58.434017968828151 -34.650154430698912,-58.434057011243048 -34.650119931795786,-58.434077910206639 -34.650061202541721,-58.434116942690906 -34.650055436875512,-58.434156344410106 -34.649966922313887,-58.434271681806507 -34.649862579917055,-58.434293510205777 -34.649826598004381,-58.434361024012539 -34.649767245727006,-58.434622314075256 -34.649490255560544,-58.434727532620528 -34.649404779859644,-58.434335875143276 -34.649043696905153,-58.43389696005724 -34.648667455871617,-58.433453019860409 -34.64829473326472,-58.433422265704195 -34.648267964508484,-58.432967003287978 -34.647874462109733,-58.43284016457055 -34.647973518640399,-58.431961911720485 -34.648675082300052,-58.430816231128055 -34.649590167913843,-58.430589484358855 -34.649757014855581,-58.430517283241144 -34.649810096012821)));;3554;7_18_9;COMUNA 7;18;9;1203;594;609;97,54%;274;274;100,00%;0;0,00%;377;160;42,44%;217;57,56%
